"job_name";"taxonomy";"coverage";"specificity";"accessions";"eligible";"match";"mismat";"nodata";"outgroup_matchable";"outgroup_matched"
"LOK1378_1mm";"SILVA (only NR);Unclassified;";"0.0";"0";"0";"0";"0";"0";"0";"430524";"5766"
"LOK1378_1mm";"SILVA (only NR);Archaea;";"55.0";"100";"20197";"10485";"5765";"4720";"9712";"420039";"1"
"LOK1378_1mm";"SILVA (only NR);Archaea;Aenigmarchaeota;";"30.3";"98.7";"319";"132";"40";"92";"187";"430392";"5726"
"LOK1378_1mm";"SILVA (only NR);Archaea;Aenigmarchaeota;Aenigmarchaeia;";"10.0";"98.7";"161";"50";"5";"45";"111";"430474";"5761"
"LOK1378_1mm";"SILVA (only NR);Archaea;Aenigmarchaeota;Aenigmarchaeia;Aenigmarchaeales;";"10.0";"98.7";"161";"50";"5";"45";"111";"430474";"5761"
"LOK1378_1mm";"SILVA (only NR);Archaea;Aenigmarchaeota;Aenigmarchaeia;Aenigmarchaeales;Candidatus Aenigmarchaeum;";"25.0";"98.7";"16";"8";"2";"6";"8";"430516";"5764"
"LOK1378_1mm";"SILVA (only NR);Archaea;Aenigmarchaeota;Deep Sea Euryarchaeotic Group(DSEG);";"43.8";"98.7";"155";"80";"35";"45";"75";"430444";"5731"
"LOK1378_1mm";"SILVA (only NR);Archaea;Altiarchaeota;";"0.0";"0";"41";"24";"0";"24";"17";"430500";"5766"
"LOK1378_1mm";"SILVA (only NR);Archaea;Altiarchaeota;Altiarchaeia;";"0.0";"0";"41";"24";"0";"24";"17";"430500";"5766"
"LOK1378_1mm";"SILVA (only NR);Archaea;Altiarchaeota;Altiarchaeia;Altiarchaeales;";"0.0";"0";"41";"24";"0";"24";"17";"430500";"5766"
"LOK1378_1mm";"SILVA (only NR);Archaea;Altiarchaeota;Altiarchaeia;Altiarchaeales;Altiarchaeaceae;";"0.0";"0";"41";"24";"0";"24";"17";"430500";"5766"
"LOK1378_1mm";"SILVA (only NR);Archaea;Altiarchaeota;Altiarchaeia;Altiarchaeales;Altiarchaeaceae;Candidatus Altiarchaeum;";"0.0";"0";"41";"24";"0";"24";"17";"430500";"5766"
"LOK1378_1mm";"SILVA (only NR);Archaea;Asgardarchaeota;";"77.4";"98.7";"670";"328";"254";"74";"342";"430196";"5512"
"LOK1378_1mm";"SILVA (only NR);Archaea;Asgardarchaeota;Heimdallarchaeia;";"5.1";"98.7";"45";"39";"2";"37";"6";"430485";"5764"
"LOK1378_1mm";"SILVA (only NR);Archaea;Asgardarchaeota;Lokiarchaeia;";"94.6";"98.7";"527";"239";"226";"13";"288";"430285";"5540"
"LOK1378_1mm";"SILVA (only NR);Archaea;Asgardarchaeota;Odinarchaeia;";"54.2";"98.7";"95";"48";"26";"22";"47";"430476";"5740"
"LOK1378_1mm";"SILVA (only NR);Archaea;Crenarchaeota;";"57.4";"99";"7625";"2778";"1594";"1184";"4847";"427746";"4172"
"LOK1378_1mm";"SILVA (only NR);Archaea;Crenarchaeota;Bathyarchaeia;";"49.7";"98.8";"3641";"794";"395";"399";"2847";"429730";"5371"
"LOK1378_1mm";"SILVA (only NR);Archaea;Crenarchaeota;Methanomethylicia;";"69.2";"98.7";"34";"13";"9";"4";"21";"430511";"5757"
"LOK1378_1mm";"SILVA (only NR);Archaea;Crenarchaeota;Methanomethylicia;Methanomethyliales;";"69.2";"98.7";"34";"13";"9";"4";"21";"430511";"5757"
"LOK1378_1mm";"SILVA (only NR);Archaea;Crenarchaeota;Methanomethylicia;Methanomethyliales;Methanomethyliaceae;";"69.2";"98.7";"34";"13";"9";"4";"21";"430511";"5757"
"LOK1378_1mm";"SILVA (only NR);Archaea;Crenarchaeota;Methanomethylicia;Methanomethyliales;Methanomethyliaceae;Candidatus Methanomethylicus;";"88.9";"98.7";"28";"9";"8";"1";"19";"430515";"5758"
"LOK1378_1mm";"SILVA (only NR);Archaea;Crenarchaeota;Nitrososphaeria;";"66.2";"98.9";"3259";"1519";"1005";"514";"1740";"429005";"4761"
"LOK1378_1mm";"SILVA (only NR);Archaea;Crenarchaeota;Nitrososphaeria;Caldiarchaeales;";"8.4";"98.7";"170";"83";"7";"76";"87";"430441";"5759"
"LOK1378_1mm";"SILVA (only NR);Archaea;Crenarchaeota;Nitrososphaeria;Caldiarchaeales;Caldiarchaeaceae;";"6.5";"98.7";"58";"31";"2";"29";"27";"430493";"5764"
"LOK1378_1mm";"SILVA (only NR);Archaea;Crenarchaeota;Nitrososphaeria;Caldiarchaeales;Caldiarchaeaceae;Candidatus Caldiarchaeum;";"6.5";"98.7";"58";"31";"2";"29";"27";"430493";"5764"
"LOK1378_1mm";"SILVA (only NR);Archaea;Crenarchaeota;Nitrososphaeria;Caldiarchaeales;Geothermarchaeaceae;";"26.3";"98.7";"66";"19";"5";"14";"47";"430505";"5761"
"LOK1378_1mm";"SILVA (only NR);Archaea;Crenarchaeota;Nitrososphaeria;Caldiarchaeales;Terrestrial Hot Spring Gp(THSCG);";"0.0";"0";"46";"33";"0";"33";"13";"430491";"5766"
"LOK1378_1mm";"SILVA (only NR);Archaea;Crenarchaeota;Nitrososphaeria;Group 1.1c;";"90.5";"98.7";"233";"42";"38";"4";"191";"430482";"5728"
"LOK1378_1mm";"SILVA (only NR);Archaea;Crenarchaeota;Nitrososphaeria;Marine Benthic Group A;";"74.5";"98.7";"131";"55";"41";"14";"76";"430469";"5725"
"LOK1378_1mm";"SILVA (only NR);Archaea;Crenarchaeota;Nitrososphaeria;Nitrosocaldales;";"62.5";"98.7";"37";"24";"15";"9";"13";"430500";"5751"
"LOK1378_1mm";"SILVA (only NR);Archaea;Crenarchaeota;Nitrososphaeria;Nitrosocaldales;Nitrosocaldaceae;";"62.5";"98.7";"37";"24";"15";"9";"13";"430500";"5751"
"LOK1378_1mm";"SILVA (only NR);Archaea;Crenarchaeota;Nitrososphaeria;Nitrosocaldales;Nitrosocaldaceae;Candidatus Nitrosocaldus;";"71.4";"98.7";"18";"14";"10";"4";"4";"430510";"5756"
"LOK1378_1mm";"SILVA (only NR);Archaea;Crenarchaeota;Nitrososphaeria;Nitrosocaldales;Nitrosocaldaceae;uncultured;";"50.0";"98.7";"19";"10";"5";"5";"9";"430514";"5761"
"LOK1378_1mm";"SILVA (only NR);Archaea;Crenarchaeota;Nitrososphaeria;Nitrosopumilales;";"80.1";"98.8";"1831";"899";"720";"179";"932";"429625";"5046"
"LOK1378_1mm";"SILVA (only NR);Archaea;Crenarchaeota;Nitrososphaeria;Nitrosopumilales;Nitrosopumilaceae;";"80.1";"98.8";"1831";"899";"720";"179";"932";"429625";"5046"
"LOK1378_1mm";"SILVA (only NR);Archaea;Crenarchaeota;Nitrososphaeria;Nitrosopumilales;Nitrosopumilaceae;Candidatus Nitrosopelagicus;";"96.9";"98.7";"51";"32";"31";"1";"19";"430492";"5735"
"LOK1378_1mm";"SILVA (only NR);Archaea;Crenarchaeota;Nitrososphaeria;Nitrosopumilales;Nitrosopumilaceae;Candidatus Nitrosopumilus;";"75.0";"98.7";"717";"392";"294";"98";"325";"430132";"5472"
"LOK1378_1mm";"SILVA (only NR);Archaea;Crenarchaeota;Nitrososphaeria;Nitrosopumilales;Nitrosopumilaceae;Candidatus Nitrosotenuis;";"59.1";"98.7";"34";"22";"13";"9";"12";"430502";"5753"
"LOK1378_1mm";"SILVA (only NR);Archaea;Crenarchaeota;Nitrososphaeria;Nitrosopumilales;Nitrosopumilaceae;Cenarchaeum;";"66.7";"98.7";"27";"18";"12";"6";"9";"430506";"5754"
"LOK1378_1mm";"SILVA (only NR);Archaea;Crenarchaeota;Nitrososphaeria;Nitrosopumilales;Nitrosopumilaceae;Nitrosarchaeum;";"68.8";"98.7";"63";"32";"22";"10";"31";"430492";"5744"
"LOK1378_1mm";"SILVA (only NR);Archaea;Crenarchaeota;Nitrososphaeria;Nitrososphaerales;";"38.8";"98.7";"603";"325";"126";"199";"278";"430199";"5640"
"LOK1378_1mm";"SILVA (only NR);Archaea;Crenarchaeota;Nitrososphaeria;Nitrososphaerales;Nitrososphaeraceae;";"38.8";"98.7";"603";"325";"126";"199";"278";"430199";"5640"
"LOK1378_1mm";"SILVA (only NR);Archaea;Crenarchaeota;Nitrososphaeria;Nitrososphaerales;Nitrososphaeraceae;Candidatus Nitrocosmicus;";"32.4";"98.7";"49";"37";"12";"25";"12";"430487";"5754"
"LOK1378_1mm";"SILVA (only NR);Archaea;Crenarchaeota;Nitrososphaeria;Nitrososphaerales;Nitrososphaeraceae;Candidatus Nitrososphaera;";"30.9";"98.7";"233";"152";"47";"105";"81";"430372";"5719"
"LOK1378_1mm";"SILVA (only NR);Archaea;Crenarchaeota;Nitrososphaeria;Nitrosotaleales;";"73.3";"98.7";"141";"45";"33";"12";"96";"430479";"5733"
"LOK1378_1mm";"SILVA (only NR);Archaea;Crenarchaeota;Nitrososphaeria;Nitrosotaleales;Nitrosotaleaceae;";"73.3";"98.7";"141";"45";"33";"12";"96";"430479";"5733"
"LOK1378_1mm";"SILVA (only NR);Archaea;Crenarchaeota;Nitrososphaeria;Nitrosotaleales;Nitrosotaleaceae;Candidatus Nitrosotalea;";"100.0";"98.7";"17";"3";"3";"0";"14";"430521";"5763"
"LOK1378_1mm";"SILVA (only NR);Archaea;Crenarchaeota;Nitrososphaeria;SCGC AB-179-E04;";"48.6";"98.7";"57";"35";"17";"18";"22";"430489";"5749"
"LOK1378_1mm";"SILVA (only NR);Archaea;Crenarchaeota;Nitrososphaeria;uncultured;";"72.7";"98.7";"56";"11";"8";"3";"45";"430513";"5758"
"LOK1378_1mm";"SILVA (only NR);Archaea;Crenarchaeota;Thermoprotei;";"40.9";"98.7";"691";"452";"185";"267";"239";"430072";"5581"
"LOK1378_1mm";"SILVA (only NR);Archaea;Crenarchaeota;Thermoprotei;Desulfurococcales;";"44.3";"98.7";"219";"97";"43";"54";"122";"430427";"5723"
"LOK1378_1mm";"SILVA (only NR);Archaea;Crenarchaeota;Thermoprotei;Desulfurococcales;Acidilobaceae;";"24.3";"98.7";"71";"37";"9";"28";"34";"430487";"5757"
"LOK1378_1mm";"SILVA (only NR);Archaea;Crenarchaeota;Thermoprotei;Desulfurococcales;Acidilobaceae;Acidilobus;";"0.0";"0";"10";"9";"0";"9";"1";"430515";"5766"
"LOK1378_1mm";"SILVA (only NR);Archaea;Crenarchaeota;Thermoprotei;Desulfurococcales;Acidilobaceae;Aeropyrum;";"63.6";"98.7";"27";"11";"7";"4";"16";"430513";"5759"
"LOK1378_1mm";"SILVA (only NR);Archaea;Crenarchaeota;Thermoprotei;Desulfurococcales;Acidilobaceae;Caldisphaera;";"0.0";"0";"13";"13";"0";"13";"0";"430511";"5766"
"LOK1378_1mm";"SILVA (only NR);Archaea;Crenarchaeota;Thermoprotei;Desulfurococcales;Acidilobaceae;Stetteria;";"0.0";"0";"4";"1";"0";"1";"3";"430523";"5766"
"LOK1378_1mm";"SILVA (only NR);Archaea;Crenarchaeota;Thermoprotei;Desulfurococcales;Acidilobaceae;Thermodiscus;";"66.7";"98.7";"12";"3";"2";"1";"9";"430521";"5764"
"LOK1378_1mm";"SILVA (only NR);Archaea;Crenarchaeota;Thermoprotei;Desulfurococcales;Desulfurococcaceae;";"66.7";"98.7";"44";"27";"18";"9";"17";"430497";"5748"
"LOK1378_1mm";"SILVA (only NR);Archaea;Crenarchaeota;Thermoprotei;Desulfurococcales;Desulfurococcaceae;Desulfurococcus;";"100.0";"98.7";"9";"8";"8";"0";"1";"430516";"5758"
"LOK1378_1mm";"SILVA (only NR);Archaea;Crenarchaeota;Thermoprotei;Desulfurococcales;Desulfurococcaceae;Staphylothermus;";"44.4";"98.7";"16";"9";"4";"5";"7";"430515";"5762"
"LOK1378_1mm";"SILVA (only NR);Archaea;Crenarchaeota;Thermoprotei;Desulfurococcales;Desulfurococcaceae;Sulfophobococcus;";"100.0";"98.7";"1";"1";"1";"0";"0";"430523";"5765"
"LOK1378_1mm";"SILVA (only NR);Archaea;Crenarchaeota;Thermoprotei;Desulfurococcales;Desulfurococcaceae;Thermogladius;";"50.0";"98.7";"4";"4";"2";"2";"0";"430520";"5764"
"LOK1378_1mm";"SILVA (only NR);Archaea;Crenarchaeota;Thermoprotei;Desulfurococcales;Desulfurococcaceae;Thermosphaera;";"60.0";"98.7";"9";"5";"3";"2";"4";"430519";"5763"
"LOK1378_1mm";"SILVA (only NR);Archaea;Crenarchaeota;Thermoprotei;Desulfurococcales;Desulfurococcaceae;uncultured;";"0.0";"0";"3";"0";"0";"0";"3";"430524";"5766"
"LOK1378_1mm";"SILVA (only NR);Archaea;Crenarchaeota;Thermoprotei;Desulfurococcales;Ignicoccaceae;";"85.7";"98.7";"11";"7";"6";"1";"4";"430517";"5760"
"LOK1378_1mm";"SILVA (only NR);Archaea;Crenarchaeota;Thermoprotei;Desulfurococcales;Ignicoccaceae;Ignicoccus;";"85.7";"98.7";"11";"7";"6";"1";"4";"430517";"5760"
"LOK1378_1mm";"SILVA (only NR);Archaea;Crenarchaeota;Thermoprotei;Desulfurococcales;Ignisphaeraceae;";"47.1";"98.7";"54";"17";"8";"9";"37";"430507";"5758"
"LOK1378_1mm";"SILVA (only NR);Archaea;Crenarchaeota;Thermoprotei;Desulfurococcales;Ignisphaeraceae;Ignisphaera;";"72.7";"98.7";"29";"11";"8";"3";"18";"430513";"5758"
"LOK1378_1mm";"SILVA (only NR);Archaea;Crenarchaeota;Thermoprotei;Desulfurococcales;Ignisphaeraceae;uncultured;";"0.0";"0";"24";"6";"0";"6";"18";"430518";"5766"
"LOK1378_1mm";"SILVA (only NR);Archaea;Crenarchaeota;Thermoprotei;Desulfurococcales;Pyrodictiaceae;";"28.6";"98.7";"30";"7";"2";"5";"23";"430517";"5764"
"LOK1378_1mm";"SILVA (only NR);Archaea;Crenarchaeota;Thermoprotei;Desulfurococcales;Pyrodictiaceae;Hyperthermus;";"0.0";"0";"3";"0";"0";"0";"3";"430524";"5766"
"LOK1378_1mm";"SILVA (only NR);Archaea;Crenarchaeota;Thermoprotei;Desulfurococcales;Pyrodictiaceae;Pyrodictium;";"40.0";"98.7";"10";"5";"2";"3";"5";"430519";"5764"
"LOK1378_1mm";"SILVA (only NR);Archaea;Crenarchaeota;Thermoprotei;Desulfurococcales;Pyrodictiaceae;uncultured;";"0.0";"0";"13";"1";"0";"1";"12";"430523";"5766"
"LOK1378_1mm";"SILVA (only NR);Archaea;Crenarchaeota;Thermoprotei;Desulfurococcales;uncultured;";"0.0";"0";"8";"2";"0";"2";"6";"430522";"5766"
"LOK1378_1mm";"SILVA (only NR);Archaea;Crenarchaeota;Thermoprotei;Fervidicoccales;";"40.0";"98.7";"36";"20";"8";"12";"16";"430504";"5758"
"LOK1378_1mm";"SILVA (only NR);Archaea;Crenarchaeota;Thermoprotei;Fervidicoccales;Fervidicoccaceae;";"40.0";"98.7";"36";"20";"8";"12";"16";"430504";"5758"
"LOK1378_1mm";"SILVA (only NR);Archaea;Crenarchaeota;Thermoprotei;Fervidicoccales;Fervidicoccaceae;Fervidicoccus;";"62.5";"98.7";"15";"8";"5";"3";"7";"430516";"5761"
"LOK1378_1mm";"SILVA (only NR);Archaea;Crenarchaeota;Thermoprotei;Fervidicoccales;Fervidicoccaceae;uncultured;";"25.0";"98.7";"21";"12";"3";"9";"9";"430512";"5763"
"LOK1378_1mm";"SILVA (only NR);Archaea;Crenarchaeota;Thermoprotei;Geoarchaeales;";"9.5";"98.7";"54";"42";"4";"38";"12";"430482";"5762"
"LOK1378_1mm";"SILVA (only NR);Archaea;Crenarchaeota;Thermoprotei;Geoarchaeales;SCGC AAA261-C22;";"0.0";"0";"10";"9";"0";"9";"1";"430515";"5766"
"LOK1378_1mm";"SILVA (only NR);Archaea;Crenarchaeota;Thermoprotei;Geoarchaeales;SCGC AAA471-B05;";"0.0";"0";"3";"2";"0";"2";"1";"430522";"5766"
"LOK1378_1mm";"SILVA (only NR);Archaea;Crenarchaeota;Thermoprotei;Sulfolobales;";"64.6";"98.7";"211";"181";"117";"64";"30";"430343";"5649"
"LOK1378_1mm";"SILVA (only NR);Archaea;Crenarchaeota;Thermoprotei;Sulfolobales;Sulfolobaceae;";"64.6";"98.7";"211";"181";"117";"64";"30";"430343";"5649"
"LOK1378_1mm";"SILVA (only NR);Archaea;Crenarchaeota;Thermoprotei;Sulfolobales;Sulfolobaceae;Acidianus;";"80.0";"98.7";"27";"25";"20";"5";"2";"430499";"5746"
"LOK1378_1mm";"SILVA (only NR);Archaea;Crenarchaeota;Thermoprotei;Sulfolobales;Sulfolobaceae;Metallosphaera;";"50.0";"98.7";"46";"40";"20";"20";"6";"430484";"5746"
"LOK1378_1mm";"SILVA (only NR);Archaea;Crenarchaeota;Thermoprotei;Sulfolobales;Sulfolobaceae;Saccharolobus;";"81.8";"98.7";"51";"44";"36";"8";"7";"430480";"5730"
"LOK1378_1mm";"SILVA (only NR);Archaea;Crenarchaeota;Thermoprotei;Sulfolobales;Sulfolobaceae;Stygiolobus;";"33.3";"98.7";"18";"18";"6";"12";"0";"430506";"5760"
"LOK1378_1mm";"SILVA (only NR);Archaea;Crenarchaeota;Thermoprotei;Sulfolobales;Sulfolobaceae;Sulfolobus;";"78.8";"98.7";"35";"33";"26";"7";"2";"430491";"5740"
"LOK1378_1mm";"SILVA (only NR);Archaea;Crenarchaeota;Thermoprotei;Sulfolobales;Sulfolobaceae;Sulfurisphaera;";"50.0";"98.7";"4";"4";"2";"2";"0";"430520";"5764"
"LOK1378_1mm";"SILVA (only NR);Archaea;Crenarchaeota;Thermoprotei;Sulfolobales;Sulfolobaceae;uncultured;";"38.5";"98.7";"25";"13";"5";"8";"12";"430511";"5761"
"LOK1378_1mm";"SILVA (only NR);Archaea;Crenarchaeota;Thermoprotei;Terrestrial Miscellaneous Gp(TMCG);";"0.0";"0";"10";"3";"0";"3";"7";"430521";"5766"
"LOK1378_1mm";"SILVA (only NR);Archaea;Crenarchaeota;Thermoprotei;Thermoproteales;";"11.1";"98.7";"156";"108";"12";"96";"48";"430416";"5754"
"LOK1378_1mm";"SILVA (only NR);Archaea;Crenarchaeota;Thermoprotei;Thermoproteales;Thermofilaceae;";"47.1";"98.7";"46";"17";"8";"9";"29";"430507";"5758"
"LOK1378_1mm";"SILVA (only NR);Archaea;Crenarchaeota;Thermoprotei;Thermoproteales;Thermofilaceae;Thermofilum;";"47.1";"98.7";"46";"17";"8";"9";"29";"430507";"5758"
"LOK1378_1mm";"SILVA (only NR);Archaea;Crenarchaeota;Thermoprotei;Thermoproteales;Thermoproteaceae;";"4.4";"98.7";"110";"91";"4";"87";"19";"430433";"5762"
"LOK1378_1mm";"SILVA (only NR);Archaea;Crenarchaeota;Thermoprotei;Thermoproteales;Thermoproteaceae;Caldivirga;";"0.0";"0";"5";"4";"0";"4";"1";"430520";"5766"
"LOK1378_1mm";"SILVA (only NR);Archaea;Crenarchaeota;Thermoprotei;Thermoproteales;Thermoproteaceae;Pyrobaculum;";"4.0";"98.7";"32";"25";"1";"24";"7";"430499";"5765"
"LOK1378_1mm";"SILVA (only NR);Archaea;Crenarchaeota;Thermoprotei;Thermoproteales;Thermoproteaceae;Thermocladium;";"0.0";"0";"7";"6";"0";"6";"1";"430518";"5766"
"LOK1378_1mm";"SILVA (only NR);Archaea;Crenarchaeota;Thermoprotei;Thermoproteales;Thermoproteaceae;Thermoproteus;";"0.0";"0";"9";"9";"0";"9";"0";"430515";"5766"
"LOK1378_1mm";"SILVA (only NR);Archaea;Crenarchaeota;Thermoprotei;Thermoproteales;Thermoproteaceae;Vulcanisaeta;";"4.0";"98.7";"31";"25";"1";"24";"6";"430499";"5765"
"LOK1378_1mm";"SILVA (only NR);Archaea;Crenarchaeota;Thermoprotei;Thermoproteales;Thermoproteaceae;uncultured;";"5.9";"98.7";"18";"17";"1";"16";"1";"430507";"5765"
"LOK1378_1mm";"SILVA (only NR);Archaea;Crenarchaeota;Thermoprotei;uncultured;";"100.0";"98.7";"3";"1";"1";"0";"2";"430523";"5765"
"LOK1378_1mm";"SILVA (only NR);Archaea;Euryarchaeota;";"79.2";"98.9";"1993";"1482";"1174";"308";"511";"429042";"4592"
"LOK1378_1mm";"SILVA (only NR);Archaea;Euryarchaeota;Methanobacteria;";"85.6";"98.9";"1500";"1148";"983";"165";"352";"429376";"4783"
"LOK1378_1mm";"SILVA (only NR);Archaea;Euryarchaeota;Methanobacteria;Methanobacteriales;";"85.6";"98.9";"1500";"1148";"983";"165";"352";"429376";"4783"
"LOK1378_1mm";"SILVA (only NR);Archaea;Euryarchaeota;Methanobacteria;Methanobacteriales;Methanobacteriaceae;";"85.5";"98.9";"1451";"1123";"960";"163";"328";"429401";"4806"
"LOK1378_1mm";"SILVA (only NR);Archaea;Euryarchaeota;Methanobacteria;Methanobacteriales;Methanobacteriaceae;Methanobacterium;";"72.0";"98.7";"216";"132";"95";"37";"84";"430392";"5671"
"LOK1378_1mm";"SILVA (only NR);Archaea;Euryarchaeota;Methanobacteria;Methanobacteriales;Methanobacteriaceae;Methanobrevibacter;";"87.0";"98.8";"1030";"866";"753";"113";"164";"429658";"5013"
"LOK1378_1mm";"SILVA (only NR);Archaea;Euryarchaeota;Methanobacteria;Methanobacteriales;Methanobacteriaceae;Methanosphaera;";"89.1";"98.7";"198";"119";"106";"13";"79";"430405";"5660"
"LOK1378_1mm";"SILVA (only NR);Archaea;Euryarchaeota;Methanobacteria;Methanobacteriales;Methanobacteriaceae;uncultured;";"100.0";"98.7";"6";"6";"6";"0";"0";"430518";"5760"
"LOK1378_1mm";"SILVA (only NR);Archaea;Euryarchaeota;Methanobacteria;Methanobacteriales;Methanothermaceae;";"100.0";"98.7";"2";"2";"2";"0";"0";"430522";"5764"
"LOK1378_1mm";"SILVA (only NR);Archaea;Euryarchaeota;Methanobacteria;Methanobacteriales;Methanothermaceae;Methanothermus;";"100.0";"98.7";"2";"2";"2";"0";"0";"430522";"5764"
"LOK1378_1mm";"SILVA (only NR);Archaea;Euryarchaeota;Methanobacteria;Methanobacteriales;Methanothermobacteriaceae;";"91.3";"98.7";"47";"23";"21";"2";"24";"430501";"5745"
"LOK1378_1mm";"SILVA (only NR);Archaea;Euryarchaeota;Methanobacteria;Methanobacteriales;Methanothermobacteriaceae;Methanothermobacter;";"91.3";"98.7";"47";"23";"21";"2";"24";"430501";"5745"
"LOK1378_1mm";"SILVA (only NR);Archaea;Euryarchaeota;Methanococci;";"46.6";"98.7";"83";"58";"27";"31";"25";"430466";"5739"
"LOK1378_1mm";"SILVA (only NR);Archaea;Euryarchaeota;Methanococci;Methanococcales;";"46.6";"98.7";"83";"58";"27";"31";"25";"430466";"5739"
"LOK1378_1mm";"SILVA (only NR);Archaea;Euryarchaeota;Methanococci;Methanococcales;Methanocaldococcaceae;";"89.5";"98.7";"27";"19";"17";"2";"8";"430505";"5749"
"LOK1378_1mm";"SILVA (only NR);Archaea;Euryarchaeota;Methanococci;Methanococcales;Methanocaldococcaceae;Methanocaldococcus;";"89.5";"98.7";"27";"19";"17";"2";"8";"430505";"5749"
"LOK1378_1mm";"SILVA (only NR);Archaea;Euryarchaeota;Methanococci;Methanococcales;Methanococcaceae;";"25.6";"98.7";"56";"39";"10";"29";"17";"430485";"5756"
"LOK1378_1mm";"SILVA (only NR);Archaea;Euryarchaeota;Methanococci;Methanococcales;Methanococcaceae;Methanococcus;";"0.0";"0";"28";"20";"0";"20";"8";"430504";"5766"
"LOK1378_1mm";"SILVA (only NR);Archaea;Euryarchaeota;Methanococci;Methanococcales;Methanococcaceae;Methanothermococcus;";"0.0";"0";"9";"6";"0";"6";"3";"430518";"5766"
"LOK1378_1mm";"SILVA (only NR);Archaea;Euryarchaeota;Methanococci;Methanococcales;Methanococcaceae;Methanotorris;";"90.9";"98.7";"14";"11";"10";"1";"3";"430513";"5756"
"LOK1378_1mm";"SILVA (only NR);Archaea;Euryarchaeota;Methanococci;Methanococcales;Methanococcaceae;uncultured;";"0.0";"0";"4";"1";"0";"1";"3";"430523";"5766"
"LOK1378_1mm";"SILVA (only NR);Archaea;Euryarchaeota;Methanopyri;";"100.0";"98.7";"9";"7";"7";"0";"2";"430517";"5759"
"LOK1378_1mm";"SILVA (only NR);Archaea;Euryarchaeota;Methanopyri;Methanopyrales;";"100.0";"98.7";"9";"7";"7";"0";"2";"430517";"5759"
"LOK1378_1mm";"SILVA (only NR);Archaea;Euryarchaeota;Methanopyri;Methanopyrales;Methanopyraceae;";"100.0";"98.7";"9";"7";"7";"0";"2";"430517";"5759"
"LOK1378_1mm";"SILVA (only NR);Archaea;Euryarchaeota;Methanopyri;Methanopyrales;Methanopyraceae;Methanopyrus;";"100.0";"98.7";"9";"7";"7";"0";"2";"430517";"5759"
"LOK1378_1mm";"SILVA (only NR);Archaea;Euryarchaeota;Thermococci;";"58.4";"98.7";"401";"269";"157";"112";"132";"430255";"5609"
"LOK1378_1mm";"SILVA (only NR);Archaea;Euryarchaeota;Thermococci;Methanofastidiosales;";"19.2";"98.7";"195";"120";"23";"97";"75";"430404";"5743"
"LOK1378_1mm";"SILVA (only NR);Archaea;Euryarchaeota;Thermococci;Methanofastidiosales;Methanofastidiosaceae;";"24.4";"98.7";"60";"45";"11";"34";"15";"430479";"5755"
"LOK1378_1mm";"SILVA (only NR);Archaea;Euryarchaeota;Thermococci;Methanofastidiosales;Methanofastidiosaceae;Candidatus Methanofastidiosum;";"24.4";"98.7";"60";"45";"11";"34";"15";"430479";"5755"
"LOK1378_1mm";"SILVA (only NR);Archaea;Euryarchaeota;Thermococci;Methanofastidiosales;uncultured;";"16.0";"98.7";"132";"75";"12";"63";"57";"430449";"5754"
"LOK1378_1mm";"SILVA (only NR);Archaea;Euryarchaeota;Thermococci;Thermococcales;";"89.9";"98.7";"206";"149";"134";"15";"57";"430375";"5632"
"LOK1378_1mm";"SILVA (only NR);Archaea;Euryarchaeota;Thermococci;Thermococcales;Thermococcaceae;";"89.9";"98.7";"206";"149";"134";"15";"57";"430375";"5632"
"LOK1378_1mm";"SILVA (only NR);Archaea;Euryarchaeota;Thermococci;Thermococcales;Thermococcaceae;Palaeococcus;";"83.3";"98.7";"9";"6";"5";"1";"3";"430518";"5761"
"LOK1378_1mm";"SILVA (only NR);Archaea;Euryarchaeota;Thermococci;Thermococcales;Thermococcaceae;Pyrococcus;";"100.0";"98.7";"23";"22";"22";"0";"1";"430502";"5744"
"LOK1378_1mm";"SILVA (only NR);Archaea;Euryarchaeota;Thermococci;Thermococcales;Thermococcaceae;Thermococcus;";"88.4";"98.7";"174";"121";"107";"14";"53";"430403";"5659"
"LOK1378_1mm";"SILVA (only NR);Archaea;Hadarchaeota;";"81.6";"98.7";"300";"190";"155";"35";"110";"430334";"5611"
"LOK1378_1mm";"SILVA (only NR);Archaea;Hadarchaeota;Hadarchaeia;";"81.6";"98.7";"300";"190";"155";"35";"110";"430334";"5611"
"LOK1378_1mm";"SILVA (only NR);Archaea;Hadarchaeota;Hadarchaeia;Hadarchaeales;";"81.6";"98.7";"300";"190";"155";"35";"110";"430334";"5611"
"LOK1378_1mm";"SILVA (only NR);Archaea;Halobacterota;";"70.3";"99.2";"5352";"3532";"2483";"1049";"1820";"426992";"3283"
"LOK1378_1mm";"SILVA (only NR);Archaea;Halobacterota;ANME-1;";"3.6";"98.7";"154";"112";"4";"108";"42";"430412";"5762"
"LOK1378_1mm";"SILVA (only NR);Archaea;Halobacterota;ANME-1;ANME-1a;";"3.7";"98.7";"45";"27";"1";"26";"18";"430497";"5765"
"LOK1378_1mm";"SILVA (only NR);Archaea;Halobacterota;ANME-1;ANME-1b;";"2.8";"98.7";"94";"72";"2";"70";"22";"430452";"5764"
"LOK1378_1mm";"SILVA (only NR);Archaea;Halobacterota;Archaeoglobi;";"77.4";"98.7";"80";"62";"48";"14";"18";"430462";"5718"
"LOK1378_1mm";"SILVA (only NR);Archaea;Halobacterota;Archaeoglobi;Archaeoglobales;";"77.4";"98.7";"80";"62";"48";"14";"18";"430462";"5718"
"LOK1378_1mm";"SILVA (only NR);Archaea;Halobacterota;Archaeoglobi;Archaeoglobales;Archaeoglobaceae;";"77.4";"98.7";"80";"62";"48";"14";"18";"430462";"5718"
"LOK1378_1mm";"SILVA (only NR);Archaea;Halobacterota;Archaeoglobi;Archaeoglobales;Archaeoglobaceae;Archaeoglobus;";"86.2";"98.7";"32";"29";"25";"4";"3";"430495";"5741"
"LOK1378_1mm";"SILVA (only NR);Archaea;Halobacterota;Archaeoglobi;Archaeoglobales;Archaeoglobaceae;Ferroglobus;";"100.0";"98.7";"3";"3";"3";"0";"0";"430521";"5763"
"LOK1378_1mm";"SILVA (only NR);Archaea;Halobacterota;Archaeoglobi;Archaeoglobales;Archaeoglobaceae;Geoglobus;";"75.0";"98.7";"12";"4";"3";"1";"8";"430520";"5763"
"LOK1378_1mm";"SILVA (only NR);Archaea;Halobacterota;Archaeoglobi;Archaeoglobales;Archaeoglobaceae;JdFR-20;";"100.0";"98.7";"2";"2";"2";"0";"0";"430522";"5764"
"LOK1378_1mm";"SILVA (only NR);Archaea;Halobacterota;Archaeoglobi;Archaeoglobales;Archaeoglobaceae;uncultured;";"57.9";"98.7";"23";"19";"11";"8";"4";"430505";"5755"
"LOK1378_1mm";"SILVA (only NR);Archaea;Halobacterota;Halobacteria;";"84.3";"99";"2624";"1943";"1637";"306";"681";"428581";"4129"
"LOK1378_1mm";"SILVA (only NR);Archaea;Halobacterota;Halobacteria;Halobacterales;";"84.3";"99";"2624";"1943";"1637";"306";"681";"428581";"4129"
"LOK1378_1mm";"SILVA (only NR);Archaea;Halobacterota;Halobacteria;Halobacterales;Haloadaptaceae;";"89.5";"98.7";"32";"19";"17";"2";"13";"430505";"5749"
"LOK1378_1mm";"SILVA (only NR);Archaea;Halobacterota;Halobacteria;Halobacterales;Haloadaptaceae;Haladaptatus;";"89.5";"98.7";"32";"19";"17";"2";"13";"430505";"5749"
"LOK1378_1mm";"SILVA (only NR);Archaea;Halobacterota;Halobacteria;Halobacterales;Halobacteriaceae;";"90.5";"98.7";"147";"116";"105";"11";"31";"430408";"5661"
"LOK1378_1mm";"SILVA (only NR);Archaea;Halobacterota;Halobacteria;Halobacterales;Halobacteriaceae;Halanaeroarchaeum;";"100.0";"98.7";"19";"13";"13";"0";"6";"430511";"5753"
"LOK1378_1mm";"SILVA (only NR);Archaea;Halobacterota;Halobacteria;Halobacterales;Halobacteriaceae;Halarchaeum;";"89.5";"98.7";"25";"19";"17";"2";"6";"430505";"5749"
"LOK1378_1mm";"SILVA (only NR);Archaea;Halobacterota;Halobacteria;Halobacterales;Halobacteriaceae;Halobacterium;";"88.7";"98.7";"82";"71";"63";"8";"11";"430453";"5703"
"LOK1378_1mm";"SILVA (only NR);Archaea;Halobacterota;Halobacteria;Halobacterales;Halobacteriaceae;Halocalculus;";"100.0";"98.7";"1";"1";"1";"0";"0";"430523";"5765"
"LOK1378_1mm";"SILVA (only NR);Archaea;Halobacterota;Halobacteria;Halobacterales;Halobacteriaceae;Halodesulfurarchaeum;";"88.9";"98.7";"13";"9";"8";"1";"4";"430515";"5758"
"LOK1378_1mm";"SILVA (only NR);Archaea;Halobacterota;Halobacteria;Halobacterales;Halobacteriaceae;Salarchaeum;";"100.0";"98.7";"3";"2";"2";"0";"1";"430522";"5764"
"LOK1378_1mm";"SILVA (only NR);Archaea;Halobacterota;Halobacteria;Halobacterales;Halobacteriaceae;uncultured;";"0.0";"0";"2";"0";"0";"0";"2";"430524";"5766"
"LOK1378_1mm";"SILVA (only NR);Archaea;Halobacterota;Halobacteria;Halobacterales;Halococcaceae;";"82.1";"98.7";"86";"67";"55";"12";"19";"430457";"5711"
"LOK1378_1mm";"SILVA (only NR);Archaea;Halobacterota;Halobacteria;Halobacterales;Halococcaceae;Halalkalicoccus;";"100.0";"98.7";"14";"11";"11";"0";"3";"430513";"5755"
"LOK1378_1mm";"SILVA (only NR);Archaea;Halobacterota;Halobacteria;Halobacterales;Halococcaceae;Halococcus;";"76.0";"98.7";"64";"50";"38";"12";"14";"430474";"5728"
"LOK1378_1mm";"SILVA (only NR);Archaea;Halobacterota;Halobacteria;Halobacterales;Halococcaceae;Halostella;";"100.0";"98.7";"5";"5";"5";"0";"0";"430519";"5761"
"LOK1378_1mm";"SILVA (only NR);Archaea;Halobacterota;Halobacteria;Halobacterales;Halococcaceae;uncultured;";"100.0";"98.7";"3";"1";"1";"0";"2";"430523";"5765"
"LOK1378_1mm";"SILVA (only NR);Archaea;Halobacterota;Halobacteria;Halobacterales;Haloferacaceae;";"83.0";"98.9";"1634";"1256";"1042";"214";"378";"429268";"4724"
"LOK1378_1mm";"SILVA (only NR);Archaea;Halobacterota;Halobacteria;Halobacterales;Haloferacaceae;A07HB70;";"40.0";"98.7";"17";"5";"2";"3";"12";"430519";"5764"
"LOK1378_1mm";"SILVA (only NR);Archaea;Halobacterota;Halobacteria;Halobacterales;Haloferacaceae;Candidatus Haloectosymbiotes;";"100.0";"98.7";"1";"1";"1";"0";"0";"430523";"5765"
"LOK1378_1mm";"SILVA (only NR);Archaea;Halobacterota;Halobacteria;Halobacterales;Haloferacaceae;Haloarchaeobius;";"93.3";"98.7";"23";"15";"14";"1";"8";"430509";"5752"
"LOK1378_1mm";"SILVA (only NR);Archaea;Halobacterota;Halobacteria;Halobacterales;Haloferacaceae;Halobaculum;";"91.7";"98.7";"18";"12";"11";"1";"6";"430512";"5755"
"LOK1378_1mm";"SILVA (only NR);Archaea;Halobacterota;Halobacteria;Halobacterales;Haloferacaceae;Halobellus;";"78.8";"98.7";"44";"33";"26";"7";"11";"430491";"5740"
"LOK1378_1mm";"SILVA (only NR);Archaea;Halobacterota;Halobacteria;Halobacterales;Haloferacaceae;Halobiforma;";"100.0";"98.7";"14";"14";"14";"0";"0";"430510";"5752"
"LOK1378_1mm";"SILVA (only NR);Archaea;Halobacterota;Halobacteria;Halobacterales;Haloferacaceae;Haloferax;";"91.6";"98.7";"113";"95";"87";"8";"18";"430429";"5679"
"LOK1378_1mm";"SILVA (only NR);Archaea;Halobacterota;Halobacteria;Halobacterales;Haloferacaceae;Halogeometricum;";"95.8";"98.7";"37";"24";"23";"1";"13";"430500";"5743"
"LOK1378_1mm";"SILVA (only NR);Archaea;Halobacterota;Halobacteria;Halobacterales;Haloferacaceae;Halogranum;";"100.0";"98.7";"16";"12";"12";"0";"4";"430512";"5754"
"LOK1378_1mm";"SILVA (only NR);Archaea;Halobacterota;Halobacteria;Halobacterales;Haloferacaceae;Halohasta;";"76.9";"98.7";"18";"13";"10";"3";"5";"430511";"5756"
"LOK1378_1mm";"SILVA (only NR);Archaea;Halobacterota;Halobacteria;Halobacterales;Haloferacaceae;Halolamina;";"89.7";"98.7";"68";"39";"35";"4";"29";"430485";"5731"
"LOK1378_1mm";"SILVA (only NR);Archaea;Halobacterota;Halobacteria;Halobacterales;Haloferacaceae;Halonotius;";"32.5";"98.7";"98";"83";"27";"56";"15";"430441";"5739"
"LOK1378_1mm";"SILVA (only NR);Archaea;Halobacterota;Halobacteria;Halobacterales;Haloferacaceae;Haloparvum;";"96.3";"98.7";"38";"27";"26";"1";"11";"430497";"5740"
"LOK1378_1mm";"SILVA (only NR);Archaea;Halobacterota;Halobacteria;Halobacterales;Haloferacaceae;Halopelagius;";"83.3";"98.7";"8";"6";"5";"1";"2";"430518";"5761"
"LOK1378_1mm";"SILVA (only NR);Archaea;Halobacterota;Halobacteria;Halobacterales;Haloferacaceae;Halopenitus;";"100.0";"98.7";"7";"7";"7";"0";"0";"430517";"5759"
"LOK1378_1mm";"SILVA (only NR);Archaea;Halobacterota;Halobacteria;Halobacterales;Haloferacaceae;Halopiger;";"100.0";"98.7";"25";"24";"24";"0";"1";"430500";"5742"
"LOK1378_1mm";"SILVA (only NR);Archaea;Halobacterota;Halobacteria;Halobacterales;Haloferacaceae;Haloplanus;";"83.9";"98.7";"44";"31";"26";"5";"13";"430493";"5740"
"LOK1378_1mm";"SILVA (only NR);Archaea;Halobacterota;Halobacteria;Halobacterales;Haloferacaceae;Haloquadratum;";"58.0";"98.7";"70";"50";"29";"21";"20";"430474";"5737"
"LOK1378_1mm";"SILVA (only NR);Archaea;Halobacterota;Halobacteria;Halobacterales;Haloferacaceae;Halorubellus;";"87.5";"98.7";"16";"8";"7";"1";"8";"430516";"5759"
"LOK1378_1mm";"SILVA (only NR);Archaea;Halobacterota;Halobacteria;Halobacterales;Haloferacaceae;Halorubrum;";"77.1";"98.7";"345";"292";"225";"67";"53";"430232";"5541"
"LOK1378_1mm";"SILVA (only NR);Archaea;Halobacterota;Halobacteria;Halobacterales;Haloferacaceae;Halorussus;";"95.2";"98.7";"33";"21";"20";"1";"12";"430503";"5746"
"LOK1378_1mm";"SILVA (only NR);Archaea;Halobacterota;Halobacteria;Halobacterales;Haloferacaceae;Halostagnicola;";"100.0";"98.7";"17";"15";"15";"0";"2";"430509";"5751"
"LOK1378_1mm";"SILVA (only NR);Archaea;Halobacterota;Halobacteria;Halobacterales;Haloferacaceae;Haloterrigena;";"96.4";"98.7";"123";"110";"106";"4";"13";"430414";"5660"
"LOK1378_1mm";"SILVA (only NR);Archaea;Halobacterota;Halobacteria;Halobacterales;Haloferacaceae;Halovarius;";"100.0";"98.7";"1";"1";"1";"0";"0";"430523";"5765"
"LOK1378_1mm";"SILVA (only NR);Archaea;Halobacterota;Halobacteria;Halobacterales;Haloferacaceae;Halovenus;";"95.0";"98.7";"22";"20";"19";"1";"2";"430504";"5747"
"LOK1378_1mm";"SILVA (only NR);Archaea;Halobacterota;Halobacteria;Halobacterales;Haloferacaceae;Halovivax;";"100.0";"98.7";"19";"13";"13";"0";"6";"430511";"5753"
"LOK1378_1mm";"SILVA (only NR);Archaea;Halobacterota;Halobacteria;Halobacterales;Haloferacaceae;Natrialba;";"90.0";"98.7";"47";"30";"27";"3";"17";"430494";"5739"
"LOK1378_1mm";"SILVA (only NR);Archaea;Halobacterota;Halobacteria;Halobacterales;Haloferacaceae;Natribaculum;";"50.0";"98.7";"2";"2";"1";"1";"0";"430522";"5765"
"LOK1378_1mm";"SILVA (only NR);Archaea;Halobacterota;Halobacteria;Halobacterales;Haloferacaceae;Natrinema;";"100.0";"98.7";"29";"27";"27";"0";"2";"430497";"5739"
"LOK1378_1mm";"SILVA (only NR);Archaea;Halobacterota;Halobacteria;Halobacterales;Haloferacaceae;Natronoarchaeum;";"100.0";"98.7";"26";"22";"22";"0";"4";"430502";"5744"
"LOK1378_1mm";"SILVA (only NR);Archaea;Halobacterota;Halobacteria;Halobacterales;Haloferacaceae;Natronobacterium;";"100.0";"98.7";"10";"8";"8";"0";"2";"430516";"5758"
"LOK1378_1mm";"SILVA (only NR);Archaea;Halobacterota;Halobacteria;Halobacterales;Haloferacaceae;Natronococcus;";"96.6";"98.7";"38";"29";"28";"1";"9";"430495";"5738"
"LOK1378_1mm";"SILVA (only NR);Archaea;Halobacterota;Halobacteria;Halobacterales;Haloferacaceae;Natronolimnobius;";"91.7";"98.7";"12";"12";"11";"1";"0";"430512";"5755"
"LOK1378_1mm";"SILVA (only NR);Archaea;Halobacterota;Halobacteria;Halobacterales;Haloferacaceae;Natronorubrum;";"96.9";"98.7";"43";"32";"31";"1";"11";"430492";"5735"
"LOK1378_1mm";"SILVA (only NR);Archaea;Halobacterota;Halobacteria;Halobacterales;Haloferacaceae;Salinarchaeum;";"93.3";"98.7";"17";"15";"14";"1";"2";"430509";"5752"
"LOK1378_1mm";"SILVA (only NR);Archaea;Halobacterota;Halobacteria;Halobacterales;Haloferacaceae;Salinigranum;";"42.9";"98.7";"19";"14";"6";"8";"5";"430510";"5760"
"LOK1378_1mm";"SILVA (only NR);Archaea;Halobacterota;Halobacteria;Halobacterales;Haloferacaceae;Saliphagus;";"100.0";"98.7";"5";"4";"4";"0";"1";"430520";"5762"
"LOK1378_1mm";"SILVA (only NR);Archaea;Halobacterota;Halobacteria;Halobacterales;Haloferacaceae;uncultured;";"84.1";"98.7";"116";"63";"53";"10";"53";"430461";"5713"
"LOK1378_1mm";"SILVA (only NR);Archaea;Halobacterota;Halobacteria;Halobacterales;Halomicrobiaceae;";"88.6";"98.7";"641";"428";"379";"49";"213";"430096";"5387"
"LOK1378_1mm";"SILVA (only NR);Archaea;Halobacterota;Halobacteria;Halobacterales;Halomicrobiaceae;Candidatus Halobonum;";"100.0";"98.7";"19";"4";"4";"0";"15";"430520";"5762"
"LOK1378_1mm";"SILVA (only NR);Archaea;Halobacterota;Halobacteria;Halobacterales;Halomicrobiaceae;Halapricum;";"80.0";"98.7";"50";"30";"24";"6";"20";"430494";"5742"
"LOK1378_1mm";"SILVA (only NR);Archaea;Halobacterota;Halobacteria;Halobacterales;Halomicrobiaceae;Haloarcula;";"87.8";"98.7";"214";"189";"166";"23";"25";"430335";"5600"
"LOK1378_1mm";"SILVA (only NR);Archaea;Halobacterota;Halobacteria;Halobacterales;Halomicrobiaceae;Halomarina;";"100.0";"98.7";"21";"11";"11";"0";"10";"430513";"5755"
"LOK1378_1mm";"SILVA (only NR);Archaea;Halobacterota;Halobacteria;Halobacterales;Halomicrobiaceae;Halomicroarcula;";"93.9";"98.7";"40";"33";"31";"2";"7";"430491";"5735"
"LOK1378_1mm";"SILVA (only NR);Archaea;Halobacterota;Halobacteria;Halobacterales;Halomicrobiaceae;Halomicrobium;";"84.6";"98.7";"64";"39";"33";"6";"25";"430485";"5733"
"LOK1378_1mm";"SILVA (only NR);Archaea;Halobacterota;Halobacteria;Halobacterales;Halomicrobiaceae;Halorhabdus;";"93.8";"98.7";"20";"16";"15";"1";"4";"430508";"5751"
"LOK1378_1mm";"SILVA (only NR);Archaea;Halobacterota;Halobacteria;Halobacterales;Halomicrobiaceae;Halorientalis;";"91.7";"98.7";"18";"12";"11";"1";"6";"430512";"5755"
"LOK1378_1mm";"SILVA (only NR);Archaea;Halobacterota;Halobacteria;Halobacterales;Halomicrobiaceae;Halosiccatus;";"100.0";"98.7";"3";"3";"3";"0";"0";"430521";"5763"
"LOK1378_1mm";"SILVA (only NR);Archaea;Halobacterota;Halobacteria;Halobacterales;Halomicrobiaceae;Halosimplex;";"100.0";"98.7";"38";"32";"32";"0";"6";"430492";"5734"
"LOK1378_1mm";"SILVA (only NR);Archaea;Halobacterota;Halobacteria;Halobacterales;Halomicrobiaceae;Natronomonas;";"77.5";"98.7";"79";"40";"31";"9";"39";"430484";"5735"
"LOK1378_1mm";"SILVA (only NR);Archaea;Halobacterota;Halobacteria;Halobacterales;Halomicrobiaceae;Salinirubrum;";"66.7";"98.7";"4";"3";"2";"1";"1";"430521";"5764"
"LOK1378_1mm";"SILVA (only NR);Archaea;Halobacterota;Halobacteria;Halobacterales;Halomicrobiaceae;uncultured;";"100.0";"98.7";"64";"13";"13";"0";"51";"430511";"5753"
"LOK1378_1mm";"SILVA (only NR);Archaea;Halobacterota;Halobacteria;Halobacterales;J07HX5;";"100.0";"98.7";"3";"3";"3";"0";"0";"430521";"5763"
"LOK1378_1mm";"SILVA (only NR);Archaea;Halobacterota;Halobacteria;Halobacterales;uncultured;";"65.4";"98.7";"77";"52";"34";"18";"25";"430472";"5732"
"LOK1378_1mm";"SILVA (only NR);Archaea;Halobacterota;Methanocellia;";"87.8";"98.7";"101";"41";"36";"5";"60";"430483";"5730"
"LOK1378_1mm";"SILVA (only NR);Archaea;Halobacterota;Methanocellia;Methanocellales;";"87.8";"98.7";"101";"41";"36";"5";"60";"430483";"5730"
"LOK1378_1mm";"SILVA (only NR);Archaea;Halobacterota;Methanocellia;Methanocellales;Methanocellaceae;";"90.9";"98.7";"83";"33";"30";"3";"50";"430491";"5736"
"LOK1378_1mm";"SILVA (only NR);Archaea;Halobacterota;Methanocellia;Methanocellales;Methanocellaceae;Methanocella;";"90.9";"98.7";"49";"22";"20";"2";"27";"430502";"5746"
"LOK1378_1mm";"SILVA (only NR);Archaea;Halobacterota;Methanocellia;Methanocellales;Methanocellaceae;Rice Cluster I;";"90.9";"98.7";"33";"11";"10";"1";"22";"430513";"5756"
"LOK1378_1mm";"SILVA (only NR);Archaea;Halobacterota;Methanocellia;Methanocellales;uncultured;";"75.0";"98.7";"18";"8";"6";"2";"10";"430516";"5760"
"LOK1378_1mm";"SILVA (only NR);Archaea;Halobacterota;Methanomicrobia;";"18.8";"98.7";"891";"496";"93";"403";"395";"430028";"5673"
"LOK1378_1mm";"SILVA (only NR);Archaea;Halobacterota;Methanomicrobia;Methanomicrobiales;";"18.8";"98.7";"891";"496";"93";"403";"395";"430028";"5673"
"LOK1378_1mm";"SILVA (only NR);Archaea;Halobacterota;Methanomicrobia;Methanomicrobiales;Methanocorpusculaceae;";"50.9";"98.7";"79";"53";"27";"26";"26";"430471";"5739"
"LOK1378_1mm";"SILVA (only NR);Archaea;Halobacterota;Methanomicrobia;Methanomicrobiales;Methanocorpusculaceae;Methanocalculus;";"14.8";"98.7";"34";"27";"4";"23";"7";"430497";"5762"
"LOK1378_1mm";"SILVA (only NR);Archaea;Halobacterota;Methanomicrobia;Methanomicrobiales;Methanocorpusculaceae;Methanocorpusculum;";"88.5";"98.7";"45";"26";"23";"3";"19";"430498";"5743"
"LOK1378_1mm";"SILVA (only NR);Archaea;Halobacterota;Methanomicrobia;Methanomicrobiales;Methanomicrobiaceae;";"25.3";"98.7";"368";"217";"55";"162";"151";"430307";"5711"
"LOK1378_1mm";"SILVA (only NR);Archaea;Halobacterota;Methanomicrobia;Methanomicrobiales;Methanomicrobiaceae;Methanoculleus;";"8.9";"98.7";"204";"124";"11";"113";"80";"430400";"5755"
"LOK1378_1mm";"SILVA (only NR);Archaea;Halobacterota;Methanomicrobia;Methanomicrobiales;Methanomicrobiaceae;Methanofollis;";"0.0";"0";"22";"15";"0";"15";"7";"430509";"5766"
"LOK1378_1mm";"SILVA (only NR);Archaea;Halobacterota;Methanomicrobia;Methanomicrobiales;Methanomicrobiaceae;Methanogenium;";"100.0";"98.7";"32";"18";"18";"0";"14";"430506";"5748"
"LOK1378_1mm";"SILVA (only NR);Archaea;Halobacterota;Methanomicrobia;Methanomicrobiales;Methanomicrobiaceae;Methanolacinia;";"75.0";"98.7";"6";"4";"3";"1";"2";"430520";"5763"
"LOK1378_1mm";"SILVA (only NR);Archaea;Halobacterota;Methanomicrobia;Methanomicrobiales;Methanomicrobiaceae;Methanomicrobium;";"33.3";"98.7";"39";"18";"6";"12";"21";"430506";"5760"
"LOK1378_1mm";"SILVA (only NR);Archaea;Halobacterota;Methanomicrobia;Methanomicrobiales;Methanomicrobiaceae;Methanoplanus;";"100.0";"98.7";"5";"5";"5";"0";"0";"430519";"5761"
"LOK1378_1mm";"SILVA (only NR);Archaea;Halobacterota;Methanomicrobia;Methanomicrobiales;Methanomicrobiaceae;SDB;";"100.0";"98.7";"2";"2";"2";"0";"0";"430522";"5764"
"LOK1378_1mm";"SILVA (only NR);Archaea;Halobacterota;Methanomicrobia;Methanomicrobiales;Methanomicrobiaceae;uncultured;";"25.0";"98.7";"54";"28";"7";"21";"26";"430496";"5759"
"LOK1378_1mm";"SILVA (only NR);Archaea;Halobacterota;Methanomicrobia;Methanomicrobiales;Methanoregulaceae;";"1.7";"98.7";"289";"117";"2";"115";"172";"430407";"5764"
"LOK1378_1mm";"SILVA (only NR);Archaea;Halobacterota;Methanomicrobia;Methanomicrobiales;Methanoregulaceae;Methanolinea;";"2.8";"98.7";"99";"36";"1";"35";"63";"430488";"5765"
"LOK1378_1mm";"SILVA (only NR);Archaea;Halobacterota;Methanomicrobia;Methanomicrobiales;Methanoregulaceae;Methanoregula;";"1.3";"98.7";"186";"78";"1";"77";"108";"430446";"5765"
"LOK1378_1mm";"SILVA (only NR);Archaea;Halobacterota;Methanomicrobia;Methanomicrobiales;Methanoregulaceae;Methanosphaerula;";"0.0";"0";"4";"3";"0";"3";"1";"430521";"5766"
"LOK1378_1mm";"SILVA (only NR);Archaea;Halobacterota;Methanomicrobia;Methanomicrobiales;Methanospirillaceae;";"2.3";"98.7";"115";"86";"2";"84";"29";"430438";"5764"
"LOK1378_1mm";"SILVA (only NR);Archaea;Halobacterota;Methanomicrobia;Methanomicrobiales;Methanospirillaceae;Methanospirillum;";"2.3";"98.7";"115";"86";"2";"84";"29";"430438";"5764"
"LOK1378_1mm";"SILVA (only NR);Archaea;Halobacterota;Methanomicrobia;Methanomicrobiales;Rice Cluster II;";"100.0";"98.7";"18";"6";"6";"0";"12";"430518";"5760"
"LOK1378_1mm";"SILVA (only NR);Archaea;Halobacterota;Methanomicrobia;Methanomicrobiales;uncultured;";"0.0";"0";"20";"15";"0";"15";"5";"430509";"5766"
"LOK1378_1mm";"SILVA (only NR);Archaea;Halobacterota;Methanonatronarchaeia;";"57.1";"98.7";"15";"14";"8";"6";"1";"430510";"5758"
"LOK1378_1mm";"SILVA (only NR);Archaea;Halobacterota;Methanonatronarchaeia;Methanonatronaechaeales;";"57.1";"98.7";"15";"14";"8";"6";"1";"430510";"5758"
"LOK1378_1mm";"SILVA (only NR);Archaea;Halobacterota;Methanonatronarchaeia;Methanonatronaechaeales;Methanonatronarchaeaceae;";"57.1";"98.7";"15";"14";"8";"6";"1";"430510";"5758"
"LOK1378_1mm";"SILVA (only NR);Archaea;Halobacterota;Methanosarcinia;";"76.6";"98.8";"1470";"851";"652";"199";"619";"429673";"5114"
"LOK1378_1mm";"SILVA (only NR);Archaea;Halobacterota;Methanosarcinia;Methanosarciniales;";"76.6";"98.8";"1470";"851";"652";"199";"619";"429673";"5114"
"LOK1378_1mm";"SILVA (only NR);Archaea;Halobacterota;Methanosarcinia;Methanosarciniales;ANME-2a-2b;";"80.0";"98.7";"111";"70";"56";"14";"41";"430454";"5710"
"LOK1378_1mm";"SILVA (only NR);Archaea;Halobacterota;Methanosarcinia;Methanosarciniales;ANME-2a-2b;ANME-2b;";"77.8";"98.7";"11";"9";"7";"2";"2";"430515";"5759"
"LOK1378_1mm";"SILVA (only NR);Archaea;Halobacterota;Methanosarcinia;Methanosarciniales;ANME-2c;";"78.2";"98.7";"86";"55";"43";"12";"31";"430469";"5723"
"LOK1378_1mm";"SILVA (only NR);Archaea;Halobacterota;Methanosarcinia;Methanosarciniales;Methanoperedenaceae;";"91.9";"98.7";"117";"62";"57";"5";"55";"430462";"5709"
"LOK1378_1mm";"SILVA (only NR);Archaea;Halobacterota;Methanosarcinia;Methanosarciniales;Methanoperedenaceae;Candidatus Methanoperedens;";"95.0";"98.7";"87";"40";"38";"2";"47";"430484";"5728"
"LOK1378_1mm";"SILVA (only NR);Archaea;Halobacterota;Methanosarcinia;Methanosarciniales;Methanosaetaceae;";"69.2";"98.7";"564";"286";"198";"88";"278";"430238";"5568"
"LOK1378_1mm";"SILVA (only NR);Archaea;Halobacterota;Methanosarcinia;Methanosarciniales;Methanosaetaceae;Methanosaeta;";"69.2";"98.7";"564";"286";"198";"88";"278";"430238";"5568"
"LOK1378_1mm";"SILVA (only NR);Archaea;Halobacterota;Methanosarcinia;Methanosarciniales;Methanosarcinaceae;";"78.5";"98.7";"555";"354";"278";"76";"201";"430170";"5488"
"LOK1378_1mm";"SILVA (only NR);Archaea;Halobacterota;Methanosarcinia;Methanosarciniales;Methanosarcinaceae;ANME-3;";"27.6";"98.7";"46";"29";"8";"21";"17";"430495";"5758"
"LOK1378_1mm";"SILVA (only NR);Archaea;Halobacterota;Methanosarcinia;Methanosarciniales;Methanosarcinaceae;Methanimicrococcus;";"88.0";"98.7";"34";"25";"22";"3";"9";"430499";"5744"
"LOK1378_1mm";"SILVA (only NR);Archaea;Halobacterota;Methanosarcinia;Methanosarciniales;Methanosarcinaceae;Methanococcoides;";"87.2";"98.7";"45";"39";"34";"5";"6";"430485";"5732"
"LOK1378_1mm";"SILVA (only NR);Archaea;Halobacterota;Methanosarcinia;Methanosarciniales;Methanosarcinaceae;Methanohalobium;";"100.0";"98.7";"4";"3";"3";"0";"1";"430521";"5763"
"LOK1378_1mm";"SILVA (only NR);Archaea;Halobacterota;Methanosarcinia;Methanosarciniales;Methanosarcinaceae;Methanohalophilus;";"90.5";"98.7";"39";"21";"19";"2";"18";"430503";"5747"
"LOK1378_1mm";"SILVA (only NR);Archaea;Halobacterota;Methanosarcinia;Methanosarciniales;Methanosarcinaceae;Methanolobus;";"75.6";"98.7";"66";"45";"34";"11";"21";"430479";"5732"
"LOK1378_1mm";"SILVA (only NR);Archaea;Halobacterota;Methanosarcinia;Methanosarciniales;Methanosarcinaceae;Methanomethylovorans;";"86.7";"98.7";"49";"15";"13";"2";"34";"430509";"5753"
"LOK1378_1mm";"SILVA (only NR);Archaea;Halobacterota;Methanosarcinia;Methanosarciniales;Methanosarcinaceae;Methanosalsum;";"100.0";"98.7";"3";"3";"3";"0";"0";"430521";"5763"
"LOK1378_1mm";"SILVA (only NR);Archaea;Halobacterota;Methanosarcinia;Methanosarciniales;Methanosarcinaceae;Methanosarcina;";"81.4";"98.7";"251";"167";"136";"31";"84";"430357";"5630"
"LOK1378_1mm";"SILVA (only NR);Archaea;Halobacterota;Methanosarcinia;Methanosarciniales;Methanosarcinaceae;uncultured;";"85.7";"98.7";"18";"7";"6";"1";"11";"430517";"5760"
"LOK1378_1mm";"SILVA (only NR);Archaea;Halobacterota;Methanosarcinia;Methanosarciniales;Methermicoccaceae;";"100.0";"98.7";"5";"5";"5";"0";"0";"430519";"5761"
"LOK1378_1mm";"SILVA (only NR);Archaea;Halobacterota;Methanosarcinia;Methanosarciniales;Methermicoccaceae;Methermicoccus;";"100.0";"98.7";"4";"4";"4";"0";"0";"430520";"5762"
"LOK1378_1mm";"SILVA (only NR);Archaea;Halobacterota;Methanosarcinia;Methanosarciniales;Syntrophoarchaeaceae;";"78.9";"98.7";"28";"19";"15";"4";"9";"430505";"5751"
"LOK1378_1mm";"SILVA (only NR);Archaea;Halobacterota;Methanosarcinia;Methanosarciniales;Syntrophoarchaeaceae;Candidatus Syntrophoarchaeum;";"25.0";"98.7";"4";"4";"1";"3";"0";"430520";"5765"
"LOK1378_1mm";"SILVA (only NR);Archaea;Halobacterota;uncultured;";"38.5";"98.7";"17";"13";"5";"8";"4";"430511";"5761"
"LOK1378_1mm";"SILVA (only NR);Archaea;Hydrothermarchaeota;";"35.6";"98.7";"212";"101";"36";"65";"111";"430423";"5730"
"LOK1378_1mm";"SILVA (only NR);Archaea;Hydrothermarchaeota;Hydrothermarchaeia;";"35.6";"98.7";"212";"101";"36";"65";"111";"430423";"5730"
"LOK1378_1mm";"SILVA (only NR);Archaea;Hydrothermarchaeota;Hydrothermarchaeia;Hydrothermarchaeales;";"35.6";"98.7";"212";"101";"36";"65";"111";"430423";"5730"
"LOK1378_1mm";"SILVA (only NR);Archaea;Iainarchaeota;";"0.0";"0";"46";"27";"0";"27";"19";"430497";"5766"
"LOK1378_1mm";"SILVA (only NR);Archaea;Iainarchaeota;Iainarchaeia;";"0.0";"0";"46";"27";"0";"27";"19";"430497";"5766"
"LOK1378_1mm";"SILVA (only NR);Archaea;Iainarchaeota;Iainarchaeia;Iainarchaeales;";"0.0";"0";"46";"27";"0";"27";"19";"430497";"5766"
"LOK1378_1mm";"SILVA (only NR);Archaea;Iainarchaeota;Iainarchaeia;Iainarchaeales;Candidatus Iainarchaeum;";"0.0";"0";"15";"13";"0";"13";"2";"430511";"5766"
"LOK1378_1mm";"SILVA (only NR);Archaea;Korarchaeota;";"0.0";"0";"62";"36";"0";"36";"26";"430488";"5766"
"LOK1378_1mm";"SILVA (only NR);Archaea;Korarchaeota;Korarchaeia;";"0.0";"0";"62";"36";"0";"36";"26";"430488";"5766"
"LOK1378_1mm";"SILVA (only NR);Archaea;Korarchaeota;Korarchaeia;Korarchaeales;";"0.0";"0";"62";"36";"0";"36";"26";"430488";"5766"
"LOK1378_1mm";"SILVA (only NR);Archaea;Korarchaeota;Korarchaeia;Korarchaeales;Korarchaeaceae;";"0.0";"0";"62";"36";"0";"36";"26";"430488";"5766"
"LOK1378_1mm";"SILVA (only NR);Archaea;Korarchaeota;Korarchaeia;Korarchaeales;Korarchaeaceae;Candidatus Korarchaeum;";"0.0";"0";"62";"36";"0";"36";"26";"430488";"5766"
"LOK1378_1mm";"SILVA (only NR);Archaea;Micrarchaeota;";"3.1";"98.7";"88";"32";"1";"31";"56";"430492";"5765"
"LOK1378_1mm";"SILVA (only NR);Archaea;Micrarchaeota;Micrarchaeia;";"3.1";"98.7";"88";"32";"1";"31";"56";"430492";"5765"
"LOK1378_1mm";"SILVA (only NR);Archaea;Micrarchaeota;Micrarchaeia;Micrarchaeales;";"3.1";"98.7";"88";"32";"1";"31";"56";"430492";"5765"
"LOK1378_1mm";"SILVA (only NR);Archaea;Micrarchaeota;Micrarchaeia;Micrarchaeales;CG1-02-32-21;";"0.0";"0";"12";"8";"0";"8";"4";"430516";"5766"
"LOK1378_1mm";"SILVA (only NR);Archaea;Micrarchaeota;Micrarchaeia;Micrarchaeales;Candidatus Micrarchaeum;";"14.3";"98.7";"10";"7";"1";"6";"3";"430517";"5765"
"LOK1378_1mm";"SILVA (only NR);Archaea;Nanoarchaeota;";"2.1";"98.7";"550";"341";"7";"334";"209";"430183";"5759"
"LOK1378_1mm";"SILVA (only NR);Archaea;Nanoarchaeota;Nanoarchaeia;";"2.1";"98.7";"550";"341";"7";"334";"209";"430183";"5759"
"LOK1378_1mm";"SILVA (only NR);Archaea;Nanoarchaeota;Nanoarchaeia;Nanoarchaeales;";"0.0";"0";"40";"10";"0";"10";"30";"430514";"5766"
"LOK1378_1mm";"SILVA (only NR);Archaea;Nanoarchaeota;Nanoarchaeia;Nanoarchaeales;Nanoarchaeaceae;";"0.0";"0";"22";"6";"0";"6";"16";"430518";"5766"
"LOK1378_1mm";"SILVA (only NR);Archaea;Nanoarchaeota;Nanoarchaeia;Nanoarchaeales;Nanoarchaeaceae;Nanoarchaeum;";"0.0";"0";"22";"6";"0";"6";"16";"430518";"5766"
"LOK1378_1mm";"SILVA (only NR);Archaea;Nanoarchaeota;Nanoarchaeia;Nanoarchaeales;Nanopusillaceae;";"0.0";"0";"18";"4";"0";"4";"14";"430520";"5766"
"LOK1378_1mm";"SILVA (only NR);Archaea;Nanoarchaeota;Nanoarchaeia;Nanoarchaeales;Nanopusillaceae;Candidatus Nanobsidianus;";"0.0";"0";"11";"3";"0";"3";"8";"430521";"5766"
"LOK1378_1mm";"SILVA (only NR);Archaea;Nanoarchaeota;Nanoarchaeia;Nanoarchaeales;Nanopusillaceae;Candidatus Nanopusillus;";"0.0";"0";"7";"1";"0";"1";"6";"430523";"5766"
"LOK1378_1mm";"SILVA (only NR);Archaea;Nanoarchaeota;Nanoarchaeia;Woesearchaeales;";"2.1";"98.7";"510";"331";"7";"324";"179";"430193";"5759"
"LOK1378_1mm";"SILVA (only NR);Archaea;Nanoarchaeota;Nanoarchaeia;Woesearchaeales;CG1-02-57-44;";"0.0";"0";"10";"6";"0";"6";"4";"430518";"5766"
"LOK1378_1mm";"SILVA (only NR);Archaea;Nanoarchaeota;Nanoarchaeia;Woesearchaeales;GW2011;";"0.0";"0";"32";"20";"0";"20";"12";"430504";"5766"
"LOK1378_1mm";"SILVA (only NR);Archaea;Nanoarchaeota;Nanoarchaeia;Woesearchaeales;GW2011;AR15;";"0.0";"0";"28";"16";"0";"16";"12";"430508";"5766"
"LOK1378_1mm";"SILVA (only NR);Archaea;Nanoarchaeota;Nanoarchaeia;Woesearchaeales;GW2011;AR20;";"0.0";"0";"4";"4";"0";"4";"0";"430520";"5766"
"LOK1378_1mm";"SILVA (only NR);Archaea;Nanoarchaeota;Nanoarchaeia;Woesearchaeales;GW2011_GWC1_47_15;";"0.0";"0";"6";"3";"0";"3";"3";"430521";"5766"
"LOK1378_1mm";"SILVA (only NR);Archaea;Nanoarchaeota;Nanoarchaeia;Woesearchaeales;SCGC AAA011-D5;";"0.0";"0";"17";"13";"0";"13";"4";"430511";"5766"
"LOK1378_1mm";"SILVA (only NR);Archaea;Nanoarchaeota;Nanoarchaeia;Woesearchaeales;SCGC AAA286-E23;";"0.0";"0";"6";"4";"0";"4";"2";"430520";"5766"
"LOK1378_1mm";"SILVA (only NR);Archaea;Nanohaloarchaeota;";"20.0";"98.7";"34";"20";"4";"16";"14";"430504";"5762"
"LOK1378_1mm";"SILVA (only NR);Archaea;Nanohaloarchaeota;Nanosalinia;";"20.0";"98.7";"34";"20";"4";"16";"14";"430504";"5762"
"LOK1378_1mm";"SILVA (only NR);Archaea;Nanohaloarchaeota;Nanosalinia;Nanosalinales;";"20.0";"98.7";"34";"20";"4";"16";"14";"430504";"5762"
"LOK1378_1mm";"SILVA (only NR);Archaea;Nanohaloarchaeota;Nanosalinia;Nanosalinales;Nanosalinaceae;";"20.0";"98.7";"34";"20";"4";"16";"14";"430504";"5762"
"LOK1378_1mm";"SILVA (only NR);Archaea;Nanohaloarchaeota;Nanosalinia;Nanosalinales;Nanosalinaceae;Candidatus Haloredivivus;";"0.0";"0";"18";"10";"0";"10";"8";"430514";"5766"
"LOK1378_1mm";"SILVA (only NR);Archaea;Nanohaloarchaeota;Nanosalinia;Nanosalinales;Nanosalinaceae;Candidatus Nanosalinarum;";"0.0";"0";"6";"3";"0";"3";"3";"430521";"5766"
"LOK1378_1mm";"SILVA (only NR);Archaea;Thermoplasmatota;";"1.2";"98.7";"2896";"1457";"17";"1440";"1439";"429067";"5749"
"LOK1378_1mm";"SILVA (only NR);Archaea;Thermoplasmatota;Thermoplasmata;";"1.2";"98.7";"2819";"1435";"17";"1418";"1384";"429089";"5749"
"LOK1378_1mm";"SILVA (only NR);Archaea;Thermoplasmatota;Thermoplasmata;A10;";"0.0";"0";"29";"21";"0";"21";"8";"430503";"5766"
"LOK1378_1mm";"SILVA (only NR);Archaea;Thermoplasmatota;Thermoplasmata;Acidiprofundales;";"0.0";"0";"35";"22";"0";"22";"13";"430502";"5766"
"LOK1378_1mm";"SILVA (only NR);Archaea;Thermoplasmatota;Thermoplasmata;Acidiprofundales;Aciduliprofundaceae;";"0.0";"0";"35";"22";"0";"22";"13";"430502";"5766"
"LOK1378_1mm";"SILVA (only NR);Archaea;Thermoplasmatota;Thermoplasmata;Acidiprofundales;Aciduliprofundaceae;Aciduliprofundum;";"0.0";"0";"32";"20";"0";"20";"12";"430504";"5766"
"LOK1378_1mm";"SILVA (only NR);Archaea;Thermoplasmatota;Thermoplasmata;Acidiprofundales;Aciduliprofundaceae;JdFR-45;";"0.0";"0";"3";"2";"0";"2";"1";"430522";"5766"
"LOK1378_1mm";"SILVA (only NR);Archaea;Thermoplasmatota;Thermoplasmata;BSLdp215;";"0.0";"0";"25";"21";"0";"21";"4";"430503";"5766"
"LOK1378_1mm";"SILVA (only NR);Archaea;Thermoplasmatota;Thermoplasmata;JdFR-43;";"0.0";"0";"44";"12";"0";"12";"32";"430512";"5766"
"LOK1378_1mm";"SILVA (only NR);Archaea;Thermoplasmatota;Thermoplasmata;Marine Benthic Group D and DHVEG-1;";"0.3";"98.7";"765";"373";"1";"372";"392";"430151";"5765"
"LOK1378_1mm";"SILVA (only NR);Archaea;Thermoplasmatota;Thermoplasmata;Marine Group II;";"1.6";"98.7";"574";"249";"4";"245";"325";"430275";"5762"
"LOK1378_1mm";"SILVA (only NR);Archaea;Thermoplasmatota;Thermoplasmata;Marine Group III;";"0.0";"0";"282";"51";"0";"51";"231";"430473";"5766"
"LOK1378_1mm";"SILVA (only NR);Archaea;Thermoplasmatota;Thermoplasmata;Methanomassiliicoccales;";"2.8";"98.7";"495";"398";"11";"387";"97";"430126";"5755"
"LOK1378_1mm";"SILVA (only NR);Archaea;Thermoplasmatota;Thermoplasmata;Methanomassiliicoccales;Methanomassiliicoccaceae;";"0.0";"0";"62";"35";"0";"35";"27";"430489";"5766"
"LOK1378_1mm";"SILVA (only NR);Archaea;Thermoplasmatota;Thermoplasmata;Methanomassiliicoccales;Methanomassiliicoccaceae;Methanomassiliicoccus;";"0.0";"0";"20";"12";"0";"12";"8";"430512";"5766"
"LOK1378_1mm";"SILVA (only NR);Archaea;Thermoplasmatota;Thermoplasmata;Methanomassiliicoccales;Methanomassiliicoccaceae;uncultured;";"0.0";"0";"42";"23";"0";"23";"19";"430501";"5766"
"LOK1378_1mm";"SILVA (only NR);Archaea;Thermoplasmatota;Thermoplasmata;Methanomassiliicoccales;Methanomethylophilaceae;";"3.2";"98.7";"347";"316";"10";"306";"31";"430208";"5756"
"LOK1378_1mm";"SILVA (only NR);Archaea;Thermoplasmatota;Thermoplasmata;Methanomassiliicoccales;Methanomethylophilaceae;Candidatus Methanogranum;";"0.0";"0";"7";"3";"0";"3";"4";"430521";"5766"
"LOK1378_1mm";"SILVA (only NR);Archaea;Thermoplasmatota;Thermoplasmata;Methanomassiliicoccales;Methanomethylophilaceae;Candidatus Methanomethylophilus;";"1.4";"98.7";"71";"70";"1";"69";"1";"430454";"5765"
"LOK1378_1mm";"SILVA (only NR);Archaea;Thermoplasmatota;Thermoplasmata;Methanomassiliicoccales;Methanomethylophilaceae;Candidatus Methanoplasma;";"0.0";"0";"29";"27";"0";"27";"2";"430497";"5766"
"LOK1378_1mm";"SILVA (only NR);Archaea;Thermoplasmatota;Thermoplasmata;Methanomassiliicoccales;Methanomethylophilaceae;RumEn M2;";"30.8";"98.7";"13";"13";"4";"9";"0";"430511";"5762"
"LOK1378_1mm";"SILVA (only NR);Archaea;Thermoplasmatota;Thermoplasmata;Methanomassiliicoccales;Methanomethylophilaceae;uncultured;";"2.5";"98.7";"224";"202";"5";"197";"22";"430322";"5761"
"LOK1378_1mm";"SILVA (only NR);Archaea;Thermoplasmatota;Thermoplasmata;Methanomassiliicoccales;uncultured;";"2.1";"98.7";"86";"47";"1";"46";"39";"430477";"5765"
"LOK1378_1mm";"SILVA (only NR);Archaea;Thermoplasmatota;Thermoplasmata;SG8-5;";"0.0";"0";"63";"40";"0";"40";"23";"430484";"5766"
"LOK1378_1mm";"SILVA (only NR);Archaea;Thermoplasmatota;Thermoplasmata;Thermoplasmatales;";"0.0";"0";"161";"78";"0";"78";"83";"430446";"5766"
"LOK1378_1mm";"SILVA (only NR);Archaea;Thermoplasmatota;Thermoplasmata;Thermoplasmatales;Ferroplasmaceae;";"0.0";"0";"69";"23";"0";"23";"46";"430501";"5766"
"LOK1378_1mm";"SILVA (only NR);Archaea;Thermoplasmatota;Thermoplasmata;Thermoplasmatales;Ferroplasmaceae;Acidiplasma;";"0.0";"0";"8";"7";"0";"7";"1";"430517";"5766"
"LOK1378_1mm";"SILVA (only NR);Archaea;Thermoplasmatota;Thermoplasmata;Thermoplasmatales;Ferroplasmaceae;Ferroplasma;";"0.0";"0";"38";"12";"0";"12";"26";"430512";"5766"
"LOK1378_1mm";"SILVA (only NR);Archaea;Thermoplasmatota;Thermoplasmata;Thermoplasmatales;Ferroplasmaceae;uncultured;";"0.0";"0";"15";"2";"0";"2";"13";"430522";"5766"
"LOK1378_1mm";"SILVA (only NR);Archaea;Thermoplasmatota;Thermoplasmata;Thermoplasmatales;Picrophilaceae;";"0.0";"0";"2";"2";"0";"2";"0";"430522";"5766"
"LOK1378_1mm";"SILVA (only NR);Archaea;Thermoplasmatota;Thermoplasmata;Thermoplasmatales;Picrophilaceae;Picrophilus;";"0.0";"0";"2";"2";"0";"2";"0";"430522";"5766"
"LOK1378_1mm";"SILVA (only NR);Archaea;Thermoplasmatota;Thermoplasmata;Thermoplasmatales;Thermogymnomonas;";"0.0";"0";"1";"1";"0";"1";"0";"430523";"5766"
"LOK1378_1mm";"SILVA (only NR);Archaea;Thermoplasmatota;Thermoplasmata;Thermoplasmatales;Thermoplasmataceae;";"0.0";"0";"89";"52";"0";"52";"37";"430472";"5766"
"LOK1378_1mm";"SILVA (only NR);Archaea;Thermoplasmatota;Thermoplasmata;Thermoplasmatales;Thermoplasmataceae;A-plasma;";"0.0";"0";"14";"10";"0";"10";"4";"430514";"5766"
"LOK1378_1mm";"SILVA (only NR);Archaea;Thermoplasmatota;Thermoplasmata;Thermoplasmatales;Thermoplasmataceae;Cuniculiplasma;";"0.0";"0";"12";"7";"0";"7";"5";"430517";"5766"
"LOK1378_1mm";"SILVA (only NR);Archaea;Thermoplasmatota;Thermoplasmata;Thermoplasmatales;Thermoplasmataceae;E-plasma;";"0.0";"0";"10";"3";"0";"3";"7";"430521";"5766"
"LOK1378_1mm";"SILVA (only NR);Archaea;Thermoplasmatota;Thermoplasmata;Thermoplasmatales;Thermoplasmataceae;Thermoplasma;";"0.0";"0";"11";"11";"0";"11";"0";"430513";"5766"
"LOK1378_1mm";"SILVA (only NR);Archaea;Thermoplasmatota;Thermoplasmata;Thermoplasmatales;Thermoplasmataceae;uncultured;";"0.0";"0";"39";"19";"0";"19";"20";"430505";"5766"
"LOK1378_1mm";"SILVA (only NR);Archaea;Thermoplasmatota;Thermoplasmata;uncultured;";"0.6";"98.7";"345";"170";"1";"169";"175";"430354";"5765"
"LOK1378_1mm";"SILVA (only NR);Archaea;Thermoplasmatota;uncultured;";"0.0";"0";"76";"22";"0";"22";"54";"430502";"5766"
"LOK1378_1mm";"SILVA (only NR);Archaea;uncultured;";"0.0";"0";"8";"4";"0";"4";"4";"430520";"5766"
"LOK1378_1mm";"SILVA (only NR);Bacteria;";"0.0";"91";"381535";"366639";"1";"366638";"14896";"63885";"5765"
"LOK1378_1mm";"SILVA (only NR);Bacteria;10bav-F6;";"0.0";"0";"6";"6";"0";"6";"0";"430518";"5766"
"LOK1378_1mm";"SILVA (only NR);Bacteria;Abditibacteriota;";"0.0";"0";"162";"158";"0";"158";"4";"430366";"5766"
"LOK1378_1mm";"SILVA (only NR);Bacteria;Abditibacteriota;Abditibacteria;";"0.0";"0";"162";"158";"0";"158";"4";"430366";"5766"
"LOK1378_1mm";"SILVA (only NR);Bacteria;Abditibacteriota;Abditibacteria;Abditibacteriales;";"0.0";"0";"162";"158";"0";"158";"4";"430366";"5766"
"LOK1378_1mm";"SILVA (only NR);Bacteria;Abditibacteriota;Abditibacteria;Abditibacteriales;Abditibacteriaceae;";"0.0";"0";"162";"158";"0";"158";"4";"430366";"5766"
"LOK1378_1mm";"SILVA (only NR);Bacteria;Abditibacteriota;Abditibacteria;Abditibacteriales;Abditibacteriaceae;Abditibacterium;";"0.0";"0";"162";"158";"0";"158";"4";"430366";"5766"
"LOK1378_1mm";"SILVA (only NR);Bacteria;Acetothermia;";"0.0";"0";"169";"165";"0";"165";"4";"430359";"5766"
"LOK1378_1mm";"SILVA (only NR);Bacteria;Acetothermia;Acetothermiia;";"0.0";"0";"169";"165";"0";"165";"4";"430359";"5766"
"LOK1378_1mm";"SILVA (only NR);Bacteria;Acidobacteriota;";"0.0";"0";"11563";"11209";"0";"11209";"354";"419315";"5766"
"LOK1378_1mm";"SILVA (only NR);Bacteria;Acidobacteriota;AT-s3-28;";"0.0";"0";"27";"25";"0";"25";"2";"430499";"5766"
"LOK1378_1mm";"SILVA (only NR);Bacteria;Acidobacteriota;Acidobacteriae;";"0.0";"0";"3697";"3593";"0";"3593";"104";"426931";"5766"
"LOK1378_1mm";"SILVA (only NR);Bacteria;Acidobacteriota;Acidobacteriae;AKIW659;";"0.0";"0";"29";"27";"0";"27";"2";"430497";"5766"
"LOK1378_1mm";"SILVA (only NR);Bacteria;Acidobacteriota;Acidobacteriae;AMGG11;";"0.0";"0";"5";"5";"0";"5";"0";"430519";"5766"
"LOK1378_1mm";"SILVA (only NR);Bacteria;Acidobacteriota;Acidobacteriae;Acidobacteriales;";"0.0";"0";"1621";"1582";"0";"1582";"39";"428942";"5766"
"LOK1378_1mm";"SILVA (only NR);Bacteria;Acidobacteriota;Acidobacteriae;Acidobacteriales;Acidobacteriaceae (Subgroup 1);";"0.0";"0";"740";"721";"0";"721";"19";"429803";"5766"
"LOK1378_1mm";"SILVA (only NR);Bacteria;Acidobacteriota;Acidobacteriae;Acidobacteriales;Acidobacteriaceae (Subgroup 1);Acidicapsa;";"0.0";"0";"19";"18";"0";"18";"1";"430506";"5766"
"LOK1378_1mm";"SILVA (only NR);Bacteria;Acidobacteriota;Acidobacteriae;Acidobacteriales;Acidobacteriaceae (Subgroup 1);Acidipila-Silvibacterium;";"0.0";"0";"83";"82";"0";"82";"1";"430442";"5766"
"LOK1378_1mm";"SILVA (only NR);Bacteria;Acidobacteriota;Acidobacteriae;Acidobacteriales;Acidobacteriaceae (Subgroup 1);Acidobacterium;";"0.0";"0";"12";"12";"0";"12";"0";"430512";"5766"
"LOK1378_1mm";"SILVA (only NR);Bacteria;Acidobacteriota;Acidobacteriae;Acidobacteriales;Acidobacteriaceae (Subgroup 1);Bryocella;";"0.0";"0";"28";"28";"0";"28";"0";"430496";"5766"
"LOK1378_1mm";"SILVA (only NR);Bacteria;Acidobacteriota;Acidobacteriae;Acidobacteriales;Acidobacteriaceae (Subgroup 1);Edaphobacter;";"0.0";"0";"52";"50";"0";"50";"2";"430474";"5766"
"LOK1378_1mm";"SILVA (only NR);Bacteria;Acidobacteriota;Acidobacteriae;Acidobacteriales;Acidobacteriaceae (Subgroup 1);Granulicella;";"0.0";"0";"190";"187";"0";"187";"3";"430337";"5766"
"LOK1378_1mm";"SILVA (only NR);Bacteria;Acidobacteriota;Acidobacteriae;Acidobacteriales;Acidobacteriaceae (Subgroup 1);Occallatibacter;";"0.0";"0";"126";"121";"0";"121";"5";"430403";"5766"
"LOK1378_1mm";"SILVA (only NR);Bacteria;Acidobacteriota;Acidobacteriae;Acidobacteriales;Acidobacteriaceae (Subgroup 1);Telmatobacter;";"0.0";"0";"4";"4";"0";"4";"0";"430520";"5766"
"LOK1378_1mm";"SILVA (only NR);Bacteria;Acidobacteriota;Acidobacteriae;Acidobacteriales;Acidobacteriaceae (Subgroup 1);Terracidiphilus;";"0.0";"0";"9";"9";"0";"9";"0";"430515";"5766"
"LOK1378_1mm";"SILVA (only NR);Bacteria;Acidobacteriota;Acidobacteriae;Acidobacteriales;Acidobacteriaceae (Subgroup 1);Terriglobus;";"0.0";"0";"27";"27";"0";"27";"0";"430497";"5766"
"LOK1378_1mm";"SILVA (only NR);Bacteria;Acidobacteriota;Acidobacteriae;Acidobacteriales;Acidobacteriaceae (Subgroup 1);uncultured;";"0.0";"0";"184";"177";"0";"177";"7";"430347";"5766"
"LOK1378_1mm";"SILVA (only NR);Bacteria;Acidobacteriota;Acidobacteriae;Acidobacteriales;Koribacteraceae;";"0.0";"0";"90";"87";"0";"87";"3";"430437";"5766"
"LOK1378_1mm";"SILVA (only NR);Bacteria;Acidobacteriota;Acidobacteriae;Acidobacteriales;Koribacteraceae;Candidatus Koribacter;";"0.0";"0";"90";"87";"0";"87";"3";"430437";"5766"
"LOK1378_1mm";"SILVA (only NR);Bacteria;Acidobacteriota;Acidobacteriae;Acidobacteriales;uncultured;";"0.0";"0";"785";"768";"0";"768";"17";"429756";"5766"
"LOK1378_1mm";"SILVA (only NR);Bacteria;Acidobacteriota;Acidobacteriae;Bryobacterales;";"0.0";"0";"663";"647";"0";"647";"16";"429877";"5766"
"LOK1378_1mm";"SILVA (only NR);Bacteria;Acidobacteriota;Acidobacteriae;Bryobacterales;Bryobacteraceae;";"0.0";"0";"663";"647";"0";"647";"16";"429877";"5766"
"LOK1378_1mm";"SILVA (only NR);Bacteria;Acidobacteriota;Acidobacteriae;Bryobacterales;Bryobacteraceae;Bryobacter;";"0.0";"0";"663";"647";"0";"647";"16";"429877";"5766"
"LOK1378_1mm";"SILVA (only NR);Bacteria;Acidobacteriota;Acidobacteriae;Elev-16S-1166;";"0.0";"0";"16";"16";"0";"16";"0";"430508";"5766"
"LOK1378_1mm";"SILVA (only NR);Bacteria;Acidobacteriota;Acidobacteriae;GOUTB8;";"0.0";"0";"16";"16";"0";"16";"0";"430508";"5766"
"LOK1378_1mm";"SILVA (only NR);Bacteria;Acidobacteriota;Acidobacteriae;PAUC26f;";"0.0";"0";"84";"82";"0";"82";"2";"430442";"5766"
"LOK1378_1mm";"SILVA (only NR);Bacteria;Acidobacteriota;Acidobacteriae;Paludibaculum;";"0.0";"0";"103";"101";"0";"101";"2";"430423";"5766"
"LOK1378_1mm";"SILVA (only NR);Bacteria;Acidobacteriota;Acidobacteriae;Solibacterales;";"0.0";"0";"551";"535";"0";"535";"16";"429989";"5766"
"LOK1378_1mm";"SILVA (only NR);Bacteria;Acidobacteriota;Acidobacteriae;Solibacterales;Solibacteraceae;";"0.0";"0";"551";"535";"0";"535";"16";"429989";"5766"
"LOK1378_1mm";"SILVA (only NR);Bacteria;Acidobacteriota;Acidobacteriae;Solibacterales;Solibacteraceae;Candidatus Solibacter;";"0.0";"0";"551";"535";"0";"535";"16";"429989";"5766"
"LOK1378_1mm";"SILVA (only NR);Bacteria;Acidobacteriota;Acidobacteriae;Subgroup 12;";"0.0";"0";"11";"11";"0";"11";"0";"430513";"5766"
"LOK1378_1mm";"SILVA (only NR);Bacteria;Acidobacteriota;Acidobacteriae;Subgroup 13;";"0.0";"0";"88";"83";"0";"83";"5";"430441";"5766"
"LOK1378_1mm";"SILVA (only NR);Bacteria;Acidobacteriota;Acidobacteriae;Subgroup 15;";"0.0";"0";"52";"51";"0";"51";"1";"430473";"5766"
"LOK1378_1mm";"SILVA (only NR);Bacteria;Acidobacteriota;Acidobacteriae;Subgroup 2;";"0.0";"0";"450";"429";"0";"429";"21";"430095";"5766"
"LOK1378_1mm";"SILVA (only NR);Bacteria;Acidobacteriota;Acidobacteriae;TSBb06;";"0.0";"0";"2";"2";"0";"2";"0";"430522";"5766"
"LOK1378_1mm";"SILVA (only NR);Bacteria;Acidobacteriota;Aminicenantia;";"0.0";"0";"459";"441";"0";"441";"18";"430083";"5766"
"LOK1378_1mm";"SILVA (only NR);Bacteria;Acidobacteriota;Aminicenantia;Aminicenantales;";"0.0";"0";"459";"441";"0";"441";"18";"430083";"5766"
"LOK1378_1mm";"SILVA (only NR);Bacteria;Acidobacteriota;Blastocatellia;";"0.0";"0";"1876";"1794";"0";"1794";"82";"428730";"5766"
"LOK1378_1mm";"SILVA (only NR);Bacteria;Acidobacteriota;Blastocatellia;11-24;";"0.0";"0";"292";"280";"0";"280";"12";"430244";"5766"
"LOK1378_1mm";"SILVA (only NR);Bacteria;Acidobacteriota;Blastocatellia;Blastocatellales;";"0.0";"0";"647";"631";"0";"631";"16";"429893";"5766"
"LOK1378_1mm";"SILVA (only NR);Bacteria;Acidobacteriota;Blastocatellia;Blastocatellales;Blastocatellaceae;";"0.0";"0";"647";"631";"0";"631";"16";"429893";"5766"
"LOK1378_1mm";"SILVA (only NR);Bacteria;Acidobacteriota;Blastocatellia;Blastocatellales;Blastocatellaceae;Aridibacter;";"0.0";"0";"24";"24";"0";"24";"0";"430500";"5766"
"LOK1378_1mm";"SILVA (only NR);Bacteria;Acidobacteriota;Blastocatellia;Blastocatellales;Blastocatellaceae;Blastocatella;";"0.0";"0";"165";"161";"0";"161";"4";"430363";"5766"
"LOK1378_1mm";"SILVA (only NR);Bacteria;Acidobacteriota;Blastocatellia;Blastocatellales;Blastocatellaceae;JGI 0001001-H03;";"0.0";"0";"156";"154";"0";"154";"2";"430370";"5766"
"LOK1378_1mm";"SILVA (only NR);Bacteria;Acidobacteriota;Blastocatellia;Blastocatellales;Blastocatellaceae;OLB17;";"0.0";"0";"9";"9";"0";"9";"0";"430515";"5766"
"LOK1378_1mm";"SILVA (only NR);Bacteria;Acidobacteriota;Blastocatellia;Blastocatellales;Blastocatellaceae;Stenotrophobacter;";"0.0";"0";"104";"97";"0";"97";"7";"430427";"5766"
"LOK1378_1mm";"SILVA (only NR);Bacteria;Acidobacteriota;Blastocatellia;Blastocatellales;Blastocatellaceae;Tellurimicrobium;";"0.0";"0";"4";"4";"0";"4";"0";"430520";"5766"
"LOK1378_1mm";"SILVA (only NR);Bacteria;Acidobacteriota;Blastocatellia;Blastocatellales;Blastocatellaceae;uncultured;";"0.0";"0";"180";"177";"0";"177";"3";"430347";"5766"
"LOK1378_1mm";"SILVA (only NR);Bacteria;Acidobacteriota;Blastocatellia;Chloracidobacteriales;";"0.0";"0";"13";"13";"0";"13";"0";"430511";"5766"
"LOK1378_1mm";"SILVA (only NR);Bacteria;Acidobacteriota;Blastocatellia;Chloracidobacteriales;Chloracidobacteriaceae;";"0.0";"0";"13";"13";"0";"13";"0";"430511";"5766"
"LOK1378_1mm";"SILVA (only NR);Bacteria;Acidobacteriota;Blastocatellia;Chloracidobacteriales;Chloracidobacteriaceae;Chloracidobacterium;";"0.0";"0";"13";"13";"0";"13";"0";"430511";"5766"
"LOK1378_1mm";"SILVA (only NR);Bacteria;Acidobacteriota;Blastocatellia;DS-100;";"0.0";"0";"38";"36";"0";"36";"2";"430488";"5766"
"LOK1378_1mm";"SILVA (only NR);Bacteria;Acidobacteriota;Blastocatellia;Elev-16S-573;";"0.0";"0";"36";"35";"0";"35";"1";"430489";"5766"
"LOK1378_1mm";"SILVA (only NR);Bacteria;Acidobacteriota;Blastocatellia;Pyrinomonadales;";"0.0";"0";"850";"799";"0";"799";"51";"429725";"5766"
"LOK1378_1mm";"SILVA (only NR);Bacteria;Acidobacteriota;Blastocatellia;Pyrinomonadales;Pyrinomonadaceae;";"0.0";"0";"850";"799";"0";"799";"51";"429725";"5766"
"LOK1378_1mm";"SILVA (only NR);Bacteria;Acidobacteriota;Blastocatellia;Pyrinomonadales;Pyrinomonadaceae;Pyrinomonas;";"0.0";"0";"4";"4";"0";"4";"0";"430520";"5766"
"LOK1378_1mm";"SILVA (only NR);Bacteria;Acidobacteriota;Blastocatellia;Pyrinomonadales;Pyrinomonadaceae;RB41;";"0.0";"0";"846";"795";"0";"795";"51";"429729";"5766"
"LOK1378_1mm";"SILVA (only NR);Bacteria;Acidobacteriota;FFCH5909;";"0.0";"0";"4";"4";"0";"4";"0";"430520";"5766"
"LOK1378_1mm";"SILVA (only NR);Bacteria;Acidobacteriota;GBS-L1-B05;";"0.0";"0";"3";"2";"0";"2";"1";"430522";"5766"
"LOK1378_1mm";"SILVA (only NR);Bacteria;Acidobacteriota;Holophagae;";"0.0";"0";"655";"632";"0";"632";"23";"429892";"5766"
"LOK1378_1mm";"SILVA (only NR);Bacteria;Acidobacteriota;Holophagae;Acanthopleuribacterales;";"0.0";"0";"34";"34";"0";"34";"0";"430490";"5766"
"LOK1378_1mm";"SILVA (only NR);Bacteria;Acidobacteriota;Holophagae;Acanthopleuribacterales;Acanthopleuribacteraceae;";"0.0";"0";"34";"34";"0";"34";"0";"430490";"5766"
"LOK1378_1mm";"SILVA (only NR);Bacteria;Acidobacteriota;Holophagae;Acanthopleuribacterales;Acanthopleuribacteraceae;Acanthopleuribacter;";"0.0";"0";"25";"25";"0";"25";"0";"430499";"5766"
"LOK1378_1mm";"SILVA (only NR);Bacteria;Acidobacteriota;Holophagae;Acanthopleuribacterales;Acanthopleuribacteraceae;Thermotomaculum;";"0.0";"0";"9";"9";"0";"9";"0";"430515";"5766"
"LOK1378_1mm";"SILVA (only NR);Bacteria;Acidobacteriota;Holophagae;Holophagales;";"0.0";"0";"184";"177";"0";"177";"7";"430347";"5766"
"LOK1378_1mm";"SILVA (only NR);Bacteria;Acidobacteriota;Holophagae;Holophagales;Holophagaceae;";"0.0";"0";"184";"177";"0";"177";"7";"430347";"5766"
"LOK1378_1mm";"SILVA (only NR);Bacteria;Acidobacteriota;Holophagae;Holophagales;Holophagaceae;Geothrix;";"0.0";"0";"50";"49";"0";"49";"1";"430475";"5766"
"LOK1378_1mm";"SILVA (only NR);Bacteria;Acidobacteriota;Holophagae;Holophagales;Holophagaceae;Holophaga;";"0.0";"0";"19";"17";"0";"17";"2";"430507";"5766"
"LOK1378_1mm";"SILVA (only NR);Bacteria;Acidobacteriota;Holophagae;Holophagales;Holophagaceae;marine group;";"0.0";"0";"34";"33";"0";"33";"1";"430491";"5766"
"LOK1378_1mm";"SILVA (only NR);Bacteria;Acidobacteriota;Holophagae;Holophagales;Holophagaceae;uncultured;";"0.0";"0";"70";"67";"0";"67";"3";"430457";"5766"
"LOK1378_1mm";"SILVA (only NR);Bacteria;Acidobacteriota;Holophagae;Subgroup 7;";"0.0";"0";"437";"421";"0";"421";"16";"430103";"5766"
"LOK1378_1mm";"SILVA (only NR);Bacteria;Acidobacteriota;ODP1230B23.02;";"0.0";"0";"13";"13";"0";"13";"0";"430511";"5766"
"LOK1378_1mm";"SILVA (only NR);Bacteria;Acidobacteriota;Subgroup 11;";"0.0";"0";"52";"46";"0";"46";"6";"430478";"5766"
"LOK1378_1mm";"SILVA (only NR);Bacteria;Acidobacteriota;Subgroup 18;";"0.0";"0";"131";"122";"0";"122";"9";"430402";"5766"
"LOK1378_1mm";"SILVA (only NR);Bacteria;Acidobacteriota;Subgroup 19;";"0.0";"0";"3";"3";"0";"3";"0";"430521";"5766"
"LOK1378_1mm";"SILVA (only NR);Bacteria;Acidobacteriota;Subgroup 20;";"0.0";"0";"5";"5";"0";"5";"0";"430519";"5766"
"LOK1378_1mm";"SILVA (only NR);Bacteria;Acidobacteriota;Subgroup 21;";"0.0";"0";"178";"174";"0";"174";"4";"430350";"5766"
"LOK1378_1mm";"SILVA (only NR);Bacteria;Acidobacteriota;Subgroup 22;";"0.0";"0";"337";"333";"0";"333";"4";"430191";"5766"
"LOK1378_1mm";"SILVA (only NR);Bacteria;Acidobacteriota;Subgroup 25;";"0.0";"0";"59";"57";"0";"57";"2";"430467";"5766"
"LOK1378_1mm";"SILVA (only NR);Bacteria;Acidobacteriota;Subgroup 26;";"0.0";"0";"58";"57";"0";"57";"1";"430467";"5766"
"LOK1378_1mm";"SILVA (only NR);Bacteria;Acidobacteriota;Subgroup 5;";"0.0";"0";"255";"249";"0";"249";"6";"430275";"5766"
"LOK1378_1mm";"SILVA (only NR);Bacteria;Acidobacteriota;Thermoanaerobaculia;";"0.0";"0";"602";"591";"0";"591";"11";"429933";"5766"
"LOK1378_1mm";"SILVA (only NR);Bacteria;Acidobacteriota;Thermoanaerobaculia;Thermoanaerobaculales;";"0.0";"0";"602";"591";"0";"591";"11";"429933";"5766"
"LOK1378_1mm";"SILVA (only NR);Bacteria;Acidobacteriota;Thermoanaerobaculia;Thermoanaerobaculales;Thermoanaerobaculaceae;";"0.0";"0";"602";"591";"0";"591";"11";"429933";"5766"
"LOK1378_1mm";"SILVA (only NR);Bacteria;Acidobacteriota;Thermoanaerobaculia;Thermoanaerobaculales;Thermoanaerobaculaceae;B276-D12;";"0.0";"0";"3";"3";"0";"3";"0";"430521";"5766"
"LOK1378_1mm";"SILVA (only NR);Bacteria;Acidobacteriota;Thermoanaerobaculia;Thermoanaerobaculales;Thermoanaerobaculaceae;Subgroup 10;";"0.0";"0";"425";"417";"0";"417";"8";"430107";"5766"
"LOK1378_1mm";"SILVA (only NR);Bacteria;Acidobacteriota;Thermoanaerobaculia;Thermoanaerobaculales;Thermoanaerobaculaceae;Subgroup 23;";"0.0";"0";"129";"127";"0";"127";"2";"430397";"5766"
"LOK1378_1mm";"SILVA (only NR);Bacteria;Acidobacteriota;Thermoanaerobaculia;Thermoanaerobaculales;Thermoanaerobaculaceae;TPD-58;";"0.0";"0";"18";"18";"0";"18";"0";"430506";"5766"
"LOK1378_1mm";"SILVA (only NR);Bacteria;Acidobacteriota;Thermoanaerobaculia;Thermoanaerobaculales;Thermoanaerobaculaceae;Thermoanaerobaculum;";"0.0";"0";"27";"26";"0";"26";"1";"430498";"5766"
"LOK1378_1mm";"SILVA (only NR);Bacteria;Acidobacteriota;Vicinamibacteria;";"0.0";"0";"3118";"3037";"0";"3037";"81";"427487";"5766"
"LOK1378_1mm";"SILVA (only NR);Bacteria;Acidobacteriota;Vicinamibacteria;11B-2;";"0.0";"0";"3";"3";"0";"3";"0";"430521";"5766"
"LOK1378_1mm";"SILVA (only NR);Bacteria;Acidobacteriota;Vicinamibacteria;Subgroup 17;";"0.0";"0";"227";"223";"0";"223";"4";"430301";"5766"
"LOK1378_1mm";"SILVA (only NR);Bacteria;Acidobacteriota;Vicinamibacteria;Subgroup 9;";"0.0";"0";"130";"126";"0";"126";"4";"430398";"5766"
"LOK1378_1mm";"SILVA (only NR);Bacteria;Acidobacteriota;Vicinamibacteria;Vicinamibacterales;";"0.0";"0";"2758";"2685";"0";"2685";"73";"427839";"5766"
"LOK1378_1mm";"SILVA (only NR);Bacteria;Acidobacteriota;Vicinamibacteria;Vicinamibacterales;Vicinamibacteraceae;";"0.0";"0";"1056";"1023";"0";"1023";"33";"429501";"5766"
"LOK1378_1mm";"SILVA (only NR);Bacteria;Acidobacteriota;Vicinamibacteria;Vicinamibacterales;Vicinamibacteraceae;Luteitalea;";"0.0";"0";"57";"56";"0";"56";"1";"430468";"5766"
"LOK1378_1mm";"SILVA (only NR);Bacteria;Acidobacteriota;Vicinamibacteria;Vicinamibacterales;Vicinamibacteraceae;Vicinamibacter;";"0.0";"0";"24";"22";"0";"22";"2";"430502";"5766"
"LOK1378_1mm";"SILVA (only NR);Bacteria;Acidobacteriota;Vicinamibacteria;Vicinamibacterales;Vicinamibacteraceae;uncultured;";"0.0";"0";"42";"40";"0";"40";"2";"430484";"5766"
"LOK1378_1mm";"SILVA (only NR);Bacteria;Acidobacteriota;Vicinamibacteria;Vicinamibacterales;uncultured;";"0.0";"0";"1688";"1648";"0";"1648";"40";"428876";"5766"
"LOK1378_1mm";"SILVA (only NR);Bacteria;Acidobacteriota;c5LKS83;";"0.0";"0";"11";"11";"0";"11";"0";"430513";"5766"
"LOK1378_1mm";"SILVA (only NR);Bacteria;Acidobacteriota;d142;";"0.0";"0";"17";"17";"0";"17";"0";"430507";"5766"
"LOK1378_1mm";"SILVA (only NR);Bacteria;Actinobacteriota;";"0.0";"0";"36942";"35613";"0";"35613";"1329";"394911";"5766"
"LOK1378_1mm";"SILVA (only NR);Bacteria;Actinobacteriota;Acidimicrobiia;";"0.0";"0";"2771";"2659";"0";"2659";"112";"427865";"5766"
"LOK1378_1mm";"SILVA (only NR);Bacteria;Actinobacteriota;Acidimicrobiia;Acidimicrobiales;";"0.0";"0";"64";"59";"0";"59";"5";"430465";"5766"
"LOK1378_1mm";"SILVA (only NR);Bacteria;Actinobacteriota;Acidimicrobiia;Acidimicrobiales;Acidimicrobiaceae;";"0.0";"0";"60";"55";"0";"55";"5";"430469";"5766"
"LOK1378_1mm";"SILVA (only NR);Bacteria;Actinobacteriota;Acidimicrobiia;Acidimicrobiales;Acidimicrobiaceae;Acidimicrobium;";"0.0";"0";"9";"9";"0";"9";"0";"430515";"5766"
"LOK1378_1mm";"SILVA (only NR);Bacteria;Actinobacteriota;Acidimicrobiia;Acidimicrobiales;Acidimicrobiaceae;Acidithrix;";"0.0";"0";"13";"12";"0";"12";"1";"430512";"5766"
"LOK1378_1mm";"SILVA (only NR);Bacteria;Actinobacteriota;Acidimicrobiia;Acidimicrobiales;Acidimicrobiaceae;Ferrimicrobium;";"0.0";"0";"9";"8";"0";"8";"1";"430516";"5766"
"LOK1378_1mm";"SILVA (only NR);Bacteria;Actinobacteriota;Acidimicrobiia;Acidimicrobiales;Acidimicrobiaceae;Ferrithrix;";"0.0";"0";"16";"14";"0";"14";"2";"430510";"5766"
"LOK1378_1mm";"SILVA (only NR);Bacteria;Actinobacteriota;Acidimicrobiia;Acidimicrobiales;Acidimicrobiaceae;uncultured;";"0.0";"0";"12";"11";"0";"11";"1";"430513";"5766"
"LOK1378_1mm";"SILVA (only NR);Bacteria;Actinobacteriota;Acidimicrobiia;Acidimicrobiales;Acidimicrobiales Incertae Sedis;";"0.0";"0";"4";"4";"0";"4";"0";"430520";"5766"
"LOK1378_1mm";"SILVA (only NR);Bacteria;Actinobacteriota;Acidimicrobiia;Acidimicrobiales;Acidimicrobiales Incertae Sedis;Aciditerrimonas;";"0.0";"0";"4";"4";"0";"4";"0";"430520";"5766"
"LOK1378_1mm";"SILVA (only NR);Bacteria;Actinobacteriota;Acidimicrobiia;Actinomarinales;";"0.0";"0";"666";"637";"0";"637";"29";"429887";"5766"
"LOK1378_1mm";"SILVA (only NR);Bacteria;Actinobacteriota;Acidimicrobiia;Actinomarinales;Actinomarinaceae;";"0.0";"0";"178";"175";"0";"175";"3";"430349";"5766"
"LOK1378_1mm";"SILVA (only NR);Bacteria;Actinobacteriota;Acidimicrobiia;Actinomarinales;Actinomarinaceae;Candidatus Actinomarina;";"0.0";"0";"178";"175";"0";"175";"3";"430349";"5766"
"LOK1378_1mm";"SILVA (only NR);Bacteria;Actinobacteriota;Acidimicrobiia;Actinomarinales;uncultured;";"0.0";"0";"485";"459";"0";"459";"26";"430065";"5766"
"LOK1378_1mm";"SILVA (only NR);Bacteria;Actinobacteriota;Acidimicrobiia;IMCC26256;";"0.0";"0";"321";"309";"0";"309";"12";"430215";"5766"
"LOK1378_1mm";"SILVA (only NR);Bacteria;Actinobacteriota;Acidimicrobiia;Microtrichales;";"0.0";"0";"1496";"1440";"0";"1440";"56";"429084";"5766"
"LOK1378_1mm";"SILVA (only NR);Bacteria;Actinobacteriota;Acidimicrobiia;Microtrichales;Iamiaceae;";"0.0";"0";"144";"138";"0";"138";"6";"430386";"5766"
"LOK1378_1mm";"SILVA (only NR);Bacteria;Actinobacteriota;Acidimicrobiia;Microtrichales;Iamiaceae;Iamia;";"0.0";"0";"144";"138";"0";"138";"6";"430386";"5766"
"LOK1378_1mm";"SILVA (only NR);Bacteria;Actinobacteriota;Acidimicrobiia;Microtrichales;Ilumatobacteraceae;";"0.0";"0";"546";"521";"0";"521";"25";"430003";"5766"
"LOK1378_1mm";"SILVA (only NR);Bacteria;Actinobacteriota;Acidimicrobiia;Microtrichales;Ilumatobacteraceae;CL500-29 marine group;";"0.0";"0";"256";"248";"0";"248";"8";"430276";"5766"
"LOK1378_1mm";"SILVA (only NR);Bacteria;Actinobacteriota;Acidimicrobiia;Microtrichales;Ilumatobacteraceae;Ilumatobacter;";"0.0";"0";"96";"92";"0";"92";"4";"430432";"5766"
"LOK1378_1mm";"SILVA (only NR);Bacteria;Actinobacteriota;Acidimicrobiia;Microtrichales;Ilumatobacteraceae;uncultured;";"0.0";"0";"189";"176";"0";"176";"13";"430348";"5766"
"LOK1378_1mm";"SILVA (only NR);Bacteria;Actinobacteriota;Acidimicrobiia;Microtrichales;Microtrichaceae;";"0.0";"0";"521";"511";"0";"511";"10";"430013";"5766"
"LOK1378_1mm";"SILVA (only NR);Bacteria;Actinobacteriota;Acidimicrobiia;Microtrichales;Microtrichaceae;Candidatus Microthrix;";"0.0";"0";"35";"35";"0";"35";"0";"430489";"5766"
"LOK1378_1mm";"SILVA (only NR);Bacteria;Actinobacteriota;Acidimicrobiia;Microtrichales;Microtrichaceae;IMCC26207;";"0.0";"0";"44";"44";"0";"44";"0";"430480";"5766"
"LOK1378_1mm";"SILVA (only NR);Bacteria;Actinobacteriota;Acidimicrobiia;Microtrichales;Microtrichaceae;Sva0996 marine group;";"0.0";"0";"307";"300";"0";"300";"7";"430224";"5766"
"LOK1378_1mm";"SILVA (only NR);Bacteria;Actinobacteriota;Acidimicrobiia;Microtrichales;Microtrichaceae;uncultured;";"0.0";"0";"135";"132";"0";"132";"3";"430392";"5766"
"LOK1378_1mm";"SILVA (only NR);Bacteria;Actinobacteriota;Acidimicrobiia;Microtrichales;uncultured;";"0.0";"0";"281";"266";"0";"266";"15";"430258";"5766"
"LOK1378_1mm";"SILVA (only NR);Bacteria;Actinobacteriota;Acidimicrobiia;uncultured;";"0.0";"0";"223";"213";"0";"213";"10";"430311";"5766"
"LOK1378_1mm";"SILVA (only NR);Bacteria;Actinobacteriota;Actinobacteria;";"0.0";"0";"30683";"29642";"0";"29642";"1041";"400882";"5766"
"LOK1378_1mm";"SILVA (only NR);Bacteria;Actinobacteriota;Actinobacteria;0319-7L14;";"0.0";"0";"35";"35";"0";"35";"0";"430489";"5766"
"LOK1378_1mm";"SILVA (only NR);Bacteria;Actinobacteriota;Actinobacteria;Actinomycetales;";"0.0";"0";"942";"912";"0";"912";"30";"429612";"5766"
"LOK1378_1mm";"SILVA (only NR);Bacteria;Actinobacteriota;Actinobacteria;Actinomycetales;Actinomycetaceae;";"0.0";"0";"919";"891";"0";"891";"28";"429633";"5766"
"LOK1378_1mm";"SILVA (only NR);Bacteria;Actinobacteriota;Actinobacteria;Actinomycetales;Actinomycetaceae;Actinobaculum;";"0.0";"0";"2";"2";"0";"2";"0";"430522";"5766"
"LOK1378_1mm";"SILVA (only NR);Bacteria;Actinobacteriota;Actinobacteria;Actinomycetales;Actinomycetaceae;Actinomyces;";"0.0";"0";"691";"673";"0";"673";"18";"429851";"5766"
"LOK1378_1mm";"SILVA (only NR);Bacteria;Actinobacteriota;Actinobacteria;Actinomycetales;Actinomycetaceae;Actinotignum;";"0.0";"0";"15";"15";"0";"15";"0";"430509";"5766"
"LOK1378_1mm";"SILVA (only NR);Bacteria;Actinobacteriota;Actinobacteria;Actinomycetales;Actinomycetaceae;Arcanobacterium;";"0.0";"0";"30";"27";"0";"27";"3";"430497";"5766"
"LOK1378_1mm";"SILVA (only NR);Bacteria;Actinobacteriota;Actinobacteria;Actinomycetales;Actinomycetaceae;F0332;";"0.0";"0";"49";"46";"0";"46";"3";"430478";"5766"
"LOK1378_1mm";"SILVA (only NR);Bacteria;Actinobacteriota;Actinobacteria;Actinomycetales;Actinomycetaceae;Flaviflexus;";"0.0";"0";"13";"13";"0";"13";"0";"430511";"5766"
"LOK1378_1mm";"SILVA (only NR);Bacteria;Actinobacteriota;Actinobacteria;Actinomycetales;Actinomycetaceae;Mobiluncus;";"0.0";"0";"34";"34";"0";"34";"0";"430490";"5766"
"LOK1378_1mm";"SILVA (only NR);Bacteria;Actinobacteriota;Actinobacteria;Actinomycetales;Actinomycetaceae;Trueperella;";"0.0";"0";"30";"27";"0";"27";"3";"430497";"5766"
"LOK1378_1mm";"SILVA (only NR);Bacteria;Actinobacteriota;Actinobacteria;Actinomycetales;Actinomycetaceae;Varibaculum;";"0.0";"0";"37";"36";"0";"36";"1";"430488";"5766"
"LOK1378_1mm";"SILVA (only NR);Bacteria;Actinobacteriota;Actinobacteria;Actinomycetales;Actinomycetaceae;uncultured;";"0.0";"0";"10";"10";"0";"10";"0";"430514";"5766"
"LOK1378_1mm";"SILVA (only NR);Bacteria;Actinobacteriota;Actinobacteria;Actinomycetales;Actinomycetales Incertae Sedis;";"0.0";"0";"23";"21";"0";"21";"2";"430503";"5766"
"LOK1378_1mm";"SILVA (only NR);Bacteria;Actinobacteriota;Actinobacteria;Actinomycetales;Actinomycetales Incertae Sedis;Candidatus Ancillula;";"0.0";"0";"23";"21";"0";"21";"2";"430503";"5766"
"LOK1378_1mm";"SILVA (only NR);Bacteria;Actinobacteriota;Actinobacteria;Bifidobacteriales;";"0.0";"0";"505";"489";"0";"489";"16";"430035";"5766"
"LOK1378_1mm";"SILVA (only NR);Bacteria;Actinobacteriota;Actinobacteria;Bifidobacteriales;Bifidobacteriaceae;";"0.0";"0";"505";"489";"0";"489";"16";"430035";"5766"
"LOK1378_1mm";"SILVA (only NR);Bacteria;Actinobacteriota;Actinobacteria;Bifidobacteriales;Bifidobacteriaceae;Aeriscardovia;";"0.0";"0";"5";"5";"0";"5";"0";"430519";"5766"
"LOK1378_1mm";"SILVA (only NR);Bacteria;Actinobacteriota;Actinobacteria;Bifidobacteriales;Bifidobacteriaceae;Alloscardovia;";"0.0";"0";"16";"16";"0";"16";"0";"430508";"5766"
"LOK1378_1mm";"SILVA (only NR);Bacteria;Actinobacteriota;Actinobacteria;Bifidobacteriales;Bifidobacteriaceae;Bifidobacterium;";"0.0";"0";"449";"433";"0";"433";"16";"430091";"5766"
"LOK1378_1mm";"SILVA (only NR);Bacteria;Actinobacteriota;Actinobacteria;Bifidobacteriales;Bifidobacteriaceae;Bombiscardovia;";"0.0";"0";"3";"3";"0";"3";"0";"430521";"5766"
"LOK1378_1mm";"SILVA (only NR);Bacteria;Actinobacteriota;Actinobacteria;Bifidobacteriales;Bifidobacteriaceae;Gardnerella;";"0.0";"0";"15";"15";"0";"15";"0";"430509";"5766"
"LOK1378_1mm";"SILVA (only NR);Bacteria;Actinobacteriota;Actinobacteria;Bifidobacteriales;Bifidobacteriaceae;Neoscardovia;";"0.0";"0";"1";"1";"0";"1";"0";"430523";"5766"
"LOK1378_1mm";"SILVA (only NR);Bacteria;Actinobacteriota;Actinobacteria;Bifidobacteriales;Bifidobacteriaceae;Parascardovia;";"0.0";"0";"4";"4";"0";"4";"0";"430520";"5766"
"LOK1378_1mm";"SILVA (only NR);Bacteria;Actinobacteriota;Actinobacteria;Bifidobacteriales;Bifidobacteriaceae;Pseudoscardovia;";"0.0";"0";"3";"3";"0";"3";"0";"430521";"5766"
"LOK1378_1mm";"SILVA (only NR);Bacteria;Actinobacteriota;Actinobacteria;Bifidobacteriales;Bifidobacteriaceae;Scardovia;";"0.0";"0";"5";"5";"0";"5";"0";"430519";"5766"
"LOK1378_1mm";"SILVA (only NR);Bacteria;Actinobacteriota;Actinobacteria;Bifidobacteriales;Bifidobacteriaceae;uncultured;";"0.0";"0";"2";"2";"0";"2";"0";"430522";"5766"
"LOK1378_1mm";"SILVA (only NR);Bacteria;Actinobacteriota;Actinobacteria;Catenulisporales;";"0.0";"0";"36";"36";"0";"36";"0";"430488";"5766"
"LOK1378_1mm";"SILVA (only NR);Bacteria;Actinobacteriota;Actinobacteria;Catenulisporales;Actinospicaceae;";"0.0";"0";"26";"26";"0";"26";"0";"430498";"5766"
"LOK1378_1mm";"SILVA (only NR);Bacteria;Actinobacteriota;Actinobacteria;Catenulisporales;Actinospicaceae;Actinospica;";"0.0";"0";"26";"26";"0";"26";"0";"430498";"5766"
"LOK1378_1mm";"SILVA (only NR);Bacteria;Actinobacteriota;Actinobacteria;Catenulisporales;Catenulisporaceae;";"0.0";"0";"10";"10";"0";"10";"0";"430514";"5766"
"LOK1378_1mm";"SILVA (only NR);Bacteria;Actinobacteriota;Actinobacteria;Catenulisporales;Catenulisporaceae;Catenulispora;";"0.0";"0";"10";"10";"0";"10";"0";"430514";"5766"
"LOK1378_1mm";"SILVA (only NR);Bacteria;Actinobacteriota;Actinobacteria;Corynebacteriales;";"0.0";"0";"6456";"6252";"0";"6252";"204";"424272";"5766"
"LOK1378_1mm";"SILVA (only NR);Bacteria;Actinobacteriota;Actinobacteria;Corynebacteriales;Corynebacteriaceae;";"0.0";"0";"3111";"3046";"0";"3046";"65";"427478";"5766"
"LOK1378_1mm";"SILVA (only NR);Bacteria;Actinobacteriota;Actinobacteria;Corynebacteriales;Corynebacteriaceae;Corynebacterium;";"0.0";"0";"2941";"2880";"0";"2880";"61";"427644";"5766"
"LOK1378_1mm";"SILVA (only NR);Bacteria;Actinobacteriota;Actinobacteria;Corynebacteriales;Corynebacteriaceae;Lawsonella;";"0.0";"0";"142";"140";"0";"140";"2";"430384";"5766"
"LOK1378_1mm";"SILVA (only NR);Bacteria;Actinobacteriota;Actinobacteria;Corynebacteriales;Corynebacteriaceae;Turicella;";"0.0";"0";"19";"18";"0";"18";"1";"430506";"5766"
"LOK1378_1mm";"SILVA (only NR);Bacteria;Actinobacteriota;Actinobacteria;Corynebacteriales;Corynebacteriaceae;uncultured;";"0.0";"0";"3";"2";"0";"2";"1";"430522";"5766"
"LOK1378_1mm";"SILVA (only NR);Bacteria;Actinobacteriota;Actinobacteria;Corynebacteriales;Corynebacteriales Incertae Sedis;";"0.0";"0";"6";"6";"0";"6";"0";"430518";"5766"
"LOK1378_1mm";"SILVA (only NR);Bacteria;Actinobacteriota;Actinobacteria;Corynebacteriales;Corynebacteriales Incertae Sedis;Tomitella;";"0.0";"0";"6";"6";"0";"6";"0";"430518";"5766"
"LOK1378_1mm";"SILVA (only NR);Bacteria;Actinobacteriota;Actinobacteria;Corynebacteriales;Dietziaceae;";"0.0";"0";"120";"114";"0";"114";"6";"430410";"5766"
"LOK1378_1mm";"SILVA (only NR);Bacteria;Actinobacteriota;Actinobacteria;Corynebacteriales;Dietziaceae;Dietzia;";"0.0";"0";"120";"114";"0";"114";"6";"430410";"5766"
"LOK1378_1mm";"SILVA (only NR);Bacteria;Actinobacteriota;Actinobacteria;Corynebacteriales;Mycobacteriaceae;";"0.0";"0";"1535";"1491";"0";"1491";"44";"429033";"5766"
"LOK1378_1mm";"SILVA (only NR);Bacteria;Actinobacteriota;Actinobacteria;Corynebacteriales;Mycobacteriaceae;Hoyosella;";"0.0";"0";"7";"7";"0";"7";"0";"430517";"5766"
"LOK1378_1mm";"SILVA (only NR);Bacteria;Actinobacteriota;Actinobacteria;Corynebacteriales;Mycobacteriaceae;Mycobacterium;";"0.0";"0";"1528";"1484";"0";"1484";"44";"429040";"5766"
"LOK1378_1mm";"SILVA (only NR);Bacteria;Actinobacteriota;Actinobacteria;Corynebacteriales;Nocardiaceae;";"0.0";"0";"1618";"1530";"0";"1530";"88";"428994";"5766"
"LOK1378_1mm";"SILVA (only NR);Bacteria;Actinobacteriota;Actinobacteria;Corynebacteriales;Nocardiaceae;Gordonia;";"0.0";"0";"238";"223";"0";"223";"15";"430301";"5766"
"LOK1378_1mm";"SILVA (only NR);Bacteria;Actinobacteriota;Actinobacteria;Corynebacteriales;Nocardiaceae;Millisia;";"0.0";"0";"1";"1";"0";"1";"0";"430523";"5766"
"LOK1378_1mm";"SILVA (only NR);Bacteria;Actinobacteriota;Actinobacteria;Corynebacteriales;Nocardiaceae;Nocardia;";"0.0";"0";"678";"655";"0";"655";"23";"429869";"5766"
"LOK1378_1mm";"SILVA (only NR);Bacteria;Actinobacteriota;Actinobacteria;Corynebacteriales;Nocardiaceae;Rhodococcus;";"0.0";"0";"645";"597";"0";"597";"48";"429927";"5766"
"LOK1378_1mm";"SILVA (only NR);Bacteria;Actinobacteriota;Actinobacteria;Corynebacteriales;Nocardiaceae;Skermania;";"0.0";"0";"4";"4";"0";"4";"0";"430520";"5766"
"LOK1378_1mm";"SILVA (only NR);Bacteria;Actinobacteriota;Actinobacteria;Corynebacteriales;Nocardiaceae;Smaragdicoccus;";"0.0";"0";"8";"8";"0";"8";"0";"430516";"5766"
"LOK1378_1mm";"SILVA (only NR);Bacteria;Actinobacteriota;Actinobacteria;Corynebacteriales;Nocardiaceae;Williamsia;";"0.0";"0";"38";"37";"0";"37";"1";"430487";"5766"
"LOK1378_1mm";"SILVA (only NR);Bacteria;Actinobacteriota;Actinobacteria;Corynebacteriales;Segniliparaceae;";"0.0";"0";"10";"10";"0";"10";"0";"430514";"5766"
"LOK1378_1mm";"SILVA (only NR);Bacteria;Actinobacteriota;Actinobacteria;Corynebacteriales;Segniliparaceae;Segniliparus;";"0.0";"0";"6";"6";"0";"6";"0";"430518";"5766"
"LOK1378_1mm";"SILVA (only NR);Bacteria;Actinobacteriota;Actinobacteria;Corynebacteriales;Segniliparaceae;uncultured;";"0.0";"0";"4";"4";"0";"4";"0";"430520";"5766"
"LOK1378_1mm";"SILVA (only NR);Bacteria;Actinobacteriota;Actinobacteria;Corynebacteriales;Tsukamurellaceae;";"0.0";"0";"51";"50";"0";"50";"1";"430474";"5766"
"LOK1378_1mm";"SILVA (only NR);Bacteria;Actinobacteriota;Actinobacteria;Corynebacteriales;Tsukamurellaceae;Tsukamurella;";"0.0";"0";"51";"50";"0";"50";"1";"430474";"5766"
"LOK1378_1mm";"SILVA (only NR);Bacteria;Actinobacteriota;Actinobacteria;Corynebacteriales;uncultured;";"0.0";"0";"4";"4";"0";"4";"0";"430520";"5766"
"LOK1378_1mm";"SILVA (only NR);Bacteria;Actinobacteriota;Actinobacteria;Elev-16S-976;";"0.0";"0";"4";"3";"0";"3";"1";"430521";"5766"
"LOK1378_1mm";"SILVA (only NR);Bacteria;Actinobacteriota;Actinobacteria;Euzebyales;";"0.0";"0";"111";"111";"0";"111";"0";"430413";"5766"
"LOK1378_1mm";"SILVA (only NR);Bacteria;Actinobacteriota;Actinobacteria;Euzebyales;Euzebyaceae;";"0.0";"0";"111";"111";"0";"111";"0";"430413";"5766"
"LOK1378_1mm";"SILVA (only NR);Bacteria;Actinobacteriota;Actinobacteria;Euzebyales;Euzebyaceae;Egibacter;";"0.0";"0";"4";"4";"0";"4";"0";"430520";"5766"
"LOK1378_1mm";"SILVA (only NR);Bacteria;Actinobacteriota;Actinobacteria;Euzebyales;Euzebyaceae;Euzebya;";"0.0";"0";"8";"8";"0";"8";"0";"430516";"5766"
"LOK1378_1mm";"SILVA (only NR);Bacteria;Actinobacteriota;Actinobacteria;Euzebyales;Euzebyaceae;uncultured;";"0.0";"0";"99";"99";"0";"99";"0";"430425";"5766"
"LOK1378_1mm";"SILVA (only NR);Bacteria;Actinobacteriota;Actinobacteria;FFCH16263;";"0.0";"0";"3";"3";"0";"3";"0";"430521";"5766"
"LOK1378_1mm";"SILVA (only NR);Bacteria;Actinobacteriota;Actinobacteria;Frankiales;";"0.0";"0";"1118";"1048";"0";"1048";"70";"429476";"5766"
"LOK1378_1mm";"SILVA (only NR);Bacteria;Actinobacteriota;Actinobacteria;Frankiales;Acidothermaceae;";"0.0";"0";"97";"92";"0";"92";"5";"430432";"5766"
"LOK1378_1mm";"SILVA (only NR);Bacteria;Actinobacteriota;Actinobacteria;Frankiales;Acidothermaceae;Acidothermus;";"0.0";"0";"97";"92";"0";"92";"5";"430432";"5766"
"LOK1378_1mm";"SILVA (only NR);Bacteria;Actinobacteriota;Actinobacteria;Frankiales;Cryptosporangiaceae;";"0.0";"0";"17";"17";"0";"17";"0";"430507";"5766"
"LOK1378_1mm";"SILVA (only NR);Bacteria;Actinobacteriota;Actinobacteria;Frankiales;Cryptosporangiaceae;Cryptosporangium;";"0.0";"0";"15";"15";"0";"15";"0";"430509";"5766"
"LOK1378_1mm";"SILVA (only NR);Bacteria;Actinobacteriota;Actinobacteria;Frankiales;Cryptosporangiaceae;Fodinicola;";"0.0";"0";"2";"2";"0";"2";"0";"430522";"5766"
"LOK1378_1mm";"SILVA (only NR);Bacteria;Actinobacteriota;Actinobacteria;Frankiales;Frankiaceae;";"0.0";"0";"140";"135";"0";"135";"5";"430389";"5766"
"LOK1378_1mm";"SILVA (only NR);Bacteria;Actinobacteriota;Actinobacteria;Frankiales;Frankiaceae;Frankia;";"0.0";"0";"46";"44";"0";"44";"2";"430480";"5766"
"LOK1378_1mm";"SILVA (only NR);Bacteria;Actinobacteriota;Actinobacteria;Frankiales;Frankiaceae;Jatrophihabitans;";"0.0";"0";"94";"91";"0";"91";"3";"430433";"5766"
"LOK1378_1mm";"SILVA (only NR);Bacteria;Actinobacteriota;Actinobacteria;Frankiales;Geodermatophilaceae;";"0.0";"0";"239";"226";"0";"226";"13";"430298";"5766"
"LOK1378_1mm";"SILVA (only NR);Bacteria;Actinobacteriota;Actinobacteria;Frankiales;Geodermatophilaceae;Antricoccus;";"0.0";"0";"14";"14";"0";"14";"0";"430510";"5766"
"LOK1378_1mm";"SILVA (only NR);Bacteria;Actinobacteriota;Actinobacteria;Frankiales;Geodermatophilaceae;Blastococcus;";"0.0";"0";"102";"100";"0";"100";"2";"430424";"5766"
"LOK1378_1mm";"SILVA (only NR);Bacteria;Actinobacteriota;Actinobacteria;Frankiales;Geodermatophilaceae;Geodermatophilus;";"0.0";"0";"63";"59";"0";"59";"4";"430465";"5766"
"LOK1378_1mm";"SILVA (only NR);Bacteria;Actinobacteriota;Actinobacteria;Frankiales;Geodermatophilaceae;Klenkia;";"0.0";"0";"14";"13";"0";"13";"1";"430511";"5766"
"LOK1378_1mm";"SILVA (only NR);Bacteria;Actinobacteriota;Actinobacteria;Frankiales;Geodermatophilaceae;Modestobacter;";"0.0";"0";"44";"38";"0";"38";"6";"430486";"5766"
"LOK1378_1mm";"SILVA (only NR);Bacteria;Actinobacteriota;Actinobacteria;Frankiales;Nakamurellaceae;";"0.0";"0";"84";"79";"0";"79";"5";"430445";"5766"
"LOK1378_1mm";"SILVA (only NR);Bacteria;Actinobacteriota;Actinobacteria;Frankiales;Nakamurellaceae;Nakamurella;";"0.0";"0";"84";"79";"0";"79";"5";"430445";"5766"
"LOK1378_1mm";"SILVA (only NR);Bacteria;Actinobacteriota;Actinobacteria;Frankiales;Sporichthyaceae;";"0.0";"0";"420";"380";"0";"380";"40";"430144";"5766"
"LOK1378_1mm";"SILVA (only NR);Bacteria;Actinobacteriota;Actinobacteria;Frankiales;Sporichthyaceae;Candidatus Planktophila;";"0.0";"0";"21";"21";"0";"21";"0";"430503";"5766"
"LOK1378_1mm";"SILVA (only NR);Bacteria;Actinobacteriota;Actinobacteria;Frankiales;Sporichthyaceae;Longivirga;";"0.0";"0";"8";"8";"0";"8";"0";"430516";"5766"
"LOK1378_1mm";"SILVA (only NR);Bacteria;Actinobacteriota;Actinobacteria;Frankiales;Sporichthyaceae;Sporichthya;";"0.0";"0";"13";"12";"0";"12";"1";"430512";"5766"
"LOK1378_1mm";"SILVA (only NR);Bacteria;Actinobacteriota;Actinobacteria;Frankiales;Sporichthyaceae;hgcI clade;";"0.0";"0";"329";"293";"0";"293";"36";"430231";"5766"
"LOK1378_1mm";"SILVA (only NR);Bacteria;Actinobacteriota;Actinobacteria;Frankiales;Sporichthyaceae;uncultured;";"0.0";"0";"29";"28";"0";"28";"1";"430496";"5766"
"LOK1378_1mm";"SILVA (only NR);Bacteria;Actinobacteriota;Actinobacteria;Frankiales;uncultured;";"0.0";"0";"108";"107";"0";"107";"1";"430417";"5766"
"LOK1378_1mm";"SILVA (only NR);Bacteria;Actinobacteriota;Actinobacteria;Glycomycetales;";"0.0";"0";"83";"82";"0";"82";"1";"430442";"5766"
"LOK1378_1mm";"SILVA (only NR);Bacteria;Actinobacteriota;Actinobacteria;Glycomycetales;Glycomycetaceae;";"0.0";"0";"83";"82";"0";"82";"1";"430442";"5766"
"LOK1378_1mm";"SILVA (only NR);Bacteria;Actinobacteriota;Actinobacteria;Glycomycetales;Glycomycetaceae;Glycomyces;";"0.0";"0";"71";"70";"0";"70";"1";"430454";"5766"
"LOK1378_1mm";"SILVA (only NR);Bacteria;Actinobacteriota;Actinobacteria;Glycomycetales;Glycomycetaceae;Haloglycomyces;";"0.0";"0";"1";"1";"0";"1";"0";"430523";"5766"
"LOK1378_1mm";"SILVA (only NR);Bacteria;Actinobacteriota;Actinobacteria;Glycomycetales;Glycomycetaceae;Salilacibacter;";"0.0";"0";"2";"2";"0";"2";"0";"430522";"5766"
"LOK1378_1mm";"SILVA (only NR);Bacteria;Actinobacteriota;Actinobacteria;Glycomycetales;Glycomycetaceae;Salininema;";"0.0";"0";"1";"1";"0";"1";"0";"430523";"5766"
"LOK1378_1mm";"SILVA (only NR);Bacteria;Actinobacteriota;Actinobacteria;Glycomycetales;Glycomycetaceae;uncultured;";"0.0";"0";"6";"6";"0";"6";"0";"430518";"5766"
"LOK1378_1mm";"SILVA (only NR);Bacteria;Actinobacteriota;Actinobacteria;KIST-JJY010;";"0.0";"0";"5";"5";"0";"5";"0";"430519";"5766"
"LOK1378_1mm";"SILVA (only NR);Bacteria;Actinobacteriota;Actinobacteria;Kineosporiales;";"0.0";"0";"140";"135";"0";"135";"5";"430389";"5766"
"LOK1378_1mm";"SILVA (only NR);Bacteria;Actinobacteriota;Actinobacteria;Kineosporiales;Kineosporiaceae;";"0.0";"0";"140";"135";"0";"135";"5";"430389";"5766"
"LOK1378_1mm";"SILVA (only NR);Bacteria;Actinobacteriota;Actinobacteria;Kineosporiales;Kineosporiaceae;Angustibacter;";"0.0";"0";"16";"15";"0";"15";"1";"430509";"5766"
"LOK1378_1mm";"SILVA (only NR);Bacteria;Actinobacteriota;Actinobacteria;Kineosporiales;Kineosporiaceae;Kineococcus;";"0.0";"0";"41";"40";"0";"40";"1";"430484";"5766"
"LOK1378_1mm";"SILVA (only NR);Bacteria;Actinobacteriota;Actinobacteria;Kineosporiales;Kineosporiaceae;Kineosporia;";"0.0";"0";"29";"29";"0";"29";"0";"430495";"5766"
"LOK1378_1mm";"SILVA (only NR);Bacteria;Actinobacteriota;Actinobacteria;Kineosporiales;Kineosporiaceae;Pseudokineococcus;";"0.0";"0";"5";"5";"0";"5";"0";"430519";"5766"
"LOK1378_1mm";"SILVA (only NR);Bacteria;Actinobacteriota;Actinobacteria;Kineosporiales;Kineosporiaceae;Quadrisphaera;";"0.0";"0";"41";"39";"0";"39";"2";"430485";"5766"
"LOK1378_1mm";"SILVA (only NR);Bacteria;Actinobacteriota;Actinobacteria;Kineosporiales;Kineosporiaceae;uncultured;";"0.0";"0";"6";"6";"0";"6";"0";"430518";"5766"
"LOK1378_1mm";"SILVA (only NR);Bacteria;Actinobacteriota;Actinobacteria;Micrococcales;";"0.0";"0";"7473";"7182";"0";"7182";"291";"423342";"5766"
"LOK1378_1mm";"SILVA (only NR);Bacteria;Actinobacteriota;Actinobacteria;Micrococcales;AKAU3644;";"0.0";"0";"4";"3";"0";"3";"1";"430521";"5766"
"LOK1378_1mm";"SILVA (only NR);Bacteria;Actinobacteriota;Actinobacteria;Micrococcales;Beutenbergiaceae;";"0.0";"0";"14";"14";"0";"14";"0";"430510";"5766"
"LOK1378_1mm";"SILVA (only NR);Bacteria;Actinobacteriota;Actinobacteria;Micrococcales;Beutenbergiaceae;Beutenbergia;";"0.0";"0";"2";"2";"0";"2";"0";"430522";"5766"
"LOK1378_1mm";"SILVA (only NR);Bacteria;Actinobacteriota;Actinobacteria;Micrococcales;Beutenbergiaceae;Miniimonas;";"0.0";"0";"2";"2";"0";"2";"0";"430522";"5766"
"LOK1378_1mm";"SILVA (only NR);Bacteria;Actinobacteriota;Actinobacteria;Micrococcales;Beutenbergiaceae;Salana;";"0.0";"0";"5";"5";"0";"5";"0";"430519";"5766"
"LOK1378_1mm";"SILVA (only NR);Bacteria;Actinobacteriota;Actinobacteria;Micrococcales;Beutenbergiaceae;Serinibacter;";"0.0";"0";"4";"4";"0";"4";"0";"430520";"5766"
"LOK1378_1mm";"SILVA (only NR);Bacteria;Actinobacteriota;Actinobacteria;Micrococcales;Bogoriellaceae;";"0.0";"0";"56";"56";"0";"56";"0";"430468";"5766"
"LOK1378_1mm";"SILVA (only NR);Bacteria;Actinobacteriota;Actinobacteria;Micrococcales;Bogoriellaceae;Bogoriella;";"0.0";"0";"7";"7";"0";"7";"0";"430517";"5766"
"LOK1378_1mm";"SILVA (only NR);Bacteria;Actinobacteriota;Actinobacteria;Micrococcales;Bogoriellaceae;Georgenia;";"0.0";"0";"49";"49";"0";"49";"0";"430475";"5766"
"LOK1378_1mm";"SILVA (only NR);Bacteria;Actinobacteriota;Actinobacteria;Micrococcales;Brevibacteriaceae;";"0.0";"0";"258";"249";"0";"249";"9";"430275";"5766"
"LOK1378_1mm";"SILVA (only NR);Bacteria;Actinobacteriota;Actinobacteria;Micrococcales;Brevibacteriaceae;Brevibacterium;";"0.0";"0";"255";"246";"0";"246";"9";"430278";"5766"
"LOK1378_1mm";"SILVA (only NR);Bacteria;Actinobacteriota;Actinobacteria;Micrococcales;Brevibacteriaceae;Sediminivirga;";"0.0";"0";"1";"1";"0";"1";"0";"430523";"5766"
"LOK1378_1mm";"SILVA (only NR);Bacteria;Actinobacteriota;Actinobacteria;Micrococcales;Brevibacteriaceae;Spelaeicoccus;";"0.0";"0";"2";"2";"0";"2";"0";"430522";"5766"
"LOK1378_1mm";"SILVA (only NR);Bacteria;Actinobacteriota;Actinobacteria;Micrococcales;Cellulomonadaceae;";"0.0";"0";"230";"221";"0";"221";"9";"430303";"5766"
"LOK1378_1mm";"SILVA (only NR);Bacteria;Actinobacteriota;Actinobacteria;Micrococcales;Cellulomonadaceae;Actinotalea;";"0.0";"0";"26";"23";"0";"23";"3";"430501";"5766"
"LOK1378_1mm";"SILVA (only NR);Bacteria;Actinobacteriota;Actinobacteria;Micrococcales;Cellulomonadaceae;Cellulomonas;";"0.0";"0";"154";"150";"0";"150";"4";"430374";"5766"
"LOK1378_1mm";"SILVA (only NR);Bacteria;Actinobacteriota;Actinobacteria;Micrococcales;Cellulomonadaceae;Oerskovia;";"0.0";"0";"21";"20";"0";"20";"1";"430504";"5766"
"LOK1378_1mm";"SILVA (only NR);Bacteria;Actinobacteriota;Actinobacteria;Micrococcales;Cellulomonadaceae;Paraoerskovia;";"0.0";"0";"8";"8";"0";"8";"0";"430516";"5766"
"LOK1378_1mm";"SILVA (only NR);Bacteria;Actinobacteriota;Actinobacteria;Micrococcales;Cellulomonadaceae;Pseudactinotalea;";"0.0";"0";"13";"13";"0";"13";"0";"430511";"5766"
"LOK1378_1mm";"SILVA (only NR);Bacteria;Actinobacteriota;Actinobacteria;Micrococcales;Cellulomonadaceae;Sediminihabitans;";"0.0";"0";"1";"1";"0";"1";"0";"430523";"5766"
"LOK1378_1mm";"SILVA (only NR);Bacteria;Actinobacteriota;Actinobacteria;Micrococcales;Cellulomonadaceae;Tropheryma;";"0.0";"0";"3";"3";"0";"3";"0";"430521";"5766"
"LOK1378_1mm";"SILVA (only NR);Bacteria;Actinobacteriota;Actinobacteria;Micrococcales;Cellulomonadaceae;Tropicihabitans;";"0.0";"0";"1";"1";"0";"1";"0";"430523";"5766"
"LOK1378_1mm";"SILVA (only NR);Bacteria;Actinobacteriota;Actinobacteria;Micrococcales;Demequinaceae;";"0.0";"0";"62";"60";"0";"60";"2";"430464";"5766"
"LOK1378_1mm";"SILVA (only NR);Bacteria;Actinobacteriota;Actinobacteria;Micrococcales;Demequinaceae;Demequina;";"0.0";"0";"41";"39";"0";"39";"2";"430485";"5766"
"LOK1378_1mm";"SILVA (only NR);Bacteria;Actinobacteriota;Actinobacteria;Micrococcales;Demequinaceae;Lysinimicrobium;";"0.0";"0";"16";"16";"0";"16";"0";"430508";"5766"
"LOK1378_1mm";"SILVA (only NR);Bacteria;Actinobacteriota;Actinobacteria;Micrococcales;Demequinaceae;uncultured;";"0.0";"0";"4";"4";"0";"4";"0";"430520";"5766"
"LOK1378_1mm";"SILVA (only NR);Bacteria;Actinobacteriota;Actinobacteria;Micrococcales;Dermabacteraceae;";"0.0";"0";"188";"182";"0";"182";"6";"430342";"5766"
"LOK1378_1mm";"SILVA (only NR);Bacteria;Actinobacteriota;Actinobacteria;Micrococcales;Dermabacteraceae;Brachybacterium;";"0.0";"0";"148";"144";"0";"144";"4";"430380";"5766"
"LOK1378_1mm";"SILVA (only NR);Bacteria;Actinobacteriota;Actinobacteria;Micrococcales;Dermabacteraceae;Dermabacter;";"0.0";"0";"21";"20";"0";"20";"1";"430504";"5766"
"LOK1378_1mm";"SILVA (only NR);Bacteria;Actinobacteriota;Actinobacteria;Micrococcales;Dermabacteraceae;Devriesea;";"0.0";"0";"2";"2";"0";"2";"0";"430522";"5766"
"LOK1378_1mm";"SILVA (only NR);Bacteria;Actinobacteriota;Actinobacteria;Micrococcales;Dermabacteraceae;Helcobacillus;";"0.0";"0";"13";"13";"0";"13";"0";"430511";"5766"
"LOK1378_1mm";"SILVA (only NR);Bacteria;Actinobacteriota;Actinobacteria;Micrococcales;Dermabacteraceae;uncultured;";"0.0";"0";"4";"3";"0";"3";"1";"430521";"5766"
"LOK1378_1mm";"SILVA (only NR);Bacteria;Actinobacteriota;Actinobacteria;Micrococcales;Dermacoccaceae;";"0.0";"0";"70";"68";"0";"68";"2";"430456";"5766"
"LOK1378_1mm";"SILVA (only NR);Bacteria;Actinobacteriota;Actinobacteria;Micrococcales;Dermacoccaceae;Allobranchiibius;";"0.0";"0";"3";"3";"0";"3";"0";"430521";"5766"
"LOK1378_1mm";"SILVA (only NR);Bacteria;Actinobacteriota;Actinobacteria;Micrococcales;Dermacoccaceae;Barrientosiimonas;";"0.0";"0";"3";"3";"0";"3";"0";"430521";"5766"
"LOK1378_1mm";"SILVA (only NR);Bacteria;Actinobacteriota;Actinobacteria;Micrococcales;Dermacoccaceae;Branchiibius;";"0.0";"0";"3";"3";"0";"3";"0";"430521";"5766"
"LOK1378_1mm";"SILVA (only NR);Bacteria;Actinobacteriota;Actinobacteria;Micrococcales;Dermacoccaceae;Calidifontibacter;";"0.0";"0";"3";"3";"0";"3";"0";"430521";"5766"
"LOK1378_1mm";"SILVA (only NR);Bacteria;Actinobacteriota;Actinobacteria;Micrococcales;Dermacoccaceae;Demetria;";"0.0";"0";"4";"4";"0";"4";"0";"430520";"5766"
"LOK1378_1mm";"SILVA (only NR);Bacteria;Actinobacteriota;Actinobacteria;Micrococcales;Dermacoccaceae;Dermacoccus;";"0.0";"0";"19";"18";"0";"18";"1";"430506";"5766"
"LOK1378_1mm";"SILVA (only NR);Bacteria;Actinobacteriota;Actinobacteria;Micrococcales;Dermacoccaceae;Flexivirga;";"0.0";"0";"10";"10";"0";"10";"0";"430514";"5766"
"LOK1378_1mm";"SILVA (only NR);Bacteria;Actinobacteriota;Actinobacteria;Micrococcales;Dermacoccaceae;Kytococcus;";"0.0";"0";"12";"12";"0";"12";"0";"430512";"5766"
"LOK1378_1mm";"SILVA (only NR);Bacteria;Actinobacteriota;Actinobacteria;Micrococcales;Dermacoccaceae;Luteipulveratus;";"0.0";"0";"3";"3";"0";"3";"0";"430521";"5766"
"LOK1378_1mm";"SILVA (only NR);Bacteria;Actinobacteriota;Actinobacteria;Micrococcales;Dermacoccaceae;Rudaeicoccus;";"0.0";"0";"1";"1";"0";"1";"0";"430523";"5766"
"LOK1378_1mm";"SILVA (only NR);Bacteria;Actinobacteriota;Actinobacteria;Micrococcales;Dermacoccaceae;Yimella;";"0.0";"0";"2";"2";"0";"2";"0";"430522";"5766"
"LOK1378_1mm";"SILVA (only NR);Bacteria;Actinobacteriota;Actinobacteria;Micrococcales;Dermatophilaceae;";"0.0";"0";"86";"83";"0";"83";"3";"430441";"5766"
"LOK1378_1mm";"SILVA (only NR);Bacteria;Actinobacteriota;Actinobacteria;Micrococcales;Dermatophilaceae;Austwickia;";"0.0";"0";"4";"4";"0";"4";"0";"430520";"5766"
"LOK1378_1mm";"SILVA (only NR);Bacteria;Actinobacteriota;Actinobacteria;Micrococcales;Dermatophilaceae;Dermatophilus;";"0.0";"0";"6";"5";"0";"5";"1";"430519";"5766"
"LOK1378_1mm";"SILVA (only NR);Bacteria;Actinobacteriota;Actinobacteria;Micrococcales;Dermatophilaceae;Kineosphaera;";"0.0";"0";"4";"4";"0";"4";"0";"430520";"5766"
"LOK1378_1mm";"SILVA (only NR);Bacteria;Actinobacteriota;Actinobacteria;Micrococcales;Dermatophilaceae;Mobilicoccus;";"0.0";"0";"8";"8";"0";"8";"0";"430516";"5766"
"LOK1378_1mm";"SILVA (only NR);Bacteria;Actinobacteriota;Actinobacteria;Micrococcales;Dermatophilaceae;Piscicoccus;";"0.0";"0";"2";"2";"0";"2";"0";"430522";"5766"
"LOK1378_1mm";"SILVA (only NR);Bacteria;Actinobacteriota;Actinobacteria;Micrococcales;Dermatophilaceae;Tonsilliphilus;";"0.0";"0";"2";"2";"0";"2";"0";"430522";"5766"
"LOK1378_1mm";"SILVA (only NR);Bacteria;Actinobacteriota;Actinobacteria;Micrococcales;Dermatophilaceae;uncultured;";"0.0";"0";"58";"56";"0";"56";"2";"430468";"5766"
"LOK1378_1mm";"SILVA (only NR);Bacteria;Actinobacteriota;Actinobacteria;Micrococcales;Intrasporangiaceae;";"0.0";"0";"454";"437";"0";"437";"17";"430087";"5766"
"LOK1378_1mm";"SILVA (only NR);Bacteria;Actinobacteriota;Actinobacteria;Micrococcales;Intrasporangiaceae;Aquipuribacter;";"0.0";"0";"9";"9";"0";"9";"0";"430515";"5766"
"LOK1378_1mm";"SILVA (only NR);Bacteria;Actinobacteriota;Actinobacteria;Micrococcales;Intrasporangiaceae;Arsenicicoccus;";"0.0";"0";"5";"5";"0";"5";"0";"430519";"5766"
"LOK1378_1mm";"SILVA (only NR);Bacteria;Actinobacteriota;Actinobacteria;Micrococcales;Intrasporangiaceae;Fodinibacter;";"0.0";"0";"2";"2";"0";"2";"0";"430522";"5766"
"LOK1378_1mm";"SILVA (only NR);Bacteria;Actinobacteriota;Actinobacteria;Micrococcales;Intrasporangiaceae;Humibacillus;";"0.0";"0";"7";"7";"0";"7";"0";"430517";"5766"
"LOK1378_1mm";"SILVA (only NR);Bacteria;Actinobacteriota;Actinobacteria;Micrococcales;Intrasporangiaceae;Intrasporangium;";"0.0";"0";"20";"20";"0";"20";"0";"430504";"5766"
"LOK1378_1mm";"SILVA (only NR);Bacteria;Actinobacteriota;Actinobacteria;Micrococcales;Intrasporangiaceae;Janibacter;";"0.0";"0";"67";"65";"0";"65";"2";"430459";"5766"
"LOK1378_1mm";"SILVA (only NR);Bacteria;Actinobacteriota;Actinobacteria;Micrococcales;Intrasporangiaceae;Knoellia;";"0.0";"0";"35";"32";"0";"32";"3";"430492";"5766"
"LOK1378_1mm";"SILVA (only NR);Bacteria;Actinobacteriota;Actinobacteria;Micrococcales;Intrasporangiaceae;Kribbia;";"0.0";"0";"2";"2";"0";"2";"0";"430522";"5766"
"LOK1378_1mm";"SILVA (only NR);Bacteria;Actinobacteriota;Actinobacteria;Micrococcales;Intrasporangiaceae;Lapillicoccus;";"0.0";"0";"19";"19";"0";"19";"0";"430505";"5766"
"LOK1378_1mm";"SILVA (only NR);Bacteria;Actinobacteriota;Actinobacteria;Micrococcales;Intrasporangiaceae;Marihabitans;";"0.0";"0";"2";"2";"0";"2";"0";"430522";"5766"
"LOK1378_1mm";"SILVA (only NR);Bacteria;Actinobacteriota;Actinobacteria;Micrococcales;Intrasporangiaceae;Ornithinibacter;";"0.0";"0";"10";"10";"0";"10";"0";"430514";"5766"
"LOK1378_1mm";"SILVA (only NR);Bacteria;Actinobacteriota;Actinobacteria;Micrococcales;Intrasporangiaceae;Ornithinicoccus;";"0.0";"0";"18";"17";"0";"17";"1";"430507";"5766"
"LOK1378_1mm";"SILVA (only NR);Bacteria;Actinobacteriota;Actinobacteria;Micrococcales;Intrasporangiaceae;Ornithinimicrobium;";"0.0";"0";"41";"37";"0";"37";"4";"430487";"5766"
"LOK1378_1mm";"SILVA (only NR);Bacteria;Actinobacteriota;Actinobacteria;Micrococcales;Intrasporangiaceae;Oryzihumus;";"0.0";"0";"20";"19";"0";"19";"1";"430505";"5766"
"LOK1378_1mm";"SILVA (only NR);Bacteria;Actinobacteriota;Actinobacteria;Micrococcales;Intrasporangiaceae;Pedococcus-Phycicoccus;";"0.0";"0";"34";"33";"0";"33";"1";"430491";"5766"
"LOK1378_1mm";"SILVA (only NR);Bacteria;Actinobacteriota;Actinobacteria;Micrococcales;Intrasporangiaceae;Serinicoccus;";"0.0";"0";"10";"10";"0";"10";"0";"430514";"5766"
"LOK1378_1mm";"SILVA (only NR);Bacteria;Actinobacteriota;Actinobacteria;Micrococcales;Intrasporangiaceae;Terrabacter;";"0.0";"0";"33";"31";"0";"31";"2";"430493";"5766"
"LOK1378_1mm";"SILVA (only NR);Bacteria;Actinobacteriota;Actinobacteria;Micrococcales;Intrasporangiaceae;Terracoccus;";"0.0";"0";"1";"1";"0";"1";"0";"430523";"5766"
"LOK1378_1mm";"SILVA (only NR);Bacteria;Actinobacteriota;Actinobacteria;Micrococcales;Intrasporangiaceae;Tetrasphaera;";"0.0";"0";"89";"86";"0";"86";"3";"430438";"5766"
"LOK1378_1mm";"SILVA (only NR);Bacteria;Actinobacteriota;Actinobacteria;Micrococcales;Intrasporangiaceae;uncultured;";"0.0";"0";"21";"21";"0";"21";"0";"430503";"5766"
"LOK1378_1mm";"SILVA (only NR);Bacteria;Actinobacteriota;Actinobacteria;Micrococcales;Jonesiaceae;";"0.0";"0";"13";"13";"0";"13";"0";"430511";"5766"
"LOK1378_1mm";"SILVA (only NR);Bacteria;Actinobacteriota;Actinobacteria;Micrococcales;Jonesiaceae;Jonesia;";"0.0";"0";"13";"13";"0";"13";"0";"430511";"5766"
"LOK1378_1mm";"SILVA (only NR);Bacteria;Actinobacteriota;Actinobacteria;Micrococcales;Microbacteriaceae;";"0.0";"0";"2679";"2598";"0";"2598";"81";"427926";"5766"
"LOK1378_1mm";"SILVA (only NR);Bacteria;Actinobacteriota;Actinobacteria;Micrococcales;Microbacteriaceae;Agreia;";"0.0";"0";"5";"4";"0";"4";"1";"430520";"5766"
"LOK1378_1mm";"SILVA (only NR);Bacteria;Actinobacteriota;Actinobacteria;Micrococcales;Microbacteriaceae;Agrococcus;";"0.0";"0";"78";"69";"0";"69";"9";"430455";"5766"
"LOK1378_1mm";"SILVA (only NR);Bacteria;Actinobacteriota;Actinobacteria;Micrococcales;Microbacteriaceae;Agromyces;";"0.0";"0";"177";"171";"0";"171";"6";"430353";"5766"
"LOK1378_1mm";"SILVA (only NR);Bacteria;Actinobacteriota;Actinobacteria;Micrococcales;Microbacteriaceae;Allohumibacter;";"0.0";"0";"1";"1";"0";"1";"0";"430523";"5766"
"LOK1378_1mm";"SILVA (only NR);Bacteria;Actinobacteriota;Actinobacteria;Micrococcales;Microbacteriaceae;Alpinimonas;";"0.0";"0";"1";"1";"0";"1";"0";"430523";"5766"
"LOK1378_1mm";"SILVA (only NR);Bacteria;Actinobacteriota;Actinobacteria;Micrococcales;Microbacteriaceae;Amnibacterium;";"0.0";"0";"14";"14";"0";"14";"0";"430510";"5766"
"LOK1378_1mm";"SILVA (only NR);Bacteria;Actinobacteriota;Actinobacteria;Micrococcales;Microbacteriaceae;Aurantimicrobium;";"0.0";"0";"19";"18";"0";"18";"1";"430506";"5766"
"LOK1378_1mm";"SILVA (only NR);Bacteria;Actinobacteriota;Actinobacteria;Micrococcales;Microbacteriaceae;Candidatus Aquiluna;";"0.0";"0";"50";"49";"0";"49";"1";"430475";"5766"
"LOK1378_1mm";"SILVA (only NR);Bacteria;Actinobacteriota;Actinobacteria;Micrococcales;Microbacteriaceae;Candidatus Flaviluna;";"0.0";"0";"3";"3";"0";"3";"0";"430521";"5766"
"LOK1378_1mm";"SILVA (only NR);Bacteria;Actinobacteriota;Actinobacteria;Micrococcales;Microbacteriaceae;Candidatus Limnoluna;";"0.0";"0";"11";"11";"0";"11";"0";"430513";"5766"
"LOK1378_1mm";"SILVA (only NR);Bacteria;Actinobacteriota;Actinobacteria;Micrococcales;Microbacteriaceae;Candidatus Planktoluna;";"0.0";"0";"17";"17";"0";"17";"0";"430507";"5766"
"LOK1378_1mm";"SILVA (only NR);Bacteria;Actinobacteriota;Actinobacteria;Micrococcales;Microbacteriaceae;Chryseoglobus;";"0.0";"0";"11";"10";"0";"10";"1";"430514";"5766"
"LOK1378_1mm";"SILVA (only NR);Bacteria;Actinobacteriota;Actinobacteria;Micrococcales;Microbacteriaceae;Clavibacter;";"0.0";"0";"53";"53";"0";"53";"0";"430471";"5766"
"LOK1378_1mm";"SILVA (only NR);Bacteria;Actinobacteriota;Actinobacteria;Micrococcales;Microbacteriaceae;Cnuibacter;";"0.0";"0";"4";"4";"0";"4";"0";"430520";"5766"
"LOK1378_1mm";"SILVA (only NR);Bacteria;Actinobacteriota;Actinobacteria;Micrococcales;Microbacteriaceae;Compostimonas;";"0.0";"0";"1";"1";"0";"1";"0";"430523";"5766"
"LOK1378_1mm";"SILVA (only NR);Bacteria;Actinobacteriota;Actinobacteria;Micrococcales;Microbacteriaceae;Conyzicola;";"0.0";"0";"11";"11";"0";"11";"0";"430513";"5766"
"LOK1378_1mm";"SILVA (only NR);Bacteria;Actinobacteriota;Actinobacteria;Micrococcales;Microbacteriaceae;Cryobacterium;";"0.0";"0";"58";"57";"0";"57";"1";"430467";"5766"
"LOK1378_1mm";"SILVA (only NR);Bacteria;Actinobacteriota;Actinobacteria;Micrococcales;Microbacteriaceae;Cryocola;";"0.0";"0";"2";"2";"0";"2";"0";"430522";"5766"
"LOK1378_1mm";"SILVA (only NR);Bacteria;Actinobacteriota;Actinobacteria;Micrococcales;Microbacteriaceae;Curtobacterium;";"0.0";"0";"139";"135";"0";"135";"4";"430389";"5766"
"LOK1378_1mm";"SILVA (only NR);Bacteria;Actinobacteriota;Actinobacteria;Micrococcales;Microbacteriaceae;DS001;";"0.0";"0";"2";"2";"0";"2";"0";"430522";"5766"
"LOK1378_1mm";"SILVA (only NR);Bacteria;Actinobacteriota;Actinobacteria;Micrococcales;Microbacteriaceae;Diaminobutyricibacter;";"0.0";"0";"1";"1";"0";"1";"0";"430523";"5766"
"LOK1378_1mm";"SILVA (only NR);Bacteria;Actinobacteriota;Actinobacteria;Micrococcales;Microbacteriaceae;Diaminobutyricimonas;";"0.0";"0";"7";"7";"0";"7";"0";"430517";"5766"
"LOK1378_1mm";"SILVA (only NR);Bacteria;Actinobacteriota;Actinobacteria;Micrococcales;Microbacteriaceae;Frigoribacterium;";"0.0";"0";"27";"26";"0";"26";"1";"430498";"5766"
"LOK1378_1mm";"SILVA (only NR);Bacteria;Actinobacteriota;Actinobacteria;Micrococcales;Microbacteriaceae;Frondihabitans;";"0.0";"0";"17";"17";"0";"17";"0";"430507";"5766"
"LOK1378_1mm";"SILVA (only NR);Bacteria;Actinobacteriota;Actinobacteria;Micrococcales;Microbacteriaceae;Galbitalea;";"0.0";"0";"23";"23";"0";"23";"0";"430501";"5766"
"LOK1378_1mm";"SILVA (only NR);Bacteria;Actinobacteriota;Actinobacteria;Micrococcales;Microbacteriaceae;Glaciibacter;";"0.0";"0";"4";"4";"0";"4";"0";"430520";"5766"
"LOK1378_1mm";"SILVA (only NR);Bacteria;Actinobacteriota;Actinobacteria;Micrococcales;Microbacteriaceae;Glaciihabitans;";"0.0";"0";"6";"6";"0";"6";"0";"430518";"5766"
"LOK1378_1mm";"SILVA (only NR);Bacteria;Actinobacteriota;Actinobacteria;Micrococcales;Microbacteriaceae;Gryllotalpicola;";"0.0";"0";"17";"17";"0";"17";"0";"430507";"5766"
"LOK1378_1mm";"SILVA (only NR);Bacteria;Actinobacteriota;Actinobacteria;Micrococcales;Microbacteriaceae;Gulosibacter;";"0.0";"0";"8";"8";"0";"8";"0";"430516";"5766"
"LOK1378_1mm";"SILVA (only NR);Bacteria;Actinobacteriota;Actinobacteria;Micrococcales;Microbacteriaceae;Herbiconiux;";"0.0";"0";"15";"15";"0";"15";"0";"430509";"5766"
"LOK1378_1mm";"SILVA (only NR);Bacteria;Actinobacteriota;Actinobacteria;Micrococcales;Microbacteriaceae;Homoserinibacter;";"0.0";"0";"4";"4";"0";"4";"0";"430520";"5766"
"LOK1378_1mm";"SILVA (only NR);Bacteria;Actinobacteriota;Actinobacteria;Micrococcales;Microbacteriaceae;Homoserinimonas;";"0.0";"0";"3";"2";"0";"2";"1";"430522";"5766"
"LOK1378_1mm";"SILVA (only NR);Bacteria;Actinobacteriota;Actinobacteria;Micrococcales;Microbacteriaceae;Huakuichenia;";"0.0";"0";"7";"7";"0";"7";"0";"430517";"5766"
"LOK1378_1mm";"SILVA (only NR);Bacteria;Actinobacteriota;Actinobacteria;Micrococcales;Microbacteriaceae;Humibacter;";"0.0";"0";"12";"12";"0";"12";"0";"430512";"5766"
"LOK1378_1mm";"SILVA (only NR);Bacteria;Actinobacteriota;Actinobacteria;Micrococcales;Microbacteriaceae;Klugiella;";"0.0";"0";"4";"4";"0";"4";"0";"430520";"5766"
"LOK1378_1mm";"SILVA (only NR);Bacteria;Actinobacteriota;Actinobacteria;Micrococcales;Microbacteriaceae;Labedella;";"0.0";"0";"4";"4";"0";"4";"0";"430520";"5766"
"LOK1378_1mm";"SILVA (only NR);Bacteria;Actinobacteriota;Actinobacteria;Micrococcales;Microbacteriaceae;Leifsonia;";"0.0";"0";"98";"98";"0";"98";"0";"430426";"5766"
"LOK1378_1mm";"SILVA (only NR);Bacteria;Actinobacteriota;Actinobacteria;Micrococcales;Microbacteriaceae;Leucobacter;";"0.0";"0";"227";"224";"0";"224";"3";"430300";"5766"
"LOK1378_1mm";"SILVA (only NR);Bacteria;Actinobacteriota;Actinobacteria;Micrococcales;Microbacteriaceae;Luethyella;";"0.0";"0";"1";"1";"0";"1";"0";"430523";"5766"
"LOK1378_1mm";"SILVA (only NR);Bacteria;Actinobacteriota;Actinobacteria;Micrococcales;Microbacteriaceae;Lysinimonas;";"0.0";"0";"15";"15";"0";"15";"0";"430509";"5766"
"LOK1378_1mm";"SILVA (only NR);Bacteria;Actinobacteriota;Actinobacteria;Micrococcales;Microbacteriaceae;ML602J-51;";"0.0";"0";"9";"9";"0";"9";"0";"430515";"5766"
"LOK1378_1mm";"SILVA (only NR);Bacteria;Actinobacteriota;Actinobacteria;Micrococcales;Microbacteriaceae;MWH-Ta3;";"0.0";"0";"5";"5";"0";"5";"0";"430519";"5766"
"LOK1378_1mm";"SILVA (only NR);Bacteria;Actinobacteriota;Actinobacteria;Micrococcales;Microbacteriaceae;Marisediminicola;";"0.0";"0";"12";"11";"0";"11";"1";"430513";"5766"
"LOK1378_1mm";"SILVA (only NR);Bacteria;Actinobacteriota;Actinobacteria;Micrococcales;Microbacteriaceae;Microbacterium;";"0.0";"0";"1150";"1107";"0";"1107";"43";"429417";"5766"
"LOK1378_1mm";"SILVA (only NR);Bacteria;Actinobacteriota;Actinobacteria;Micrococcales;Microbacteriaceae;Microcella;";"0.0";"0";"5";"5";"0";"5";"0";"430519";"5766"
"LOK1378_1mm";"SILVA (only NR);Bacteria;Actinobacteriota;Actinobacteria;Micrococcales;Microbacteriaceae;Microterricola;";"0.0";"0";"5";"4";"0";"4";"1";"430520";"5766"
"LOK1378_1mm";"SILVA (only NR);Bacteria;Actinobacteriota;Actinobacteria;Micrococcales;Microbacteriaceae;Mycetocola;";"0.0";"0";"32";"32";"0";"32";"0";"430492";"5766"
"LOK1378_1mm";"SILVA (only NR);Bacteria;Actinobacteriota;Actinobacteria;Micrococcales;Microbacteriaceae;Naasia;";"0.0";"0";"4";"4";"0";"4";"0";"430520";"5766"
"LOK1378_1mm";"SILVA (only NR);Bacteria;Actinobacteriota;Actinobacteria;Micrococcales;Microbacteriaceae;Okibacterium;";"0.0";"0";"9";"8";"0";"8";"1";"430516";"5766"
"LOK1378_1mm";"SILVA (only NR);Bacteria;Actinobacteriota;Actinobacteria;Micrococcales;Microbacteriaceae;Parafrigoribacterium;";"0.0";"0";"47";"47";"0";"47";"0";"430477";"5766"
"LOK1378_1mm";"SILVA (only NR);Bacteria;Actinobacteriota;Actinobacteria;Micrococcales;Microbacteriaceae;Plantibacter;";"0.0";"0";"19";"18";"0";"18";"1";"430506";"5766"
"LOK1378_1mm";"SILVA (only NR);Bacteria;Actinobacteriota;Actinobacteria;Micrococcales;Microbacteriaceae;Pontimonas;";"0.0";"0";"3";"3";"0";"3";"0";"430521";"5766"
"LOK1378_1mm";"SILVA (only NR);Bacteria;Actinobacteriota;Actinobacteria;Micrococcales;Microbacteriaceae;Pseudoclavibacter;";"0.0";"0";"41";"40";"0";"40";"1";"430484";"5766"
"LOK1378_1mm";"SILVA (only NR);Bacteria;Actinobacteriota;Actinobacteria;Micrococcales;Microbacteriaceae;Rathayibacter;";"0.0";"0";"27";"26";"0";"26";"1";"430498";"5766"
"LOK1378_1mm";"SILVA (only NR);Bacteria;Actinobacteriota;Actinobacteria;Micrococcales;Microbacteriaceae;Rhodoglobus;";"0.0";"0";"8";"8";"0";"8";"0";"430516";"5766"
"LOK1378_1mm";"SILVA (only NR);Bacteria;Actinobacteriota;Actinobacteria;Micrococcales;Microbacteriaceae;Rhodoluna;";"0.0";"0";"18";"18";"0";"18";"0";"430506";"5766"
"LOK1378_1mm";"SILVA (only NR);Bacteria;Actinobacteriota;Actinobacteria;Micrococcales;Microbacteriaceae;Rudaibacter;";"0.0";"0";"1";"1";"0";"1";"0";"430523";"5766"
"LOK1378_1mm";"SILVA (only NR);Bacteria;Actinobacteriota;Actinobacteria;Micrococcales;Microbacteriaceae;SV1-3;";"0.0";"0";"3";"3";"0";"3";"0";"430521";"5766"
"LOK1378_1mm";"SILVA (only NR);Bacteria;Actinobacteriota;Actinobacteria;Micrococcales;Microbacteriaceae;Salinibacterium;";"0.0";"0";"20";"19";"0";"19";"1";"430505";"5766"
"LOK1378_1mm";"SILVA (only NR);Bacteria;Actinobacteriota;Actinobacteria;Micrococcales;Microbacteriaceae;Schumannella;";"0.0";"0";"5";"5";"0";"5";"0";"430519";"5766"
"LOK1378_1mm";"SILVA (only NR);Bacteria;Actinobacteriota;Actinobacteria;Micrococcales;Microbacteriaceae;Subtercola;";"0.0";"0";"18";"18";"0";"18";"0";"430506";"5766"
"LOK1378_1mm";"SILVA (only NR);Bacteria;Actinobacteriota;Actinobacteria;Micrococcales;Microbacteriaceae;Yonghaparkia;";"0.0";"0";"6";"5";"0";"5";"1";"430519";"5766"
"LOK1378_1mm";"SILVA (only NR);Bacteria;Actinobacteriota;Actinobacteria;Micrococcales;Microbacteriaceae;uncultured;";"0.0";"0";"54";"53";"0";"53";"1";"430471";"5766"
"LOK1378_1mm";"SILVA (only NR);Bacteria;Actinobacteriota;Actinobacteria;Micrococcales;Micrococcaceae;";"0.0";"0";"3001";"2851";"0";"2851";"150";"427673";"5766"
"LOK1378_1mm";"SILVA (only NR);Bacteria;Actinobacteriota;Actinobacteria;Micrococcales;Micrococcaceae;Acaricomes;";"0.0";"0";"3";"3";"0";"3";"0";"430521";"5766"
"LOK1378_1mm";"SILVA (only NR);Bacteria;Actinobacteriota;Actinobacteria;Micrococcales;Micrococcaceae;Arthrobacter;";"0.0";"0";"690";"661";"0";"661";"29";"429863";"5766"
"LOK1378_1mm";"SILVA (only NR);Bacteria;Actinobacteriota;Actinobacteria;Micrococcales;Micrococcaceae;Auritidibacter;";"0.0";"0";"4";"4";"0";"4";"0";"430520";"5766"
"LOK1378_1mm";"SILVA (only NR);Bacteria;Actinobacteriota;Actinobacteria;Micrococcales;Micrococcaceae;Citricoccus;";"0.0";"0";"34";"33";"0";"33";"1";"430491";"5766"
"LOK1378_1mm";"SILVA (only NR);Bacteria;Actinobacteriota;Actinobacteria;Micrococcales;Micrococcaceae;Enteractinococcus;";"0.0";"0";"17";"16";"0";"16";"1";"430508";"5766"
"LOK1378_1mm";"SILVA (only NR);Bacteria;Actinobacteriota;Actinobacteria;Micrococcales;Micrococcaceae;Falsarthrobacter;";"0.0";"0";"2";"2";"0";"2";"0";"430522";"5766"
"LOK1378_1mm";"SILVA (only NR);Bacteria;Actinobacteriota;Actinobacteria;Micrococcales;Micrococcaceae;Garicola;";"0.0";"0";"10";"6";"0";"6";"4";"430518";"5766"
"LOK1378_1mm";"SILVA (only NR);Bacteria;Actinobacteriota;Actinobacteria;Micrococcales;Micrococcaceae;Glutamicibacter;";"0.0";"0";"170";"161";"0";"161";"9";"430363";"5766"
"LOK1378_1mm";"SILVA (only NR);Bacteria;Actinobacteriota;Actinobacteria;Micrococcales;Micrococcaceae;Haematomicrobium;";"0.0";"0";"1";"1";"0";"1";"0";"430523";"5766"
"LOK1378_1mm";"SILVA (only NR);Bacteria;Actinobacteriota;Actinobacteria;Micrococcales;Micrococcaceae;Kocuria;";"0.0";"0";"336";"315";"0";"315";"21";"430209";"5766"
"LOK1378_1mm";"SILVA (only NR);Bacteria;Actinobacteriota;Actinobacteria;Micrococcales;Micrococcaceae;Micrococcus;";"0.0";"0";"327";"302";"0";"302";"25";"430222";"5766"
"LOK1378_1mm";"SILVA (only NR);Bacteria;Actinobacteriota;Actinobacteria;Micrococcales;Micrococcaceae;Neomicrococcus;";"0.0";"0";"6";"6";"0";"6";"0";"430518";"5766"
"LOK1378_1mm";"SILVA (only NR);Bacteria;Actinobacteriota;Actinobacteria;Micrococcales;Micrococcaceae;Nesterenkonia;";"0.0";"0";"76";"74";"0";"74";"2";"430450";"5766"
"LOK1378_1mm";"SILVA (only NR);Bacteria;Actinobacteriota;Actinobacteria;Micrococcales;Micrococcaceae;Paenarthrobacter;";"0.0";"0";"144";"138";"0";"138";"6";"430386";"5766"
"LOK1378_1mm";"SILVA (only NR);Bacteria;Actinobacteriota;Actinobacteria;Micrococcales;Micrococcaceae;Paeniglutamicibacter;";"0.0";"0";"62";"58";"0";"58";"4";"430466";"5766"
"LOK1378_1mm";"SILVA (only NR);Bacteria;Actinobacteriota;Actinobacteria;Micrococcales;Micrococcaceae;Pseudarthrobacter;";"0.0";"0";"439";"414";"0";"414";"25";"430110";"5766"
"LOK1378_1mm";"SILVA (only NR);Bacteria;Actinobacteriota;Actinobacteria;Micrococcales;Micrococcaceae;Pseudoglutamicibacter;";"0.0";"0";"4";"4";"0";"4";"0";"430520";"5766"
"LOK1378_1mm";"SILVA (only NR);Bacteria;Actinobacteriota;Actinobacteria;Micrococcales;Micrococcaceae;Renibacterium;";"0.0";"0";"8";"8";"0";"8";"0";"430516";"5766"
"LOK1378_1mm";"SILVA (only NR);Bacteria;Actinobacteriota;Actinobacteria;Micrococcales;Micrococcaceae;Rothia;";"0.0";"0";"582";"564";"0";"564";"18";"429960";"5766"
"LOK1378_1mm";"SILVA (only NR);Bacteria;Actinobacteriota;Actinobacteria;Micrococcales;Micrococcaceae;Sinomonas;";"0.0";"0";"41";"39";"0";"39";"2";"430485";"5766"
"LOK1378_1mm";"SILVA (only NR);Bacteria;Actinobacteriota;Actinobacteria;Micrococcales;Micrococcaceae;Tersicoccus;";"0.0";"0";"4";"4";"0";"4";"0";"430520";"5766"
"LOK1378_1mm";"SILVA (only NR);Bacteria;Actinobacteriota;Actinobacteria;Micrococcales;Micrococcaceae;Yaniella;";"0.0";"0";"8";"8";"0";"8";"0";"430516";"5766"
"LOK1378_1mm";"SILVA (only NR);Bacteria;Actinobacteriota;Actinobacteria;Micrococcales;Micrococcaceae;Zhihengliuella;";"0.0";"0";"11";"10";"0";"10";"1";"430514";"5766"
"LOK1378_1mm";"SILVA (only NR);Bacteria;Actinobacteriota;Actinobacteria;Micrococcales;Micrococcaceae;uncultured;";"0.0";"0";"11";"10";"0";"10";"1";"430514";"5766"
"LOK1378_1mm";"SILVA (only NR);Bacteria;Actinobacteriota;Actinobacteria;Micrococcales;Micrococcales Incertae Sedis;";"0.0";"0";"27";"27";"0";"27";"0";"430497";"5766"
"LOK1378_1mm";"SILVA (only NR);Bacteria;Actinobacteriota;Actinobacteria;Micrococcales;Micrococcales Incertae Sedis;Luteimicrobium;";"0.0";"0";"6";"6";"0";"6";"0";"430518";"5766"
"LOK1378_1mm";"SILVA (only NR);Bacteria;Actinobacteriota;Actinobacteria;Micrococcales;Micrococcales Incertae Sedis;Timonella;";"0.0";"0";"21";"21";"0";"21";"0";"430503";"5766"
"LOK1378_1mm";"SILVA (only NR);Bacteria;Actinobacteriota;Actinobacteria;Micrococcales;Promicromonosporaceae;";"0.0";"0";"247";"239";"0";"239";"8";"430285";"5766"
"LOK1378_1mm";"SILVA (only NR);Bacteria;Actinobacteriota;Actinobacteria;Micrococcales;Promicromonosporaceae;Cellulosimicrobium;";"0.0";"0";"82";"77";"0";"77";"5";"430447";"5766"
"LOK1378_1mm";"SILVA (only NR);Bacteria;Actinobacteriota;Actinobacteria;Micrococcales;Promicromonosporaceae;Isoptericola;";"0.0";"0";"66";"65";"0";"65";"1";"430459";"5766"
"LOK1378_1mm";"SILVA (only NR);Bacteria;Actinobacteriota;Actinobacteria;Micrococcales;Promicromonosporaceae;Krasilnikoviella;";"0.0";"0";"2";"2";"0";"2";"0";"430522";"5766"
"LOK1378_1mm";"SILVA (only NR);Bacteria;Actinobacteriota;Actinobacteria;Micrococcales;Promicromonosporaceae;Myceligenerans;";"0.0";"0";"15";"15";"0";"15";"0";"430509";"5766"
"LOK1378_1mm";"SILVA (only NR);Bacteria;Actinobacteriota;Actinobacteria;Micrococcales;Promicromonosporaceae;Promicromonospora;";"0.0";"0";"70";"68";"0";"68";"2";"430456";"5766"
"LOK1378_1mm";"SILVA (only NR);Bacteria;Actinobacteriota;Actinobacteria;Micrococcales;Promicromonosporaceae;Xylanibacterium;";"0.0";"0";"1";"1";"0";"1";"0";"430523";"5766"
"LOK1378_1mm";"SILVA (only NR);Bacteria;Actinobacteriota;Actinobacteria;Micrococcales;Promicromonosporaceae;Xylanimicrobium;";"0.0";"0";"2";"2";"0";"2";"0";"430522";"5766"
"LOK1378_1mm";"SILVA (only NR);Bacteria;Actinobacteriota;Actinobacteria;Micrococcales;Promicromonosporaceae;Xylanimonas;";"0.0";"0";"2";"2";"0";"2";"0";"430522";"5766"
"LOK1378_1mm";"SILVA (only NR);Bacteria;Actinobacteriota;Actinobacteria;Micrococcales;Promicromonosporaceae;uncultured;";"0.0";"0";"2";"2";"0";"2";"0";"430522";"5766"
"LOK1378_1mm";"SILVA (only NR);Bacteria;Actinobacteriota;Actinobacteria;Micrococcales;Rarobacteraceae;";"0.0";"0";"6";"6";"0";"6";"0";"430518";"5766"
"LOK1378_1mm";"SILVA (only NR);Bacteria;Actinobacteriota;Actinobacteria;Micrococcales;Rarobacteraceae;Rarobacter;";"0.0";"0";"6";"6";"0";"6";"0";"430518";"5766"
"LOK1378_1mm";"SILVA (only NR);Bacteria;Actinobacteriota;Actinobacteria;Micrococcales;Ruaniaceae;";"0.0";"0";"8";"8";"0";"8";"0";"430516";"5766"
"LOK1378_1mm";"SILVA (only NR);Bacteria;Actinobacteriota;Actinobacteria;Micrococcales;Ruaniaceae;Haloactinobacterium;";"0.0";"0";"3";"3";"0";"3";"0";"430521";"5766"
"LOK1378_1mm";"SILVA (only NR);Bacteria;Actinobacteriota;Actinobacteria;Micrococcales;Ruaniaceae;Ruania;";"0.0";"0";"5";"5";"0";"5";"0";"430519";"5766"
"LOK1378_1mm";"SILVA (only NR);Bacteria;Actinobacteriota;Actinobacteria;Micrococcales;Sanguibacteraceae;";"0.0";"0";"49";"47";"0";"47";"2";"430477";"5766"
"LOK1378_1mm";"SILVA (only NR);Bacteria;Actinobacteriota;Actinobacteria;Micrococcales;Sanguibacteraceae;Sanguibacter-Flavimobilis;";"0.0";"0";"49";"47";"0";"47";"2";"430477";"5766"
"LOK1378_1mm";"SILVA (only NR);Bacteria;Actinobacteriota;Actinobacteria;Micrococcales;uncultured;";"0.0";"0";"11";"11";"0";"11";"0";"430513";"5766"
"LOK1378_1mm";"SILVA (only NR);Bacteria;Actinobacteriota;Actinobacteria;Micromonosporales;";"0.0";"0";"1197";"1155";"0";"1155";"42";"429369";"5766"
"LOK1378_1mm";"SILVA (only NR);Bacteria;Actinobacteriota;Actinobacteria;Micromonosporales;Micromonosporaceae;";"0.0";"0";"1197";"1155";"0";"1155";"42";"429369";"5766"
"LOK1378_1mm";"SILVA (only NR);Bacteria;Actinobacteriota;Actinobacteria;Micromonosporales;Micromonosporaceae;Actinocatenispora;";"0.0";"0";"8";"8";"0";"8";"0";"430516";"5766"
"LOK1378_1mm";"SILVA (only NR);Bacteria;Actinobacteriota;Actinobacteria;Micromonosporales;Micromonosporaceae;Actinoplanes;";"0.0";"0";"232";"226";"0";"226";"6";"430298";"5766"
"LOK1378_1mm";"SILVA (only NR);Bacteria;Actinobacteriota;Actinobacteria;Micromonosporales;Micromonosporaceae;Actinorhabdospora;";"0.0";"0";"1";"1";"0";"1";"0";"430523";"5766"
"LOK1378_1mm";"SILVA (only NR);Bacteria;Actinobacteriota;Actinobacteria;Micromonosporales;Micromonosporaceae;Allocatelliglobosispora;";"0.0";"0";"4";"4";"0";"4";"0";"430520";"5766"
"LOK1378_1mm";"SILVA (only NR);Bacteria;Actinobacteriota;Actinobacteria;Micromonosporales;Micromonosporaceae;Asanoa;";"0.0";"0";"23";"23";"0";"23";"0";"430501";"5766"
"LOK1378_1mm";"SILVA (only NR);Bacteria;Actinobacteriota;Actinobacteria;Micromonosporales;Micromonosporaceae;Catellatospora;";"0.0";"0";"16";"16";"0";"16";"0";"430508";"5766"
"LOK1378_1mm";"SILVA (only NR);Bacteria;Actinobacteriota;Actinobacteria;Micromonosporales;Micromonosporaceae;Catelliglobosispora;";"0.0";"0";"2";"2";"0";"2";"0";"430522";"5766"
"LOK1378_1mm";"SILVA (only NR);Bacteria;Actinobacteriota;Actinobacteria;Micromonosporales;Micromonosporaceae;Catenuloplanes;";"0.0";"0";"19";"19";"0";"19";"0";"430505";"5766"
"LOK1378_1mm";"SILVA (only NR);Bacteria;Actinobacteriota;Actinobacteria;Micromonosporales;Micromonosporaceae;Couchioplanes;";"0.0";"0";"5";"5";"0";"5";"0";"430519";"5766"
"LOK1378_1mm";"SILVA (only NR);Bacteria;Actinobacteriota;Actinobacteria;Micromonosporales;Micromonosporaceae;Dactylosporangium;";"0.0";"0";"41";"40";"0";"40";"1";"430484";"5766"
"LOK1378_1mm";"SILVA (only NR);Bacteria;Actinobacteriota;Actinobacteria;Micromonosporales;Micromonosporaceae;Hamadaea;";"0.0";"0";"9";"9";"0";"9";"0";"430515";"5766"
"LOK1378_1mm";"SILVA (only NR);Bacteria;Actinobacteriota;Actinobacteria;Micromonosporales;Micromonosporaceae;Krasilnikovia;";"0.0";"0";"8";"8";"0";"8";"0";"430516";"5766"
"LOK1378_1mm";"SILVA (only NR);Bacteria;Actinobacteriota;Actinobacteria;Micromonosporales;Micromonosporaceae;Longispora;";"0.0";"0";"21";"21";"0";"21";"0";"430503";"5766"
"LOK1378_1mm";"SILVA (only NR);Bacteria;Actinobacteriota;Actinobacteria;Micromonosporales;Micromonosporaceae;Luedemannella;";"0.0";"0";"34";"30";"0";"30";"4";"430494";"5766"
"LOK1378_1mm";"SILVA (only NR);Bacteria;Actinobacteriota;Actinobacteria;Micromonosporales;Micromonosporaceae;Micromonospora;";"0.0";"0";"532";"515";"0";"515";"17";"430009";"5766"
"LOK1378_1mm";"SILVA (only NR);Bacteria;Actinobacteriota;Actinobacteria;Micromonosporales;Micromonosporaceae;Phytohabitans;";"0.0";"0";"13";"12";"0";"12";"1";"430512";"5766"
"LOK1378_1mm";"SILVA (only NR);Bacteria;Actinobacteriota;Actinobacteria;Micromonosporales;Micromonosporaceae;Phytomonospora;";"0.0";"0";"2";"2";"0";"2";"0";"430522";"5766"
"LOK1378_1mm";"SILVA (only NR);Bacteria;Actinobacteriota;Actinobacteria;Micromonosporales;Micromonosporaceae;Pilimelia;";"0.0";"0";"5";"5";"0";"5";"0";"430519";"5766"
"LOK1378_1mm";"SILVA (only NR);Bacteria;Actinobacteriota;Actinobacteria;Micromonosporales;Micromonosporaceae;Planosporangium;";"0.0";"0";"5";"5";"0";"5";"0";"430519";"5766"
"LOK1378_1mm";"SILVA (only NR);Bacteria;Actinobacteriota;Actinobacteria;Micromonosporales;Micromonosporaceae;Plantactinospora;";"0.0";"0";"21";"20";"0";"20";"1";"430504";"5766"
"LOK1378_1mm";"SILVA (only NR);Bacteria;Actinobacteriota;Actinobacteria;Micromonosporales;Micromonosporaceae;Polymorphospora;";"0.0";"0";"1";"1";"0";"1";"0";"430523";"5766"
"LOK1378_1mm";"SILVA (only NR);Bacteria;Actinobacteriota;Actinobacteria;Micromonosporales;Micromonosporaceae;Pseudosporangium;";"0.0";"0";"2";"2";"0";"2";"0";"430522";"5766"
"LOK1378_1mm";"SILVA (only NR);Bacteria;Actinobacteriota;Actinobacteria;Micromonosporales;Micromonosporaceae;Rhizocola;";"0.0";"0";"4";"4";"0";"4";"0";"430520";"5766"
"LOK1378_1mm";"SILVA (only NR);Bacteria;Actinobacteriota;Actinobacteria;Micromonosporales;Micromonosporaceae;Rugosimonospora;";"0.0";"0";"2";"2";"0";"2";"0";"430522";"5766"
"LOK1378_1mm";"SILVA (only NR);Bacteria;Actinobacteriota;Actinobacteria;Micromonosporales;Micromonosporaceae;Salinispora;";"0.0";"0";"36";"35";"0";"35";"1";"430489";"5766"
"LOK1378_1mm";"SILVA (only NR);Bacteria;Actinobacteriota;Actinobacteria;Micromonosporales;Micromonosporaceae;Spirilliplanes;";"0.0";"0";"2";"1";"0";"1";"1";"430523";"5766"
"LOK1378_1mm";"SILVA (only NR);Bacteria;Actinobacteriota;Actinobacteria;Micromonosporales;Micromonosporaceae;Stackebrandtia;";"0.0";"0";"9";"9";"0";"9";"0";"430515";"5766"
"LOK1378_1mm";"SILVA (only NR);Bacteria;Actinobacteriota;Actinobacteria;Micromonosporales;Micromonosporaceae;Verrucosispora;";"0.0";"0";"27";"27";"0";"27";"0";"430497";"5766"
"LOK1378_1mm";"SILVA (only NR);Bacteria;Actinobacteriota;Actinobacteria;Micromonosporales;Micromonosporaceae;Virgisporangium;";"0.0";"0";"11";"11";"0";"11";"0";"430513";"5766"
"LOK1378_1mm";"SILVA (only NR);Bacteria;Actinobacteriota;Actinobacteria;Micromonosporales;Micromonosporaceae;Wangella;";"0.0";"0";"4";"3";"0";"3";"1";"430521";"5766"
"LOK1378_1mm";"SILVA (only NR);Bacteria;Actinobacteriota;Actinobacteria;Micromonosporales;Micromonosporaceae;Xiangella;";"0.0";"0";"2";"2";"0";"2";"0";"430522";"5766"
"LOK1378_1mm";"SILVA (only NR);Bacteria;Actinobacteriota;Actinobacteria;Micromonosporales;Micromonosporaceae;uncultured;";"0.0";"0";"87";"78";"0";"78";"9";"430446";"5766"
"LOK1378_1mm";"SILVA (only NR);Bacteria;Actinobacteriota;Actinobacteria;Nitriliruptorales;";"0.0";"0";"66";"65";"0";"65";"1";"430459";"5766"
"LOK1378_1mm";"SILVA (only NR);Bacteria;Actinobacteriota;Actinobacteria;Nitriliruptorales;Nitriliruptoraceae;";"0.0";"0";"66";"65";"0";"65";"1";"430459";"5766"
"LOK1378_1mm";"SILVA (only NR);Bacteria;Actinobacteriota;Actinobacteria;Nitriliruptorales;Nitriliruptoraceae;Egicoccus;";"0.0";"0";"8";"8";"0";"8";"0";"430516";"5766"
"LOK1378_1mm";"SILVA (only NR);Bacteria;Actinobacteriota;Actinobacteria;Nitriliruptorales;Nitriliruptoraceae;Nitriliruptor;";"0.0";"0";"3";"3";"0";"3";"0";"430521";"5766"
"LOK1378_1mm";"SILVA (only NR);Bacteria;Actinobacteriota;Actinobacteria;Nitriliruptorales;Nitriliruptoraceae;YC-ZSS-LKJ90;";"0.0";"0";"4";"4";"0";"4";"0";"430520";"5766"
"LOK1378_1mm";"SILVA (only NR);Bacteria;Actinobacteriota;Actinobacteria;PeM15;";"0.0";"0";"95";"94";"0";"94";"1";"430430";"5766"
"LOK1378_1mm";"SILVA (only NR);Bacteria;Actinobacteriota;Actinobacteria;Propionibacteriales;";"0.0";"0";"3584";"3491";"0";"3491";"93";"427033";"5766"
"LOK1378_1mm";"SILVA (only NR);Bacteria;Actinobacteriota;Actinobacteria;Propionibacteriales;Nocardioidaceae;";"0.0";"0";"1197";"1165";"0";"1165";"32";"429359";"5766"
"LOK1378_1mm";"SILVA (only NR);Bacteria;Actinobacteriota;Actinobacteria;Propionibacteriales;Nocardioidaceae;Actinopolymorpha;";"0.0";"0";"10";"10";"0";"10";"0";"430514";"5766"
"LOK1378_1mm";"SILVA (only NR);Bacteria;Actinobacteriota;Actinobacteria;Propionibacteriales;Nocardioidaceae;Aeromicrobium;";"0.0";"0";"94";"91";"0";"91";"3";"430433";"5766"
"LOK1378_1mm";"SILVA (only NR);Bacteria;Actinobacteriota;Actinobacteria;Propionibacteriales;Nocardioidaceae;Flindersiella;";"0.0";"0";"4";"4";"0";"4";"0";"430520";"5766"
"LOK1378_1mm";"SILVA (only NR);Bacteria;Actinobacteriota;Actinobacteria;Propionibacteriales;Nocardioidaceae;Kribbella;";"0.0";"0";"81";"78";"0";"78";"3";"430446";"5766"
"LOK1378_1mm";"SILVA (only NR);Bacteria;Actinobacteriota;Actinobacteria;Propionibacteriales;Nocardioidaceae;Marmoricola;";"0.0";"0";"75";"73";"0";"73";"2";"430451";"5766"
"LOK1378_1mm";"SILVA (only NR);Bacteria;Actinobacteriota;Actinobacteria;Propionibacteriales;Nocardioidaceae;Mumia;";"0.0";"0";"7";"7";"0";"7";"0";"430517";"5766"
"LOK1378_1mm";"SILVA (only NR);Bacteria;Actinobacteriota;Actinobacteria;Propionibacteriales;Nocardioidaceae;Nocardioides;";"0.0";"0";"839";"817";"0";"817";"22";"429707";"5766"
"LOK1378_1mm";"SILVA (only NR);Bacteria;Actinobacteriota;Actinobacteria;Propionibacteriales;Nocardioidaceae;Tenggerimyces;";"0.0";"0";"3";"3";"0";"3";"0";"430521";"5766"
"LOK1378_1mm";"SILVA (only NR);Bacteria;Actinobacteriota;Actinobacteria;Propionibacteriales;Nocardioidaceae;Thermasporomyces;";"0.0";"0";"1";"1";"0";"1";"0";"430523";"5766"
"LOK1378_1mm";"SILVA (only NR);Bacteria;Actinobacteriota;Actinobacteria;Propionibacteriales;Nocardioidaceae;uncultured;";"0.0";"0";"81";"79";"0";"79";"2";"430445";"5766"
"LOK1378_1mm";"SILVA (only NR);Bacteria;Actinobacteriota;Actinobacteria;Propionibacteriales;Propionibacteriaceae;";"0.0";"0";"2387";"2326";"0";"2326";"61";"428198";"5766"
"LOK1378_1mm";"SILVA (only NR);Bacteria;Actinobacteriota;Actinobacteria;Propionibacteriales;Propionibacteriaceae;Acidipropionibacterium;";"0.0";"0";"21";"20";"0";"20";"1";"430504";"5766"
"LOK1378_1mm";"SILVA (only NR);Bacteria;Actinobacteriota;Actinobacteria;Propionibacteriales;Propionibacteriaceae;Aestuariimicrobium;";"0.0";"0";"24";"24";"0";"24";"0";"430500";"5766"
"LOK1378_1mm";"SILVA (only NR);Bacteria;Actinobacteriota;Actinobacteria;Propionibacteriales;Propionibacteriaceae;Auraticoccus;";"0.0";"0";"4";"4";"0";"4";"0";"430520";"5766"
"LOK1378_1mm";"SILVA (only NR);Bacteria;Actinobacteriota;Actinobacteria;Propionibacteriales;Propionibacteriaceae;Brooklawnia;";"0.0";"0";"8";"8";"0";"8";"0";"430516";"5766"
"LOK1378_1mm";"SILVA (only NR);Bacteria;Actinobacteriota;Actinobacteria;Propionibacteriales;Propionibacteriaceae;Cutibacterium;";"0.0";"0";"1643";"1600";"0";"1600";"43";"428924";"5766"
"LOK1378_1mm";"SILVA (only NR);Bacteria;Actinobacteriota;Actinobacteria;Propionibacteriales;Propionibacteriaceae;Friedmanniella;";"0.0";"0";"65";"63";"0";"63";"2";"430461";"5766"
"LOK1378_1mm";"SILVA (only NR);Bacteria;Actinobacteriota;Actinobacteria;Propionibacteriales;Propionibacteriaceae;Granulicoccus;";"0.0";"0";"3";"3";"0";"3";"0";"430521";"5766"
"LOK1378_1mm";"SILVA (only NR);Bacteria;Actinobacteriota;Actinobacteria;Propionibacteriales;Propionibacteriaceae;Haloactinopolyspora;";"0.0";"0";"32";"32";"0";"32";"0";"430492";"5766"
"LOK1378_1mm";"SILVA (only NR);Bacteria;Actinobacteriota;Actinobacteria;Propionibacteriales;Propionibacteriaceae;Jiangella;";"0.0";"0";"19";"19";"0";"19";"0";"430505";"5766"
"LOK1378_1mm";"SILVA (only NR);Bacteria;Actinobacteriota;Actinobacteria;Propionibacteriales;Propionibacteriaceae;Luteococcus;";"0.0";"0";"13";"13";"0";"13";"0";"430511";"5766"
"LOK1378_1mm";"SILVA (only NR);Bacteria;Actinobacteriota;Actinobacteria;Propionibacteriales;Propionibacteriaceae;Marinilutecoccus;";"0.0";"0";"10";"10";"0";"10";"0";"430514";"5766"
"LOK1378_1mm";"SILVA (only NR);Bacteria;Actinobacteriota;Actinobacteria;Propionibacteriales;Propionibacteriaceae;Microlunatus;";"0.0";"0";"80";"77";"0";"77";"3";"430447";"5766"
"LOK1378_1mm";"SILVA (only NR);Bacteria;Actinobacteriota;Actinobacteria;Propionibacteriales;Propionibacteriaceae;Micropruina;";"0.0";"0";"12";"12";"0";"12";"0";"430512";"5766"
"LOK1378_1mm";"SILVA (only NR);Bacteria;Actinobacteriota;Actinobacteria;Propionibacteriales;Propionibacteriaceae;Naumannella;";"0.0";"0";"3";"3";"0";"3";"0";"430521";"5766"
"LOK1378_1mm";"SILVA (only NR);Bacteria;Actinobacteriota;Actinobacteria;Propionibacteriales;Propionibacteriaceae;Phytoactinopolyspora;";"0.0";"0";"10";"10";"0";"10";"0";"430514";"5766"
"LOK1378_1mm";"SILVA (only NR);Bacteria;Actinobacteriota;Actinobacteria;Propionibacteriales;Propionibacteriaceae;Propionibacterium;";"0.0";"0";"60";"60";"0";"60";"0";"430464";"5766"
"LOK1378_1mm";"SILVA (only NR);Bacteria;Actinobacteriota;Actinobacteria;Propionibacteriales;Propionibacteriaceae;Propionicicella;";"0.0";"0";"30";"28";"0";"28";"2";"430496";"5766"
"LOK1378_1mm";"SILVA (only NR);Bacteria;Actinobacteriota;Actinobacteria;Propionibacteriales;Propionibacteriaceae;Propioniciclava;";"0.0";"0";"39";"38";"0";"38";"1";"430486";"5766"
"LOK1378_1mm";"SILVA (only NR);Bacteria;Actinobacteriota;Actinobacteria;Propionibacteriales;Propionibacteriaceae;Propionicimonas;";"0.0";"0";"13";"12";"0";"12";"1";"430512";"5766"
"LOK1378_1mm";"SILVA (only NR);Bacteria;Actinobacteriota;Actinobacteria;Propionibacteriales;Propionibacteriaceae;Propioniferax;";"0.0";"0";"3";"3";"0";"3";"0";"430521";"5766"
"LOK1378_1mm";"SILVA (only NR);Bacteria;Actinobacteriota;Actinobacteria;Propionibacteriales;Propionibacteriaceae;Propionimicrobium;";"0.0";"0";"6";"6";"0";"6";"0";"430518";"5766"
"LOK1378_1mm";"SILVA (only NR);Bacteria;Actinobacteriota;Actinobacteria;Propionibacteriales;Propionibacteriaceae;Pseudopropionibacterium;";"0.0";"0";"78";"75";"0";"75";"3";"430449";"5766"
"LOK1378_1mm";"SILVA (only NR);Bacteria;Actinobacteriota;Actinobacteria;Propionibacteriales;Propionibacteriaceae;Raineyella;";"0.0";"0";"11";"11";"0";"11";"0";"430513";"5766"
"LOK1378_1mm";"SILVA (only NR);Bacteria;Actinobacteriota;Actinobacteria;Propionibacteriales;Propionibacteriaceae;Tessaracoccus;";"0.0";"0";"62";"61";"0";"61";"1";"430463";"5766"
"LOK1378_1mm";"SILVA (only NR);Bacteria;Actinobacteriota;Actinobacteria;Propionibacteriales;Propionibacteriaceae;uncultured;";"0.0";"0";"127";"123";"0";"123";"4";"430401";"5766"
"LOK1378_1mm";"SILVA (only NR);Bacteria;Actinobacteriota;Actinobacteria;Pseudonocardiales;";"0.0";"0";"1365";"1322";"0";"1322";"43";"429202";"5766"
"LOK1378_1mm";"SILVA (only NR);Bacteria;Actinobacteriota;Actinobacteria;Pseudonocardiales;Pseudonocardiaceae;";"0.0";"0";"1365";"1322";"0";"1322";"43";"429202";"5766"
"LOK1378_1mm";"SILVA (only NR);Bacteria;Actinobacteriota;Actinobacteria;Pseudonocardiales;Pseudonocardiaceae;Actinoalloteichus;";"0.0";"0";"14";"14";"0";"14";"0";"430510";"5766"
"LOK1378_1mm";"SILVA (only NR);Bacteria;Actinobacteriota;Actinobacteria;Pseudonocardiales;Pseudonocardiaceae;Actinokineospora;";"0.0";"0";"29";"29";"0";"29";"0";"430495";"5766"
"LOK1378_1mm";"SILVA (only NR);Bacteria;Actinobacteriota;Actinobacteria;Pseudonocardiales;Pseudonocardiaceae;Actinomycetospora;";"0.0";"0";"40";"39";"0";"39";"1";"430485";"5766"
"LOK1378_1mm";"SILVA (only NR);Bacteria;Actinobacteriota;Actinobacteria;Pseudonocardiales;Pseudonocardiaceae;Actinophytocola;";"0.0";"0";"49";"41";"0";"41";"8";"430483";"5766"
"LOK1378_1mm";"SILVA (only NR);Bacteria;Actinobacteriota;Actinobacteria;Pseudonocardiales;Pseudonocardiaceae;Actinopolyspora;";"0.0";"0";"31";"31";"0";"31";"0";"430493";"5766"
"LOK1378_1mm";"SILVA (only NR);Bacteria;Actinobacteriota;Actinobacteria;Pseudonocardiales;Pseudonocardiaceae;Actinorectispora;";"0.0";"0";"9";"9";"0";"9";"0";"430515";"5766"
"LOK1378_1mm";"SILVA (only NR);Bacteria;Actinobacteriota;Actinobacteria;Pseudonocardiales;Pseudonocardiaceae;Actinosynnema;";"0.0";"0";"8";"8";"0";"8";"0";"430516";"5766"
"LOK1378_1mm";"SILVA (only NR);Bacteria;Actinobacteriota;Actinobacteria;Pseudonocardiales;Pseudonocardiaceae;Alloactinosynnema;";"0.0";"0";"7";"7";"0";"7";"0";"430517";"5766"
"LOK1378_1mm";"SILVA (only NR);Bacteria;Actinobacteriota;Actinobacteria;Pseudonocardiales;Pseudonocardiaceae;Allokutzneria;";"0.0";"0";"5";"5";"0";"5";"0";"430519";"5766"
"LOK1378_1mm";"SILVA (only NR);Bacteria;Actinobacteriota;Actinobacteria;Pseudonocardiales;Pseudonocardiaceae;Amycolatopsis;";"0.0";"0";"261";"260";"0";"260";"1";"430264";"5766"
"LOK1378_1mm";"SILVA (only NR);Bacteria;Actinobacteriota;Actinobacteria;Pseudonocardiales;Pseudonocardiaceae;Bounagaea;";"0.0";"0";"1";"1";"0";"1";"0";"430523";"5766"
"LOK1378_1mm";"SILVA (only NR);Bacteria;Actinobacteriota;Actinobacteria;Pseudonocardiales;Pseudonocardiaceae;Crossiella;";"0.0";"0";"142";"129";"0";"129";"13";"430395";"5766"
"LOK1378_1mm";"SILVA (only NR);Bacteria;Actinobacteriota;Actinobacteria;Pseudonocardiales;Pseudonocardiaceae;Goodfellowiella;";"0.0";"0";"5";"4";"0";"4";"1";"430520";"5766"
"LOK1378_1mm";"SILVA (only NR);Bacteria;Actinobacteriota;Actinobacteria;Pseudonocardiales;Pseudonocardiaceae;Haloechinothrix;";"0.0";"0";"1";"1";"0";"1";"0";"430523";"5766"
"LOK1378_1mm";"SILVA (only NR);Bacteria;Actinobacteriota;Actinobacteria;Pseudonocardiales;Pseudonocardiaceae;Halopolyspora;";"0.0";"0";"4";"4";"0";"4";"0";"430520";"5766"
"LOK1378_1mm";"SILVA (only NR);Bacteria;Actinobacteriota;Actinobacteria;Pseudonocardiales;Pseudonocardiaceae;Herbihabitans;";"0.0";"0";"4";"4";"0";"4";"0";"430520";"5766"
"LOK1378_1mm";"SILVA (only NR);Bacteria;Actinobacteriota;Actinobacteria;Pseudonocardiales;Pseudonocardiaceae;Kibdelosporangium;";"0.0";"0";"24";"24";"0";"24";"0";"430500";"5766"
"LOK1378_1mm";"SILVA (only NR);Bacteria;Actinobacteriota;Actinobacteria;Pseudonocardiales;Pseudonocardiaceae;Kutzneria;";"0.0";"0";"6";"6";"0";"6";"0";"430518";"5766"
"LOK1378_1mm";"SILVA (only NR);Bacteria;Actinobacteriota;Actinobacteria;Pseudonocardiales;Pseudonocardiaceae;Labedaea;";"0.0";"0";"1";"1";"0";"1";"0";"430523";"5766"
"LOK1378_1mm";"SILVA (only NR);Bacteria;Actinobacteriota;Actinobacteria;Pseudonocardiales;Pseudonocardiaceae;Lechevalieria;";"0.0";"0";"67";"66";"0";"66";"1";"430458";"5766"
"LOK1378_1mm";"SILVA (only NR);Bacteria;Actinobacteriota;Actinobacteria;Pseudonocardiales;Pseudonocardiaceae;Longimycelium;";"0.0";"0";"8";"8";"0";"8";"0";"430516";"5766"
"LOK1378_1mm";"SILVA (only NR);Bacteria;Actinobacteriota;Actinobacteria;Pseudonocardiales;Pseudonocardiaceae;Prauserella;";"0.0";"0";"26";"26";"0";"26";"0";"430498";"5766"
"LOK1378_1mm";"SILVA (only NR);Bacteria;Actinobacteriota;Actinobacteria;Pseudonocardiales;Pseudonocardiaceae;Pseudonocardia;";"0.0";"0";"359";"347";"0";"347";"12";"430177";"5766"
"LOK1378_1mm";"SILVA (only NR);Bacteria;Actinobacteriota;Actinobacteria;Pseudonocardiales;Pseudonocardiaceae;Saccharomonospora;";"0.0";"0";"71";"69";"0";"69";"2";"430455";"5766"
"LOK1378_1mm";"SILVA (only NR);Bacteria;Actinobacteriota;Actinobacteria;Pseudonocardiales;Pseudonocardiaceae;Saccharopolyspora;";"0.0";"0";"98";"97";"0";"97";"1";"430427";"5766"
"LOK1378_1mm";"SILVA (only NR);Bacteria;Actinobacteriota;Actinobacteria;Pseudonocardiales;Pseudonocardiaceae;Saccharothrix;";"0.0";"0";"57";"55";"0";"55";"2";"430469";"5766"
"LOK1378_1mm";"SILVA (only NR);Bacteria;Actinobacteriota;Actinobacteria;Pseudonocardiales;Pseudonocardiaceae;Sciscionella;";"0.0";"0";"3";"3";"0";"3";"0";"430521";"5766"
"LOK1378_1mm";"SILVA (only NR);Bacteria;Actinobacteriota;Actinobacteria;Pseudonocardiales;Pseudonocardiaceae;Streptoalloteichus;";"0.0";"0";"4";"4";"0";"4";"0";"430520";"5766"
"LOK1378_1mm";"SILVA (only NR);Bacteria;Actinobacteriota;Actinobacteria;Pseudonocardiales;Pseudonocardiaceae;Tamaricihabitans;";"0.0";"0";"1";"1";"0";"1";"0";"430523";"5766"
"LOK1378_1mm";"SILVA (only NR);Bacteria;Actinobacteriota;Actinobacteria;Pseudonocardiales;Pseudonocardiaceae;Thermocrispum;";"0.0";"0";"8";"7";"0";"7";"1";"430517";"5766"
"LOK1378_1mm";"SILVA (only NR);Bacteria;Actinobacteriota;Actinobacteria;Pseudonocardiales;Pseudonocardiaceae;Thermotunica;";"0.0";"0";"2";"2";"0";"2";"0";"430522";"5766"
"LOK1378_1mm";"SILVA (only NR);Bacteria;Actinobacteriota;Actinobacteria;Pseudonocardiales;Pseudonocardiaceae;Umezawaea;";"0.0";"0";"3";"3";"0";"3";"0";"430521";"5766"
"LOK1378_1mm";"SILVA (only NR);Bacteria;Actinobacteriota;Actinobacteria;Pseudonocardiales;Pseudonocardiaceae;Yuhushiella;";"0.0";"0";"4";"4";"0";"4";"0";"430520";"5766"
"LOK1378_1mm";"SILVA (only NR);Bacteria;Actinobacteriota;Actinobacteria;Pseudonocardiales;Pseudonocardiaceae;uncultured;";"0.0";"0";"3";"3";"0";"3";"0";"430521";"5766"
"LOK1378_1mm";"SILVA (only NR);Bacteria;Actinobacteriota;Actinobacteria;Streptomycetales;";"0.0";"0";"6216";"6005";"0";"6005";"211";"424519";"5766"
"LOK1378_1mm";"SILVA (only NR);Bacteria;Actinobacteriota;Actinobacteria;Streptomycetales;Streptomycetaceae;";"0.0";"0";"6216";"6005";"0";"6005";"211";"424519";"5766"
"LOK1378_1mm";"SILVA (only NR);Bacteria;Actinobacteriota;Actinobacteria;Streptomycetales;Streptomycetaceae;Allostreptomyces;";"0.0";"0";"3";"3";"0";"3";"0";"430521";"5766"
"LOK1378_1mm";"SILVA (only NR);Bacteria;Actinobacteriota;Actinobacteria;Streptomycetales;Streptomycetaceae;E1B-B3-114;";"0.0";"0";"2";"2";"0";"2";"0";"430522";"5766"
"LOK1378_1mm";"SILVA (only NR);Bacteria;Actinobacteriota;Actinobacteria;Streptomycetales;Streptomycetaceae;Kitasatospora;";"0.0";"0";"168";"164";"0";"164";"4";"430360";"5766"
"LOK1378_1mm";"SILVA (only NR);Bacteria;Actinobacteriota;Actinobacteria;Streptomycetales;Streptomycetaceae;Streptacidiphilus;";"0.0";"0";"31";"29";"0";"29";"2";"430495";"5766"
"LOK1378_1mm";"SILVA (only NR);Bacteria;Actinobacteriota;Actinobacteria;Streptomycetales;Streptomycetaceae;Streptomyces;";"0.0";"0";"6011";"5806";"0";"5806";"205";"424718";"5766"
"LOK1378_1mm";"SILVA (only NR);Bacteria;Actinobacteriota;Actinobacteria;Streptosporangiales;";"0.0";"0";"1229";"1197";"0";"1197";"32";"429327";"5766"
"LOK1378_1mm";"SILVA (only NR);Bacteria;Actinobacteriota;Actinobacteria;Streptosporangiales;Nocardiopsaceae;";"0.0";"0";"355";"341";"0";"341";"14";"430183";"5766"
"LOK1378_1mm";"SILVA (only NR);Bacteria;Actinobacteriota;Actinobacteria;Streptosporangiales;Nocardiopsaceae;Actinorugispora;";"0.0";"0";"1";"1";"0";"1";"0";"430523";"5766"
"LOK1378_1mm";"SILVA (only NR);Bacteria;Actinobacteriota;Actinobacteria;Streptosporangiales;Nocardiopsaceae;Allonocardiopsis;";"0.0";"0";"1";"1";"0";"1";"0";"430523";"5766"
"LOK1378_1mm";"SILVA (only NR);Bacteria;Actinobacteriota;Actinobacteria;Streptosporangiales;Nocardiopsaceae;Allosalinactinospora;";"0.0";"0";"2";"2";"0";"2";"0";"430522";"5766"
"LOK1378_1mm";"SILVA (only NR);Bacteria;Actinobacteriota;Actinobacteria;Streptosporangiales;Nocardiopsaceae;Haloactinospora;";"0.0";"0";"1";"1";"0";"1";"0";"430523";"5766"
"LOK1378_1mm";"SILVA (only NR);Bacteria;Actinobacteriota;Actinobacteria;Streptosporangiales;Nocardiopsaceae;Lipingzhangella;";"0.0";"0";"5";"5";"0";"5";"0";"430519";"5766"
"LOK1378_1mm";"SILVA (only NR);Bacteria;Actinobacteriota;Actinobacteria;Streptosporangiales;Nocardiopsaceae;Marinactinospora;";"0.0";"0";"2";"2";"0";"2";"0";"430522";"5766"
"LOK1378_1mm";"SILVA (only NR);Bacteria;Actinobacteriota;Actinobacteria;Streptosporangiales;Nocardiopsaceae;Marinateneraspora;";"0.0";"0";"1";"1";"0";"1";"0";"430523";"5766"
"LOK1378_1mm";"SILVA (only NR);Bacteria;Actinobacteriota;Actinobacteria;Streptosporangiales;Nocardiopsaceae;Murinocardiopsis;";"0.0";"0";"1";"1";"0";"1";"0";"430523";"5766"
"LOK1378_1mm";"SILVA (only NR);Bacteria;Actinobacteriota;Actinobacteria;Streptosporangiales;Nocardiopsaceae;Nocardiopsis;";"0.0";"0";"291";"277";"0";"277";"14";"430247";"5766"
"LOK1378_1mm";"SILVA (only NR);Bacteria;Actinobacteriota;Actinobacteria;Streptosporangiales;Nocardiopsaceae;Salinactinospora;";"0.0";"0";"1";"1";"0";"1";"0";"430523";"5766"
"LOK1378_1mm";"SILVA (only NR);Bacteria;Actinobacteriota;Actinobacteria;Streptosporangiales;Nocardiopsaceae;Spinactinospora;";"0.0";"0";"1";"1";"0";"1";"0";"430523";"5766"
"LOK1378_1mm";"SILVA (only NR);Bacteria;Actinobacteriota;Actinobacteria;Streptosporangiales;Nocardiopsaceae;Streptomonospora;";"0.0";"0";"23";"23";"0";"23";"0";"430501";"5766"
"LOK1378_1mm";"SILVA (only NR);Bacteria;Actinobacteriota;Actinobacteria;Streptosporangiales;Nocardiopsaceae;Thermobifida;";"0.0";"0";"19";"19";"0";"19";"0";"430505";"5766"
"LOK1378_1mm";"SILVA (only NR);Bacteria;Actinobacteriota;Actinobacteria;Streptosporangiales;Nocardiopsaceae;uncultured;";"0.0";"0";"2";"2";"0";"2";"0";"430522";"5766"
"LOK1378_1mm";"SILVA (only NR);Bacteria;Actinobacteriota;Actinobacteria;Streptosporangiales;Streptosporangiaceae;";"0.0";"0";"497";"484";"0";"484";"13";"430040";"5766"
"LOK1378_1mm";"SILVA (only NR);Bacteria;Actinobacteriota;Actinobacteria;Streptosporangiales;Streptosporangiaceae;Acrocarpospora;";"0.0";"0";"10";"10";"0";"10";"0";"430514";"5766"
"LOK1378_1mm";"SILVA (only NR);Bacteria;Actinobacteriota;Actinobacteria;Streptosporangiales;Streptosporangiaceae;Herbidospora;";"0.0";"0";"8";"8";"0";"8";"0";"430516";"5766"
"LOK1378_1mm";"SILVA (only NR);Bacteria;Actinobacteriota;Actinobacteria;Streptosporangiales;Streptosporangiaceae;Microbispora;";"0.0";"0";"53";"47";"0";"47";"6";"430477";"5766"
"LOK1378_1mm";"SILVA (only NR);Bacteria;Actinobacteriota;Actinobacteria;Streptosporangiales;Streptosporangiaceae;Microtetraspora;";"0.0";"0";"8";"7";"0";"7";"1";"430517";"5766"
"LOK1378_1mm";"SILVA (only NR);Bacteria;Actinobacteriota;Actinobacteria;Streptosporangiales;Streptosporangiaceae;Nonomuraea;";"0.0";"0";"195";"195";"0";"195";"0";"430329";"5766"
"LOK1378_1mm";"SILVA (only NR);Bacteria;Actinobacteriota;Actinobacteria;Streptosporangiales;Streptosporangiaceae;Planobispora;";"0.0";"0";"4";"4";"0";"4";"0";"430520";"5766"
"LOK1378_1mm";"SILVA (only NR);Bacteria;Actinobacteriota;Actinobacteria;Streptosporangiales;Streptosporangiaceae;Planomonospora;";"0.0";"0";"10";"10";"0";"10";"0";"430514";"5766"
"LOK1378_1mm";"SILVA (only NR);Bacteria;Actinobacteriota;Actinobacteria;Streptosporangiales;Streptosporangiaceae;Planotetraspora;";"0.0";"0";"14";"13";"0";"13";"1";"430511";"5766"
"LOK1378_1mm";"SILVA (only NR);Bacteria;Actinobacteriota;Actinobacteria;Streptosporangiales;Streptosporangiaceae;Sinosporangium;";"0.0";"0";"3";"3";"0";"3";"0";"430521";"5766"
"LOK1378_1mm";"SILVA (only NR);Bacteria;Actinobacteriota;Actinobacteria;Streptosporangiales;Streptosporangiaceae;Sphaerimonospora;";"0.0";"0";"6";"6";"0";"6";"0";"430518";"5766"
"LOK1378_1mm";"SILVA (only NR);Bacteria;Actinobacteriota;Actinobacteria;Streptosporangiales;Streptosporangiaceae;Sphaerisporangium;";"0.0";"0";"48";"47";"0";"47";"1";"430477";"5766"
"LOK1378_1mm";"SILVA (only NR);Bacteria;Actinobacteriota;Actinobacteria;Streptosporangiales;Streptosporangiaceae;Streptosporangium;";"0.0";"0";"116";"112";"0";"112";"4";"430412";"5766"
"LOK1378_1mm";"SILVA (only NR);Bacteria;Actinobacteriota;Actinobacteria;Streptosporangiales;Streptosporangiaceae;Thermoactinospora;";"0.0";"0";"1";"1";"0";"1";"0";"430523";"5766"
"LOK1378_1mm";"SILVA (only NR);Bacteria;Actinobacteriota;Actinobacteria;Streptosporangiales;Streptosporangiaceae;Thermocatellispora;";"0.0";"0";"3";"3";"0";"3";"0";"430521";"5766"
"LOK1378_1mm";"SILVA (only NR);Bacteria;Actinobacteriota;Actinobacteria;Streptosporangiales;Streptosporangiaceae;Thermopolyspora;";"0.0";"0";"4";"4";"0";"4";"0";"430520";"5766"
"LOK1378_1mm";"SILVA (only NR);Bacteria;Actinobacteriota;Actinobacteria;Streptosporangiales;Streptosporangiaceae;uncultured;";"0.0";"0";"6";"6";"0";"6";"0";"430518";"5766"
"LOK1378_1mm";"SILVA (only NR);Bacteria;Actinobacteriota;Actinobacteria;Streptosporangiales;Streptosporangiales Incertae Sedis;";"0.0";"0";"6";"6";"0";"6";"0";"430518";"5766"
"LOK1378_1mm";"SILVA (only NR);Bacteria;Actinobacteriota;Actinobacteria;Streptosporangiales;Streptosporangiales Incertae Sedis;Motilibacter;";"0.0";"0";"6";"6";"0";"6";"0";"430518";"5766"
"LOK1378_1mm";"SILVA (only NR);Bacteria;Actinobacteriota;Actinobacteria;Streptosporangiales;Thermomonosporaceae;";"0.0";"0";"369";"364";"0";"364";"5";"430160";"5766"
"LOK1378_1mm";"SILVA (only NR);Bacteria;Actinobacteriota;Actinobacteria;Streptosporangiales;Thermomonosporaceae;Actinoallomurus;";"0.0";"0";"42";"40";"0";"40";"2";"430484";"5766"
"LOK1378_1mm";"SILVA (only NR);Bacteria;Actinobacteriota;Actinobacteria;Streptosporangiales;Thermomonosporaceae;Actinocorallia;";"0.0";"0";"26";"26";"0";"26";"0";"430498";"5766"
"LOK1378_1mm";"SILVA (only NR);Bacteria;Actinobacteriota;Actinobacteria;Streptosporangiales;Thermomonosporaceae;Actinomadura;";"0.0";"0";"242";"239";"0";"239";"3";"430285";"5766"
"LOK1378_1mm";"SILVA (only NR);Bacteria;Actinobacteriota;Actinobacteria;Streptosporangiales;Thermomonosporaceae;Spirillospora;";"0.0";"0";"7";"7";"0";"7";"0";"430517";"5766"
"LOK1378_1mm";"SILVA (only NR);Bacteria;Actinobacteriota;Actinobacteria;Streptosporangiales;Thermomonosporaceae;Thermobispora;";"0.0";"0";"9";"9";"0";"9";"0";"430515";"5766"
"LOK1378_1mm";"SILVA (only NR);Bacteria;Actinobacteriota;Actinobacteria;Streptosporangiales;Thermomonosporaceae;Thermomonospora;";"0.0";"0";"9";"9";"0";"9";"0";"430515";"5766"
"LOK1378_1mm";"SILVA (only NR);Bacteria;Actinobacteriota;Actinobacteria;Streptosporangiales;Thermomonosporaceae;Thermostaphylospora;";"0.0";"0";"10";"10";"0";"10";"0";"430514";"5766"
"LOK1378_1mm";"SILVA (only NR);Bacteria;Actinobacteriota;Actinobacteria;Streptosporangiales;Thermomonosporaceae;[Streptomyces] thermoautotrophicus;";"0.0";"0";"3";"3";"0";"3";"0";"430521";"5766"
"LOK1378_1mm";"SILVA (only NR);Bacteria;Actinobacteriota;Actinobacteria;Streptosporangiales;Thermomonosporaceae;uncultured;";"0.0";"0";"4";"4";"0";"4";"0";"430520";"5766"
"LOK1378_1mm";"SILVA (only NR);Bacteria;Actinobacteriota;Actinobacteria;uncultured;";"0.0";"0";"15";"15";"0";"15";"0";"430509";"5766"
"LOK1378_1mm";"SILVA (only NR);Bacteria;Actinobacteriota;Coriobacteriia;";"0.0";"0";"1162";"1112";"0";"1112";"50";"429412";"5766"
"LOK1378_1mm";"SILVA (only NR);Bacteria;Actinobacteriota;Coriobacteriia;CG2-30-50-142;";"0.0";"0";"8";"8";"0";"8";"0";"430516";"5766"
"LOK1378_1mm";"SILVA (only NR);Bacteria;Actinobacteriota;Coriobacteriia;Coriobacteriales;";"0.0";"0";"1040";"996";"0";"996";"44";"429528";"5766"
"LOK1378_1mm";"SILVA (only NR);Bacteria;Actinobacteriota;Coriobacteriia;Coriobacteriales;Atopobiaceae;";"0.0";"0";"211";"205";"0";"205";"6";"430319";"5766"
"LOK1378_1mm";"SILVA (only NR);Bacteria;Actinobacteriota;Coriobacteriia;Coriobacteriales;Atopobiaceae;Atopobium;";"0.0";"0";"75";"74";"0";"74";"1";"430450";"5766"
"LOK1378_1mm";"SILVA (only NR);Bacteria;Actinobacteriota;Coriobacteriia;Coriobacteriales;Atopobiaceae;Coriobacteriaceae UCG-002;";"0.0";"0";"17";"15";"0";"15";"2";"430509";"5766"
"LOK1378_1mm";"SILVA (only NR);Bacteria;Actinobacteriota;Coriobacteriia;Coriobacteriales;Atopobiaceae;Coriobacteriaceae UCG-003;";"0.0";"0";"9";"9";"0";"9";"0";"430515";"5766"
"LOK1378_1mm";"SILVA (only NR);Bacteria;Actinobacteriota;Coriobacteriia;Coriobacteriales;Atopobiaceae;Libanicoccus;";"0.0";"0";"15";"15";"0";"15";"0";"430509";"5766"
"LOK1378_1mm";"SILVA (only NR);Bacteria;Actinobacteriota;Coriobacteriia;Coriobacteriales;Atopobiaceae;Olsenella;";"0.0";"0";"86";"84";"0";"84";"2";"430440";"5766"
"LOK1378_1mm";"SILVA (only NR);Bacteria;Actinobacteriota;Coriobacteriia;Coriobacteriales;Atopobiaceae;uncultured;";"0.0";"0";"7";"6";"0";"6";"1";"430518";"5766"
"LOK1378_1mm";"SILVA (only NR);Bacteria;Actinobacteriota;Coriobacteriia;Coriobacteriales;Coriobacteriaceae;";"0.0";"0";"351";"335";"0";"335";"16";"430189";"5766"
"LOK1378_1mm";"SILVA (only NR);Bacteria;Actinobacteriota;Coriobacteriia;Coriobacteriales;Coriobacteriaceae;Collinsella;";"0.0";"0";"334";"318";"0";"318";"16";"430206";"5766"
"LOK1378_1mm";"SILVA (only NR);Bacteria;Actinobacteriota;Coriobacteriia;Coriobacteriales;Coriobacteriaceae;Coriobacterium;";"0.0";"0";"8";"8";"0";"8";"0";"430516";"5766"
"LOK1378_1mm";"SILVA (only NR);Bacteria;Actinobacteriota;Coriobacteriia;Coriobacteriales;Coriobacteriaceae;Enorma;";"0.0";"0";"9";"9";"0";"9";"0";"430515";"5766"
"LOK1378_1mm";"SILVA (only NR);Bacteria;Actinobacteriota;Coriobacteriia;Coriobacteriales;Coriobacteriales Incertae Sedis;";"0.0";"0";"68";"68";"0";"68";"0";"430456";"5766"
"LOK1378_1mm";"SILVA (only NR);Bacteria;Actinobacteriota;Coriobacteriia;Coriobacteriales;Coriobacteriales Incertae Sedis;Phoenicibacter;";"0.0";"0";"8";"8";"0";"8";"0";"430516";"5766"
"LOK1378_1mm";"SILVA (only NR);Bacteria;Actinobacteriota;Coriobacteriia;Coriobacteriales;Coriobacteriales Incertae Sedis;Raoultibacter;";"0.0";"0";"16";"16";"0";"16";"0";"430508";"5766"
"LOK1378_1mm";"SILVA (only NR);Bacteria;Actinobacteriota;Coriobacteriia;Coriobacteriales;Coriobacteriales Incertae Sedis;uncultured;";"0.0";"0";"44";"44";"0";"44";"0";"430480";"5766"
"LOK1378_1mm";"SILVA (only NR);Bacteria;Actinobacteriota;Coriobacteriia;Coriobacteriales;Eggerthellaceae;";"0.0";"0";"387";"365";"0";"365";"22";"430159";"5766"
"LOK1378_1mm";"SILVA (only NR);Bacteria;Actinobacteriota;Coriobacteriia;Coriobacteriales;Eggerthellaceae;Adlercreutzia;";"0.0";"0";"10";"10";"0";"10";"0";"430514";"5766"
"LOK1378_1mm";"SILVA (only NR);Bacteria;Actinobacteriota;Coriobacteriia;Coriobacteriales;Eggerthellaceae;Asaccharobacter;";"0.0";"0";"2";"2";"0";"2";"0";"430522";"5766"
"LOK1378_1mm";"SILVA (only NR);Bacteria;Actinobacteriota;Coriobacteriia;Coriobacteriales;Eggerthellaceae;CHKCI002;";"0.0";"0";"2";"2";"0";"2";"0";"430522";"5766"
"LOK1378_1mm";"SILVA (only NR);Bacteria;Actinobacteriota;Coriobacteriia;Coriobacteriales;Eggerthellaceae;Cryptobacterium;";"0.0";"0";"3";"3";"0";"3";"0";"430521";"5766"
"LOK1378_1mm";"SILVA (only NR);Bacteria;Actinobacteriota;Coriobacteriia;Coriobacteriales;Eggerthellaceae;DNF00809;";"0.0";"0";"13";"12";"0";"12";"1";"430512";"5766"
"LOK1378_1mm";"SILVA (only NR);Bacteria;Actinobacteriota;Coriobacteriia;Coriobacteriales;Eggerthellaceae;Denitrobacterium;";"0.0";"0";"4";"4";"0";"4";"0";"430520";"5766"
"LOK1378_1mm";"SILVA (only NR);Bacteria;Actinobacteriota;Coriobacteriia;Coriobacteriales;Eggerthellaceae;Eggerthella;";"0.0";"0";"32";"30";"0";"30";"2";"430494";"5766"
"LOK1378_1mm";"SILVA (only NR);Bacteria;Actinobacteriota;Coriobacteriia;Coriobacteriales;Eggerthellaceae;Enterorhabdus;";"0.0";"0";"136";"122";"0";"122";"14";"430402";"5766"
"LOK1378_1mm";"SILVA (only NR);Bacteria;Actinobacteriota;Coriobacteriia;Coriobacteriales;Eggerthellaceae;Enteroscipio;";"0.0";"0";"2";"2";"0";"2";"0";"430522";"5766"
"LOK1378_1mm";"SILVA (only NR);Bacteria;Actinobacteriota;Coriobacteriia;Coriobacteriales;Eggerthellaceae;Gordonibacter;";"0.0";"0";"23";"23";"0";"23";"0";"430501";"5766"
"LOK1378_1mm";"SILVA (only NR);Bacteria;Actinobacteriota;Coriobacteriia;Coriobacteriales;Eggerthellaceae;Paraeggerthella;";"0.0";"0";"7";"7";"0";"7";"0";"430517";"5766"
"LOK1378_1mm";"SILVA (only NR);Bacteria;Actinobacteriota;Coriobacteriia;Coriobacteriales;Eggerthellaceae;Parvibacter;";"0.0";"0";"6";"6";"0";"6";"0";"430518";"5766"
"LOK1378_1mm";"SILVA (only NR);Bacteria;Actinobacteriota;Coriobacteriia;Coriobacteriales;Eggerthellaceae;Senegalimassilia;";"0.0";"0";"24";"24";"0";"24";"0";"430500";"5766"
"LOK1378_1mm";"SILVA (only NR);Bacteria;Actinobacteriota;Coriobacteriia;Coriobacteriales;Eggerthellaceae;Slackia;";"0.0";"0";"51";"49";"0";"49";"2";"430475";"5766"
"LOK1378_1mm";"SILVA (only NR);Bacteria;Actinobacteriota;Coriobacteriia;Coriobacteriales;Eggerthellaceae;uncultured;";"0.0";"0";"72";"69";"0";"69";"3";"430455";"5766"
"LOK1378_1mm";"SILVA (only NR);Bacteria;Actinobacteriota;Coriobacteriia;Coriobacteriales;uncultured;";"0.0";"0";"22";"22";"0";"22";"0";"430502";"5766"
"LOK1378_1mm";"SILVA (only NR);Bacteria;Actinobacteriota;Coriobacteriia;FS118-23B-02;";"0.0";"0";"11";"11";"0";"11";"0";"430513";"5766"
"LOK1378_1mm";"SILVA (only NR);Bacteria;Actinobacteriota;Coriobacteriia;OPB41;";"0.0";"0";"103";"97";"0";"97";"6";"430427";"5766"
"LOK1378_1mm";"SILVA (only NR);Bacteria;Actinobacteriota;MB-A2-108;";"0.0";"0";"194";"185";"0";"185";"9";"430339";"5766"
"LOK1378_1mm";"SILVA (only NR);Bacteria;Actinobacteriota;RBG-16-55-12;";"0.0";"0";"32";"26";"0";"26";"6";"430498";"5766"
"LOK1378_1mm";"SILVA (only NR);Bacteria;Actinobacteriota;Rubrobacteria;";"0.0";"0";"261";"244";"0";"244";"17";"430280";"5766"
"LOK1378_1mm";"SILVA (only NR);Bacteria;Actinobacteriota;Rubrobacteria;Rubrobacterales;";"0.0";"0";"261";"244";"0";"244";"17";"430280";"5766"
"LOK1378_1mm";"SILVA (only NR);Bacteria;Actinobacteriota;Rubrobacteria;Rubrobacterales;Rubrobacteriaceae;";"0.0";"0";"261";"244";"0";"244";"17";"430280";"5766"
"LOK1378_1mm";"SILVA (only NR);Bacteria;Actinobacteriota;Rubrobacteria;Rubrobacterales;Rubrobacteriaceae;Rubrobacter;";"0.0";"0";"261";"244";"0";"244";"17";"430280";"5766"
"LOK1378_1mm";"SILVA (only NR);Bacteria;Actinobacteriota;Thermoleophilia;";"0.0";"0";"1750";"1660";"0";"1660";"90";"428864";"5766"
"LOK1378_1mm";"SILVA (only NR);Bacteria;Actinobacteriota;Thermoleophilia;Gaiellales;";"0.0";"0";"1029";"964";"0";"964";"65";"429560";"5766"
"LOK1378_1mm";"SILVA (only NR);Bacteria;Actinobacteriota;Thermoleophilia;Gaiellales;Gaiellaceae;";"0.0";"0";"203";"190";"0";"190";"13";"430334";"5766"
"LOK1378_1mm";"SILVA (only NR);Bacteria;Actinobacteriota;Thermoleophilia;Gaiellales;Gaiellaceae;Gaiella;";"0.0";"0";"203";"190";"0";"190";"13";"430334";"5766"
"LOK1378_1mm";"SILVA (only NR);Bacteria;Actinobacteriota;Thermoleophilia;Gaiellales;uncultured;";"0.0";"0";"823";"771";"0";"771";"52";"429753";"5766"
"LOK1378_1mm";"SILVA (only NR);Bacteria;Actinobacteriota;Thermoleophilia;Solirubrobacterales;";"0.0";"0";"692";"668";"0";"668";"24";"429856";"5766"
"LOK1378_1mm";"SILVA (only NR);Bacteria;Actinobacteriota;Thermoleophilia;Solirubrobacterales;67-14;";"0.0";"0";"327";"315";"0";"315";"12";"430209";"5766"
"LOK1378_1mm";"SILVA (only NR);Bacteria;Actinobacteriota;Thermoleophilia;Solirubrobacterales;Solirubrobacteraceae;";"0.0";"0";"365";"353";"0";"353";"12";"430171";"5766"
"LOK1378_1mm";"SILVA (only NR);Bacteria;Actinobacteriota;Thermoleophilia;Solirubrobacterales;Solirubrobacteraceae;Conexibacter;";"0.0";"0";"110";"107";"0";"107";"3";"430417";"5766"
"LOK1378_1mm";"SILVA (only NR);Bacteria;Actinobacteriota;Thermoleophilia;Solirubrobacterales;Solirubrobacteraceae;JCM 18997;";"0.0";"0";"5";"5";"0";"5";"0";"430519";"5766"
"LOK1378_1mm";"SILVA (only NR);Bacteria;Actinobacteriota;Thermoleophilia;Solirubrobacterales;Solirubrobacteraceae;Parviterribacter;";"0.0";"0";"13";"13";"0";"13";"0";"430511";"5766"
"LOK1378_1mm";"SILVA (only NR);Bacteria;Actinobacteriota;Thermoleophilia;Solirubrobacterales;Solirubrobacteraceae;Patulibacter;";"0.0";"0";"17";"17";"0";"17";"0";"430507";"5766"
"LOK1378_1mm";"SILVA (only NR);Bacteria;Actinobacteriota;Thermoleophilia;Solirubrobacterales;Solirubrobacteraceae;Solirubrobacter;";"0.0";"0";"183";"175";"0";"175";"8";"430349";"5766"
"LOK1378_1mm";"SILVA (only NR);Bacteria;Actinobacteriota;Thermoleophilia;Solirubrobacterales;Solirubrobacteraceae;uncultured;";"0.0";"0";"34";"33";"0";"33";"1";"430491";"5766"
"LOK1378_1mm";"SILVA (only NR);Bacteria;Actinobacteriota;Thermoleophilia;Thermophilales;";"0.0";"0";"5";"5";"0";"5";"0";"430519";"5766"
"LOK1378_1mm";"SILVA (only NR);Bacteria;Actinobacteriota;Thermoleophilia;Thermophilales;Thermoleophilaceae;";"0.0";"0";"5";"5";"0";"5";"0";"430519";"5766"
"LOK1378_1mm";"SILVA (only NR);Bacteria;Actinobacteriota;Thermoleophilia;Thermophilales;Thermoleophilaceae;Thermoleophilum;";"0.0";"0";"5";"5";"0";"5";"0";"430519";"5766"
"LOK1378_1mm";"SILVA (only NR);Bacteria;Actinobacteriota;Thermoleophilia;uncultured;";"0.0";"0";"24";"23";"0";"23";"1";"430501";"5766"
"LOK1378_1mm";"SILVA (only NR);Bacteria;Actinobacteriota;WCHB1-81;";"0.0";"0";"89";"85";"0";"85";"4";"430439";"5766"
"LOK1378_1mm";"SILVA (only NR);Bacteria;Aerophobota;";"0.0";"0";"70";"70";"0";"70";"0";"430454";"5766"
"LOK1378_1mm";"SILVA (only NR);Bacteria;Aerophobota;Aerophobia;";"0.0";"0";"70";"70";"0";"70";"0";"430454";"5766"
"LOK1378_1mm";"SILVA (only NR);Bacteria;Aerophobota;Aerophobia;Aerophobales;";"0.0";"0";"70";"70";"0";"70";"0";"430454";"5766"
"LOK1378_1mm";"SILVA (only NR);Bacteria;AncK6;";"0.0";"0";"23";"23";"0";"23";"0";"430501";"5766"
"LOK1378_1mm";"SILVA (only NR);Bacteria;Apal-E12;";"0.0";"0";"3";"3";"0";"3";"0";"430521";"5766"
"LOK1378_1mm";"SILVA (only NR);Bacteria;Aquificota;";"0.0";"0";"253";"239";"0";"239";"14";"430285";"5766"
"LOK1378_1mm";"SILVA (only NR);Bacteria;Aquificota;Aquificae;";"0.0";"0";"226";"212";"0";"212";"14";"430312";"5766"
"LOK1378_1mm";"SILVA (only NR);Bacteria;Aquificota;Aquificae;Aquificales;";"0.0";"0";"130";"122";"0";"122";"8";"430402";"5766"
"LOK1378_1mm";"SILVA (only NR);Bacteria;Aquificota;Aquificae;Aquificales;Aquificaceae;";"0.0";"0";"90";"85";"0";"85";"5";"430439";"5766"
"LOK1378_1mm";"SILVA (only NR);Bacteria;Aquificota;Aquificae;Aquificales;Aquificaceae;Aquifex;";"0.0";"0";"3";"3";"0";"3";"0";"430521";"5766"
"LOK1378_1mm";"SILVA (only NR);Bacteria;Aquificota;Aquificae;Aquificales;Aquificaceae;Hydrogenivirga;";"0.0";"0";"4";"4";"0";"4";"0";"430520";"5766"
"LOK1378_1mm";"SILVA (only NR);Bacteria;Aquificota;Aquificae;Aquificales;Aquificaceae;Hydrogenobacter;";"0.0";"0";"30";"30";"0";"30";"0";"430494";"5766"
"LOK1378_1mm";"SILVA (only NR);Bacteria;Aquificota;Aquificae;Aquificales;Aquificaceae;Thermocrinis;";"0.0";"0";"48";"43";"0";"43";"5";"430481";"5766"
"LOK1378_1mm";"SILVA (only NR);Bacteria;Aquificota;Aquificae;Aquificales;Aquificaceae;uncultured;";"0.0";"0";"2";"2";"0";"2";"0";"430522";"5766"
"LOK1378_1mm";"SILVA (only NR);Bacteria;Aquificota;Aquificae;Aquificales;Hydrogenobaculaceae;";"0.0";"0";"40";"37";"0";"37";"3";"430487";"5766"
"LOK1378_1mm";"SILVA (only NR);Bacteria;Aquificota;Aquificae;Aquificales;Hydrogenobaculaceae;Hydrogenobaculum;";"0.0";"0";"40";"37";"0";"37";"3";"430487";"5766"
"LOK1378_1mm";"SILVA (only NR);Bacteria;Aquificota;Aquificae;Hydrogenothermales;";"0.0";"0";"96";"90";"0";"90";"6";"430434";"5766"
"LOK1378_1mm";"SILVA (only NR);Bacteria;Aquificota;Aquificae;Hydrogenothermales;Hydrogenothermaceae;";"0.0";"0";"96";"90";"0";"90";"6";"430434";"5766"
"LOK1378_1mm";"SILVA (only NR);Bacteria;Aquificota;Aquificae;Hydrogenothermales;Hydrogenothermaceae;Hydrogenothermus;";"0.0";"0";"7";"7";"0";"7";"0";"430517";"5766"
"LOK1378_1mm";"SILVA (only NR);Bacteria;Aquificota;Aquificae;Hydrogenothermales;Hydrogenothermaceae;Persephonella;";"0.0";"0";"16";"16";"0";"16";"0";"430508";"5766"
"LOK1378_1mm";"SILVA (only NR);Bacteria;Aquificota;Aquificae;Hydrogenothermales;Hydrogenothermaceae;Sulfurihydrogenibium;";"0.0";"0";"54";"49";"0";"49";"5";"430475";"5766"
"LOK1378_1mm";"SILVA (only NR);Bacteria;Aquificota;Aquificae;Hydrogenothermales;Hydrogenothermaceae;Venenivibrio;";"0.0";"0";"9";"8";"0";"8";"1";"430516";"5766"
"LOK1378_1mm";"SILVA (only NR);Bacteria;Aquificota;Aquificae;Hydrogenothermales;Hydrogenothermaceae;uncultured;";"0.0";"0";"7";"7";"0";"7";"0";"430517";"5766"
"LOK1378_1mm";"SILVA (only NR);Bacteria;Aquificota;Desulfurobacteriia;";"0.0";"0";"27";"27";"0";"27";"0";"430497";"5766"
"LOK1378_1mm";"SILVA (only NR);Bacteria;Aquificota;Desulfurobacteriia;Desulfurobacteriales;";"0.0";"0";"27";"27";"0";"27";"0";"430497";"5766"
"LOK1378_1mm";"SILVA (only NR);Bacteria;Aquificota;Desulfurobacteriia;Desulfurobacteriales;Desulfurobacteriaceae;";"0.0";"0";"27";"27";"0";"27";"0";"430497";"5766"
"LOK1378_1mm";"SILVA (only NR);Bacteria;Aquificota;Desulfurobacteriia;Desulfurobacteriales;Desulfurobacteriaceae;Balnearium;";"0.0";"0";"2";"2";"0";"2";"0";"430522";"5766"
"LOK1378_1mm";"SILVA (only NR);Bacteria;Aquificota;Desulfurobacteriia;Desulfurobacteriales;Desulfurobacteriaceae;Desulfurobacterium;";"0.0";"0";"18";"18";"0";"18";"0";"430506";"5766"
"LOK1378_1mm";"SILVA (only NR);Bacteria;Aquificota;Desulfurobacteriia;Desulfurobacteriales;Desulfurobacteriaceae;Phorcysia;";"0.0";"0";"1";"1";"0";"1";"0";"430523";"5766"
"LOK1378_1mm";"SILVA (only NR);Bacteria;Aquificota;Desulfurobacteriia;Desulfurobacteriales;Desulfurobacteriaceae;Thermovibrio;";"0.0";"0";"5";"5";"0";"5";"0";"430519";"5766"
"LOK1378_1mm";"SILVA (only NR);Bacteria;Armatimonadota;";"0.0";"0";"776";"728";"0";"728";"48";"429796";"5766"
"LOK1378_1mm";"SILVA (only NR);Bacteria;Armatimonadota;Armatimonadia;";"0.0";"0";"156";"146";"0";"146";"10";"430378";"5766"
"LOK1378_1mm";"SILVA (only NR);Bacteria;Armatimonadota;Armatimonadia;Armatimonadales;";"0.0";"0";"156";"146";"0";"146";"10";"430378";"5766"
"LOK1378_1mm";"SILVA (only NR);Bacteria;Armatimonadota;Armatimonadia;Armatimonadales;Armatimonadaceae;";"0.0";"0";"12";"12";"0";"12";"0";"430512";"5766"
"LOK1378_1mm";"SILVA (only NR);Bacteria;Armatimonadota;Armatimonadia;Armatimonadales;Armatimonadaceae;Armatimonas;";"0.0";"0";"12";"12";"0";"12";"0";"430512";"5766"
"LOK1378_1mm";"SILVA (only NR);Bacteria;Armatimonadota;Chthonomonadetes;";"0.0";"0";"88";"79";"0";"79";"9";"430445";"5766"
"LOK1378_1mm";"SILVA (only NR);Bacteria;Armatimonadota;Chthonomonadetes;Chthonomonadales;";"0.0";"0";"88";"79";"0";"79";"9";"430445";"5766"
"LOK1378_1mm";"SILVA (only NR);Bacteria;Armatimonadota;Chthonomonadetes;Chthonomonadales;Chthonomonadaceae;";"0.0";"0";"34";"29";"0";"29";"5";"430495";"5766"
"LOK1378_1mm";"SILVA (only NR);Bacteria;Armatimonadota;Chthonomonadetes;Chthonomonadales;Chthonomonadaceae;Chthonomonas;";"0.0";"0";"34";"29";"0";"29";"5";"430495";"5766"
"LOK1378_1mm";"SILVA (only NR);Bacteria;Armatimonadota;DG-56;";"0.0";"0";"21";"19";"0";"19";"2";"430505";"5766"
"LOK1378_1mm";"SILVA (only NR);Bacteria;Armatimonadota;Fimbriimonadia;";"0.0";"0";"220";"214";"0";"214";"6";"430310";"5766"
"LOK1378_1mm";"SILVA (only NR);Bacteria;Armatimonadota;Fimbriimonadia;Fimbriimonadales;";"0.0";"0";"220";"214";"0";"214";"6";"430310";"5766"
"LOK1378_1mm";"SILVA (only NR);Bacteria;Armatimonadota;Fimbriimonadia;Fimbriimonadales;Fimbriimonadaceae;";"0.0";"0";"172";"167";"0";"167";"5";"430357";"5766"
"LOK1378_1mm";"SILVA (only NR);Bacteria;Armatimonadota;Fimbriimonadia;Fimbriimonadales;Fimbriimonadaceae;Fimbriimonas;";"0.0";"0";"7";"7";"0";"7";"0";"430517";"5766"
"LOK1378_1mm";"SILVA (only NR);Bacteria;Armatimonadota;uncultured;";"0.0";"0";"291";"270";"0";"270";"21";"430254";"5766"
"LOK1378_1mm";"SILVA (only NR);Bacteria;BHI80-139;";"0.0";"0";"41";"41";"0";"41";"0";"430483";"5766"
"LOK1378_1mm";"SILVA (only NR);Bacteria;Bacteroidota;";"0.0";"98.5";"45751";"44137";"1";"44136";"1614";"386387";"5765"
"LOK1378_1mm";"SILVA (only NR);Bacteria;Bacteroidota;Bacteroidia;";"0.0";"98.5";"42694";"41138";"1";"41137";"1556";"389386";"5765"
"LOK1378_1mm";"SILVA (only NR);Bacteria;Bacteroidota;Bacteroidia;Bacteroidales;";"0.0";"98.6";"21842";"21031";"1";"21030";"811";"409493";"5765"
"LOK1378_1mm";"SILVA (only NR);Bacteria;Bacteroidota;Bacteroidia;Bacteroidales;009E01-B-SD-P15;";"0.0";"0";"9";"9";"0";"9";"0";"430515";"5766"
"LOK1378_1mm";"SILVA (only NR);Bacteria;Bacteroidota;Bacteroidia;Bacteroidales;3M1PL1-52 termite group;";"0.0";"0";"13";"13";"0";"13";"0";"430511";"5766"
"LOK1378_1mm";"SILVA (only NR);Bacteria;Bacteroidota;Bacteroidia;Bacteroidales;Bacteroidaceae;";"0.0";"0";"3631";"3546";"0";"3546";"85";"426978";"5766"
"LOK1378_1mm";"SILVA (only NR);Bacteria;Bacteroidota;Bacteroidia;Bacteroidales;Bacteroidaceae;Bacteroides;";"0.0";"0";"3631";"3546";"0";"3546";"85";"426978";"5766"
"LOK1378_1mm";"SILVA (only NR);Bacteria;Bacteroidota;Bacteroidia;Bacteroidales;Bacteroidales BS11 gut group;";"0.0";"0";"97";"90";"0";"90";"7";"430434";"5766"
"LOK1378_1mm";"SILVA (only NR);Bacteria;Bacteroidota;Bacteroidia;Bacteroidales;Bacteroidales Incertae Sedis;";"0.0";"0";"3";"3";"0";"3";"0";"430521";"5766"
"LOK1378_1mm";"SILVA (only NR);Bacteria;Bacteroidota;Bacteroidia;Bacteroidales;Bacteroidales Incertae Sedis;Phocaeicola;";"0.0";"0";"3";"3";"0";"3";"0";"430521";"5766"
"LOK1378_1mm";"SILVA (only NR);Bacteria;Bacteroidota;Bacteroidia;Bacteroidales;Bacteroidales RF16 group;";"0.0";"0";"125";"122";"0";"122";"3";"430402";"5766"
"LOK1378_1mm";"SILVA (only NR);Bacteria;Bacteroidota;Bacteroidia;Bacteroidales;Bacteroidales UCG-001;";"0.0";"0";"133";"126";"0";"126";"7";"430398";"5766"
"LOK1378_1mm";"SILVA (only NR);Bacteria;Bacteroidota;Bacteroidia;Bacteroidales;Bacteroidetes BD2-2;";"0.0";"0";"586";"563";"0";"563";"23";"429961";"5766"
"LOK1378_1mm";"SILVA (only NR);Bacteria;Bacteroidota;Bacteroidia;Bacteroidales;Bacteroidetes vadinHA17;";"0.0";"0";"333";"321";"0";"321";"12";"430203";"5766"
"LOK1378_1mm";"SILVA (only NR);Bacteria;Bacteroidota;Bacteroidia;Bacteroidales;Barnesiellaceae;";"0.0";"0";"140";"135";"0";"135";"5";"430389";"5766"
"LOK1378_1mm";"SILVA (only NR);Bacteria;Bacteroidota;Bacteroidia;Bacteroidales;Barnesiellaceae;Barnesiella;";"0.0";"0";"84";"81";"0";"81";"3";"430443";"5766"
"LOK1378_1mm";"SILVA (only NR);Bacteria;Bacteroidota;Bacteroidia;Bacteroidales;Barnesiellaceae;Coprobacter;";"0.0";"0";"26";"26";"0";"26";"0";"430498";"5766"
"LOK1378_1mm";"SILVA (only NR);Bacteria;Bacteroidota;Bacteroidia;Bacteroidales;Barnesiellaceae;uncultured;";"0.0";"0";"30";"28";"0";"28";"2";"430496";"5766"
"LOK1378_1mm";"SILVA (only NR);Bacteria;Bacteroidota;Bacteroidia;Bacteroidales;CAP-aah99b04;";"0.0";"0";"5";"4";"0";"4";"1";"430520";"5766"
"LOK1378_1mm";"SILVA (only NR);Bacteria;Bacteroidota;Bacteroidia;Bacteroidales;COB P4-1 termite group;";"0.0";"0";"11";"11";"0";"11";"0";"430513";"5766"
"LOK1378_1mm";"SILVA (only NR);Bacteria;Bacteroidota;Bacteroidia;Bacteroidales;CR-115;";"0.0";"0";"4";"4";"0";"4";"0";"430520";"5766"
"LOK1378_1mm";"SILVA (only NR);Bacteria;Bacteroidota;Bacteroidia;Bacteroidales;Dysgonomonadaceae;";"0.0";"0";"876";"854";"0";"854";"22";"429670";"5766"
"LOK1378_1mm";"SILVA (only NR);Bacteria;Bacteroidota;Bacteroidia;Bacteroidales;Dysgonomonadaceae;Candidatus Armantifilum;";"0.0";"0";"44";"40";"0";"40";"4";"430484";"5766"
"LOK1378_1mm";"SILVA (only NR);Bacteria;Bacteroidota;Bacteroidia;Bacteroidales;Dysgonomonadaceae;Candidatus Azobacteroides;";"0.0";"0";"23";"23";"0";"23";"0";"430501";"5766"
"LOK1378_1mm";"SILVA (only NR);Bacteria;Bacteroidota;Bacteroidia;Bacteroidales;Dysgonomonadaceae;Candidatus Symbiothrix;";"0.0";"0";"75";"73";"0";"73";"2";"430451";"5766"
"LOK1378_1mm";"SILVA (only NR);Bacteria;Bacteroidota;Bacteroidia;Bacteroidales;Dysgonomonadaceae;Dysgonomonas;";"0.0";"0";"159";"156";"0";"156";"3";"430368";"5766"
"LOK1378_1mm";"SILVA (only NR);Bacteria;Bacteroidota;Bacteroidia;Bacteroidales;Dysgonomonadaceae;Fermentimonas;";"0.0";"0";"136";"133";"0";"133";"3";"430391";"5766"
"LOK1378_1mm";"SILVA (only NR);Bacteria;Bacteroidota;Bacteroidia;Bacteroidales;Dysgonomonadaceae;Petrimonas;";"0.0";"0";"47";"45";"0";"45";"2";"430479";"5766"
"LOK1378_1mm";"SILVA (only NR);Bacteria;Bacteroidota;Bacteroidia;Bacteroidales;Dysgonomonadaceae;Proteiniphilum;";"0.0";"0";"275";"270";"0";"270";"5";"430254";"5766"
"LOK1378_1mm";"SILVA (only NR);Bacteria;Bacteroidota;Bacteroidia;Bacteroidales;Dysgonomonadaceae;uncultured;";"0.0";"0";"110";"107";"0";"107";"3";"430417";"5766"
"LOK1378_1mm";"SILVA (only NR);Bacteria;Bacteroidota;Bacteroidia;Bacteroidales;F082;";"0.0";"0";"366";"353";"0";"353";"13";"430171";"5766"
"LOK1378_1mm";"SILVA (only NR);Bacteria;Bacteroidota;Bacteroidia;Bacteroidales;FTLpost3;";"0.0";"0";"9";"9";"0";"9";"0";"430515";"5766"
"LOK1378_1mm";"SILVA (only NR);Bacteria;Bacteroidota;Bacteroidia;Bacteroidales;GZKB124;";"0.0";"0";"5";"5";"0";"5";"0";"430519";"5766"
"LOK1378_1mm";"SILVA (only NR);Bacteria;Bacteroidota;Bacteroidia;Bacteroidales;HAW-RM37-2;";"0.0";"0";"2";"2";"0";"2";"0";"430522";"5766"
"LOK1378_1mm";"SILVA (only NR);Bacteria;Bacteroidota;Bacteroidia;Bacteroidales;Ika33;";"0.0";"0";"7";"6";"0";"6";"1";"430518";"5766"
"LOK1378_1mm";"SILVA (only NR);Bacteria;Bacteroidota;Bacteroidia;Bacteroidales;LKC2.127-25;";"0.0";"0";"7";"7";"0";"7";"0";"430517";"5766"
"LOK1378_1mm";"SILVA (only NR);Bacteria;Bacteroidota;Bacteroidia;Bacteroidales;M2PB4-65 termite group;";"0.0";"0";"44";"44";"0";"44";"0";"430480";"5766"
"LOK1378_1mm";"SILVA (only NR);Bacteria;Bacteroidota;Bacteroidia;Bacteroidales;ML635J-40 aquatic group;";"0.0";"0";"120";"113";"0";"113";"7";"430411";"5766"
"LOK1378_1mm";"SILVA (only NR);Bacteria;Bacteroidota;Bacteroidia;Bacteroidales;Marinifilaceae;";"0.0";"0";"472";"464";"0";"464";"8";"430060";"5766"
"LOK1378_1mm";"SILVA (only NR);Bacteria;Bacteroidota;Bacteroidia;Bacteroidales;Marinifilaceae;Butyricimonas;";"0.0";"0";"56";"55";"0";"55";"1";"430469";"5766"
"LOK1378_1mm";"SILVA (only NR);Bacteria;Bacteroidota;Bacteroidia;Bacteroidales;Marinifilaceae;Marinifilum;";"0.0";"0";"224";"222";"0";"222";"2";"430302";"5766"
"LOK1378_1mm";"SILVA (only NR);Bacteria;Bacteroidota;Bacteroidia;Bacteroidales;Marinifilaceae;Odoribacter;";"0.0";"0";"102";"99";"0";"99";"3";"430425";"5766"
"LOK1378_1mm";"SILVA (only NR);Bacteria;Bacteroidota;Bacteroidia;Bacteroidales;Marinifilaceae;Sanguibacteroides;";"0.0";"0";"8";"8";"0";"8";"0";"430516";"5766"
"LOK1378_1mm";"SILVA (only NR);Bacteria;Bacteroidota;Bacteroidia;Bacteroidales;Marinifilaceae;uncultured;";"0.0";"0";"82";"80";"0";"80";"2";"430444";"5766"
"LOK1378_1mm";"SILVA (only NR);Bacteria;Bacteroidota;Bacteroidia;Bacteroidales;Marinilabiliaceae;";"0.0";"0";"611";"577";"0";"577";"34";"429947";"5766"
"LOK1378_1mm";"SILVA (only NR);Bacteria;Bacteroidota;Bacteroidia;Bacteroidales;Marinilabiliaceae;Alkaliflexus;";"0.0";"0";"17";"17";"0";"17";"0";"430507";"5766"
"LOK1378_1mm";"SILVA (only NR);Bacteria;Bacteroidota;Bacteroidia;Bacteroidales;Marinilabiliaceae;Alkalitalea;";"0.0";"0";"3";"3";"0";"3";"0";"430521";"5766"
"LOK1378_1mm";"SILVA (only NR);Bacteria;Bacteroidota;Bacteroidia;Bacteroidales;Marinilabiliaceae;Anaerophaga;";"0.0";"0";"24";"22";"0";"22";"2";"430502";"5766"
"LOK1378_1mm";"SILVA (only NR);Bacteria;Bacteroidota;Bacteroidia;Bacteroidales;Marinilabiliaceae;Carboxylicivirga;";"0.0";"0";"51";"51";"0";"51";"0";"430473";"5766"
"LOK1378_1mm";"SILVA (only NR);Bacteria;Bacteroidota;Bacteroidia;Bacteroidales;Marinilabiliaceae;Geofilum;";"0.0";"0";"1";"1";"0";"1";"0";"430523";"5766"
"LOK1378_1mm";"SILVA (only NR);Bacteria;Bacteroidota;Bacteroidia;Bacteroidales;Marinilabiliaceae;Labilibacter;";"0.0";"0";"14";"14";"0";"14";"0";"430510";"5766"
"LOK1378_1mm";"SILVA (only NR);Bacteria;Bacteroidota;Bacteroidia;Bacteroidales;Marinilabiliaceae;Mangroviflexus;";"0.0";"0";"11";"11";"0";"11";"0";"430513";"5766"
"LOK1378_1mm";"SILVA (only NR);Bacteria;Bacteroidota;Bacteroidia;Bacteroidales;Marinilabiliaceae;Marinilabilia;";"0.0";"0";"8";"8";"0";"8";"0";"430516";"5766"
"LOK1378_1mm";"SILVA (only NR);Bacteria;Bacteroidota;Bacteroidia;Bacteroidales;Marinilabiliaceae;Natronoflexus;";"0.0";"0";"1";"1";"0";"1";"0";"430523";"5766"
"LOK1378_1mm";"SILVA (only NR);Bacteria;Bacteroidota;Bacteroidia;Bacteroidales;Marinilabiliaceae;Ruminofilibacter;";"0.0";"0";"8";"8";"0";"8";"0";"430516";"5766"
"LOK1378_1mm";"SILVA (only NR);Bacteria;Bacteroidota;Bacteroidia;Bacteroidales;Marinilabiliaceae;Saccharicrinis;";"0.0";"0";"5";"4";"0";"4";"1";"430520";"5766"
"LOK1378_1mm";"SILVA (only NR);Bacteria;Bacteroidota;Bacteroidia;Bacteroidales;Marinilabiliaceae;Thermophagus;";"0.0";"0";"1";"1";"0";"1";"0";"430523";"5766"
"LOK1378_1mm";"SILVA (only NR);Bacteria;Bacteroidota;Bacteroidia;Bacteroidales;Marinilabiliaceae;[Cytophaga] xylanolytica group;";"0.0";"0";"14";"14";"0";"14";"0";"430510";"5766"
"LOK1378_1mm";"SILVA (only NR);Bacteria;Bacteroidota;Bacteroidia;Bacteroidales;Marinilabiliaceae;uncultured;";"0.0";"0";"449";"418";"0";"418";"31";"430106";"5766"
"LOK1378_1mm";"SILVA (only NR);Bacteria;Bacteroidota;Bacteroidia;Bacteroidales;MgMjR-022;";"0.0";"0";"7";"7";"0";"7";"0";"430517";"5766"
"LOK1378_1mm";"SILVA (only NR);Bacteria;Bacteroidota;Bacteroidia;Bacteroidales;Muribaculaceae;";"0.0";"0";"2753";"2502";"0";"2502";"251";"428022";"5766"
"LOK1378_1mm";"SILVA (only NR);Bacteria;Bacteroidota;Bacteroidia;Bacteroidales;Muribaculaceae;CAG-873;";"0.0";"0";"8";"8";"0";"8";"0";"430516";"5766"
"LOK1378_1mm";"SILVA (only NR);Bacteria;Bacteroidota;Bacteroidia;Bacteroidales;Muribaculaceae;Muribaculum;";"0.0";"0";"25";"22";"0";"22";"3";"430502";"5766"
"LOK1378_1mm";"SILVA (only NR);Bacteria;Bacteroidota;Bacteroidia;Bacteroidales;Paludibacteraceae;";"0.0";"0";"391";"379";"0";"379";"12";"430145";"5766"
"LOK1378_1mm";"SILVA (only NR);Bacteria;Bacteroidota;Bacteroidia;Bacteroidales;Paludibacteraceae;F0058;";"0.0";"0";"47";"44";"0";"44";"3";"430480";"5766"
"LOK1378_1mm";"SILVA (only NR);Bacteria;Bacteroidota;Bacteroidia;Bacteroidales;Paludibacteraceae;H1;";"0.0";"0";"13";"11";"0";"11";"2";"430513";"5766"
"LOK1378_1mm";"SILVA (only NR);Bacteria;Bacteroidota;Bacteroidia;Bacteroidales;Paludibacteraceae;Microbacter;";"0.0";"0";"10";"10";"0";"10";"0";"430514";"5766"
"LOK1378_1mm";"SILVA (only NR);Bacteria;Bacteroidota;Bacteroidia;Bacteroidales;Paludibacteraceae;Paludibacter;";"0.0";"0";"151";"150";"0";"150";"1";"430374";"5766"
"LOK1378_1mm";"SILVA (only NR);Bacteria;Bacteroidota;Bacteroidia;Bacteroidales;Paludibacteraceae;uncultured;";"0.0";"0";"170";"164";"0";"164";"6";"430360";"5766"
"LOK1378_1mm";"SILVA (only NR);Bacteria;Bacteroidota;Bacteroidia;Bacteroidales;PeH15;";"0.0";"0";"14";"14";"0";"14";"0";"430510";"5766"
"LOK1378_1mm";"SILVA (only NR);Bacteria;Bacteroidota;Bacteroidia;Bacteroidales;Porphyromonadaceae;";"0.0";"0";"647";"638";"0";"638";"9";"429886";"5766"
"LOK1378_1mm";"SILVA (only NR);Bacteria;Bacteroidota;Bacteroidia;Bacteroidales;Porphyromonadaceae;Falsiporphyromonas;";"0.0";"0";"1";"1";"0";"1";"0";"430523";"5766"
"LOK1378_1mm";"SILVA (only NR);Bacteria;Bacteroidota;Bacteroidia;Bacteroidales;Porphyromonadaceae;Porphyromonas;";"0.0";"0";"644";"635";"0";"635";"9";"429889";"5766"
"LOK1378_1mm";"SILVA (only NR);Bacteria;Bacteroidota;Bacteroidia;Bacteroidales;Prevotellaceae;";"0.0";"98.6";"5074";"4931";"1";"4930";"143";"425593";"5765"
"LOK1378_1mm";"SILVA (only NR);Bacteria;Bacteroidota;Bacteroidia;Bacteroidales;Prevotellaceae;Alloprevotella;";"0.0";"0";"435";"431";"0";"431";"4";"430093";"5766"
"LOK1378_1mm";"SILVA (only NR);Bacteria;Bacteroidota;Bacteroidia;Bacteroidales;Prevotellaceae;Paraprevotella;";"0.0";"0";"43";"43";"0";"43";"0";"430481";"5766"
"LOK1378_1mm";"SILVA (only NR);Bacteria;Bacteroidota;Bacteroidia;Bacteroidales;Prevotellaceae;Prevotella;";"0.0";"98.7";"2164";"2119";"1";"2118";"45";"428405";"5765"
"LOK1378_1mm";"SILVA (only NR);Bacteria;Bacteroidota;Bacteroidia;Bacteroidales;Prevotellaceae;Prevotella_7;";"0.0";"0";"535";"512";"0";"512";"23";"430012";"5766"
"LOK1378_1mm";"SILVA (only NR);Bacteria;Bacteroidota;Bacteroidia;Bacteroidales;Prevotellaceae;Prevotella_9;";"0.0";"0";"1041";"1002";"0";"1002";"39";"429522";"5766"
"LOK1378_1mm";"SILVA (only NR);Bacteria;Bacteroidota;Bacteroidia;Bacteroidales;Prevotellaceae;Prevotellaceae Ga6A1 group;";"0.0";"0";"21";"20";"0";"20";"1";"430504";"5766"
"LOK1378_1mm";"SILVA (only NR);Bacteria;Bacteroidota;Bacteroidia;Bacteroidales;Prevotellaceae;Prevotellaceae NK3B31 group;";"0.0";"0";"115";"112";"0";"112";"3";"430412";"5766"
"LOK1378_1mm";"SILVA (only NR);Bacteria;Bacteroidota;Bacteroidia;Bacteroidales;Prevotellaceae;Prevotellaceae UCG-001;";"0.0";"0";"321";"309";"0";"309";"12";"430215";"5766"
"LOK1378_1mm";"SILVA (only NR);Bacteria;Bacteroidota;Bacteroidia;Bacteroidales;Prevotellaceae;Prevotellaceae UCG-003;";"0.0";"0";"158";"151";"0";"151";"7";"430373";"5766"
"LOK1378_1mm";"SILVA (only NR);Bacteria;Bacteroidota;Bacteroidia;Bacteroidales;Prevotellaceae;Prevotellaceae UCG-004;";"0.0";"0";"100";"93";"0";"93";"7";"430431";"5766"
"LOK1378_1mm";"SILVA (only NR);Bacteria;Bacteroidota;Bacteroidia;Bacteroidales;Prevotellaceae;Prevotellaceae YAB2003 group;";"0.0";"0";"9";"8";"0";"8";"1";"430516";"5766"
"LOK1378_1mm";"SILVA (only NR);Bacteria;Bacteroidota;Bacteroidia;Bacteroidales;Prevotellaceae;uncultured;";"0.0";"0";"129";"128";"0";"128";"1";"430396";"5766"
"LOK1378_1mm";"SILVA (only NR);Bacteria;Bacteroidota;Bacteroidia;Bacteroidales;Prolixibacteraceae;";"0.0";"0";"755";"740";"0";"740";"15";"429784";"5766"
"LOK1378_1mm";"SILVA (only NR);Bacteria;Bacteroidota;Bacteroidia;Bacteroidales;Prolixibacteraceae;BSV13;";"0.0";"0";"86";"86";"0";"86";"0";"430438";"5766"
"LOK1378_1mm";"SILVA (only NR);Bacteria;Bacteroidota;Bacteroidia;Bacteroidales;Prolixibacteraceae;Draconibacterium;";"0.0";"0";"54";"54";"0";"54";"0";"430470";"5766"
"LOK1378_1mm";"SILVA (only NR);Bacteria;Bacteroidota;Bacteroidia;Bacteroidales;Prolixibacteraceae;Mangrovibacterium;";"0.0";"0";"4";"4";"0";"4";"0";"430520";"5766"
"LOK1378_1mm";"SILVA (only NR);Bacteria;Bacteroidota;Bacteroidia;Bacteroidales;Prolixibacteraceae;Mariniphaga;";"0.0";"0";"7";"7";"0";"7";"0";"430517";"5766"
"LOK1378_1mm";"SILVA (only NR);Bacteria;Bacteroidota;Bacteroidia;Bacteroidales;Prolixibacteraceae;Meniscus;";"0.0";"0";"17";"16";"0";"16";"1";"430508";"5766"
"LOK1378_1mm";"SILVA (only NR);Bacteria;Bacteroidota;Bacteroidia;Bacteroidales;Prolixibacteraceae;Prolixibacter;";"0.0";"0";"14";"14";"0";"14";"0";"430510";"5766"
"LOK1378_1mm";"SILVA (only NR);Bacteria;Bacteroidota;Bacteroidia;Bacteroidales;Prolixibacteraceae;Roseimarinus;";"0.0";"0";"81";"80";"0";"80";"1";"430444";"5766"
"LOK1378_1mm";"SILVA (only NR);Bacteria;Bacteroidota;Bacteroidia;Bacteroidales;Prolixibacteraceae;Sunxiuqinia;";"0.0";"0";"15";"15";"0";"15";"0";"430509";"5766"
"LOK1378_1mm";"SILVA (only NR);Bacteria;Bacteroidota;Bacteroidia;Bacteroidales;Prolixibacteraceae;Tangfeifania;";"0.0";"0";"27";"26";"0";"26";"1";"430498";"5766"
"LOK1378_1mm";"SILVA (only NR);Bacteria;Bacteroidota;Bacteroidia;Bacteroidales;Prolixibacteraceae;WCHB1-32;";"0.0";"0";"176";"170";"0";"170";"6";"430354";"5766"
"LOK1378_1mm";"SILVA (only NR);Bacteria;Bacteroidota;Bacteroidia;Bacteroidales;Prolixibacteraceae;uncultured;";"0.0";"0";"264";"258";"0";"258";"6";"430266";"5766"
"LOK1378_1mm";"SILVA (only NR);Bacteria;Bacteroidota;Bacteroidia;Bacteroidales;RH-aaj90h05;";"0.0";"0";"3";"3";"0";"3";"0";"430521";"5766"
"LOK1378_1mm";"SILVA (only NR);Bacteria;Bacteroidota;Bacteroidia;Bacteroidales;Rikenellaceae;";"0.0";"0";"2859";"2782";"0";"2782";"77";"427742";"5766"
"LOK1378_1mm";"SILVA (only NR);Bacteria;Bacteroidota;Bacteroidia;Bacteroidales;Rikenellaceae;Alistipes;";"0.0";"0";"554";"538";"0";"538";"16";"429986";"5766"
"LOK1378_1mm";"SILVA (only NR);Bacteria;Bacteroidota;Bacteroidia;Bacteroidales;Rikenellaceae;Anaerocella;";"0.0";"0";"19";"18";"0";"18";"1";"430506";"5766"
"LOK1378_1mm";"SILVA (only NR);Bacteria;Bacteroidota;Bacteroidia;Bacteroidales;Rikenellaceae;Bact-08;";"0.0";"0";"6";"5";"0";"5";"1";"430519";"5766"
"LOK1378_1mm";"SILVA (only NR);Bacteria;Bacteroidota;Bacteroidia;Bacteroidales;Rikenellaceae;DMER64;";"0.0";"0";"152";"147";"0";"147";"5";"430377";"5766"
"LOK1378_1mm";"SILVA (only NR);Bacteria;Bacteroidota;Bacteroidia;Bacteroidales;Rikenellaceae;M2PB4-61 termite group;";"0.0";"0";"22";"22";"0";"22";"0";"430502";"5766"
"LOK1378_1mm";"SILVA (only NR);Bacteria;Bacteroidota;Bacteroidia;Bacteroidales;Rikenellaceae;Mucinivorans;";"0.0";"0";"4";"4";"0";"4";"0";"430520";"5766"
"LOK1378_1mm";"SILVA (only NR);Bacteria;Bacteroidota;Bacteroidia;Bacteroidales;Rikenellaceae;Rikenella;";"0.0";"0";"39";"38";"0";"38";"1";"430486";"5766"
"LOK1378_1mm";"SILVA (only NR);Bacteria;Bacteroidota;Bacteroidia;Bacteroidales;Rikenellaceae;Rikenellaceae RC9 gut group;";"0.0";"0";"1613";"1586";"0";"1586";"27";"428938";"5766"
"LOK1378_1mm";"SILVA (only NR);Bacteria;Bacteroidota;Bacteroidia;Bacteroidales;Rikenellaceae;S50 wastewater-sludge group;";"0.0";"0";"5";"5";"0";"5";"0";"430519";"5766"
"LOK1378_1mm";"SILVA (only NR);Bacteria;Bacteroidota;Bacteroidia;Bacteroidales;Rikenellaceae;SP3-e08;";"0.0";"0";"19";"17";"0";"17";"2";"430507";"5766"
"LOK1378_1mm";"SILVA (only NR);Bacteria;Bacteroidota;Bacteroidia;Bacteroidales;Rikenellaceae;U29-B03;";"0.0";"0";"19";"19";"0";"19";"0";"430505";"5766"
"LOK1378_1mm";"SILVA (only NR);Bacteria;Bacteroidota;Bacteroidia;Bacteroidales;Rikenellaceae;dgA-11 gut group;";"0.0";"0";"45";"44";"0";"44";"1";"430480";"5766"
"LOK1378_1mm";"SILVA (only NR);Bacteria;Bacteroidota;Bacteroidia;Bacteroidales;Rikenellaceae;hoa5-07d05 gut group;";"0.0";"0";"12";"12";"0";"12";"0";"430512";"5766"
"LOK1378_1mm";"SILVA (only NR);Bacteria;Bacteroidota;Bacteroidia;Bacteroidales;Rikenellaceae;uncultured;";"0.0";"0";"343";"320";"0";"320";"23";"430204";"5766"
"LOK1378_1mm";"SILVA (only NR);Bacteria;Bacteroidota;Bacteroidia;Bacteroidales;Rs-E47 termite group;";"0.0";"0";"99";"98";"0";"98";"1";"430426";"5766"
"LOK1378_1mm";"SILVA (only NR);Bacteria;Bacteroidota;Bacteroidia;Bacteroidales;Rs-E47 termite group;GWE2-42-42;";"0.0";"0";"81";"80";"0";"80";"1";"430444";"5766"
"LOK1378_1mm";"SILVA (only NR);Bacteria;Bacteroidota;Bacteroidia;Bacteroidales;SB-5;";"0.0";"0";"383";"353";"0";"353";"30";"430171";"5766"
"LOK1378_1mm";"SILVA (only NR);Bacteria;Bacteroidota;Bacteroidia;Bacteroidales;Salinivirgaceae;";"0.0";"0";"179";"159";"0";"159";"20";"430365";"5766"
"LOK1378_1mm";"SILVA (only NR);Bacteria;Bacteroidota;Bacteroidia;Bacteroidales;Salinivirgaceae;Salinivirga;";"0.0";"0";"52";"48";"0";"48";"4";"430476";"5766"
"LOK1378_1mm";"SILVA (only NR);Bacteria;Bacteroidota;Bacteroidia;Bacteroidales;Salinivirgaceae;uncultured;";"0.0";"0";"127";"111";"0";"111";"16";"430413";"5766"
"LOK1378_1mm";"SILVA (only NR);Bacteria;Bacteroidota;Bacteroidia;Bacteroidales;Tannerellaceae;";"0.0";"0";"659";"644";"0";"644";"15";"429880";"5766"
"LOK1378_1mm";"SILVA (only NR);Bacteria;Bacteroidota;Bacteroidia;Bacteroidales;Tannerellaceae;Candidatus Vestibaculum;";"0.0";"0";"34";"34";"0";"34";"0";"430490";"5766"
"LOK1378_1mm";"SILVA (only NR);Bacteria;Bacteroidota;Bacteroidia;Bacteroidales;Tannerellaceae;Macellibacteroides;";"0.0";"0";"62";"61";"0";"61";"1";"430463";"5766"
"LOK1378_1mm";"SILVA (only NR);Bacteria;Bacteroidota;Bacteroidia;Bacteroidales;Tannerellaceae;Parabacteroides;";"0.0";"0";"460";"447";"0";"447";"13";"430077";"5766"
"LOK1378_1mm";"SILVA (only NR);Bacteria;Bacteroidota;Bacteroidia;Bacteroidales;Tannerellaceae;Tannerella;";"0.0";"0";"78";"77";"0";"77";"1";"430447";"5766"
"LOK1378_1mm";"SILVA (only NR);Bacteria;Bacteroidota;Bacteroidia;Bacteroidales;Tannerellaceae;uncultured;";"0.0";"0";"21";"21";"0";"21";"0";"430503";"5766"
"LOK1378_1mm";"SILVA (only NR);Bacteria;Bacteroidota;Bacteroidia;Bacteroidales;Williamwhitmaniaceae;";"0.0";"0";"152";"149";"0";"149";"3";"430375";"5766"
"LOK1378_1mm";"SILVA (only NR);Bacteria;Bacteroidota;Bacteroidia;Bacteroidales;Williamwhitmaniaceae;Acetobacteroides;";"0.0";"0";"14";"14";"0";"14";"0";"430510";"5766"
"LOK1378_1mm";"SILVA (only NR);Bacteria;Bacteroidota;Bacteroidia;Bacteroidales;Williamwhitmaniaceae;BCf9-17 termite group;";"0.0";"0";"26";"26";"0";"26";"0";"430498";"5766"
"LOK1378_1mm";"SILVA (only NR);Bacteria;Bacteroidota;Bacteroidia;Bacteroidales;Williamwhitmaniaceae;Blvii28 wastewater-sludge group;";"0.0";"0";"75";"72";"0";"72";"3";"430452";"5766"
"LOK1378_1mm";"SILVA (only NR);Bacteria;Bacteroidota;Bacteroidia;Bacteroidales;Williamwhitmaniaceae;Rs-D38 termite group;";"0.0";"0";"22";"22";"0";"22";"0";"430502";"5766"
"LOK1378_1mm";"SILVA (only NR);Bacteria;Bacteroidota;Bacteroidia;Bacteroidales;Williamwhitmaniaceae;Williamwhitmania;";"0.0";"0";"6";"6";"0";"6";"0";"430518";"5766"
"LOK1378_1mm";"SILVA (only NR);Bacteria;Bacteroidota;Bacteroidia;Bacteroidales;Williamwhitmaniaceae;uncultured;";"0.0";"0";"8";"8";"0";"8";"0";"430516";"5766"
"LOK1378_1mm";"SILVA (only NR);Bacteria;Bacteroidota;Bacteroidia;Bacteroidales;gir-aah93h0;";"0.0";"0";"6";"6";"0";"6";"0";"430518";"5766"
"LOK1378_1mm";"SILVA (only NR);Bacteria;Bacteroidota;Bacteroidia;Bacteroidales;p-251-o5;";"0.0";"0";"139";"135";"0";"135";"4";"430389";"5766"
"LOK1378_1mm";"SILVA (only NR);Bacteria;Bacteroidota;Bacteroidia;Bacteroidales;p-2534-18B5 gut group;";"0.0";"0";"32";"31";"0";"31";"1";"430493";"5766"
"LOK1378_1mm";"SILVA (only NR);Bacteria;Bacteroidota;Bacteroidia;Bacteroidales;uncultured;";"0.0";"0";"69";"67";"0";"67";"2";"430457";"5766"
"LOK1378_1mm";"SILVA (only NR);Bacteria;Bacteroidota;Bacteroidia;Bacteroidales;vadinHA21;";"0.0";"0";"8";"8";"0";"8";"0";"430516";"5766"
"LOK1378_1mm";"SILVA (only NR);Bacteria;Bacteroidota;Bacteroidia;Bacteroidetes VC2.1 Bac22;";"0.0";"0";"214";"198";"0";"198";"16";"430326";"5766"
"LOK1378_1mm";"SILVA (only NR);Bacteria;Bacteroidota;Bacteroidia;Chitinophagales;";"0.0";"0";"4399";"4243";"0";"4243";"156";"426281";"5766"
"LOK1378_1mm";"SILVA (only NR);Bacteria;Bacteroidota;Bacteroidia;Chitinophagales;37-13;";"0.0";"0";"66";"63";"0";"63";"3";"430461";"5766"
"LOK1378_1mm";"SILVA (only NR);Bacteria;Bacteroidota;Bacteroidia;Chitinophagales;Chitinophagaceae;";"0.0";"0";"2544";"2463";"0";"2463";"81";"428061";"5766"
"LOK1378_1mm";"SILVA (only NR);Bacteria;Bacteroidota;Bacteroidia;Chitinophagales;Chitinophagaceae;Arachidicoccus;";"0.0";"0";"18";"18";"0";"18";"0";"430506";"5766"
"LOK1378_1mm";"SILVA (only NR);Bacteria;Bacteroidota;Bacteroidia;Chitinophagales;Chitinophagaceae;Asinibacterium;";"0.0";"0";"8";"6";"0";"6";"2";"430518";"5766"
"LOK1378_1mm";"SILVA (only NR);Bacteria;Bacteroidota;Bacteroidia;Chitinophagales;Chitinophagaceae;Aurantisolimonas;";"0.0";"0";"61";"58";"0";"58";"3";"430466";"5766"
"LOK1378_1mm";"SILVA (only NR);Bacteria;Bacteroidota;Bacteroidia;Chitinophagales;Chitinophagaceae;Chitinophaga;";"0.0";"0";"175";"164";"0";"164";"11";"430360";"5766"
"LOK1378_1mm";"SILVA (only NR);Bacteria;Bacteroidota;Bacteroidia;Chitinophagales;Chitinophagaceae;Cnuella;";"0.0";"0";"32";"32";"0";"32";"0";"430492";"5766"
"LOK1378_1mm";"SILVA (only NR);Bacteria;Bacteroidota;Bacteroidia;Chitinophagales;Chitinophagaceae;Crenotalea;";"0.0";"0";"1";"1";"0";"1";"0";"430523";"5766"
"LOK1378_1mm";"SILVA (only NR);Bacteria;Bacteroidota;Bacteroidia;Chitinophagales;Chitinophagaceae;Dinghuibacter;";"0.0";"0";"57";"57";"0";"57";"0";"430467";"5766"
"LOK1378_1mm";"SILVA (only NR);Bacteria;Bacteroidota;Bacteroidia;Chitinophagales;Chitinophagaceae;Edaphobaculum;";"0.0";"0";"189";"184";"0";"184";"5";"430340";"5766"
"LOK1378_1mm";"SILVA (only NR);Bacteria;Bacteroidota;Bacteroidia;Chitinophagales;Chitinophagaceae;Ferruginibacter;";"0.0";"0";"308";"297";"0";"297";"11";"430227";"5766"
"LOK1378_1mm";"SILVA (only NR);Bacteria;Bacteroidota;Bacteroidia;Chitinophagales;Chitinophagaceae;Filimonas;";"0.0";"0";"22";"22";"0";"22";"0";"430502";"5766"
"LOK1378_1mm";"SILVA (only NR);Bacteria;Bacteroidota;Bacteroidia;Chitinophagales;Chitinophagaceae;Filobacterium;";"0.0";"0";"4";"2";"0";"2";"2";"430522";"5766"
"LOK1378_1mm";"SILVA (only NR);Bacteria;Bacteroidota;Bacteroidia;Chitinophagales;Chitinophagaceae;Flaviaesturariibacter;";"0.0";"0";"19";"19";"0";"19";"0";"430505";"5766"
"LOK1378_1mm";"SILVA (only NR);Bacteria;Bacteroidota;Bacteroidia;Chitinophagales;Chitinophagaceae;Flavihumibacter;";"0.0";"0";"24";"24";"0";"24";"0";"430500";"5766"
"LOK1378_1mm";"SILVA (only NR);Bacteria;Bacteroidota;Bacteroidia;Chitinophagales;Chitinophagaceae;Flavisolibacter;";"0.0";"0";"196";"189";"0";"189";"7";"430335";"5766"
"LOK1378_1mm";"SILVA (only NR);Bacteria;Bacteroidota;Bacteroidia;Chitinophagales;Chitinophagaceae;Flavitalea;";"0.0";"0";"46";"46";"0";"46";"0";"430478";"5766"
"LOK1378_1mm";"SILVA (only NR);Bacteria;Bacteroidota;Bacteroidia;Chitinophagales;Chitinophagaceae;Haoranjiania;";"0.0";"0";"6";"6";"0";"6";"0";"430518";"5766"
"LOK1378_1mm";"SILVA (only NR);Bacteria;Bacteroidota;Bacteroidia;Chitinophagales;Chitinophagaceae;Heliimonas;";"0.0";"0";"7";"6";"0";"6";"1";"430518";"5766"
"LOK1378_1mm";"SILVA (only NR);Bacteria;Bacteroidota;Bacteroidia;Chitinophagales;Chitinophagaceae;Hydrobacter;";"0.0";"0";"2";"1";"0";"1";"1";"430523";"5766"
"LOK1378_1mm";"SILVA (only NR);Bacteria;Bacteroidota;Bacteroidia;Chitinophagales;Chitinophagaceae;Hydrotalea;";"0.0";"0";"8";"7";"0";"7";"1";"430517";"5766"
"LOK1378_1mm";"SILVA (only NR);Bacteria;Bacteroidota;Bacteroidia;Chitinophagales;Chitinophagaceae;Lacibacter;";"0.0";"0";"16";"16";"0";"16";"0";"430508";"5766"
"LOK1378_1mm";"SILVA (only NR);Bacteria;Bacteroidota;Bacteroidia;Chitinophagales;Chitinophagaceae;Niabella;";"0.0";"0";"60";"59";"0";"59";"1";"430465";"5766"
"LOK1378_1mm";"SILVA (only NR);Bacteria;Bacteroidota;Bacteroidia;Chitinophagales;Chitinophagaceae;Niastella;";"0.0";"0";"57";"56";"0";"56";"1";"430468";"5766"
"LOK1378_1mm";"SILVA (only NR);Bacteria;Bacteroidota;Bacteroidia;Chitinophagales;Chitinophagaceae;Niveitalea;";"0.0";"0";"1";"1";"0";"1";"0";"430523";"5766"
"LOK1378_1mm";"SILVA (only NR);Bacteria;Bacteroidota;Bacteroidia;Chitinophagales;Chitinophagaceae;Parafilimonas;";"0.0";"0";"20";"19";"0";"19";"1";"430505";"5766"
"LOK1378_1mm";"SILVA (only NR);Bacteria;Bacteroidota;Bacteroidia;Chitinophagales;Chitinophagaceae;Parasediminibacterium;";"0.0";"0";"11";"10";"0";"10";"1";"430514";"5766"
"LOK1378_1mm";"SILVA (only NR);Bacteria;Bacteroidota;Bacteroidia;Chitinophagales;Chitinophagaceae;Parasegetibacter;";"0.0";"0";"17";"17";"0";"17";"0";"430507";"5766"
"LOK1378_1mm";"SILVA (only NR);Bacteria;Bacteroidota;Bacteroidia;Chitinophagales;Chitinophagaceae;Pseudoflavitalea;";"0.0";"0";"24";"23";"0";"23";"1";"430501";"5766"
"LOK1378_1mm";"SILVA (only NR);Bacteria;Bacteroidota;Bacteroidia;Chitinophagales;Chitinophagaceae;Puia;";"0.0";"0";"79";"77";"0";"77";"2";"430447";"5766"
"LOK1378_1mm";"SILVA (only NR);Bacteria;Bacteroidota;Bacteroidia;Chitinophagales;Chitinophagaceae;Rurimicrobium;";"0.0";"0";"6";"6";"0";"6";"0";"430518";"5766"
"LOK1378_1mm";"SILVA (only NR);Bacteria;Bacteroidota;Bacteroidia;Chitinophagales;Chitinophagaceae;Sediminibacterium;";"0.0";"0";"95";"92";"0";"92";"3";"430432";"5766"
"LOK1378_1mm";"SILVA (only NR);Bacteria;Bacteroidota;Bacteroidia;Chitinophagales;Chitinophagaceae;Segetibacter;";"0.0";"0";"128";"121";"0";"121";"7";"430403";"5766"
"LOK1378_1mm";"SILVA (only NR);Bacteria;Bacteroidota;Bacteroidia;Chitinophagales;Chitinophagaceae;Taibaiella;";"0.0";"0";"99";"99";"0";"99";"0";"430425";"5766"
"LOK1378_1mm";"SILVA (only NR);Bacteria;Bacteroidota;Bacteroidia;Chitinophagales;Chitinophagaceae;Terrimonas;";"0.0";"0";"211";"204";"0";"204";"7";"430320";"5766"
"LOK1378_1mm";"SILVA (only NR);Bacteria;Bacteroidota;Bacteroidia;Chitinophagales;Chitinophagaceae;Thermoflavifilum;";"0.0";"0";"4";"4";"0";"4";"0";"430520";"5766"
"LOK1378_1mm";"SILVA (only NR);Bacteria;Bacteroidota;Bacteroidia;Chitinophagales;Chitinophagaceae;UTBCD1;";"0.0";"0";"13";"11";"0";"11";"2";"430513";"5766"
"LOK1378_1mm";"SILVA (only NR);Bacteria;Bacteroidota;Bacteroidia;Chitinophagales;Chitinophagaceae;Vibrionimonas;";"0.0";"0";"5";"5";"0";"5";"0";"430519";"5766"
"LOK1378_1mm";"SILVA (only NR);Bacteria;Bacteroidota;Bacteroidia;Chitinophagales;Chitinophagaceae;uncultured;";"0.0";"0";"505";"494";"0";"494";"11";"430030";"5766"
"LOK1378_1mm";"SILVA (only NR);Bacteria;Bacteroidota;Bacteroidia;Chitinophagales;Saprospiraceae;";"0.0";"0";"1415";"1361";"0";"1361";"54";"429163";"5766"
"LOK1378_1mm";"SILVA (only NR);Bacteria;Bacteroidota;Bacteroidia;Chitinophagales;Saprospiraceae;Aureispira;";"0.0";"0";"27";"27";"0";"27";"0";"430497";"5766"
"LOK1378_1mm";"SILVA (only NR);Bacteria;Bacteroidota;Bacteroidia;Chitinophagales;Saprospiraceae;Candidatus Aquirestis;";"0.0";"0";"27";"27";"0";"27";"0";"430497";"5766"
"LOK1378_1mm";"SILVA (only NR);Bacteria;Bacteroidota;Bacteroidia;Chitinophagales;Saprospiraceae;Haliscomenobacter;";"0.0";"0";"34";"34";"0";"34";"0";"430490";"5766"
"LOK1378_1mm";"SILVA (only NR);Bacteria;Bacteroidota;Bacteroidia;Chitinophagales;Saprospiraceae;Lewinella;";"0.0";"0";"136";"133";"0";"133";"3";"430391";"5766"
"LOK1378_1mm";"SILVA (only NR);Bacteria;Bacteroidota;Bacteroidia;Chitinophagales;Saprospiraceae;Membranicola;";"0.0";"0";"21";"21";"0";"21";"0";"430503";"5766"
"LOK1378_1mm";"SILVA (only NR);Bacteria;Bacteroidota;Bacteroidia;Chitinophagales;Saprospiraceae;OLB8;";"0.0";"0";"18";"17";"0";"17";"1";"430507";"5766"
"LOK1378_1mm";"SILVA (only NR);Bacteria;Bacteroidota;Bacteroidia;Chitinophagales;Saprospiraceae;Phaeodactylibacter;";"0.0";"0";"179";"158";"0";"158";"21";"430366";"5766"
"LOK1378_1mm";"SILVA (only NR);Bacteria;Bacteroidota;Bacteroidia;Chitinophagales;Saprospiraceae;Portibacter;";"0.0";"0";"34";"34";"0";"34";"0";"430490";"5766"
"LOK1378_1mm";"SILVA (only NR);Bacteria;Bacteroidota;Bacteroidia;Chitinophagales;Saprospiraceae;Rubidimonas;";"0.0";"0";"18";"16";"0";"16";"2";"430508";"5766"
"LOK1378_1mm";"SILVA (only NR);Bacteria;Bacteroidota;Bacteroidia;Chitinophagales;Saprospiraceae;Saprospira;";"0.0";"0";"12";"12";"0";"12";"0";"430512";"5766"
"LOK1378_1mm";"SILVA (only NR);Bacteria;Bacteroidota;Bacteroidia;Chitinophagales;Saprospiraceae;uncultured;";"0.0";"0";"909";"882";"0";"882";"27";"429642";"5766"
"LOK1378_1mm";"SILVA (only NR);Bacteria;Bacteroidota;Bacteroidia;Chitinophagales;uncultured;";"0.0";"0";"374";"356";"0";"356";"18";"430168";"5766"
"LOK1378_1mm";"SILVA (only NR);Bacteria;Bacteroidota;Bacteroidia;Cytophagales;";"0.0";"0";"3573";"3473";"0";"3473";"100";"427051";"5766"
"LOK1378_1mm";"SILVA (only NR);Bacteria;Bacteroidota;Bacteroidia;Cytophagales;Amoebophilaceae;";"0.0";"0";"135";"129";"0";"129";"6";"430395";"5766"
"LOK1378_1mm";"SILVA (only NR);Bacteria;Bacteroidota;Bacteroidia;Cytophagales;Amoebophilaceae;Candidatus Amoebophilus;";"0.0";"0";"60";"59";"0";"59";"1";"430465";"5766"
"LOK1378_1mm";"SILVA (only NR);Bacteria;Bacteroidota;Bacteroidia;Cytophagales;Amoebophilaceae;Candidatus Cardinium;";"0.0";"0";"23";"22";"0";"22";"1";"430502";"5766"
"LOK1378_1mm";"SILVA (only NR);Bacteria;Bacteroidota;Bacteroidia;Cytophagales;Amoebophilaceae;Candidatus Paenicardinium;";"0.0";"0";"6";"2";"0";"2";"4";"430522";"5766"
"LOK1378_1mm";"SILVA (only NR);Bacteria;Bacteroidota;Bacteroidia;Cytophagales;Amoebophilaceae;uncultured;";"0.0";"0";"43";"43";"0";"43";"0";"430481";"5766"
"LOK1378_1mm";"SILVA (only NR);Bacteria;Bacteroidota;Bacteroidia;Cytophagales;Bernardetiaceae;";"0.0";"0";"13";"13";"0";"13";"0";"430511";"5766"
"LOK1378_1mm";"SILVA (only NR);Bacteria;Bacteroidota;Bacteroidia;Cytophagales;Bernardetiaceae;Bernardetia;";"0.0";"0";"3";"3";"0";"3";"0";"430521";"5766"
"LOK1378_1mm";"SILVA (only NR);Bacteria;Bacteroidota;Bacteroidia;Cytophagales;Bernardetiaceae;Garritya;";"0.0";"0";"2";"2";"0";"2";"0";"430522";"5766"
"LOK1378_1mm";"SILVA (only NR);Bacteria;Bacteroidota;Bacteroidia;Cytophagales;Bernardetiaceae;Hugenholtzia;";"0.0";"0";"5";"5";"0";"5";"0";"430519";"5766"
"LOK1378_1mm";"SILVA (only NR);Bacteria;Bacteroidota;Bacteroidia;Cytophagales;Bernardetiaceae;uncultured;";"0.0";"0";"3";"3";"0";"3";"0";"430521";"5766"
"LOK1378_1mm";"SILVA (only NR);Bacteria;Bacteroidota;Bacteroidia;Cytophagales;Cyclobacteriaceae;";"0.0";"0";"953";"934";"0";"934";"19";"429590";"5766"
"LOK1378_1mm";"SILVA (only NR);Bacteria;Bacteroidota;Bacteroidia;Cytophagales;Cyclobacteriaceae;Algoriphagus;";"0.0";"0";"165";"163";"0";"163";"2";"430361";"5766"
"LOK1378_1mm";"SILVA (only NR);Bacteria;Bacteroidota;Bacteroidia;Cytophagales;Cyclobacteriaceae;Anditalea;";"0.0";"0";"2";"2";"0";"2";"0";"430522";"5766"
"LOK1378_1mm";"SILVA (only NR);Bacteria;Bacteroidota;Bacteroidia;Cytophagales;Cyclobacteriaceae;Aquiflexum;";"0.0";"0";"14";"14";"0";"14";"0";"430510";"5766"
"LOK1378_1mm";"SILVA (only NR);Bacteria;Bacteroidota;Bacteroidia;Cytophagales;Cyclobacteriaceae;Aureibacter;";"0.0";"0";"1";"1";"0";"1";"0";"430523";"5766"
"LOK1378_1mm";"SILVA (only NR);Bacteria;Bacteroidota;Bacteroidia;Cytophagales;Cyclobacteriaceae;Belliella;";"0.0";"0";"12";"12";"0";"12";"0";"430512";"5766"
"LOK1378_1mm";"SILVA (only NR);Bacteria;Bacteroidota;Bacteroidia;Cytophagales;Cyclobacteriaceae;Catalinimonas;";"0.0";"0";"12";"12";"0";"12";"0";"430512";"5766"
"LOK1378_1mm";"SILVA (only NR);Bacteria;Bacteroidota;Bacteroidia;Cytophagales;Cyclobacteriaceae;Cecembia;";"0.0";"0";"6";"6";"0";"6";"0";"430518";"5766"
"LOK1378_1mm";"SILVA (only NR);Bacteria;Bacteroidota;Bacteroidia;Cytophagales;Cyclobacteriaceae;Cesiribacter;";"0.0";"0";"11";"11";"0";"11";"0";"430513";"5766"
"LOK1378_1mm";"SILVA (only NR);Bacteria;Bacteroidota;Bacteroidia;Cytophagales;Cyclobacteriaceae;Cyclobacterium;";"0.0";"0";"34";"32";"0";"32";"2";"430492";"5766"
"LOK1378_1mm";"SILVA (only NR);Bacteria;Bacteroidota;Bacteroidia;Cytophagales;Cyclobacteriaceae;Echinicola;";"0.0";"0";"15";"15";"0";"15";"0";"430509";"5766"
"LOK1378_1mm";"SILVA (only NR);Bacteria;Bacteroidota;Bacteroidia;Cytophagales;Cyclobacteriaceae;Ekhidna;";"0.0";"0";"34";"33";"0";"33";"1";"430491";"5766"
"LOK1378_1mm";"SILVA (only NR);Bacteria;Bacteroidota;Bacteroidia;Cytophagales;Cyclobacteriaceae;Fabibacter;";"0.0";"0";"24";"22";"0";"22";"2";"430502";"5766"
"LOK1378_1mm";"SILVA (only NR);Bacteria;Bacteroidota;Bacteroidia;Cytophagales;Cyclobacteriaceae;Fontibacter;";"0.0";"0";"3";"3";"0";"3";"0";"430521";"5766"
"LOK1378_1mm";"SILVA (only NR);Bacteria;Bacteroidota;Bacteroidia;Cytophagales;Cyclobacteriaceae;Fulvitalea;";"0.0";"0";"1";"0";"0";"0";"1";"430524";"5766"
"LOK1378_1mm";"SILVA (only NR);Bacteria;Bacteroidota;Bacteroidia;Cytophagales;Cyclobacteriaceae;Fulvivirga;";"0.0";"0";"42";"41";"0";"41";"1";"430483";"5766"
"LOK1378_1mm";"SILVA (only NR);Bacteria;Bacteroidota;Bacteroidia;Cytophagales;Cyclobacteriaceae;Imperialibacter;";"0.0";"0";"20";"20";"0";"20";"0";"430504";"5766"
"LOK1378_1mm";"SILVA (only NR);Bacteria;Bacteroidota;Bacteroidia;Cytophagales;Cyclobacteriaceae;Indibacter;";"0.0";"0";"4";"4";"0";"4";"0";"430520";"5766"
"LOK1378_1mm";"SILVA (only NR);Bacteria;Bacteroidota;Bacteroidia;Cytophagales;Cyclobacteriaceae;Litoribacter;";"0.0";"0";"2";"2";"0";"2";"0";"430522";"5766"
"LOK1378_1mm";"SILVA (only NR);Bacteria;Bacteroidota;Bacteroidia;Cytophagales;Cyclobacteriaceae;Lunatimonas;";"0.0";"0";"4";"4";"0";"4";"0";"430520";"5766"
"LOK1378_1mm";"SILVA (only NR);Bacteria;Bacteroidota;Bacteroidia;Cytophagales;Cyclobacteriaceae;Mariniradius;";"0.0";"0";"4";"4";"0";"4";"0";"430520";"5766"
"LOK1378_1mm";"SILVA (only NR);Bacteria;Bacteroidota;Bacteroidia;Cytophagales;Cyclobacteriaceae;Marinoscillum;";"0.0";"0";"75";"75";"0";"75";"0";"430449";"5766"
"LOK1378_1mm";"SILVA (only NR);Bacteria;Bacteroidota;Bacteroidia;Cytophagales;Cyclobacteriaceae;Marivirga;";"0.0";"0";"26";"26";"0";"26";"0";"430498";"5766"
"LOK1378_1mm";"SILVA (only NR);Bacteria;Bacteroidota;Bacteroidia;Cytophagales;Cyclobacteriaceae;Mongoliibacter;";"0.0";"0";"1";"1";"0";"1";"0";"430523";"5766"
"LOK1378_1mm";"SILVA (only NR);Bacteria;Bacteroidota;Bacteroidia;Cytophagales;Cyclobacteriaceae;Mongoliicoccus;";"0.0";"0";"4";"4";"0";"4";"0";"430520";"5766"
"LOK1378_1mm";"SILVA (only NR);Bacteria;Bacteroidota;Bacteroidia;Cytophagales;Cyclobacteriaceae;Mongoliitalea;";"0.0";"0";"5";"5";"0";"5";"0";"430519";"5766"
"LOK1378_1mm";"SILVA (only NR);Bacteria;Bacteroidota;Bacteroidia;Cytophagales;Cyclobacteriaceae;Nafulsella;";"0.0";"0";"3";"3";"0";"3";"0";"430521";"5766"
"LOK1378_1mm";"SILVA (only NR);Bacteria;Bacteroidota;Bacteroidia;Cytophagales;Cyclobacteriaceae;Negadavirga;";"0.0";"0";"2";"2";"0";"2";"0";"430522";"5766"
"LOK1378_1mm";"SILVA (only NR);Bacteria;Bacteroidota;Bacteroidia;Cytophagales;Cyclobacteriaceae;Nitritalea;";"0.0";"0";"2";"2";"0";"2";"0";"430522";"5766"
"LOK1378_1mm";"SILVA (only NR);Bacteria;Bacteroidota;Bacteroidia;Cytophagales;Cyclobacteriaceae;Persicobacter;";"0.0";"0";"7";"6";"0";"6";"1";"430518";"5766"
"LOK1378_1mm";"SILVA (only NR);Bacteria;Bacteroidota;Bacteroidia;Cytophagales;Cyclobacteriaceae;Reichenbachiella;";"0.0";"0";"26";"26";"0";"26";"0";"430498";"5766"
"LOK1378_1mm";"SILVA (only NR);Bacteria;Bacteroidota;Bacteroidia;Cytophagales;Cyclobacteriaceae;Rhodonellum;";"0.0";"0";"2";"2";"0";"2";"0";"430522";"5766"
"LOK1378_1mm";"SILVA (only NR);Bacteria;Bacteroidota;Bacteroidia;Cytophagales;Cyclobacteriaceae;Roseivirga;";"0.0";"0";"14";"14";"0";"14";"0";"430510";"5766"
"LOK1378_1mm";"SILVA (only NR);Bacteria;Bacteroidota;Bacteroidia;Cytophagales;Cyclobacteriaceae;Shivajiella;";"0.0";"0";"3";"3";"0";"3";"0";"430521";"5766"
"LOK1378_1mm";"SILVA (only NR);Bacteria;Bacteroidota;Bacteroidia;Cytophagales;Cyclobacteriaceae;Tunicatimonas;";"0.0";"0";"13";"11";"0";"11";"2";"430513";"5766"
"LOK1378_1mm";"SILVA (only NR);Bacteria;Bacteroidota;Bacteroidia;Cytophagales;Cyclobacteriaceae;uncultured;";"0.0";"0";"345";"338";"0";"338";"7";"430186";"5766"
"LOK1378_1mm";"SILVA (only NR);Bacteria;Bacteroidota;Bacteroidia;Cytophagales;Cytophagaceae;";"0.0";"0";"130";"123";"0";"123";"7";"430401";"5766"
"LOK1378_1mm";"SILVA (only NR);Bacteria;Bacteroidota;Bacteroidia;Cytophagales;Cytophagaceae;Cytophaga;";"0.0";"0";"51";"48";"0";"48";"3";"430476";"5766"
"LOK1378_1mm";"SILVA (only NR);Bacteria;Bacteroidota;Bacteroidia;Cytophagales;Cytophagaceae;Rhodocytophaga;";"0.0";"0";"30";"30";"0";"30";"0";"430494";"5766"
"LOK1378_1mm";"SILVA (only NR);Bacteria;Bacteroidota;Bacteroidia;Cytophagales;Cytophagaceae;Siphonobacter;";"0.0";"0";"9";"8";"0";"8";"1";"430516";"5766"
"LOK1378_1mm";"SILVA (only NR);Bacteria;Bacteroidota;Bacteroidia;Cytophagales;Cytophagaceae;Sporocytophaga;";"0.0";"0";"36";"34";"0";"34";"2";"430490";"5766"
"LOK1378_1mm";"SILVA (only NR);Bacteria;Bacteroidota;Bacteroidia;Cytophagales;Cytophagaceae;uncultured;";"0.0";"0";"3";"2";"0";"2";"1";"430522";"5766"
"LOK1378_1mm";"SILVA (only NR);Bacteria;Bacteroidota;Bacteroidia;Cytophagales;Flammeovirgaceae;";"0.0";"0";"97";"96";"0";"96";"1";"430428";"5766"
"LOK1378_1mm";"SILVA (only NR);Bacteria;Bacteroidota;Bacteroidia;Cytophagales;Flammeovirgaceae;Algivirga;";"0.0";"0";"3";"3";"0";"3";"0";"430521";"5766"
"LOK1378_1mm";"SILVA (only NR);Bacteria;Bacteroidota;Bacteroidia;Cytophagales;Flammeovirgaceae;Flammeovirga;";"0.0";"0";"36";"36";"0";"36";"0";"430488";"5766"
"LOK1378_1mm";"SILVA (only NR);Bacteria;Bacteroidota;Bacteroidia;Cytophagales;Flammeovirgaceae;Flexithrix;";"0.0";"0";"26";"26";"0";"26";"0";"430498";"5766"
"LOK1378_1mm";"SILVA (only NR);Bacteria;Bacteroidota;Bacteroidia;Cytophagales;Flammeovirgaceae;Limibacter;";"0.0";"0";"2";"2";"0";"2";"0";"430522";"5766"
"LOK1378_1mm";"SILVA (only NR);Bacteria;Bacteroidota;Bacteroidia;Cytophagales;Flammeovirgaceae;Luteivirga;";"0.0";"0";"8";"7";"0";"7";"1";"430517";"5766"
"LOK1378_1mm";"SILVA (only NR);Bacteria;Bacteroidota;Bacteroidia;Cytophagales;Flammeovirgaceae;Perexilibacter;";"0.0";"0";"3";"3";"0";"3";"0";"430521";"5766"
"LOK1378_1mm";"SILVA (only NR);Bacteria;Bacteroidota;Bacteroidia;Cytophagales;Flammeovirgaceae;Rapidithrix;";"0.0";"0";"10";"10";"0";"10";"0";"430514";"5766"
"LOK1378_1mm";"SILVA (only NR);Bacteria;Bacteroidota;Bacteroidia;Cytophagales;Flammeovirgaceae;Sediminitomix;";"0.0";"0";"2";"2";"0";"2";"0";"430522";"5766"
"LOK1378_1mm";"SILVA (only NR);Bacteria;Bacteroidota;Bacteroidia;Cytophagales;Flammeovirgaceae;uncultured;";"0.0";"0";"6";"6";"0";"6";"0";"430518";"5766"
"LOK1378_1mm";"SILVA (only NR);Bacteria;Bacteroidota;Bacteroidia;Cytophagales;Hymenobacteraceae;";"0.0";"0";"898";"879";"0";"879";"19";"429645";"5766"
"LOK1378_1mm";"SILVA (only NR);Bacteria;Bacteroidota;Bacteroidia;Cytophagales;Hymenobacteraceae;Adhaeribacter;";"0.0";"0";"118";"113";"0";"113";"5";"430411";"5766"
"LOK1378_1mm";"SILVA (only NR);Bacteria;Bacteroidota;Bacteroidia;Cytophagales;Hymenobacteraceae;Hymenobacter;";"0.0";"0";"567";"555";"0";"555";"12";"429969";"5766"
"LOK1378_1mm";"SILVA (only NR);Bacteria;Bacteroidota;Bacteroidia;Cytophagales;Hymenobacteraceae;Nibribacter;";"0.0";"0";"21";"21";"0";"21";"0";"430503";"5766"
"LOK1378_1mm";"SILVA (only NR);Bacteria;Bacteroidota;Bacteroidia;Cytophagales;Hymenobacteraceae;Pontibacter;";"0.0";"0";"169";"167";"0";"167";"2";"430357";"5766"
"LOK1378_1mm";"SILVA (only NR);Bacteria;Bacteroidota;Bacteroidia;Cytophagales;Hymenobacteraceae;Rufibacter;";"0.0";"0";"23";"23";"0";"23";"0";"430501";"5766"
"LOK1378_1mm";"SILVA (only NR);Bacteria;Bacteroidota;Bacteroidia;Cytophagales;MWH-CFBk5;";"0.0";"0";"40";"40";"0";"40";"0";"430484";"5766"
"LOK1378_1mm";"SILVA (only NR);Bacteria;Bacteroidota;Bacteroidia;Cytophagales;Microscillaceae;";"0.0";"0";"660";"633";"0";"633";"27";"429891";"5766"
"LOK1378_1mm";"SILVA (only NR);Bacteria;Bacteroidota;Bacteroidia;Cytophagales;Microscillaceae;Chryseolinea;";"0.0";"0";"65";"62";"0";"62";"3";"430462";"5766"
"LOK1378_1mm";"SILVA (only NR);Bacteria;Bacteroidota;Bacteroidia;Cytophagales;Microscillaceae;Eisenibacter;";"0.0";"0";"7";"6";"0";"6";"1";"430518";"5766"
"LOK1378_1mm";"SILVA (only NR);Bacteria;Bacteroidota;Bacteroidia;Cytophagales;Microscillaceae;Flexibacter;";"0.0";"0";"17";"17";"0";"17";"0";"430507";"5766"
"LOK1378_1mm";"SILVA (only NR);Bacteria;Bacteroidota;Bacteroidia;Cytophagales;Microscillaceae;Hassallia;";"0.0";"0";"57";"55";"0";"55";"2";"430469";"5766"
"LOK1378_1mm";"SILVA (only NR);Bacteria;Bacteroidota;Bacteroidia;Cytophagales;Microscillaceae;Microscilla;";"0.0";"0";"12";"12";"0";"12";"0";"430512";"5766"
"LOK1378_1mm";"SILVA (only NR);Bacteria;Bacteroidota;Bacteroidia;Cytophagales;Microscillaceae;OLB12;";"0.0";"0";"36";"35";"0";"35";"1";"430489";"5766"
"LOK1378_1mm";"SILVA (only NR);Bacteria;Bacteroidota;Bacteroidia;Cytophagales;Microscillaceae;Ohtaekwangia;";"0.0";"0";"53";"51";"0";"51";"2";"430473";"5766"
"LOK1378_1mm";"SILVA (only NR);Bacteria;Bacteroidota;Bacteroidia;Cytophagales;Microscillaceae;Thermoflexibacter;";"0.0";"0";"7";"5";"0";"5";"2";"430519";"5766"
"LOK1378_1mm";"SILVA (only NR);Bacteria;Bacteroidota;Bacteroidia;Cytophagales;Microscillaceae;uncultured;";"0.0";"0";"404";"388";"0";"388";"16";"430136";"5766"
"LOK1378_1mm";"SILVA (only NR);Bacteria;Bacteroidota;Bacteroidia;Cytophagales;Mooreiaceae;";"0.0";"0";"3";"3";"0";"3";"0";"430521";"5766"
"LOK1378_1mm";"SILVA (only NR);Bacteria;Bacteroidota;Bacteroidia;Cytophagales;Mooreiaceae;Mooreia;";"0.0";"0";"3";"3";"0";"3";"0";"430521";"5766"
"LOK1378_1mm";"SILVA (only NR);Bacteria;Bacteroidota;Bacteroidia;Cytophagales;Raineyaceae;";"0.0";"0";"16";"16";"0";"16";"0";"430508";"5766"
"LOK1378_1mm";"SILVA (only NR);Bacteria;Bacteroidota;Bacteroidia;Cytophagales;Raineyaceae;Raineya;";"0.0";"0";"16";"16";"0";"16";"0";"430508";"5766"
"LOK1378_1mm";"SILVA (only NR);Bacteria;Bacteroidota;Bacteroidia;Cytophagales;Spirosomaceae;";"0.0";"0";"603";"583";"0";"583";"20";"429941";"5766"
"LOK1378_1mm";"SILVA (only NR);Bacteria;Bacteroidota;Bacteroidia;Cytophagales;Spirosomaceae;Arcicella;";"0.0";"0";"44";"43";"0";"43";"1";"430481";"5766"
"LOK1378_1mm";"SILVA (only NR);Bacteria;Bacteroidota;Bacteroidia;Cytophagales;Spirosomaceae;Arsenicibacter;";"0.0";"0";"3";"3";"0";"3";"0";"430521";"5766"
"LOK1378_1mm";"SILVA (only NR);Bacteria;Bacteroidota;Bacteroidia;Cytophagales;Spirosomaceae;Dyadobacter;";"0.0";"0";"133";"129";"0";"129";"4";"430395";"5766"
"LOK1378_1mm";"SILVA (only NR);Bacteria;Bacteroidota;Bacteroidia;Cytophagales;Spirosomaceae;Emticicia;";"0.0";"0";"31";"31";"0";"31";"0";"430493";"5766"
"LOK1378_1mm";"SILVA (only NR);Bacteria;Bacteroidota;Bacteroidia;Cytophagales;Spirosomaceae;Fibrella;";"0.0";"0";"13";"12";"0";"12";"1";"430512";"5766"
"LOK1378_1mm";"SILVA (only NR);Bacteria;Bacteroidota;Bacteroidia;Cytophagales;Spirosomaceae;Fibrisoma;";"0.0";"0";"9";"9";"0";"9";"0";"430515";"5766"
"LOK1378_1mm";"SILVA (only NR);Bacteria;Bacteroidota;Bacteroidia;Cytophagales;Spirosomaceae;Flectobacillus;";"0.0";"0";"19";"18";"0";"18";"1";"430506";"5766"
"LOK1378_1mm";"SILVA (only NR);Bacteria;Bacteroidota;Bacteroidia;Cytophagales;Spirosomaceae;Fluviimonas;";"0.0";"0";"3";"2";"0";"2";"1";"430522";"5766"
"LOK1378_1mm";"SILVA (only NR);Bacteria;Bacteroidota;Bacteroidia;Cytophagales;Spirosomaceae;Huanghella;";"0.0";"0";"1";"1";"0";"1";"0";"430523";"5766"
"LOK1378_1mm";"SILVA (only NR);Bacteria;Bacteroidota;Bacteroidia;Cytophagales;Spirosomaceae;Lacihabitans;";"0.0";"0";"20";"19";"0";"19";"1";"430505";"5766"
"LOK1378_1mm";"SILVA (only NR);Bacteria;Bacteroidota;Bacteroidia;Cytophagales;Spirosomaceae;Larkinella;";"0.0";"0";"26";"26";"0";"26";"0";"430498";"5766"
"LOK1378_1mm";"SILVA (only NR);Bacteria;Bacteroidota;Bacteroidia;Cytophagales;Spirosomaceae;Leadbetterella;";"0.0";"0";"19";"19";"0";"19";"0";"430505";"5766"
"LOK1378_1mm";"SILVA (only NR);Bacteria;Bacteroidota;Bacteroidia;Cytophagales;Spirosomaceae;Nibrella;";"0.0";"0";"5";"5";"0";"5";"0";"430519";"5766"
"LOK1378_1mm";"SILVA (only NR);Bacteria;Bacteroidota;Bacteroidia;Cytophagales;Spirosomaceae;Persicitalea;";"0.0";"0";"17";"17";"0";"17";"0";"430507";"5766"
"LOK1378_1mm";"SILVA (only NR);Bacteria;Bacteroidota;Bacteroidia;Cytophagales;Spirosomaceae;Pseudarcicella;";"0.0";"0";"30";"30";"0";"30";"0";"430494";"5766"
"LOK1378_1mm";"SILVA (only NR);Bacteria;Bacteroidota;Bacteroidia;Cytophagales;Spirosomaceae;Rhabdobacter;";"0.0";"0";"6";"6";"0";"6";"0";"430518";"5766"
"LOK1378_1mm";"SILVA (only NR);Bacteria;Bacteroidota;Bacteroidia;Cytophagales;Spirosomaceae;Rudanella;";"0.0";"0";"4";"4";"0";"4";"0";"430520";"5766"
"LOK1378_1mm";"SILVA (only NR);Bacteria;Bacteroidota;Bacteroidia;Cytophagales;Spirosomaceae;Runella;";"0.0";"0";"36";"36";"0";"36";"0";"430488";"5766"
"LOK1378_1mm";"SILVA (only NR);Bacteria;Bacteroidota;Bacteroidia;Cytophagales;Spirosomaceae;Spirosoma;";"0.0";"0";"129";"119";"0";"119";"10";"430405";"5766"
"LOK1378_1mm";"SILVA (only NR);Bacteria;Bacteroidota;Bacteroidia;Cytophagales;Spirosomaceae;Taeseokella;";"0.0";"0";"7";"7";"0";"7";"0";"430517";"5766"
"LOK1378_1mm";"SILVA (only NR);Bacteria;Bacteroidota;Bacteroidia;Cytophagales;Spirosomaceae;uncultured;";"0.0";"0";"42";"41";"0";"41";"1";"430483";"5766"
"LOK1378_1mm";"SILVA (only NR);Bacteria;Bacteroidota;Bacteroidia;Cytophagales;Thermonemataceae;";"0.0";"0";"5";"5";"0";"5";"0";"430519";"5766"
"LOK1378_1mm";"SILVA (only NR);Bacteria;Bacteroidota;Bacteroidia;Cytophagales;Thermonemataceae;Thermonema;";"0.0";"0";"5";"5";"0";"5";"0";"430519";"5766"
"LOK1378_1mm";"SILVA (only NR);Bacteria;Bacteroidota;Bacteroidia;Cytophagales;uncultured;";"0.0";"0";"19";"18";"0";"18";"1";"430506";"5766"
"LOK1378_1mm";"SILVA (only NR);Bacteria;Bacteroidota;Bacteroidia;Flavobacteriales;";"0.0";"0";"9773";"9406";"0";"9406";"367";"421118";"5766"
"LOK1378_1mm";"SILVA (only NR);Bacteria;Bacteroidota;Bacteroidia;Flavobacteriales;Blattabacteriaceae;";"0.0";"0";"267";"197";"0";"197";"70";"430327";"5766"
"LOK1378_1mm";"SILVA (only NR);Bacteria;Bacteroidota;Bacteroidia;Flavobacteriales;Blattabacteriaceae;Blattabacterium;";"0.0";"0";"46";"32";"0";"32";"14";"430492";"5766"
"LOK1378_1mm";"SILVA (only NR);Bacteria;Bacteroidota;Bacteroidia;Flavobacteriales;Blattabacteriaceae;Candidatus Brownia;";"0.0";"0";"14";"14";"0";"14";"0";"430510";"5766"
"LOK1378_1mm";"SILVA (only NR);Bacteria;Bacteroidota;Bacteroidia;Flavobacteriales;Blattabacteriaceae;Candidatus Sulcia;";"0.0";"0";"117";"111";"0";"111";"6";"430413";"5766"
"LOK1378_1mm";"SILVA (only NR);Bacteria;Bacteroidota;Bacteroidia;Flavobacteriales;Blattabacteriaceae;Candidatus Uzinura;";"0.0";"0";"74";"24";"0";"24";"50";"430500";"5766"
"LOK1378_1mm";"SILVA (only NR);Bacteria;Bacteroidota;Bacteroidia;Flavobacteriales;Blattabacteriaceae;uncultured;";"0.0";"0";"12";"12";"0";"12";"0";"430512";"5766"
"LOK1378_1mm";"SILVA (only NR);Bacteria;Bacteroidota;Bacteroidia;Flavobacteriales;Crocinitomicaceae;";"0.0";"0";"387";"379";"0";"379";"8";"430145";"5766"
"LOK1378_1mm";"SILVA (only NR);Bacteria;Bacteroidota;Bacteroidia;Flavobacteriales;Crocinitomicaceae;Brumimicrobium;";"0.0";"0";"22";"21";"0";"21";"1";"430503";"5766"
"LOK1378_1mm";"SILVA (only NR);Bacteria;Bacteroidota;Bacteroidia;Flavobacteriales;Crocinitomicaceae;Crocinitomix;";"0.0";"0";"84";"82";"0";"82";"2";"430442";"5766"
"LOK1378_1mm";"SILVA (only NR);Bacteria;Bacteroidota;Bacteroidia;Flavobacteriales;Crocinitomicaceae;Fluviicola;";"0.0";"0";"230";"226";"0";"226";"4";"430298";"5766"
"LOK1378_1mm";"SILVA (only NR);Bacteria;Bacteroidota;Bacteroidia;Flavobacteriales;Crocinitomicaceae;Lishizhenia;";"0.0";"0";"3";"3";"0";"3";"0";"430521";"5766"
"LOK1378_1mm";"SILVA (only NR);Bacteria;Bacteroidota;Bacteroidia;Flavobacteriales;Crocinitomicaceae;Salinirepens;";"0.0";"0";"12";"12";"0";"12";"0";"430512";"5766"
"LOK1378_1mm";"SILVA (only NR);Bacteria;Bacteroidota;Bacteroidia;Flavobacteriales;Crocinitomicaceae;Wandonia;";"0.0";"0";"7";"7";"0";"7";"0";"430517";"5766"
"LOK1378_1mm";"SILVA (only NR);Bacteria;Bacteroidota;Bacteroidia;Flavobacteriales;Crocinitomicaceae;uncultured;";"0.0";"0";"29";"28";"0";"28";"1";"430496";"5766"
"LOK1378_1mm";"SILVA (only NR);Bacteria;Bacteroidota;Bacteroidia;Flavobacteriales;Cryomorphaceae;";"0.0";"0";"425";"417";"0";"417";"8";"430107";"5766"
"LOK1378_1mm";"SILVA (only NR);Bacteria;Bacteroidota;Bacteroidia;Flavobacteriales;Cryomorphaceae;Cryomorpha;";"0.0";"0";"50";"48";"0";"48";"2";"430476";"5766"
"LOK1378_1mm";"SILVA (only NR);Bacteria;Bacteroidota;Bacteroidia;Flavobacteriales;Cryomorphaceae;Luteibaculum;";"0.0";"0";"8";"7";"0";"7";"1";"430517";"5766"
"LOK1378_1mm";"SILVA (only NR);Bacteria;Bacteroidota;Bacteroidia;Flavobacteriales;Cryomorphaceae;NS10 marine group;";"0.0";"0";"41";"40";"0";"40";"1";"430484";"5766"
"LOK1378_1mm";"SILVA (only NR);Bacteria;Bacteroidota;Bacteroidia;Flavobacteriales;Cryomorphaceae;Owenweeksia;";"0.0";"0";"34";"34";"0";"34";"0";"430490";"5766"
"LOK1378_1mm";"SILVA (only NR);Bacteria;Bacteroidota;Bacteroidia;Flavobacteriales;Cryomorphaceae;Phaeocystidibacter;";"0.0";"0";"7";"7";"0";"7";"0";"430517";"5766"
"LOK1378_1mm";"SILVA (only NR);Bacteria;Bacteroidota;Bacteroidia;Flavobacteriales;Cryomorphaceae;Vicingus;";"0.0";"0";"67";"66";"0";"66";"1";"430458";"5766"
"LOK1378_1mm";"SILVA (only NR);Bacteria;Bacteroidota;Bacteroidia;Flavobacteriales;Cryomorphaceae;uncultured;";"0.0";"0";"215";"212";"0";"212";"3";"430312";"5766"
"LOK1378_1mm";"SILVA (only NR);Bacteria;Bacteroidota;Bacteroidia;Flavobacteriales;Flavobacteriaceae;";"0.0";"0";"6681";"6444";"0";"6444";"237";"424080";"5766"
"LOK1378_1mm";"SILVA (only NR);Bacteria;Bacteroidota;Bacteroidia;Flavobacteriales;Flavobacteriaceae;Actibacter;";"0.0";"0";"20";"19";"0";"19";"1";"430505";"5766"
"LOK1378_1mm";"SILVA (only NR);Bacteria;Bacteroidota;Bacteroidia;Flavobacteriales;Flavobacteriaceae;Aequorivita;";"0.0";"0";"33";"31";"0";"31";"2";"430493";"5766"
"LOK1378_1mm";"SILVA (only NR);Bacteria;Bacteroidota;Bacteroidia;Flavobacteriales;Flavobacteriaceae;Aestuariibaculum;";"0.0";"0";"7";"7";"0";"7";"0";"430517";"5766"
"LOK1378_1mm";"SILVA (only NR);Bacteria;Bacteroidota;Bacteroidia;Flavobacteriales;Flavobacteriaceae;Aestuariimonas;";"0.0";"0";"4";"4";"0";"4";"0";"430520";"5766"
"LOK1378_1mm";"SILVA (only NR);Bacteria;Bacteroidota;Bacteroidia;Flavobacteriales;Flavobacteriaceae;Aestuariivivens;";"0.0";"0";"3";"3";"0";"3";"0";"430521";"5766"
"LOK1378_1mm";"SILVA (only NR);Bacteria;Bacteroidota;Bacteroidia;Flavobacteriales;Flavobacteriaceae;Algibacter;";"0.0";"0";"40";"39";"0";"39";"1";"430485";"5766"
"LOK1378_1mm";"SILVA (only NR);Bacteria;Bacteroidota;Bacteroidia;Flavobacteriales;Flavobacteriaceae;Algitalea;";"0.0";"0";"10";"9";"0";"9";"1";"430515";"5766"
"LOK1378_1mm";"SILVA (only NR);Bacteria;Bacteroidota;Bacteroidia;Flavobacteriales;Flavobacteriaceae;Antarcticibacterium;";"0.0";"0";"30";"30";"0";"30";"0";"430494";"5766"
"LOK1378_1mm";"SILVA (only NR);Bacteria;Bacteroidota;Bacteroidia;Flavobacteriales;Flavobacteriaceae;Antarcticimonas;";"0.0";"0";"2";"2";"0";"2";"0";"430522";"5766"
"LOK1378_1mm";"SILVA (only NR);Bacteria;Bacteroidota;Bacteroidia;Flavobacteriales;Flavobacteriaceae;Aquibacter;";"0.0";"0";"108";"107";"0";"107";"1";"430417";"5766"
"LOK1378_1mm";"SILVA (only NR);Bacteria;Bacteroidota;Bacteroidia;Flavobacteriales;Flavobacteriaceae;Aquimarina;";"0.0";"0";"67";"62";"0";"62";"5";"430462";"5766"
"LOK1378_1mm";"SILVA (only NR);Bacteria;Bacteroidota;Bacteroidia;Flavobacteriales;Flavobacteriaceae;Arcticiflavibacter;";"0.0";"0";"19";"18";"0";"18";"1";"430506";"5766"
"LOK1378_1mm";"SILVA (only NR);Bacteria;Bacteroidota;Bacteroidia;Flavobacteriales;Flavobacteriaceae;Arenibacter;";"0.0";"0";"49";"49";"0";"49";"0";"430475";"5766"
"LOK1378_1mm";"SILVA (only NR);Bacteria;Bacteroidota;Bacteroidia;Flavobacteriales;Flavobacteriaceae;Arenitalea;";"0.0";"0";"1";"1";"0";"1";"0";"430523";"5766"
"LOK1378_1mm";"SILVA (only NR);Bacteria;Bacteroidota;Bacteroidia;Flavobacteriales;Flavobacteriaceae;Ascidiimonas;";"0.0";"0";"3";"3";"0";"3";"0";"430521";"5766"
"LOK1378_1mm";"SILVA (only NR);Bacteria;Bacteroidota;Bacteroidia;Flavobacteriales;Flavobacteriaceae;Aurantiacicella;";"0.0";"0";"1";"1";"0";"1";"0";"430523";"5766"
"LOK1378_1mm";"SILVA (only NR);Bacteria;Bacteroidota;Bacteroidia;Flavobacteriales;Flavobacteriaceae;Aurantivirga;";"0.0";"0";"14";"13";"0";"13";"1";"430511";"5766"
"LOK1378_1mm";"SILVA (only NR);Bacteria;Bacteroidota;Bacteroidia;Flavobacteriales;Flavobacteriaceae;Aureicoccus;";"0.0";"0";"1";"1";"0";"1";"0";"430523";"5766"
"LOK1378_1mm";"SILVA (only NR);Bacteria;Bacteroidota;Bacteroidia;Flavobacteriales;Flavobacteriaceae;Aureimarina;";"0.0";"0";"2";"2";"0";"2";"0";"430522";"5766"
"LOK1378_1mm";"SILVA (only NR);Bacteria;Bacteroidota;Bacteroidia;Flavobacteriales;Flavobacteriaceae;Aureisphaera;";"0.0";"0";"5";"5";"0";"5";"0";"430519";"5766"
"LOK1378_1mm";"SILVA (only NR);Bacteria;Bacteroidota;Bacteroidia;Flavobacteriales;Flavobacteriaceae;Aureitalea;";"0.0";"0";"2";"2";"0";"2";"0";"430522";"5766"
"LOK1378_1mm";"SILVA (only NR);Bacteria;Bacteroidota;Bacteroidia;Flavobacteriales;Flavobacteriaceae;Aureivirga;";"0.0";"0";"2";"2";"0";"2";"0";"430522";"5766"
"LOK1378_1mm";"SILVA (only NR);Bacteria;Bacteroidota;Bacteroidia;Flavobacteriales;Flavobacteriaceae;Bizionia;";"0.0";"0";"22";"21";"0";"21";"1";"430503";"5766"
"LOK1378_1mm";"SILVA (only NR);Bacteria;Bacteroidota;Bacteroidia;Flavobacteriales;Flavobacteriaceae;Capnocytophaga;";"0.0";"0";"482";"471";"0";"471";"11";"430053";"5766"
"LOK1378_1mm";"SILVA (only NR);Bacteria;Bacteroidota;Bacteroidia;Flavobacteriales;Flavobacteriaceae;Cellulophaga;";"0.0";"0";"63";"56";"0";"56";"7";"430468";"5766"
"LOK1378_1mm";"SILVA (only NR);Bacteria;Bacteroidota;Bacteroidia;Flavobacteriales;Flavobacteriaceae;Changchengzhania;";"0.0";"0";"4";"4";"0";"4";"0";"430520";"5766"
"LOK1378_1mm";"SILVA (only NR);Bacteria;Bacteroidota;Bacteroidia;Flavobacteriales;Flavobacteriaceae;Citreitalea;";"0.0";"0";"9";"9";"0";"9";"0";"430515";"5766"
"LOK1378_1mm";"SILVA (only NR);Bacteria;Bacteroidota;Bacteroidia;Flavobacteriales;Flavobacteriaceae;Coenonia;";"0.0";"0";"5";"5";"0";"5";"0";"430519";"5766"
"LOK1378_1mm";"SILVA (only NR);Bacteria;Bacteroidota;Bacteroidia;Flavobacteriales;Flavobacteriaceae;Confluentibacter;";"0.0";"0";"9";"8";"0";"8";"1";"430516";"5766"
"LOK1378_1mm";"SILVA (only NR);Bacteria;Bacteroidota;Bacteroidia;Flavobacteriales;Flavobacteriaceae;Corallibacter;";"0.0";"0";"3";"3";"0";"3";"0";"430521";"5766"
"LOK1378_1mm";"SILVA (only NR);Bacteria;Bacteroidota;Bacteroidia;Flavobacteriales;Flavobacteriaceae;Costertonia;";"0.0";"0";"6";"6";"0";"6";"0";"430518";"5766"
"LOK1378_1mm";"SILVA (only NR);Bacteria;Bacteroidota;Bacteroidia;Flavobacteriales;Flavobacteriaceae;Croceibacter;";"0.0";"0";"4";"4";"0";"4";"0";"430520";"5766"
"LOK1378_1mm";"SILVA (only NR);Bacteria;Bacteroidota;Bacteroidia;Flavobacteriales;Flavobacteriaceae;Croceitalea;";"0.0";"0";"16";"14";"0";"14";"2";"430510";"5766"
"LOK1378_1mm";"SILVA (only NR);Bacteria;Bacteroidota;Bacteroidia;Flavobacteriales;Flavobacteriaceae;Dokdonia;";"0.0";"0";"48";"46";"0";"46";"2";"430478";"5766"
"LOK1378_1mm";"SILVA (only NR);Bacteria;Bacteroidota;Bacteroidia;Flavobacteriales;Flavobacteriaceae;Eudoraea;";"0.0";"0";"9";"9";"0";"9";"0";"430515";"5766"
"LOK1378_1mm";"SILVA (only NR);Bacteria;Bacteroidota;Bacteroidia;Flavobacteriales;Flavobacteriaceae;Euzebyella;";"0.0";"0";"15";"15";"0";"15";"0";"430509";"5766"
"LOK1378_1mm";"SILVA (only NR);Bacteria;Bacteroidota;Bacteroidia;Flavobacteriales;Flavobacteriaceae;Flagellimonas;";"0.0";"0";"4";"4";"0";"4";"0";"430520";"5766"
"LOK1378_1mm";"SILVA (only NR);Bacteria;Bacteroidota;Bacteroidia;Flavobacteriales;Flavobacteriaceae;Flavicella;";"0.0";"0";"10";"10";"0";"10";"0";"430514";"5766"
"LOK1378_1mm";"SILVA (only NR);Bacteria;Bacteroidota;Bacteroidia;Flavobacteriales;Flavobacteriaceae;Flavimarina;";"0.0";"0";"7";"5";"0";"5";"2";"430519";"5766"
"LOK1378_1mm";"SILVA (only NR);Bacteria;Bacteroidota;Bacteroidia;Flavobacteriales;Flavobacteriaceae;Flaviramulus;";"0.0";"0";"2";"2";"0";"2";"0";"430522";"5766"
"LOK1378_1mm";"SILVA (only NR);Bacteria;Bacteroidota;Bacteroidia;Flavobacteriales;Flavobacteriaceae;Flavirhabdus;";"0.0";"0";"15";"15";"0";"15";"0";"430509";"5766"
"LOK1378_1mm";"SILVA (only NR);Bacteria;Bacteroidota;Bacteroidia;Flavobacteriales;Flavobacteriaceae;Flavivirga;";"0.0";"0";"4";"4";"0";"4";"0";"430520";"5766"
"LOK1378_1mm";"SILVA (only NR);Bacteria;Bacteroidota;Bacteroidia;Flavobacteriales;Flavobacteriaceae;Flavobacterium;";"0.0";"0";"2191";"2080";"0";"2080";"111";"428444";"5766"
"LOK1378_1mm";"SILVA (only NR);Bacteria;Bacteroidota;Bacteroidia;Flavobacteriales;Flavobacteriaceae;Formosa;";"0.0";"0";"104";"100";"0";"100";"4";"430424";"5766"
"LOK1378_1mm";"SILVA (only NR);Bacteria;Bacteroidota;Bacteroidia;Flavobacteriales;Flavobacteriaceae;Frondibacter;";"0.0";"0";"2";"2";"0";"2";"0";"430522";"5766"
"LOK1378_1mm";"SILVA (only NR);Bacteria;Bacteroidota;Bacteroidia;Flavobacteriales;Flavobacteriaceae;Fulvibacter;";"0.0";"0";"2";"2";"0";"2";"0";"430522";"5766"
"LOK1378_1mm";"SILVA (only NR);Bacteria;Bacteroidota;Bacteroidia;Flavobacteriales;Flavobacteriaceae;Gaetbulibacter;";"0.0";"0";"17";"16";"0";"16";"1";"430508";"5766"
"LOK1378_1mm";"SILVA (only NR);Bacteria;Bacteroidota;Bacteroidia;Flavobacteriales;Flavobacteriaceae;Galbibacter;";"0.0";"0";"6";"6";"0";"6";"0";"430518";"5766"
"LOK1378_1mm";"SILVA (only NR);Bacteria;Bacteroidota;Bacteroidia;Flavobacteriales;Flavobacteriaceae;Gangjinia;";"0.0";"0";"9";"9";"0";"9";"0";"430515";"5766"
"LOK1378_1mm";"SILVA (only NR);Bacteria;Bacteroidota;Bacteroidia;Flavobacteriales;Flavobacteriaceae;Gelidibacter;";"0.0";"0";"17";"17";"0";"17";"0";"430507";"5766"
"LOK1378_1mm";"SILVA (only NR);Bacteria;Bacteroidota;Bacteroidia;Flavobacteriales;Flavobacteriaceae;Geojedonia;";"0.0";"0";"3";"3";"0";"3";"0";"430521";"5766"
"LOK1378_1mm";"SILVA (only NR);Bacteria;Bacteroidota;Bacteroidia;Flavobacteriales;Flavobacteriaceae;Gillisia;";"0.0";"0";"37";"37";"0";"37";"0";"430487";"5766"
"LOK1378_1mm";"SILVA (only NR);Bacteria;Bacteroidota;Bacteroidia;Flavobacteriales;Flavobacteriaceae;Gilvibacter;";"0.0";"0";"10";"10";"0";"10";"0";"430514";"5766"
"LOK1378_1mm";"SILVA (only NR);Bacteria;Bacteroidota;Bacteroidia;Flavobacteriales;Flavobacteriaceae;Gramella;";"0.0";"0";"44";"42";"0";"42";"2";"430482";"5766"
"LOK1378_1mm";"SILVA (only NR);Bacteria;Bacteroidota;Bacteroidia;Flavobacteriales;Flavobacteriaceae;Hanstruepera;";"0.0";"0";"2";"2";"0";"2";"0";"430522";"5766"
"LOK1378_1mm";"SILVA (only NR);Bacteria;Bacteroidota;Bacteroidia;Flavobacteriales;Flavobacteriaceae;Hoppeia;";"0.0";"0";"12";"12";"0";"12";"0";"430512";"5766"
"LOK1378_1mm";"SILVA (only NR);Bacteria;Bacteroidota;Bacteroidia;Flavobacteriales;Flavobacteriaceae;Hwangdonia;";"0.0";"0";"3";"3";"0";"3";"0";"430521";"5766"
"LOK1378_1mm";"SILVA (only NR);Bacteria;Bacteroidota;Bacteroidia;Flavobacteriales;Flavobacteriaceae;Hyunsoonleella;";"0.0";"0";"11";"11";"0";"11";"0";"430513";"5766"
"LOK1378_1mm";"SILVA (only NR);Bacteria;Bacteroidota;Bacteroidia;Flavobacteriales;Flavobacteriaceae;Ichthyenterobacterium;";"0.0";"0";"3";"3";"0";"3";"0";"430521";"5766"
"LOK1378_1mm";"SILVA (only NR);Bacteria;Bacteroidota;Bacteroidia;Flavobacteriales;Flavobacteriaceae;Imtechella;";"0.0";"0";"2";"2";"0";"2";"0";"430522";"5766"
"LOK1378_1mm";"SILVA (only NR);Bacteria;Bacteroidota;Bacteroidia;Flavobacteriales;Flavobacteriaceae;Jejudonia;";"0.0";"0";"7";"7";"0";"7";"0";"430517";"5766"
"LOK1378_1mm";"SILVA (only NR);Bacteria;Bacteroidota;Bacteroidia;Flavobacteriales;Flavobacteriaceae;Jejuia;";"0.0";"0";"3";"2";"0";"2";"1";"430522";"5766"
"LOK1378_1mm";"SILVA (only NR);Bacteria;Bacteroidota;Bacteroidia;Flavobacteriales;Flavobacteriaceae;Joostella;";"0.0";"0";"9";"8";"0";"8";"1";"430516";"5766"
"LOK1378_1mm";"SILVA (only NR);Bacteria;Bacteroidota;Bacteroidia;Flavobacteriales;Flavobacteriaceae;Kordia;";"0.0";"0";"32";"31";"0";"31";"1";"430493";"5766"
"LOK1378_1mm";"SILVA (only NR);Bacteria;Bacteroidota;Bacteroidia;Flavobacteriales;Flavobacteriaceae;Kriegella;";"0.0";"0";"2";"1";"0";"1";"1";"430523";"5766"
"LOK1378_1mm";"SILVA (only NR);Bacteria;Bacteroidota;Bacteroidia;Flavobacteriales;Flavobacteriaceae;Lacinutrix;";"0.0";"0";"20";"20";"0";"20";"0";"430504";"5766"
"LOK1378_1mm";"SILVA (only NR);Bacteria;Bacteroidota;Bacteroidia;Flavobacteriales;Flavobacteriaceae;Leeuwenhoekiella;";"0.0";"0";"24";"24";"0";"24";"0";"430500";"5766"
"LOK1378_1mm";"SILVA (only NR);Bacteria;Bacteroidota;Bacteroidia;Flavobacteriales;Flavobacteriaceae;Leptobacterium;";"0.0";"0";"2";"2";"0";"2";"0";"430522";"5766"
"LOK1378_1mm";"SILVA (only NR);Bacteria;Bacteroidota;Bacteroidia;Flavobacteriales;Flavobacteriaceae;Litoribaculum;";"0.0";"0";"1";"1";"0";"1";"0";"430523";"5766"
"LOK1378_1mm";"SILVA (only NR);Bacteria;Bacteroidota;Bacteroidia;Flavobacteriales;Flavobacteriaceae;Lutaonella;";"0.0";"0";"1";"1";"0";"1";"0";"430523";"5766"
"LOK1378_1mm";"SILVA (only NR);Bacteria;Bacteroidota;Bacteroidia;Flavobacteriales;Flavobacteriaceae;Lutibacter;";"0.0";"0";"68";"67";"0";"67";"1";"430457";"5766"
"LOK1378_1mm";"SILVA (only NR);Bacteria;Bacteroidota;Bacteroidia;Flavobacteriales;Flavobacteriaceae;Lutimonas;";"0.0";"0";"14";"14";"0";"14";"0";"430510";"5766"
"LOK1378_1mm";"SILVA (only NR);Bacteria;Bacteroidota;Bacteroidia;Flavobacteriales;Flavobacteriaceae;Mangrovimonas;";"0.0";"0";"5";"5";"0";"5";"0";"430519";"5766"
"LOK1378_1mm";"SILVA (only NR);Bacteria;Bacteroidota;Bacteroidia;Flavobacteriales;Flavobacteriaceae;Maribacter;";"0.0";"0";"124";"119";"0";"119";"5";"430405";"5766"
"LOK1378_1mm";"SILVA (only NR);Bacteria;Bacteroidota;Bacteroidia;Flavobacteriales;Flavobacteriaceae;Mariniflexile;";"0.0";"0";"10";"10";"0";"10";"0";"430514";"5766"
"LOK1378_1mm";"SILVA (only NR);Bacteria;Bacteroidota;Bacteroidia;Flavobacteriales;Flavobacteriaceae;Maritimimonas;";"0.0";"0";"135";"135";"0";"135";"0";"430389";"5766"
"LOK1378_1mm";"SILVA (only NR);Bacteria;Bacteroidota;Bacteroidia;Flavobacteriales;Flavobacteriaceae;Marixanthomonas;";"0.0";"0";"10";"10";"0";"10";"0";"430514";"5766"
"LOK1378_1mm";"SILVA (only NR);Bacteria;Bacteroidota;Bacteroidia;Flavobacteriales;Flavobacteriaceae;Meridianimaribacter;";"0.0";"0";"4";"4";"0";"4";"0";"430520";"5766"
"LOK1378_1mm";"SILVA (only NR);Bacteria;Bacteroidota;Bacteroidia;Flavobacteriales;Flavobacteriaceae;Mesoflavibacter;";"0.0";"0";"20";"19";"0";"19";"1";"430505";"5766"
"LOK1378_1mm";"SILVA (only NR);Bacteria;Bacteroidota;Bacteroidia;Flavobacteriales;Flavobacteriaceae;Mesonia;";"0.0";"0";"25";"21";"0";"21";"4";"430503";"5766"
"LOK1378_1mm";"SILVA (only NR);Bacteria;Bacteroidota;Bacteroidia;Flavobacteriales;Flavobacteriaceae;Muricauda;";"0.0";"0";"111";"107";"0";"107";"4";"430417";"5766"
"LOK1378_1mm";"SILVA (only NR);Bacteria;Bacteroidota;Bacteroidia;Flavobacteriales;Flavobacteriaceae;Muriicola;";"0.0";"0";"8";"7";"0";"7";"1";"430517";"5766"
"LOK1378_1mm";"SILVA (only NR);Bacteria;Bacteroidota;Bacteroidia;Flavobacteriales;Flavobacteriaceae;Myroides;";"0.0";"0";"89";"87";"0";"87";"2";"430437";"5766"
"LOK1378_1mm";"SILVA (only NR);Bacteria;Bacteroidota;Bacteroidia;Flavobacteriales;Flavobacteriaceae;NS2b marine group;";"0.0";"0";"54";"54";"0";"54";"0";"430470";"5766"
"LOK1378_1mm";"SILVA (only NR);Bacteria;Bacteroidota;Bacteroidia;Flavobacteriales;Flavobacteriaceae;NS3a marine group;";"0.0";"0";"35";"34";"0";"34";"1";"430490";"5766"
"LOK1378_1mm";"SILVA (only NR);Bacteria;Bacteroidota;Bacteroidia;Flavobacteriales;Flavobacteriaceae;NS4 marine group;";"0.0";"0";"144";"138";"0";"138";"6";"430386";"5766"
"LOK1378_1mm";"SILVA (only NR);Bacteria;Bacteroidota;Bacteroidia;Flavobacteriales;Flavobacteriaceae;NS5 marine group;";"0.0";"0";"249";"249";"0";"249";"0";"430275";"5766"
"LOK1378_1mm";"SILVA (only NR);Bacteria;Bacteroidota;Bacteroidia;Flavobacteriales;Flavobacteriaceae;Neptunitalea;";"0.0";"0";"4";"4";"0";"4";"0";"430520";"5766"
"LOK1378_1mm";"SILVA (only NR);Bacteria;Bacteroidota;Bacteroidia;Flavobacteriales;Flavobacteriaceae;Nonlabens;";"0.0";"0";"55";"52";"0";"52";"3";"430472";"5766"
"LOK1378_1mm";"SILVA (only NR);Bacteria;Bacteroidota;Bacteroidia;Flavobacteriales;Flavobacteriaceae;Ochrovirga;";"0.0";"0";"1";"1";"0";"1";"0";"430523";"5766"
"LOK1378_1mm";"SILVA (only NR);Bacteria;Bacteroidota;Bacteroidia;Flavobacteriales;Flavobacteriaceae;Olleya;";"0.0";"0";"20";"18";"0";"18";"2";"430506";"5766"
"LOK1378_1mm";"SILVA (only NR);Bacteria;Bacteroidota;Bacteroidia;Flavobacteriales;Flavobacteriaceae;Pibocella;";"0.0";"0";"7";"7";"0";"7";"0";"430517";"5766"
"LOK1378_1mm";"SILVA (only NR);Bacteria;Bacteroidota;Bacteroidia;Flavobacteriales;Flavobacteriaceae;Planktosalinus;";"0.0";"0";"12";"12";"0";"12";"0";"430512";"5766"
"LOK1378_1mm";"SILVA (only NR);Bacteria;Bacteroidota;Bacteroidia;Flavobacteriales;Flavobacteriaceae;Polaribacter;";"0.0";"0";"181";"175";"0";"175";"6";"430349";"5766"
"LOK1378_1mm";"SILVA (only NR);Bacteria;Bacteroidota;Bacteroidia;Flavobacteriales;Flavobacteriaceae;Postechiella;";"0.0";"0";"3";"3";"0";"3";"0";"430521";"5766"
"LOK1378_1mm";"SILVA (only NR);Bacteria;Bacteroidota;Bacteroidia;Flavobacteriales;Flavobacteriaceae;Pricia;";"0.0";"0";"10";"10";"0";"10";"0";"430514";"5766"
"LOK1378_1mm";"SILVA (only NR);Bacteria;Bacteroidota;Bacteroidia;Flavobacteriales;Flavobacteriaceae;Pseudofulvibacter;";"0.0";"0";"129";"128";"0";"128";"1";"430396";"5766"
"LOK1378_1mm";"SILVA (only NR);Bacteria;Bacteroidota;Bacteroidia;Flavobacteriales;Flavobacteriaceae;Pseudozobellia;";"0.0";"0";"2";"2";"0";"2";"0";"430522";"5766"
"LOK1378_1mm";"SILVA (only NR);Bacteria;Bacteroidota;Bacteroidia;Flavobacteriales;Flavobacteriaceae;Psychroflexus;";"0.0";"0";"103";"99";"0";"99";"4";"430425";"5766"
"LOK1378_1mm";"SILVA (only NR);Bacteria;Bacteroidota;Bacteroidia;Flavobacteriales;Flavobacteriaceae;Psychroserpens;";"0.0";"0";"35";"34";"0";"34";"1";"430490";"5766"
"LOK1378_1mm";"SILVA (only NR);Bacteria;Bacteroidota;Bacteroidia;Flavobacteriales;Flavobacteriaceae;Pustulibacterium;";"0.0";"0";"1";"1";"0";"1";"0";"430523";"5766"
"LOK1378_1mm";"SILVA (only NR);Bacteria;Bacteroidota;Bacteroidia;Flavobacteriales;Flavobacteriaceae;Robertkochia;";"0.0";"0";"1";"1";"0";"1";"0";"430523";"5766"
"LOK1378_1mm";"SILVA (only NR);Bacteria;Bacteroidota;Bacteroidia;Flavobacteriales;Flavobacteriaceae;Robiginitalea;";"0.0";"0";"46";"42";"0";"42";"4";"430482";"5766"
"LOK1378_1mm";"SILVA (only NR);Bacteria;Bacteroidota;Bacteroidia;Flavobacteriales;Flavobacteriaceae;Sabulilitoribacter;";"0.0";"0";"2";"2";"0";"2";"0";"430522";"5766"
"LOK1378_1mm";"SILVA (only NR);Bacteria;Bacteroidota;Bacteroidia;Flavobacteriales;Flavobacteriaceae;Salegentibacter;";"0.0";"0";"82";"81";"0";"81";"1";"430443";"5766"
"LOK1378_1mm";"SILVA (only NR);Bacteria;Bacteroidota;Bacteroidia;Flavobacteriales;Flavobacteriaceae;Salinimicrobium;";"0.0";"0";"79";"78";"0";"78";"1";"430446";"5766"
"LOK1378_1mm";"SILVA (only NR);Bacteria;Bacteroidota;Bacteroidia;Flavobacteriales;Flavobacteriaceae;Sediminibacter;";"0.0";"0";"4";"3";"0";"3";"1";"430521";"5766"
"LOK1378_1mm";"SILVA (only NR);Bacteria;Bacteroidota;Bacteroidia;Flavobacteriales;Flavobacteriaceae;Sediminicola;";"0.0";"0";"14";"13";"0";"13";"1";"430511";"5766"
"LOK1378_1mm";"SILVA (only NR);Bacteria;Bacteroidota;Bacteroidia;Flavobacteriales;Flavobacteriaceae;Seonamhaeicola;";"0.0";"0";"14";"14";"0";"14";"0";"430510";"5766"
"LOK1378_1mm";"SILVA (only NR);Bacteria;Bacteroidota;Bacteroidia;Flavobacteriales;Flavobacteriaceae;Siansivirga;";"0.0";"0";"3";"3";"0";"3";"0";"430521";"5766"
"LOK1378_1mm";"SILVA (only NR);Bacteria;Bacteroidota;Bacteroidia;Flavobacteriales;Flavobacteriaceae;Sinomicrobium;";"0.0";"0";"11";"10";"0";"10";"1";"430514";"5766"
"LOK1378_1mm";"SILVA (only NR);Bacteria;Bacteroidota;Bacteroidia;Flavobacteriales;Flavobacteriaceae;Snuella;";"0.0";"0";"2";"2";"0";"2";"0";"430522";"5766"
"LOK1378_1mm";"SILVA (only NR);Bacteria;Bacteroidota;Bacteroidia;Flavobacteriales;Flavobacteriaceae;Spongiibacterium;";"0.0";"0";"7";"7";"0";"7";"0";"430517";"5766"
"LOK1378_1mm";"SILVA (only NR);Bacteria;Bacteroidota;Bacteroidia;Flavobacteriales;Flavobacteriaceae;Spongiiferula;";"0.0";"0";"2";"2";"0";"2";"0";"430522";"5766"
"LOK1378_1mm";"SILVA (only NR);Bacteria;Bacteroidota;Bacteroidia;Flavobacteriales;Flavobacteriaceae;Spongiimicrobium;";"0.0";"0";"5";"5";"0";"5";"0";"430519";"5766"
"LOK1378_1mm";"SILVA (only NR);Bacteria;Bacteroidota;Bacteroidia;Flavobacteriales;Flavobacteriaceae;Spongiimonas;";"0.0";"0";"5";"5";"0";"5";"0";"430519";"5766"
"LOK1378_1mm";"SILVA (only NR);Bacteria;Bacteroidota;Bacteroidia;Flavobacteriales;Flavobacteriaceae;Spongiivirga;";"0.0";"0";"5";"5";"0";"5";"0";"430519";"5766"
"LOK1378_1mm";"SILVA (only NR);Bacteria;Bacteroidota;Bacteroidia;Flavobacteriales;Flavobacteriaceae;Subsaxibacter;";"0.0";"0";"17";"17";"0";"17";"0";"430507";"5766"
"LOK1378_1mm";"SILVA (only NR);Bacteria;Bacteroidota;Bacteroidia;Flavobacteriales;Flavobacteriaceae;Subsaximicrobium;";"0.0";"0";"4";"4";"0";"4";"0";"430520";"5766"
"LOK1378_1mm";"SILVA (only NR);Bacteria;Bacteroidota;Bacteroidia;Flavobacteriales;Flavobacteriaceae;Sufflavibacter;";"0.0";"0";"1";"1";"0";"1";"0";"430523";"5766"
"LOK1378_1mm";"SILVA (only NR);Bacteria;Bacteroidota;Bacteroidia;Flavobacteriales;Flavobacteriaceae;Sungkyunkwania;";"0.0";"0";"4";"4";"0";"4";"0";"430520";"5766"
"LOK1378_1mm";"SILVA (only NR);Bacteria;Bacteroidota;Bacteroidia;Flavobacteriales;Flavobacteriaceae;Tamlana;";"0.0";"0";"18";"18";"0";"18";"0";"430506";"5766"
"LOK1378_1mm";"SILVA (only NR);Bacteria;Bacteroidota;Bacteroidia;Flavobacteriales;Flavobacteriaceae;Tenacibaculum;";"0.0";"0";"227";"219";"0";"219";"8";"430305";"5766"
"LOK1378_1mm";"SILVA (only NR);Bacteria;Bacteroidota;Bacteroidia;Flavobacteriales;Flavobacteriaceae;Ulvibacter;";"0.0";"0";"63";"63";"0";"63";"0";"430461";"5766"
"LOK1378_1mm";"SILVA (only NR);Bacteria;Bacteroidota;Bacteroidia;Flavobacteriales;Flavobacteriaceae;Vitellibacter;";"0.0";"0";"23";"22";"0";"22";"1";"430502";"5766"
"LOK1378_1mm";"SILVA (only NR);Bacteria;Bacteroidota;Bacteroidia;Flavobacteriales;Flavobacteriaceae;Wenyingzhuangia;";"0.0";"0";"12";"12";"0";"12";"0";"430512";"5766"
"LOK1378_1mm";"SILVA (only NR);Bacteria;Bacteroidota;Bacteroidia;Flavobacteriales;Flavobacteriaceae;Winogradskyella;";"0.0";"0";"131";"126";"0";"126";"5";"430398";"5766"
"LOK1378_1mm";"SILVA (only NR);Bacteria;Bacteroidota;Bacteroidia;Flavobacteriales;Flavobacteriaceae;Xanthomarina;";"0.0";"0";"6";"6";"0";"6";"0";"430518";"5766"
"LOK1378_1mm";"SILVA (only NR);Bacteria;Bacteroidota;Bacteroidia;Flavobacteriales;Flavobacteriaceae;Yeosuana;";"0.0";"0";"3";"3";"0";"3";"0";"430521";"5766"
"LOK1378_1mm";"SILVA (only NR);Bacteria;Bacteroidota;Bacteroidia;Flavobacteriales;Flavobacteriaceae;Zeaxanthinibacter;";"0.0";"0";"22";"21";"0";"21";"1";"430503";"5766"
"LOK1378_1mm";"SILVA (only NR);Bacteria;Bacteroidota;Bacteroidia;Flavobacteriales;Flavobacteriaceae;Zhouia;";"0.0";"0";"2";"2";"0";"2";"0";"430522";"5766"
"LOK1378_1mm";"SILVA (only NR);Bacteria;Bacteroidota;Bacteroidia;Flavobacteriales;Flavobacteriaceae;Zobellia;";"0.0";"0";"19";"19";"0";"19";"0";"430505";"5766"
"LOK1378_1mm";"SILVA (only NR);Bacteria;Bacteroidota;Bacteroidia;Flavobacteriales;Flavobacteriaceae;Zunongwangia;";"0.0";"0";"16";"15";"0";"15";"1";"430509";"5766"
"LOK1378_1mm";"SILVA (only NR);Bacteria;Bacteroidota;Bacteroidia;Flavobacteriales;Flavobacteriaceae;uncultured;";"0.0";"0";"361";"354";"0";"354";"7";"430170";"5766"
"LOK1378_1mm";"SILVA (only NR);Bacteria;Bacteroidota;Bacteroidia;Flavobacteriales;Flavobacteriales Incertae Sedis;";"0.0";"0";"11";"11";"0";"11";"0";"430513";"5766"
"LOK1378_1mm";"SILVA (only NR);Bacteria;Bacteroidota;Bacteroidia;Flavobacteriales;Flavobacteriales Incertae Sedis;Ichthyobacterium;";"0.0";"0";"11";"11";"0";"11";"0";"430513";"5766"
"LOK1378_1mm";"SILVA (only NR);Bacteria;Bacteroidota;Bacteroidia;Flavobacteriales;NS7 marine group;";"0.0";"0";"42";"42";"0";"42";"0";"430482";"5766"
"LOK1378_1mm";"SILVA (only NR);Bacteria;Bacteroidota;Bacteroidia;Flavobacteriales;NS9 marine group;";"0.0";"0";"477";"471";"0";"471";"6";"430053";"5766"
"LOK1378_1mm";"SILVA (only NR);Bacteria;Bacteroidota;Bacteroidia;Flavobacteriales;Schleiferiaceae;";"0.0";"0";"48";"46";"0";"46";"2";"430478";"5766"
"LOK1378_1mm";"SILVA (only NR);Bacteria;Bacteroidota;Bacteroidia;Flavobacteriales;Schleiferiaceae;Schleiferia;";"0.0";"0";"48";"46";"0";"46";"2";"430478";"5766"
"LOK1378_1mm";"SILVA (only NR);Bacteria;Bacteroidota;Bacteroidia;Flavobacteriales;Weeksellaceae;";"0.0";"0";"1433";"1397";"0";"1397";"36";"429127";"5766"
"LOK1378_1mm";"SILVA (only NR);Bacteria;Bacteroidota;Bacteroidia;Flavobacteriales;Weeksellaceae;Algoriella;";"0.0";"0";"2";"2";"0";"2";"0";"430522";"5766"
"LOK1378_1mm";"SILVA (only NR);Bacteria;Bacteroidota;Bacteroidia;Flavobacteriales;Weeksellaceae;Apibacter;";"0.0";"0";"9";"8";"0";"8";"1";"430516";"5766"
"LOK1378_1mm";"SILVA (only NR);Bacteria;Bacteroidota;Bacteroidia;Flavobacteriales;Weeksellaceae;Bergeyella;";"0.0";"0";"138";"137";"0";"137";"1";"430387";"5766"
"LOK1378_1mm";"SILVA (only NR);Bacteria;Bacteroidota;Bacteroidia;Flavobacteriales;Weeksellaceae;Candidatus Hemobacterium;";"0.0";"0";"1";"1";"0";"1";"0";"430523";"5766"
"LOK1378_1mm";"SILVA (only NR);Bacteria;Bacteroidota;Bacteroidia;Flavobacteriales;Weeksellaceae;Chishuiella;";"0.0";"0";"4";"4";"0";"4";"0";"430520";"5766"
"LOK1378_1mm";"SILVA (only NR);Bacteria;Bacteroidota;Bacteroidia;Flavobacteriales;Weeksellaceae;Chryseobacterium;";"0.0";"0";"750";"724";"0";"724";"26";"429800";"5766"
"LOK1378_1mm";"SILVA (only NR);Bacteria;Bacteroidota;Bacteroidia;Flavobacteriales;Weeksellaceae;Cloacibacterium;";"0.0";"0";"227";"224";"0";"224";"3";"430300";"5766"
"LOK1378_1mm";"SILVA (only NR);Bacteria;Bacteroidota;Bacteroidia;Flavobacteriales;Weeksellaceae;Cruoricaptor;";"0.0";"0";"2";"2";"0";"2";"0";"430522";"5766"
"LOK1378_1mm";"SILVA (only NR);Bacteria;Bacteroidota;Bacteroidia;Flavobacteriales;Weeksellaceae;Elizabethkingia;";"0.0";"0";"62";"62";"0";"62";"0";"430462";"5766"
"LOK1378_1mm";"SILVA (only NR);Bacteria;Bacteroidota;Bacteroidia;Flavobacteriales;Weeksellaceae;Empedobacter;";"0.0";"0";"27";"23";"0";"23";"4";"430501";"5766"
"LOK1378_1mm";"SILVA (only NR);Bacteria;Bacteroidota;Bacteroidia;Flavobacteriales;Weeksellaceae;Moheibacter;";"0.0";"0";"43";"43";"0";"43";"0";"430481";"5766"
"LOK1378_1mm";"SILVA (only NR);Bacteria;Bacteroidota;Bacteroidia;Flavobacteriales;Weeksellaceae;Ornithobacterium;";"0.0";"0";"36";"36";"0";"36";"0";"430488";"5766"
"LOK1378_1mm";"SILVA (only NR);Bacteria;Bacteroidota;Bacteroidia;Flavobacteriales;Weeksellaceae;Riemerella;";"0.0";"0";"34";"34";"0";"34";"0";"430490";"5766"
"LOK1378_1mm";"SILVA (only NR);Bacteria;Bacteroidota;Bacteroidia;Flavobacteriales;Weeksellaceae;Soonwooa;";"0.0";"0";"5";"5";"0";"5";"0";"430519";"5766"
"LOK1378_1mm";"SILVA (only NR);Bacteria;Bacteroidota;Bacteroidia;Flavobacteriales;Weeksellaceae;Wautersiella;";"0.0";"0";"3";"3";"0";"3";"0";"430521";"5766"
"LOK1378_1mm";"SILVA (only NR);Bacteria;Bacteroidota;Bacteroidia;Flavobacteriales;Weeksellaceae;Weeksella;";"0.0";"0";"10";"10";"0";"10";"0";"430514";"5766"
"LOK1378_1mm";"SILVA (only NR);Bacteria;Bacteroidota;Bacteroidia;Flavobacteriales;Weeksellaceae;uncultured;";"0.0";"0";"72";"71";"0";"71";"1";"430453";"5766"
"LOK1378_1mm";"SILVA (only NR);Bacteria;Bacteroidota;Bacteroidia;ML602M-17;";"0.0";"0";"10";"8";"0";"8";"2";"430516";"5766"
"LOK1378_1mm";"SILVA (only NR);Bacteria;Bacteroidota;Bacteroidia;SM1A07;";"0.0";"0";"59";"57";"0";"57";"2";"430467";"5766"
"LOK1378_1mm";"SILVA (only NR);Bacteria;Bacteroidota;Bacteroidia;Sphingobacteriales;";"0.0";"0";"2824";"2722";"0";"2722";"102";"427802";"5766"
"LOK1378_1mm";"SILVA (only NR);Bacteria;Bacteroidota;Bacteroidia;Sphingobacteriales;ADurb.Bin408;";"0.0";"0";"7";"7";"0";"7";"0";"430517";"5766"
"LOK1378_1mm";"SILVA (only NR);Bacteria;Bacteroidota;Bacteroidia;Sphingobacteriales;AKYH767;";"0.0";"0";"106";"103";"0";"103";"3";"430421";"5766"
"LOK1378_1mm";"SILVA (only NR);Bacteria;Bacteroidota;Bacteroidia;Sphingobacteriales;CMW-169;";"0.0";"0";"7";"7";"0";"7";"0";"430517";"5766"
"LOK1378_1mm";"SILVA (only NR);Bacteria;Bacteroidota;Bacteroidia;Sphingobacteriales;CWT CU03-E12;";"0.0";"0";"6";"6";"0";"6";"0";"430518";"5766"
"LOK1378_1mm";"SILVA (only NR);Bacteria;Bacteroidota;Bacteroidia;Sphingobacteriales;E6aC02;";"0.0";"0";"86";"80";"0";"80";"6";"430444";"5766"
"LOK1378_1mm";"SILVA (only NR);Bacteria;Bacteroidota;Bacteroidia;Sphingobacteriales;FFCH9454;";"0.0";"0";"6";"6";"0";"6";"0";"430518";"5766"
"LOK1378_1mm";"SILVA (only NR);Bacteria;Bacteroidota;Bacteroidia;Sphingobacteriales;GWF2-29-10;";"0.0";"0";"5";"5";"0";"5";"0";"430519";"5766"
"LOK1378_1mm";"SILVA (only NR);Bacteria;Bacteroidota;Bacteroidia;Sphingobacteriales;KD1-131;";"0.0";"0";"15";"15";"0";"15";"0";"430509";"5766"
"LOK1378_1mm";"SILVA (only NR);Bacteria;Bacteroidota;Bacteroidia;Sphingobacteriales;KD3-93;";"0.0";"0";"49";"42";"0";"42";"7";"430482";"5766"
"LOK1378_1mm";"SILVA (only NR);Bacteria;Bacteroidota;Bacteroidia;Sphingobacteriales;Lentimicrobiaceae;";"0.0";"0";"534";"514";"0";"514";"20";"430010";"5766"
"LOK1378_1mm";"SILVA (only NR);Bacteria;Bacteroidota;Bacteroidia;Sphingobacteriales;Lentimicrobiaceae;Lentimicrobium;";"0.0";"0";"266";"258";"0";"258";"8";"430266";"5766"
"LOK1378_1mm";"SILVA (only NR);Bacteria;Bacteroidota;Bacteroidia;Sphingobacteriales;LiUU-11-161;";"0.0";"0";"20";"20";"0";"20";"0";"430504";"5766"
"LOK1378_1mm";"SILVA (only NR);Bacteria;Bacteroidota;Bacteroidia;Sphingobacteriales;NS11-12 marine group;";"0.0";"0";"196";"193";"0";"193";"3";"430331";"5766"
"LOK1378_1mm";"SILVA (only NR);Bacteria;Bacteroidota;Bacteroidia;Sphingobacteriales;S15-21;";"0.0";"0";"2";"2";"0";"2";"0";"430522";"5766"
"LOK1378_1mm";"SILVA (only NR);Bacteria;Bacteroidota;Bacteroidia;Sphingobacteriales;S15A-MN91;";"0.0";"0";"14";"14";"0";"14";"0";"430510";"5766"
"LOK1378_1mm";"SILVA (only NR);Bacteria;Bacteroidota;Bacteroidia;Sphingobacteriales;SBYC-2600;";"0.0";"0";"3";"3";"0";"3";"0";"430521";"5766"
"LOK1378_1mm";"SILVA (only NR);Bacteria;Bacteroidota;Bacteroidia;Sphingobacteriales;ST-12K33;";"0.0";"0";"49";"48";"0";"48";"1";"430476";"5766"
"LOK1378_1mm";"SILVA (only NR);Bacteria;Bacteroidota;Bacteroidia;Sphingobacteriales;Sphingobacteriaceae;";"0.0";"0";"1491";"1440";"0";"1440";"51";"429084";"5766"
"LOK1378_1mm";"SILVA (only NR);Bacteria;Bacteroidota;Bacteroidia;Sphingobacteriales;Sphingobacteriaceae;Anseongella;";"0.0";"0";"8";"8";"0";"8";"0";"430516";"5766"
"LOK1378_1mm";"SILVA (only NR);Bacteria;Bacteroidota;Bacteroidia;Sphingobacteriales;Sphingobacteriaceae;Arcticibacter;";"0.0";"0";"22";"20";"0";"20";"2";"430504";"5766"
"LOK1378_1mm";"SILVA (only NR);Bacteria;Bacteroidota;Bacteroidia;Sphingobacteriales;Sphingobacteriaceae;Mucilaginibacter;";"0.0";"0";"309";"298";"0";"298";"11";"430226";"5766"
"LOK1378_1mm";"SILVA (only NR);Bacteria;Bacteroidota;Bacteroidia;Sphingobacteriales;Sphingobacteriaceae;Nubsella;";"0.0";"0";"21";"20";"0";"20";"1";"430504";"5766"
"LOK1378_1mm";"SILVA (only NR);Bacteria;Bacteroidota;Bacteroidia;Sphingobacteriales;Sphingobacteriaceae;Olivibacter;";"0.0";"0";"33";"31";"0";"31";"2";"430493";"5766"
"LOK1378_1mm";"SILVA (only NR);Bacteria;Bacteroidota;Bacteroidia;Sphingobacteriales;Sphingobacteriaceae;Parapedobacter;";"0.0";"0";"51";"51";"0";"51";"0";"430473";"5766"
"LOK1378_1mm";"SILVA (only NR);Bacteria;Bacteroidota;Bacteroidia;Sphingobacteriales;Sphingobacteriaceae;Pedobacter;";"0.0";"0";"518";"505";"0";"505";"13";"430019";"5766"
"LOK1378_1mm";"SILVA (only NR);Bacteria;Bacteroidota;Bacteroidia;Sphingobacteriales;Sphingobacteriaceae;Pelobium;";"0.0";"0";"4";"4";"0";"4";"0";"430520";"5766"
"LOK1378_1mm";"SILVA (only NR);Bacteria;Bacteroidota;Bacteroidia;Sphingobacteriales;Sphingobacteriaceae;Pseudopedobacter;";"0.0";"0";"18";"17";"0";"17";"1";"430507";"5766"
"LOK1378_1mm";"SILVA (only NR);Bacteria;Bacteroidota;Bacteroidia;Sphingobacteriales;Sphingobacteriaceae;Pseudosphingobacterium;";"0.0";"0";"6";"6";"0";"6";"0";"430518";"5766"
"LOK1378_1mm";"SILVA (only NR);Bacteria;Bacteroidota;Bacteroidia;Sphingobacteriales;Sphingobacteriaceae;Solitalea;";"0.0";"0";"34";"34";"0";"34";"0";"430490";"5766"
"LOK1378_1mm";"SILVA (only NR);Bacteria;Bacteroidota;Bacteroidia;Sphingobacteriales;Sphingobacteriaceae;Sphingobacterium;";"0.0";"0";"380";"360";"0";"360";"20";"430164";"5766"
"LOK1378_1mm";"SILVA (only NR);Bacteria;Bacteroidota;Bacteroidia;Sphingobacteriales;Sphingobacteriaceae;uncultured;";"0.0";"0";"79";"79";"0";"79";"0";"430445";"5766"
"LOK1378_1mm";"SILVA (only NR);Bacteria;Bacteroidota;Bacteroidia;Sphingobacteriales;Z4MB62;";"0.0";"0";"3";"3";"0";"3";"0";"430521";"5766"
"LOK1378_1mm";"SILVA (only NR);Bacteria;Bacteroidota;Bacteroidia;Sphingobacteriales;env.OPS 17;";"0.0";"0";"212";"201";"0";"201";"11";"430323";"5766"
"LOK1378_1mm";"SILVA (only NR);Bacteria;Bacteroidota;Bacteroidia;Sphingobacteriales;s74e-6049;";"0.0";"0";"4";"4";"0";"4";"0";"430520";"5766"
"LOK1378_1mm";"SILVA (only NR);Bacteria;Bacteroidota;Bacteroidia;Sphingobacteriales;uncultured;";"0.0";"0";"3";"3";"0";"3";"0";"430521";"5766"
"LOK1378_1mm";"SILVA (only NR);Bacteria;Bacteroidota;Chlorobia;";"0.0";"0";"153";"137";"0";"137";"16";"430387";"5766"
"LOK1378_1mm";"SILVA (only NR);Bacteria;Bacteroidota;Chlorobia;Chlorobiales;";"0.0";"0";"153";"137";"0";"137";"16";"430387";"5766"
"LOK1378_1mm";"SILVA (only NR);Bacteria;Bacteroidota;Chlorobia;Chlorobiales;Chlorobiaceae;";"0.0";"0";"134";"118";"0";"118";"16";"430406";"5766"
"LOK1378_1mm";"SILVA (only NR);Bacteria;Bacteroidota;Chlorobia;Chlorobiales;Chlorobiaceae;Chlorobaculum;";"0.0";"0";"38";"31";"0";"31";"7";"430493";"5766"
"LOK1378_1mm";"SILVA (only NR);Bacteria;Bacteroidota;Chlorobia;Chlorobiales;Chlorobiaceae;Chlorobium;";"0.0";"0";"70";"63";"0";"63";"7";"430461";"5766"
"LOK1378_1mm";"SILVA (only NR);Bacteria;Bacteroidota;Chlorobia;Chlorobiales;Chlorobiaceae;Prosthecochloris;";"0.0";"0";"23";"21";"0";"21";"2";"430503";"5766"
"LOK1378_1mm";"SILVA (only NR);Bacteria;Bacteroidota;Chlorobia;Chlorobiales;Chlorobiaceae;uncultured;";"0.0";"0";"3";"3";"0";"3";"0";"430521";"5766"
"LOK1378_1mm";"SILVA (only NR);Bacteria;Bacteroidota;Chlorobia;Chlorobiales;Chloroherpetonaceae;";"0.0";"0";"19";"19";"0";"19";"0";"430505";"5766"
"LOK1378_1mm";"SILVA (only NR);Bacteria;Bacteroidota;Chlorobia;Chlorobiales;Chloroherpetonaceae;Chloroherpeton;";"0.0";"0";"4";"4";"0";"4";"0";"430520";"5766"
"LOK1378_1mm";"SILVA (only NR);Bacteria;Bacteroidota;Chlorobia;Chlorobiales;Chloroherpetonaceae;GBChlB;";"0.0";"0";"15";"15";"0";"15";"0";"430509";"5766"
"LOK1378_1mm";"SILVA (only NR);Bacteria;Bacteroidota;Ignavibacteria;";"0.0";"0";"378";"366";"0";"366";"12";"430158";"5766"
"LOK1378_1mm";"SILVA (only NR);Bacteria;Bacteroidota;Ignavibacteria;Ignavibacteriales;";"0.0";"0";"282";"271";"0";"271";"11";"430253";"5766"
"LOK1378_1mm";"SILVA (only NR);Bacteria;Bacteroidota;Ignavibacteria;Ignavibacteriales;BSN166;";"0.0";"0";"6";"6";"0";"6";"0";"430518";"5766"
"LOK1378_1mm";"SILVA (only NR);Bacteria;Bacteroidota;Ignavibacteria;Ignavibacteriales;BSV40;";"0.0";"0";"11";"11";"0";"11";"0";"430513";"5766"
"LOK1378_1mm";"SILVA (only NR);Bacteria;Bacteroidota;Ignavibacteria;Ignavibacteriales;Ignavibacteriaceae;";"0.0";"0";"76";"67";"0";"67";"9";"430457";"5766"
"LOK1378_1mm";"SILVA (only NR);Bacteria;Bacteroidota;Ignavibacteria;Ignavibacteriales;Ignavibacteriaceae;Ignavibacterium;";"0.0";"0";"76";"67";"0";"67";"9";"430457";"5766"
"LOK1378_1mm";"SILVA (only NR);Bacteria;Bacteroidota;Ignavibacteria;Ignavibacteriales;LD-RB-34;";"0.0";"0";"15";"15";"0";"15";"0";"430509";"5766"
"LOK1378_1mm";"SILVA (only NR);Bacteria;Bacteroidota;Ignavibacteria;Ignavibacteriales;Melioribacteraceae;";"0.0";"0";"73";"72";"0";"72";"1";"430452";"5766"
"LOK1378_1mm";"SILVA (only NR);Bacteria;Bacteroidota;Ignavibacteria;Ignavibacteriales;Melioribacteraceae;IheB3-7;";"0.0";"0";"59";"59";"0";"59";"0";"430465";"5766"
"LOK1378_1mm";"SILVA (only NR);Bacteria;Bacteroidota;Ignavibacteria;Ignavibacteriales;Melioribacteraceae;Melioribacter;";"0.0";"0";"13";"12";"0";"12";"1";"430512";"5766"
"LOK1378_1mm";"SILVA (only NR);Bacteria;Bacteroidota;Ignavibacteria;Ignavibacteriales;PHOS-HE36;";"0.0";"0";"67";"67";"0";"67";"0";"430457";"5766"
"LOK1378_1mm";"SILVA (only NR);Bacteria;Bacteroidota;Ignavibacteria;Ignavibacteriales;SM1H02;";"0.0";"0";"8";"8";"0";"8";"0";"430516";"5766"
"LOK1378_1mm";"SILVA (only NR);Bacteria;Bacteroidota;Ignavibacteria;Ignavibacteriales;SR-FBR-L83;";"0.0";"0";"20";"20";"0";"20";"0";"430504";"5766"
"LOK1378_1mm";"SILVA (only NR);Bacteria;Bacteroidota;Ignavibacteria;Ignavibacteriales;UA-50;";"0.0";"0";"3";"3";"0";"3";"0";"430521";"5766"
"LOK1378_1mm";"SILVA (only NR);Bacteria;Bacteroidota;Ignavibacteria;SJA-28;";"0.0";"0";"96";"95";"0";"95";"1";"430429";"5766"
"LOK1378_1mm";"SILVA (only NR);Bacteria;Bacteroidota;Kapabacteria;";"0.0";"0";"246";"240";"0";"240";"6";"430284";"5766"
"LOK1378_1mm";"SILVA (only NR);Bacteria;Bacteroidota;Kapabacteria;Kapabacteriales;";"0.0";"0";"246";"240";"0";"240";"6";"430284";"5766"
"LOK1378_1mm";"SILVA (only NR);Bacteria;Bacteroidota;Kryptonia;";"0.0";"0";"170";"164";"0";"164";"6";"430360";"5766"
"LOK1378_1mm";"SILVA (only NR);Bacteria;Bacteroidota;Kryptonia;Kryptoniales;";"0.0";"0";"170";"164";"0";"164";"6";"430360";"5766"
"LOK1378_1mm";"SILVA (only NR);Bacteria;Bacteroidota;Kryptonia;Kryptoniales;BSV26;";"0.0";"0";"150";"144";"0";"144";"6";"430380";"5766"
"LOK1378_1mm";"SILVA (only NR);Bacteria;Bacteroidota;Kryptonia;Kryptoniales;Kryptoniaceae;";"0.0";"0";"7";"7";"0";"7";"0";"430517";"5766"
"LOK1378_1mm";"SILVA (only NR);Bacteria;Bacteroidota;Kryptonia;Kryptoniales;Kryptoniaceae;Candidatus Chrysopegis;";"0.0";"0";"1";"1";"0";"1";"0";"430523";"5766"
"LOK1378_1mm";"SILVA (only NR);Bacteria;Bacteroidota;Kryptonia;Kryptoniales;Kryptoniaceae;Candidatus Kryptobacter;";"0.0";"0";"1";"1";"0";"1";"0";"430523";"5766"
"LOK1378_1mm";"SILVA (only NR);Bacteria;Bacteroidota;Kryptonia;Kryptoniales;Kryptoniaceae;Candidatus Kryptonium;";"0.0";"0";"2";"2";"0";"2";"0";"430522";"5766"
"LOK1378_1mm";"SILVA (only NR);Bacteria;Bacteroidota;Kryptonia;Kryptoniales;Kryptoniaceae;Candidatus Thermokryptus;";"0.0";"0";"1";"1";"0";"1";"0";"430523";"5766"
"LOK1378_1mm";"SILVA (only NR);Bacteria;Bacteroidota;Kryptonia;Kryptoniales;MSB-3C8;";"0.0";"0";"13";"13";"0";"13";"0";"430511";"5766"
"LOK1378_1mm";"SILVA (only NR);Bacteria;Bacteroidota;OC31;";"0.0";"0";"8";"7";"0";"7";"1";"430517";"5766"
"LOK1378_1mm";"SILVA (only NR);Bacteria;Bacteroidota;Rhodothermia;";"0.0";"0";"2102";"2085";"0";"2085";"17";"428439";"5766"
"LOK1378_1mm";"SILVA (only NR);Bacteria;Bacteroidota;Rhodothermia;Balneolales;";"0.0";"0";"351";"346";"0";"346";"5";"430178";"5766"
"LOK1378_1mm";"SILVA (only NR);Bacteria;Bacteroidota;Rhodothermia;Balneolales;Balneolaceae;";"0.0";"0";"351";"346";"0";"346";"5";"430178";"5766"
"LOK1378_1mm";"SILVA (only NR);Bacteria;Bacteroidota;Rhodothermia;Balneolales;Balneolaceae;A815;";"0.0";"0";"2";"2";"0";"2";"0";"430522";"5766"
"LOK1378_1mm";"SILVA (only NR);Bacteria;Bacteroidota;Rhodothermia;Balneolales;Balneolaceae;Aliifodinibius;";"0.0";"0";"13";"13";"0";"13";"0";"430511";"5766"
"LOK1378_1mm";"SILVA (only NR);Bacteria;Bacteroidota;Rhodothermia;Balneolales;Balneolaceae;B2706-C7;";"0.0";"0";"4";"4";"0";"4";"0";"430520";"5766"
"LOK1378_1mm";"SILVA (only NR);Bacteria;Bacteroidota;Rhodothermia;Balneolales;Balneolaceae;Balneola;";"0.0";"0";"38";"37";"0";"37";"1";"430487";"5766"
"LOK1378_1mm";"SILVA (only NR);Bacteria;Bacteroidota;Rhodothermia;Balneolales;Balneolaceae;CK06-06-Mud-MAS4B-21;";"0.0";"0";"5";"4";"0";"4";"1";"430520";"5766"
"LOK1378_1mm";"SILVA (only NR);Bacteria;Bacteroidota;Rhodothermia;Balneolales;Balneolaceae;F1-37X2;";"0.0";"0";"7";"7";"0";"7";"0";"430517";"5766"
"LOK1378_1mm";"SILVA (only NR);Bacteria;Bacteroidota;Rhodothermia;Balneolales;Balneolaceae;Fodinibius;";"0.0";"0";"6";"5";"0";"5";"1";"430519";"5766"
"LOK1378_1mm";"SILVA (only NR);Bacteria;Bacteroidota;Rhodothermia;Balneolales;Balneolaceae;Gracilimonas;";"0.0";"0";"40";"40";"0";"40";"0";"430484";"5766"
"LOK1378_1mm";"SILVA (only NR);Bacteria;Bacteroidota;Rhodothermia;Balneolales;Balneolaceae;HK-RBC54;";"0.0";"0";"2";"2";"0";"2";"0";"430522";"5766"
"LOK1378_1mm";"SILVA (only NR);Bacteria;Bacteroidota;Rhodothermia;Balneolales;Balneolaceae;MAT-CR-P4-C12;";"0.0";"0";"11";"11";"0";"11";"0";"430513";"5766"
"LOK1378_1mm";"SILVA (only NR);Bacteria;Bacteroidota;Rhodothermia;Balneolales;Balneolaceae;ML310M-34;";"0.0";"0";"8";"8";"0";"8";"0";"430516";"5766"
"LOK1378_1mm";"SILVA (only NR);Bacteria;Bacteroidota;Rhodothermia;Balneolales;Balneolaceae;Rhodohalobacter;";"0.0";"0";"5";"5";"0";"5";"0";"430519";"5766"
"LOK1378_1mm";"SILVA (only NR);Bacteria;Bacteroidota;Rhodothermia;Balneolales;Balneolaceae;Soortia;";"0.0";"0";"2";"2";"0";"2";"0";"430522";"5766"
"LOK1378_1mm";"SILVA (only NR);Bacteria;Bacteroidota;Rhodothermia;Balneolales;Balneolaceae;uncultured;";"0.0";"0";"203";"201";"0";"201";"2";"430323";"5766"
"LOK1378_1mm";"SILVA (only NR);Bacteria;Bacteroidota;Rhodothermia;Rhodothermales;";"0.0";"0";"1751";"1739";"0";"1739";"12";"428785";"5766"
"LOK1378_1mm";"SILVA (only NR);Bacteria;Bacteroidota;Rhodothermia;Rhodothermales;Rhodothermaceae;";"0.0";"0";"1751";"1739";"0";"1739";"12";"428785";"5766"
"LOK1378_1mm";"SILVA (only NR);Bacteria;Bacteroidota;Rhodothermia;Rhodothermales;Rhodothermaceae;Longimonas;";"0.0";"0";"8";"8";"0";"8";"0";"430516";"5766"
"LOK1378_1mm";"SILVA (only NR);Bacteria;Bacteroidota;Rhodothermia;Rhodothermales;Rhodothermaceae;Natronotalea;";"0.0";"0";"2";"2";"0";"2";"0";"430522";"5766"
"LOK1378_1mm";"SILVA (only NR);Bacteria;Bacteroidota;Rhodothermia;Rhodothermales;Rhodothermaceae;Rhodothermus;";"0.0";"0";"18";"17";"0";"17";"1";"430507";"5766"
"LOK1378_1mm";"SILVA (only NR);Bacteria;Bacteroidota;Rhodothermia;Rhodothermales;Rhodothermaceae;Rubricoccus;";"0.0";"0";"2";"2";"0";"2";"0";"430522";"5766"
"LOK1378_1mm";"SILVA (only NR);Bacteria;Bacteroidota;Rhodothermia;Rhodothermales;Rhodothermaceae;Rubrivirga;";"0.0";"0";"11";"11";"0";"11";"0";"430513";"5766"
"LOK1378_1mm";"SILVA (only NR);Bacteria;Bacteroidota;Rhodothermia;Rhodothermales;Rhodothermaceae;Salinibacter;";"0.0";"0";"1559";"1550";"0";"1550";"9";"428974";"5766"
"LOK1378_1mm";"SILVA (only NR);Bacteria;Bacteroidota;Rhodothermia;Rhodothermales;Rhodothermaceae;Salisaeta;";"0.0";"0";"10";"10";"0";"10";"0";"430514";"5766"
"LOK1378_1mm";"SILVA (only NR);Bacteria;Bacteroidota;Rhodothermia;Rhodothermales;Rhodothermaceae;uncultured;";"0.0";"0";"131";"129";"0";"129";"2";"430395";"5766"
"LOK1378_1mm";"SILVA (only NR);Bacteria;Bdellovibrionota;";"0.0";"0";"1665";"1605";"0";"1605";"60";"428919";"5766"
"LOK1378_1mm";"SILVA (only NR);Bacteria;Bdellovibrionota;Bdellovibrionia;";"0.0";"0";"1013";"980";"0";"980";"33";"429544";"5766"
"LOK1378_1mm";"SILVA (only NR);Bacteria;Bdellovibrionota;Bdellovibrionia;Bacteriovoracales;";"0.0";"0";"362";"353";"0";"353";"9";"430171";"5766"
"LOK1378_1mm";"SILVA (only NR);Bacteria;Bdellovibrionota;Bdellovibrionia;Bacteriovoracales;Bacteriovoracaceae;";"0.0";"0";"362";"353";"0";"353";"9";"430171";"5766"
"LOK1378_1mm";"SILVA (only NR);Bacteria;Bdellovibrionota;Bdellovibrionia;Bacteriovoracales;Bacteriovoracaceae;Bacteriovorax;";"0.0";"0";"28";"27";"0";"27";"1";"430497";"5766"
"LOK1378_1mm";"SILVA (only NR);Bacteria;Bdellovibrionota;Bdellovibrionia;Bacteriovoracales;Bacteriovoracaceae;Halobacteriovorax;";"0.0";"0";"101";"99";"0";"99";"2";"430425";"5766"
"LOK1378_1mm";"SILVA (only NR);Bacteria;Bdellovibrionota;Bdellovibrionia;Bacteriovoracales;Bacteriovoracaceae;Peredibacter;";"0.0";"0";"154";"150";"0";"150";"4";"430374";"5766"
"LOK1378_1mm";"SILVA (only NR);Bacteria;Bdellovibrionota;Bdellovibrionia;Bacteriovoracales;Bacteriovoracaceae;uncultured;";"0.0";"0";"76";"74";"0";"74";"2";"430450";"5766"
"LOK1378_1mm";"SILVA (only NR);Bacteria;Bdellovibrionota;Bdellovibrionia;Bdellovibrionales;";"0.0";"0";"651";"627";"0";"627";"24";"429897";"5766"
"LOK1378_1mm";"SILVA (only NR);Bacteria;Bdellovibrionota;Bdellovibrionia;Bdellovibrionales;Bdellovibrionaceae;";"0.0";"0";"651";"627";"0";"627";"24";"429897";"5766"
"LOK1378_1mm";"SILVA (only NR);Bacteria;Bdellovibrionota;Bdellovibrionia;Bdellovibrionales;Bdellovibrionaceae;Bdellovibrio;";"0.0";"0";"345";"327";"0";"327";"18";"430197";"5766"
"LOK1378_1mm";"SILVA (only NR);Bacteria;Bdellovibrionota;Bdellovibrionia;Bdellovibrionales;Bdellovibrionaceae;OM27 clade;";"0.0";"0";"304";"298";"0";"298";"6";"430226";"5766"
"LOK1378_1mm";"SILVA (only NR);Bacteria;Bdellovibrionota;Bdellovibrionia;Bdellovibrionales;Bdellovibrionaceae;uncultured;";"0.0";"0";"2";"2";"0";"2";"0";"430522";"5766"
"LOK1378_1mm";"SILVA (only NR);Bacteria;Bdellovibrionota;Oligoflexia;";"0.0";"0";"652";"625";"0";"625";"27";"429899";"5766"
"LOK1378_1mm";"SILVA (only NR);Bacteria;Bdellovibrionota;Oligoflexia;0319-6G20;";"0.0";"0";"372";"360";"0";"360";"12";"430164";"5766"
"LOK1378_1mm";"SILVA (only NR);Bacteria;Bdellovibrionota;Oligoflexia;053A03-B-DI-P58;";"0.0";"0";"28";"25";"0";"25";"3";"430499";"5766"
"LOK1378_1mm";"SILVA (only NR);Bacteria;Bdellovibrionota;Oligoflexia;Oligoflexales;";"0.0";"0";"219";"209";"0";"209";"10";"430315";"5766"
"LOK1378_1mm";"SILVA (only NR);Bacteria;Bdellovibrionota;Oligoflexia;Oligoflexales;Oligoflexaceae;";"0.0";"0";"219";"209";"0";"209";"10";"430315";"5766"
"LOK1378_1mm";"SILVA (only NR);Bacteria;Bdellovibrionota;Oligoflexia;Oligoflexales;Oligoflexaceae;Oligoflexus;";"0.0";"0";"31";"30";"0";"30";"1";"430494";"5766"
"LOK1378_1mm";"SILVA (only NR);Bacteria;Bdellovibrionota;Oligoflexia;Oligoflexales;Oligoflexaceae;Pseudobacteriovorax;";"0.0";"0";"7";"7";"0";"7";"0";"430517";"5766"
"LOK1378_1mm";"SILVA (only NR);Bacteria;Bdellovibrionota;Oligoflexia;Oligoflexales;Oligoflexaceae;uncultured;";"0.0";"0";"178";"169";"0";"169";"9";"430355";"5766"
"LOK1378_1mm";"SILVA (only NR);Bacteria;Bdellovibrionota;Oligoflexia;Silvanigrellales;";"0.0";"0";"29";"27";"0";"27";"2";"430497";"5766"
"LOK1378_1mm";"SILVA (only NR);Bacteria;Bdellovibrionota;Oligoflexia;Silvanigrellales;Silvanigrellaceae;";"0.0";"0";"29";"27";"0";"27";"2";"430497";"5766"
"LOK1378_1mm";"SILVA (only NR);Bacteria;Bdellovibrionota;Oligoflexia;Silvanigrellales;Silvanigrellaceae;Candidatus Turbabacter;";"0.0";"0";"2";"2";"0";"2";"0";"430522";"5766"
"LOK1378_1mm";"SILVA (only NR);Bacteria;Bdellovibrionota;Oligoflexia;Silvanigrellales;Silvanigrellaceae;Silvanigrella;";"0.0";"0";"13";"12";"0";"12";"1";"430512";"5766"
"LOK1378_1mm";"SILVA (only NR);Bacteria;Bdellovibrionota;Oligoflexia;Silvanigrellales;Silvanigrellaceae;uncultured;";"0.0";"0";"12";"11";"0";"11";"1";"430513";"5766"
"LOK1378_1mm";"SILVA (only NR);Bacteria;Bdellovibrionota;Oligoflexia;uncultured;";"0.0";"0";"3";"3";"0";"3";"0";"430521";"5766"
"LOK1378_1mm";"SILVA (only NR);Bacteria;CK-2C2-2;";"0.0";"0";"22";"22";"0";"22";"0";"430502";"5766"
"LOK1378_1mm";"SILVA (only NR);Bacteria;Caldatribacteriota;";"0.0";"0";"391";"376";"0";"376";"15";"430148";"5766"
"LOK1378_1mm";"SILVA (only NR);Bacteria;Caldatribacteriota;Caldatribacteriia;";"0.0";"0";"48";"48";"0";"48";"0";"430476";"5766"
"LOK1378_1mm";"SILVA (only NR);Bacteria;Caldatribacteriota;Caldatribacteriia;Caldatribacteriales;";"0.0";"0";"48";"48";"0";"48";"0";"430476";"5766"
"LOK1378_1mm";"SILVA (only NR);Bacteria;Caldatribacteriota;Caldatribacteriia;Caldatribacteriales;Caldatribacteriaceae;";"0.0";"0";"48";"48";"0";"48";"0";"430476";"5766"
"LOK1378_1mm";"SILVA (only NR);Bacteria;Caldatribacteriota;Caldatribacteriia;Caldatribacteriales;Caldatribacteriaceae;Candidatus Caldatribacterium;";"0.0";"0";"48";"48";"0";"48";"0";"430476";"5766"
"LOK1378_1mm";"SILVA (only NR);Bacteria;Caldatribacteriota;JS1;";"0.0";"0";"343";"328";"0";"328";"15";"430196";"5766"
"LOK1378_1mm";"SILVA (only NR);Bacteria;Caldisericota;";"0.0";"0";"99";"95";"0";"95";"4";"430429";"5766"
"LOK1378_1mm";"SILVA (only NR);Bacteria;Caldisericota;Caldisericia;";"0.0";"0";"99";"95";"0";"95";"4";"430429";"5766"
"LOK1378_1mm";"SILVA (only NR);Bacteria;Caldisericota;Caldisericia;Caldisericales;";"0.0";"0";"99";"95";"0";"95";"4";"430429";"5766"
"LOK1378_1mm";"SILVA (only NR);Bacteria;Caldisericota;Caldisericia;Caldisericales;Caldisericaceae;";"0.0";"0";"33";"32";"0";"32";"1";"430492";"5766"
"LOK1378_1mm";"SILVA (only NR);Bacteria;Caldisericota;Caldisericia;Caldisericales;Caldisericaceae;Caldisericum;";"0.0";"0";"33";"32";"0";"32";"1";"430492";"5766"
"LOK1378_1mm";"SILVA (only NR);Bacteria;Caldisericota;Caldisericia;Caldisericales;LF045;";"0.0";"0";"29";"26";"0";"26";"3";"430498";"5766"
"LOK1378_1mm";"SILVA (only NR);Bacteria;Caldisericota;Caldisericia;Caldisericales;TTA-B15;";"0.0";"0";"3";"3";"0";"3";"0";"430521";"5766"
"LOK1378_1mm";"SILVA (only NR);Bacteria;Caldisericota;Caldisericia;Caldisericales;TTA-B1;";"0.0";"0";"17";"17";"0";"17";"0";"430507";"5766"
"LOK1378_1mm";"SILVA (only NR);Bacteria;Caldisericota;Caldisericia;Caldisericales;WCHB1-02;";"0.0";"0";"17";"17";"0";"17";"0";"430507";"5766"
"LOK1378_1mm";"SILVA (only NR);Bacteria;Calditrichota;";"0.0";"0";"296";"287";"0";"287";"9";"430237";"5766"
"LOK1378_1mm";"SILVA (only NR);Bacteria;Calditrichota;Calditrichia;";"0.0";"0";"296";"287";"0";"287";"9";"430237";"5766"
"LOK1378_1mm";"SILVA (only NR);Bacteria;Calditrichota;Calditrichia;Calditrichales;";"0.0";"0";"296";"287";"0";"287";"9";"430237";"5766"
"LOK1378_1mm";"SILVA (only NR);Bacteria;Calditrichota;Calditrichia;Calditrichales;Calditrichaceae;";"0.0";"0";"296";"287";"0";"287";"9";"430237";"5766"
"LOK1378_1mm";"SILVA (only NR);Bacteria;Calditrichota;Calditrichia;Calditrichales;Calditrichaceae;Caldithrix;";"0.0";"0";"23";"21";"0";"21";"2";"430503";"5766"
"LOK1378_1mm";"SILVA (only NR);Bacteria;Calditrichota;Calditrichia;Calditrichales;Calditrichaceae;Calorithrix;";"0.0";"0";"24";"24";"0";"24";"0";"430500";"5766"
"LOK1378_1mm";"SILVA (only NR);Bacteria;Calditrichota;Calditrichia;Calditrichales;Calditrichaceae;JdFR-76;";"0.0";"0";"24";"23";"0";"23";"1";"430501";"5766"
"LOK1378_1mm";"SILVA (only NR);Bacteria;Calditrichota;Calditrichia;Calditrichales;Calditrichaceae;SM23-31;";"0.0";"0";"31";"30";"0";"30";"1";"430494";"5766"
"LOK1378_1mm";"SILVA (only NR);Bacteria;Calescamantes;";"0.0";"0";"3";"3";"0";"3";"0";"430521";"5766"
"LOK1378_1mm";"SILVA (only NR);Bacteria;Calescamantes;Calescibacteriia;";"0.0";"0";"3";"3";"0";"3";"0";"430521";"5766"
"LOK1378_1mm";"SILVA (only NR);Bacteria;Calescamantes;Calescibacteriia;Calescibacteriales;";"0.0";"0";"3";"3";"0";"3";"0";"430521";"5766"
"LOK1378_1mm";"SILVA (only NR);Bacteria;Calescamantes;Calescibacteriia;Calescibacteriales;Calescibacteriaceae;";"0.0";"0";"3";"3";"0";"3";"0";"430521";"5766"
"LOK1378_1mm";"SILVA (only NR);Bacteria;Campylobacterota;";"0.0";"0";"4220";"4135";"0";"4135";"85";"426389";"5766"
"LOK1378_1mm";"SILVA (only NR);Bacteria;Campylobacterota;Campylobacteria;";"0.0";"0";"4188";"4103";"0";"4103";"85";"426421";"5766"
"LOK1378_1mm";"SILVA (only NR);Bacteria;Campylobacterota;Campylobacteria;Campylobacterales;";"0.0";"0";"4127";"4042";"0";"4042";"85";"426482";"5766"
"LOK1378_1mm";"SILVA (only NR);Bacteria;Campylobacterota;Campylobacteria;Campylobacterales;Arcobacteraceae;";"0.0";"0";"578";"562";"0";"562";"16";"429962";"5766"
"LOK1378_1mm";"SILVA (only NR);Bacteria;Campylobacterota;Campylobacteria;Campylobacterales;Arcobacteraceae;Arcobacter;";"0.0";"0";"70";"66";"0";"66";"4";"430458";"5766"
"LOK1378_1mm";"SILVA (only NR);Bacteria;Campylobacterota;Campylobacteria;Campylobacterales;Arcobacteraceae;Halarcobacter;";"0.0";"0";"51";"50";"0";"50";"1";"430474";"5766"
"LOK1378_1mm";"SILVA (only NR);Bacteria;Campylobacterota;Campylobacteria;Campylobacterales;Arcobacteraceae;Malaciobacter;";"0.0";"0";"34";"34";"0";"34";"0";"430490";"5766"
"LOK1378_1mm";"SILVA (only NR);Bacteria;Campylobacterota;Campylobacteria;Campylobacterales;Arcobacteraceae;Poseidonibacter;";"0.0";"0";"5";"5";"0";"5";"0";"430519";"5766"
"LOK1378_1mm";"SILVA (only NR);Bacteria;Campylobacterota;Campylobacteria;Campylobacterales;Arcobacteraceae;Pseudarcobacter;";"0.0";"0";"66";"64";"0";"64";"2";"430460";"5766"
"LOK1378_1mm";"SILVA (only NR);Bacteria;Campylobacterota;Campylobacteria;Campylobacterales;Arcobacteraceae;uncultured;";"0.0";"0";"331";"323";"0";"323";"8";"430201";"5766"
"LOK1378_1mm";"SILVA (only NR);Bacteria;Campylobacterota;Campylobacteria;Campylobacterales;CH8-1-BAC;";"0.0";"0";"2";"2";"0";"2";"0";"430522";"5766"
"LOK1378_1mm";"SILVA (only NR);Bacteria;Campylobacterota;Campylobacteria;Campylobacterales;Campylobacteraceae;";"0.0";"0";"724";"717";"0";"717";"7";"429807";"5766"
"LOK1378_1mm";"SILVA (only NR);Bacteria;Campylobacterota;Campylobacteria;Campylobacterales;Campylobacteraceae;Campylobacter;";"0.0";"0";"724";"717";"0";"717";"7";"429807";"5766"
"LOK1378_1mm";"SILVA (only NR);Bacteria;Campylobacterota;Campylobacteria;Campylobacterales;Helicobacteraceae;";"0.0";"0";"514";"498";"0";"498";"16";"430026";"5766"
"LOK1378_1mm";"SILVA (only NR);Bacteria;Campylobacterota;Campylobacteria;Campylobacterales;Helicobacteraceae;Helicobacter;";"0.0";"0";"469";"456";"0";"456";"13";"430068";"5766"
"LOK1378_1mm";"SILVA (only NR);Bacteria;Campylobacterota;Campylobacteria;Campylobacterales;Helicobacteraceae;Wolinella;";"0.0";"0";"5";"5";"0";"5";"0";"430519";"5766"
"LOK1378_1mm";"SILVA (only NR);Bacteria;Campylobacterota;Campylobacteria;Campylobacterales;Helicobacteraceae;uncultured;";"0.0";"0";"39";"36";"0";"36";"3";"430488";"5766"
"LOK1378_1mm";"SILVA (only NR);Bacteria;Campylobacterota;Campylobacteria;Campylobacterales;Hydrogenimonadaceae;";"0.0";"0";"20";"19";"0";"19";"1";"430505";"5766"
"LOK1378_1mm";"SILVA (only NR);Bacteria;Campylobacterota;Campylobacteria;Campylobacterales;Hydrogenimonadaceae;Hydrogenimonas;";"0.0";"0";"20";"19";"0";"19";"1";"430505";"5766"
"LOK1378_1mm";"SILVA (only NR);Bacteria;Campylobacterota;Campylobacteria;Campylobacterales;Incertae Sedis;";"0.0";"0";"7";"6";"0";"6";"1";"430518";"5766"
"LOK1378_1mm";"SILVA (only NR);Bacteria;Campylobacterota;Campylobacteria;Campylobacterales;Incertae Sedis;Thiofractor;";"0.0";"0";"7";"6";"0";"6";"1";"430518";"5766"
"LOK1378_1mm";"SILVA (only NR);Bacteria;Campylobacterota;Campylobacteria;Campylobacterales;Nitratiruptoraceae;";"0.0";"0";"18";"18";"0";"18";"0";"430506";"5766"
"LOK1378_1mm";"SILVA (only NR);Bacteria;Campylobacterota;Campylobacteria;Campylobacterales;Nitratiruptoraceae;Nitratiruptor;";"0.0";"0";"18";"18";"0";"18";"0";"430506";"5766"
"LOK1378_1mm";"SILVA (only NR);Bacteria;Campylobacterota;Campylobacteria;Campylobacterales;P6-b51;";"0.0";"0";"2";"2";"0";"2";"0";"430522";"5766"
"LOK1378_1mm";"SILVA (only NR);Bacteria;Campylobacterota;Campylobacteria;Campylobacterales;PS-B32;";"0.0";"0";"2";"2";"0";"2";"0";"430522";"5766"
"LOK1378_1mm";"SILVA (only NR);Bacteria;Campylobacterota;Campylobacteria;Campylobacterales;Rs-M59 termite group;";"0.0";"0";"12";"12";"0";"12";"0";"430512";"5766"
"LOK1378_1mm";"SILVA (only NR);Bacteria;Campylobacterota;Campylobacteria;Campylobacterales;Sulfurimonadaceae;";"0.0";"0";"814";"798";"0";"798";"16";"429726";"5766"
"LOK1378_1mm";"SILVA (only NR);Bacteria;Campylobacterota;Campylobacteria;Campylobacterales;Sulfurimonadaceae;Sulfuricurvum;";"0.0";"0";"164";"159";"0";"159";"5";"430365";"5766"
"LOK1378_1mm";"SILVA (only NR);Bacteria;Campylobacterota;Campylobacteria;Campylobacterales;Sulfurimonadaceae;Sulfurimonas;";"0.0";"0";"641";"630";"0";"630";"11";"429894";"5766"
"LOK1378_1mm";"SILVA (only NR);Bacteria;Campylobacterota;Campylobacteria;Campylobacterales;Sulfurimonadaceae;Thiovulum;";"0.0";"0";"9";"9";"0";"9";"0";"430515";"5766"
"LOK1378_1mm";"SILVA (only NR);Bacteria;Campylobacterota;Campylobacteria;Campylobacterales;Sulfurospirillaceae;";"0.0";"0";"168";"163";"0";"163";"5";"430361";"5766"
"LOK1378_1mm";"SILVA (only NR);Bacteria;Campylobacterota;Campylobacteria;Campylobacterales;Sulfurospirillaceae;Sulfurospirillum;";"0.0";"0";"168";"163";"0";"163";"5";"430361";"5766"
"LOK1378_1mm";"SILVA (only NR);Bacteria;Campylobacterota;Campylobacteria;Campylobacterales;Sulfurovaceae;";"0.0";"0";"1219";"1197";"0";"1197";"22";"429327";"5766"
"LOK1378_1mm";"SILVA (only NR);Bacteria;Campylobacterota;Campylobacteria;Campylobacterales;Sulfurovaceae;Nitratifractor;";"0.0";"0";"83";"82";"0";"82";"1";"430442";"5766"
"LOK1378_1mm";"SILVA (only NR);Bacteria;Campylobacterota;Campylobacteria;Campylobacterales;Sulfurovaceae;Sulfurovum;";"0.0";"0";"1136";"1115";"0";"1115";"21";"429409";"5766"
"LOK1378_1mm";"SILVA (only NR);Bacteria;Campylobacterota;Campylobacteria;Campylobacterales;Thioreductoraceae;";"0.0";"0";"7";"7";"0";"7";"0";"430517";"5766"
"LOK1378_1mm";"SILVA (only NR);Bacteria;Campylobacterota;Campylobacteria;Campylobacterales;Thioreductoraceae;Thioreductor;";"0.0";"0";"7";"7";"0";"7";"0";"430517";"5766"
"LOK1378_1mm";"SILVA (only NR);Bacteria;Campylobacterota;Campylobacteria;Campylobacterales;uncultured;";"0.0";"0";"39";"38";"0";"38";"1";"430486";"5766"
"LOK1378_1mm";"SILVA (only NR);Bacteria;Campylobacterota;Campylobacteria;Nautiliales;";"0.0";"0";"61";"61";"0";"61";"0";"430463";"5766"
"LOK1378_1mm";"SILVA (only NR);Bacteria;Campylobacterota;Campylobacteria;Nautiliales;Nautiliaceae;";"0.0";"0";"61";"61";"0";"61";"0";"430463";"5766"
"LOK1378_1mm";"SILVA (only NR);Bacteria;Campylobacterota;Campylobacteria;Nautiliales;Nautiliaceae;Caminibacter;";"0.0";"0";"27";"27";"0";"27";"0";"430497";"5766"
"LOK1378_1mm";"SILVA (only NR);Bacteria;Campylobacterota;Campylobacteria;Nautiliales;Nautiliaceae;Lebetimonas;";"0.0";"0";"8";"8";"0";"8";"0";"430516";"5766"
"LOK1378_1mm";"SILVA (only NR);Bacteria;Campylobacterota;Campylobacteria;Nautiliales;Nautiliaceae;Nautilia;";"0.0";"0";"8";"8";"0";"8";"0";"430516";"5766"
"LOK1378_1mm";"SILVA (only NR);Bacteria;Campylobacterota;Campylobacteria;Nautiliales;Nautiliaceae;uncultured;";"0.0";"0";"14";"14";"0";"14";"0";"430510";"5766"
"LOK1378_1mm";"SILVA (only NR);Bacteria;Campylobacterota;Desulfurellia;";"0.0";"0";"32";"32";"0";"32";"0";"430492";"5766"
"LOK1378_1mm";"SILVA (only NR);Bacteria;Campylobacterota;Desulfurellia;Desulfurellales;";"0.0";"0";"32";"32";"0";"32";"0";"430492";"5766"
"LOK1378_1mm";"SILVA (only NR);Bacteria;Campylobacterota;Desulfurellia;Desulfurellales;Desulfurellaceae;";"0.0";"0";"17";"17";"0";"17";"0";"430507";"5766"
"LOK1378_1mm";"SILVA (only NR);Bacteria;Campylobacterota;Desulfurellia;Desulfurellales;Desulfurellaceae;Desulfurella;";"0.0";"0";"17";"17";"0";"17";"0";"430507";"5766"
"LOK1378_1mm";"SILVA (only NR);Bacteria;Campylobacterota;Desulfurellia;Desulfurellales;Hippeaceae;";"0.0";"0";"11";"11";"0";"11";"0";"430513";"5766"
"LOK1378_1mm";"SILVA (only NR);Bacteria;Campylobacterota;Desulfurellia;Desulfurellales;Hippeaceae;Hippea;";"0.0";"0";"11";"11";"0";"11";"0";"430513";"5766"
"LOK1378_1mm";"SILVA (only NR);Bacteria;Campylobacterota;Desulfurellia;Desulfurellales;uncultured;";"0.0";"0";"4";"4";"0";"4";"0";"430520";"5766"
"LOK1378_1mm";"SILVA (only NR);Bacteria;Chloroflexi;";"0.0";"0";"9049";"8628";"0";"8628";"421";"421896";"5766"
"LOK1378_1mm";"SILVA (only NR);Bacteria;Chloroflexi;AD3;";"0.0";"0";"93";"92";"0";"92";"1";"430432";"5766"
"LOK1378_1mm";"SILVA (only NR);Bacteria;Chloroflexi;Anaerolineae;";"0.0";"0";"5491";"5238";"0";"5238";"253";"425286";"5766"
"LOK1378_1mm";"SILVA (only NR);Bacteria;Chloroflexi;Anaerolineae;1-20;";"0.0";"0";"19";"19";"0";"19";"0";"430505";"5766"
"LOK1378_1mm";"SILVA (only NR);Bacteria;Chloroflexi;Anaerolineae;ADurb.Bin180;";"0.0";"0";"29";"29";"0";"29";"0";"430495";"5766"
"LOK1378_1mm";"SILVA (only NR);Bacteria;Chloroflexi;Anaerolineae;Anaerolineales;";"0.0";"0";"2052";"1979";"0";"1979";"73";"428545";"5766"
"LOK1378_1mm";"SILVA (only NR);Bacteria;Chloroflexi;Anaerolineae;Anaerolineales;Anaerolineaceae;";"0.0";"0";"2052";"1979";"0";"1979";"73";"428545";"5766"
"LOK1378_1mm";"SILVA (only NR);Bacteria;Chloroflexi;Anaerolineae;Anaerolineales;Anaerolineaceae;ADurb.Bin120;";"0.0";"0";"45";"44";"0";"44";"1";"430480";"5766"
"LOK1378_1mm";"SILVA (only NR);Bacteria;Chloroflexi;Anaerolineae;Anaerolineales;Anaerolineaceae;Anaerolinea;";"0.0";"0";"111";"107";"0";"107";"4";"430417";"5766"
"LOK1378_1mm";"SILVA (only NR);Bacteria;Chloroflexi;Anaerolineae;Anaerolineales;Anaerolineaceae;Anaerolineaceae UCG-001;";"0.0";"0";"23";"21";"0";"21";"2";"430503";"5766"
"LOK1378_1mm";"SILVA (only NR);Bacteria;Chloroflexi;Anaerolineae;Anaerolineales;Anaerolineaceae;Bellilinea;";"0.0";"0";"12";"12";"0";"12";"0";"430512";"5766"
"LOK1378_1mm";"SILVA (only NR);Bacteria;Chloroflexi;Anaerolineae;Anaerolineales;Anaerolineaceae;Flexilinea;";"0.0";"0";"30";"30";"0";"30";"0";"430494";"5766"
"LOK1378_1mm";"SILVA (only NR);Bacteria;Chloroflexi;Anaerolineae;Anaerolineales;Anaerolineaceae;GWD2-49-16;";"0.0";"0";"4";"4";"0";"4";"0";"430520";"5766"
"LOK1378_1mm";"SILVA (only NR);Bacteria;Chloroflexi;Anaerolineae;Anaerolineales;Anaerolineaceae;Leptolinea;";"0.0";"0";"127";"125";"0";"125";"2";"430399";"5766"
"LOK1378_1mm";"SILVA (only NR);Bacteria;Chloroflexi;Anaerolineae;Anaerolineales;Anaerolineaceae;Levilinea;";"0.0";"0";"17";"17";"0";"17";"0";"430507";"5766"
"LOK1378_1mm";"SILVA (only NR);Bacteria;Chloroflexi;Anaerolineae;Anaerolineales;Anaerolineaceae;Longilinea;";"0.0";"0";"163";"157";"0";"157";"6";"430367";"5766"
"LOK1378_1mm";"SILVA (only NR);Bacteria;Chloroflexi;Anaerolineae;Anaerolineales;Anaerolineaceae;Ornatilinea;";"0.0";"0";"25";"25";"0";"25";"0";"430499";"5766"
"LOK1378_1mm";"SILVA (only NR);Bacteria;Chloroflexi;Anaerolineae;Anaerolineales;Anaerolineaceae;Pelolinea;";"0.0";"0";"47";"44";"0";"44";"3";"430480";"5766"
"LOK1378_1mm";"SILVA (only NR);Bacteria;Chloroflexi;Anaerolineae;Anaerolineales;Anaerolineaceae;RBG-16-58-14;";"0.0";"0";"12";"12";"0";"12";"0";"430512";"5766"
"LOK1378_1mm";"SILVA (only NR);Bacteria;Chloroflexi;Anaerolineae;Anaerolineales;Anaerolineaceae;Thermanaerothrix;";"0.0";"0";"2";"2";"0";"2";"0";"430522";"5766"
"LOK1378_1mm";"SILVA (only NR);Bacteria;Chloroflexi;Anaerolineae;Anaerolineales;Anaerolineaceae;Thermomarinilinea;";"0.0";"0";"11";"11";"0";"11";"0";"430513";"5766"
"LOK1378_1mm";"SILVA (only NR);Bacteria;Chloroflexi;Anaerolineae;Anaerolineales;Anaerolineaceae;UTCFX1;";"0.0";"0";"41";"40";"0";"40";"1";"430484";"5766"
"LOK1378_1mm";"SILVA (only NR);Bacteria;Chloroflexi;Anaerolineae;Anaerolineales;Anaerolineaceae;uncultured;";"0.0";"0";"1375";"1321";"0";"1321";"54";"429203";"5766"
"LOK1378_1mm";"SILVA (only NR);Bacteria;Chloroflexi;Anaerolineae;Ardenticatenales;";"0.0";"0";"592";"563";"0";"563";"29";"429961";"5766"
"LOK1378_1mm";"SILVA (only NR);Bacteria;Chloroflexi;Anaerolineae;Ardenticatenales;Ardenticatenaceae;";"0.0";"0";"66";"65";"0";"65";"1";"430459";"5766"
"LOK1378_1mm";"SILVA (only NR);Bacteria;Chloroflexi;Anaerolineae;Ardenticatenales;Ardenticatenaceae;Ardenticatena;";"0.0";"0";"4";"4";"0";"4";"0";"430520";"5766"
"LOK1378_1mm";"SILVA (only NR);Bacteria;Chloroflexi;Anaerolineae;Ardenticatenales;Ardenticatenaceae;uncultured;";"0.0";"0";"61";"61";"0";"61";"0";"430463";"5766"
"LOK1378_1mm";"SILVA (only NR);Bacteria;Chloroflexi;Anaerolineae;Ardenticatenales;uncultured;";"0.0";"0";"526";"498";"0";"498";"28";"430026";"5766"
"LOK1378_1mm";"SILVA (only NR);Bacteria;Chloroflexi;Anaerolineae;C10-SB1A;";"0.0";"0";"8";"7";"0";"7";"1";"430517";"5766"
"LOK1378_1mm";"SILVA (only NR);Bacteria;Chloroflexi;Anaerolineae;Caldilineales;";"0.0";"0";"314";"304";"0";"304";"10";"430220";"5766"
"LOK1378_1mm";"SILVA (only NR);Bacteria;Chloroflexi;Anaerolineae;Caldilineales;Caldilineaceae;";"0.0";"0";"314";"304";"0";"304";"10";"430220";"5766"
"LOK1378_1mm";"SILVA (only NR);Bacteria;Chloroflexi;Anaerolineae;Caldilineales;Caldilineaceae;Caldilinea;";"0.0";"0";"8";"8";"0";"8";"0";"430516";"5766"
"LOK1378_1mm";"SILVA (only NR);Bacteria;Chloroflexi;Anaerolineae;Caldilineales;Caldilineaceae;Litorilinea;";"0.0";"0";"23";"20";"0";"20";"3";"430504";"5766"
"LOK1378_1mm";"SILVA (only NR);Bacteria;Chloroflexi;Anaerolineae;Caldilineales;Caldilineaceae;uncultured;";"0.0";"0";"280";"273";"0";"273";"7";"430251";"5766"
"LOK1378_1mm";"SILVA (only NR);Bacteria;Chloroflexi;Anaerolineae;KZNMV-5-B42;";"0.0";"0";"3";"3";"0";"3";"0";"430521";"5766"
"LOK1378_1mm";"SILVA (only NR);Bacteria;Chloroflexi;Anaerolineae;MSB-5B2;";"0.0";"0";"19";"15";"0";"15";"4";"430509";"5766"
"LOK1378_1mm";"SILVA (only NR);Bacteria;Chloroflexi;Anaerolineae;MSB-5E12;";"0.0";"0";"7";"7";"0";"7";"0";"430517";"5766"
"LOK1378_1mm";"SILVA (only NR);Bacteria;Chloroflexi;Anaerolineae;RBG-13-54-9;";"0.0";"0";"270";"264";"0";"264";"6";"430260";"5766"
"LOK1378_1mm";"SILVA (only NR);Bacteria;Chloroflexi;Anaerolineae;SBR1031;";"0.0";"0";"1974";"1856";"0";"1856";"118";"428668";"5766"
"LOK1378_1mm";"SILVA (only NR);Bacteria;Chloroflexi;Anaerolineae;SBR1031;A4b;";"0.0";"0";"565";"549";"0";"549";"16";"429975";"5766"
"LOK1378_1mm";"SILVA (only NR);Bacteria;Chloroflexi;Anaerolineae;SBR1031;A4b;OLB13;";"0.0";"0";"15";"15";"0";"15";"0";"430509";"5766"
"LOK1378_1mm";"SILVA (only NR);Bacteria;Chloroflexi;Anaerolineae;SBR1031;A4b;OLB15;";"0.0";"0";"2";"2";"0";"2";"0";"430522";"5766"
"LOK1378_1mm";"SILVA (only NR);Bacteria;Chloroflexi;Anaerolineae;SJA-15;";"0.0";"0";"73";"73";"0";"73";"0";"430451";"5766"
"LOK1378_1mm";"SILVA (only NR);Bacteria;Chloroflexi;Anaerolineae;Thermoflexales;";"0.0";"0";"51";"49";"0";"49";"2";"430475";"5766"
"LOK1378_1mm";"SILVA (only NR);Bacteria;Chloroflexi;Anaerolineae;Thermoflexales;Thermoflexaceae;";"0.0";"0";"51";"49";"0";"49";"2";"430475";"5766"
"LOK1378_1mm";"SILVA (only NR);Bacteria;Chloroflexi;Anaerolineae;Thermoflexales;Thermoflexaceae;Thermoflexus;";"0.0";"0";"51";"49";"0";"49";"2";"430475";"5766"
"LOK1378_1mm";"SILVA (only NR);Bacteria;Chloroflexi;Anaerolineae;uncultured;";"0.0";"0";"77";"67";"0";"67";"10";"430457";"5766"
"LOK1378_1mm";"SILVA (only NR);Bacteria;Chloroflexi;Chloroflexia;";"0.0";"0";"700";"677";"0";"677";"23";"429847";"5766"
"LOK1378_1mm";"SILVA (only NR);Bacteria;Chloroflexi;Chloroflexia;Chloroflexales;";"0.0";"0";"409";"392";"0";"392";"17";"430132";"5766"
"LOK1378_1mm";"SILVA (only NR);Bacteria;Chloroflexi;Chloroflexia;Chloroflexales;Chloroflexaceae;";"0.0";"0";"201";"194";"0";"194";"7";"430330";"5766"
"LOK1378_1mm";"SILVA (only NR);Bacteria;Chloroflexi;Chloroflexia;Chloroflexales;Chloroflexaceae;Candidatus Chloroploca;";"0.0";"0";"12";"12";"0";"12";"0";"430512";"5766"
"LOK1378_1mm";"SILVA (only NR);Bacteria;Chloroflexi;Chloroflexia;Chloroflexales;Chloroflexaceae;Candidatus Chlorothrix;";"0.0";"0";"113";"107";"0";"107";"6";"430417";"5766"
"LOK1378_1mm";"SILVA (only NR);Bacteria;Chloroflexi;Chloroflexia;Chloroflexales;Chloroflexaceae;Chloroflexus;";"0.0";"0";"42";"42";"0";"42";"0";"430482";"5766"
"LOK1378_1mm";"SILVA (only NR);Bacteria;Chloroflexi;Chloroflexia;Chloroflexales;Chloroflexaceae;Chloronema;";"0.0";"0";"7";"7";"0";"7";"0";"430517";"5766"
"LOK1378_1mm";"SILVA (only NR);Bacteria;Chloroflexi;Chloroflexia;Chloroflexales;Chloroflexaceae;FFCH7168;";"0.0";"0";"19";"18";"0";"18";"1";"430506";"5766"
"LOK1378_1mm";"SILVA (only NR);Bacteria;Chloroflexi;Chloroflexia;Chloroflexales;Chloroflexaceae;Oscillochloris;";"0.0";"0";"5";"5";"0";"5";"0";"430519";"5766"
"LOK1378_1mm";"SILVA (only NR);Bacteria;Chloroflexi;Chloroflexia;Chloroflexales;Chloroflexaceae;uncultured;";"0.0";"0";"2";"2";"0";"2";"0";"430522";"5766"
"LOK1378_1mm";"SILVA (only NR);Bacteria;Chloroflexi;Chloroflexia;Chloroflexales;Herpetosiphonaceae;";"0.0";"0";"17";"16";"0";"16";"1";"430508";"5766"
"LOK1378_1mm";"SILVA (only NR);Bacteria;Chloroflexi;Chloroflexia;Chloroflexales;Herpetosiphonaceae;Herpetosiphon;";"0.0";"0";"17";"16";"0";"16";"1";"430508";"5766"
"LOK1378_1mm";"SILVA (only NR);Bacteria;Chloroflexi;Chloroflexia;Chloroflexales;Roseiflexaceae;";"0.0";"0";"191";"182";"0";"182";"9";"430342";"5766"
"LOK1378_1mm";"SILVA (only NR);Bacteria;Chloroflexi;Chloroflexia;Chloroflexales;Roseiflexaceae;Kouleothrix;";"0.0";"0";"10";"10";"0";"10";"0";"430514";"5766"
"LOK1378_1mm";"SILVA (only NR);Bacteria;Chloroflexi;Chloroflexia;Chloroflexales;Roseiflexaceae;Roseiflexus;";"0.0";"0";"30";"30";"0";"30";"0";"430494";"5766"
"LOK1378_1mm";"SILVA (only NR);Bacteria;Chloroflexi;Chloroflexia;Chloroflexales;Roseiflexaceae;uncultured;";"0.0";"0";"151";"142";"0";"142";"9";"430382";"5766"
"LOK1378_1mm";"SILVA (only NR);Bacteria;Chloroflexi;Chloroflexia;Elev-1554;";"0.0";"0";"9";"9";"0";"9";"0";"430515";"5766"
"LOK1378_1mm";"SILVA (only NR);Bacteria;Chloroflexi;Chloroflexia;Kallotenuales;";"0.0";"0";"46";"46";"0";"46";"0";"430478";"5766"
"LOK1378_1mm";"SILVA (only NR);Bacteria;Chloroflexi;Chloroflexia;Kallotenuales;AKIW781;";"0.0";"0";"42";"42";"0";"42";"0";"430482";"5766"
"LOK1378_1mm";"SILVA (only NR);Bacteria;Chloroflexi;Chloroflexia;Kallotenuales;Kallotenuaceae;";"0.0";"0";"4";"4";"0";"4";"0";"430520";"5766"
"LOK1378_1mm";"SILVA (only NR);Bacteria;Chloroflexi;Chloroflexia;Kallotenuales;Kallotenuaceae;Kallotenue;";"0.0";"0";"4";"4";"0";"4";"0";"430520";"5766"
"LOK1378_1mm";"SILVA (only NR);Bacteria;Chloroflexi;Chloroflexia;Thermobaculales;";"0.0";"0";"12";"12";"0";"12";"0";"430512";"5766"
"LOK1378_1mm";"SILVA (only NR);Bacteria;Chloroflexi;Chloroflexia;Thermobaculales;Thermobaculaceae;";"0.0";"0";"12";"12";"0";"12";"0";"430512";"5766"
"LOK1378_1mm";"SILVA (only NR);Bacteria;Chloroflexi;Chloroflexia;Thermobaculales;Thermobaculaceae;Thermobaculum;";"0.0";"0";"12";"12";"0";"12";"0";"430512";"5766"
"LOK1378_1mm";"SILVA (only NR);Bacteria;Chloroflexi;Chloroflexia;Thermomicrobiales;";"0.0";"0";"224";"218";"0";"218";"6";"430306";"5766"
"LOK1378_1mm";"SILVA (only NR);Bacteria;Chloroflexi;Chloroflexia;Thermomicrobiales;AKYG1722;";"0.0";"0";"48";"48";"0";"48";"0";"430476";"5766"
"LOK1378_1mm";"SILVA (only NR);Bacteria;Chloroflexi;Chloroflexia;Thermomicrobiales;JG30-KF-CM45;";"0.0";"0";"137";"134";"0";"134";"3";"430390";"5766"
"LOK1378_1mm";"SILVA (only NR);Bacteria;Chloroflexi;Chloroflexia;Thermomicrobiales;Thermomicrobiaceae;";"0.0";"0";"39";"36";"0";"36";"3";"430488";"5766"
"LOK1378_1mm";"SILVA (only NR);Bacteria;Chloroflexi;Chloroflexia;Thermomicrobiales;Thermomicrobiaceae;Nitrolancea;";"0.0";"0";"19";"19";"0";"19";"0";"430505";"5766"
"LOK1378_1mm";"SILVA (only NR);Bacteria;Chloroflexi;Chloroflexia;Thermomicrobiales;Thermomicrobiaceae;Sphaerobacter;";"0.0";"0";"7";"7";"0";"7";"0";"430517";"5766"
"LOK1378_1mm";"SILVA (only NR);Bacteria;Chloroflexi;Chloroflexia;Thermomicrobiales;Thermomicrobiaceae;Thermomicrobium;";"0.0";"0";"10";"8";"0";"8";"2";"430516";"5766"
"LOK1378_1mm";"SILVA (only NR);Bacteria;Chloroflexi;Chloroflexia;Thermomicrobiales;Thermomicrobiaceae;Thermorudis;";"0.0";"0";"2";"1";"0";"1";"1";"430523";"5766"
"LOK1378_1mm";"SILVA (only NR);Bacteria;Chloroflexi;Dehalococcoidia;";"0.0";"0";"1601";"1496";"0";"1496";"105";"429028";"5766"
"LOK1378_1mm";"SILVA (only NR);Bacteria;Chloroflexi;Dehalococcoidia;1226B1H1-22-FL;";"0.0";"0";"3";"3";"0";"3";"0";"430521";"5766"
"LOK1378_1mm";"SILVA (only NR);Bacteria;Chloroflexi;Dehalococcoidia;185B01;";"0.0";"0";"3";"3";"0";"3";"0";"430521";"5766"
"LOK1378_1mm";"SILVA (only NR);Bacteria;Chloroflexi;Dehalococcoidia;3051bac4-16;";"0.0";"0";"5";"4";"0";"4";"1";"430520";"5766"
"LOK1378_1mm";"SILVA (only NR);Bacteria;Chloroflexi;Dehalococcoidia;661239;";"0.0";"0";"16";"13";"0";"13";"3";"430511";"5766"
"LOK1378_1mm";"SILVA (only NR);Bacteria;Chloroflexi;Dehalococcoidia;Dehalococcoidales;";"0.0";"0";"88";"71";"0";"71";"17";"430453";"5766"
"LOK1378_1mm";"SILVA (only NR);Bacteria;Chloroflexi;Dehalococcoidia;Dehalococcoidales;Dehalococcoidaceae;";"0.0";"0";"51";"50";"0";"50";"1";"430474";"5766"
"LOK1378_1mm";"SILVA (only NR);Bacteria;Chloroflexi;Dehalococcoidia;Dehalococcoidales;Dehalococcoidaceae;Dehalococcoides;";"0.0";"0";"38";"37";"0";"37";"1";"430487";"5766"
"LOK1378_1mm";"SILVA (only NR);Bacteria;Chloroflexi;Dehalococcoidia;Dehalococcoidales;Dehalococcoidaceae;Dehalogenimonas;";"0.0";"0";"13";"13";"0";"13";"0";"430511";"5766"
"LOK1378_1mm";"SILVA (only NR);Bacteria;Chloroflexi;Dehalococcoidia;Dehalococcoidales;Dehalococcoidales Incertae Sedis;";"0.0";"0";"7";"3";"0";"3";"4";"430521";"5766"
"LOK1378_1mm";"SILVA (only NR);Bacteria;Chloroflexi;Dehalococcoidia;Dehalococcoidales;Dehalococcoidales Incertae Sedis;Dehalobium;";"0.0";"0";"7";"3";"0";"3";"4";"430521";"5766"
"LOK1378_1mm";"SILVA (only NR);Bacteria;Chloroflexi;Dehalococcoidia;Dehalococcoidales;uncultured;";"0.0";"0";"29";"18";"0";"18";"11";"430506";"5766"
"LOK1378_1mm";"SILVA (only NR);Bacteria;Chloroflexi;Dehalococcoidia;DscP2;";"0.0";"0";"111";"109";"0";"109";"2";"430415";"5766"
"LOK1378_1mm";"SILVA (only NR);Bacteria;Chloroflexi;Dehalococcoidia;ER-E4-17;";"0.0";"0";"4";"3";"0";"3";"1";"430521";"5766"
"LOK1378_1mm";"SILVA (only NR);Bacteria;Chloroflexi;Dehalococcoidia;FS117-23B-02;";"0.0";"0";"21";"18";"0";"18";"3";"430506";"5766"
"LOK1378_1mm";"SILVA (only NR);Bacteria;Chloroflexi;Dehalococcoidia;FW22;";"0.0";"0";"49";"44";"0";"44";"5";"430480";"5766"
"LOK1378_1mm";"SILVA (only NR);Bacteria;Chloroflexi;Dehalococcoidia;GIF3;";"0.0";"0";"91";"82";"0";"82";"9";"430442";"5766"
"LOK1378_1mm";"SILVA (only NR);Bacteria;Chloroflexi;Dehalococcoidia;GIF9;";"0.0";"0";"137";"124";"0";"124";"13";"430400";"5766"
"LOK1378_1mm";"SILVA (only NR);Bacteria;Chloroflexi;Dehalococcoidia;GIF9;AB-539-J10;";"0.0";"0";"86";"74";"0";"74";"12";"430450";"5766"
"LOK1378_1mm";"SILVA (only NR);Bacteria;Chloroflexi;Dehalococcoidia;GIF9;AB-539-J10;Dsc1;";"0.0";"0";"2";"2";"0";"2";"0";"430522";"5766"
"LOK1378_1mm";"SILVA (only NR);Bacteria;Chloroflexi;Dehalococcoidia;GIF9;AB-539-J10;SCGC-AB-539-J10;";"0.0";"0";"50";"41";"0";"41";"9";"430483";"5766"
"LOK1378_1mm";"SILVA (only NR);Bacteria;Chloroflexi;Dehalococcoidia;H3.93;";"0.0";"0";"40";"36";"0";"36";"4";"430488";"5766"
"LOK1378_1mm";"SILVA (only NR);Bacteria;Chloroflexi;Dehalococcoidia;JdFR-54;";"0.0";"0";"2";"2";"0";"2";"0";"430522";"5766"
"LOK1378_1mm";"SILVA (only NR);Bacteria;Chloroflexi;Dehalococcoidia;MB-C2-126;";"0.0";"0";"9";"9";"0";"9";"0";"430515";"5766"
"LOK1378_1mm";"SILVA (only NR);Bacteria;Chloroflexi;Dehalococcoidia;MSBL5;";"0.0";"0";"80";"76";"0";"76";"4";"430448";"5766"
"LOK1378_1mm";"SILVA (only NR);Bacteria;Chloroflexi;Dehalococcoidia;Napoli-4B-65;";"0.0";"0";"71";"66";"0";"66";"5";"430458";"5766"
"LOK1378_1mm";"SILVA (only NR);Bacteria;Chloroflexi;Dehalococcoidia;RBG-13-46-9;";"0.0";"0";"7";"7";"0";"7";"0";"430517";"5766"
"LOK1378_1mm";"SILVA (only NR);Bacteria;Chloroflexi;Dehalococcoidia;S085;";"0.0";"0";"180";"172";"0";"172";"8";"430352";"5766"
"LOK1378_1mm";"SILVA (only NR);Bacteria;Chloroflexi;Dehalococcoidia;SAR202 clade;";"0.0";"0";"475";"466";"0";"466";"9";"430058";"5766"
"LOK1378_1mm";"SILVA (only NR);Bacteria;Chloroflexi;Dehalococcoidia;SPG12-343-353-B75;";"0.0";"0";"6";"6";"0";"6";"0";"430518";"5766"
"LOK1378_1mm";"SILVA (only NR);Bacteria;Chloroflexi;Dehalococcoidia;SPG12-461-471-B8;";"0.0";"0";"5";"4";"0";"4";"1";"430520";"5766"
"LOK1378_1mm";"SILVA (only NR);Bacteria;Chloroflexi;Dehalococcoidia;Sh765B-AG-111;";"0.0";"0";"107";"102";"0";"102";"5";"430422";"5766"
"LOK1378_1mm";"SILVA (only NR);Bacteria;Chloroflexi;Dehalococcoidia;Sh765B-TzT-20;";"0.0";"0";"10";"8";"0";"8";"2";"430516";"5766"
"LOK1378_1mm";"SILVA (only NR);Bacteria;Chloroflexi;Dehalococcoidia;t0.6.f;";"0.0";"0";"23";"17";"0";"17";"6";"430507";"5766"
"LOK1378_1mm";"SILVA (only NR);Bacteria;Chloroflexi;Dehalococcoidia;vadinBA26;";"0.0";"0";"41";"37";"0";"37";"4";"430487";"5766"
"LOK1378_1mm";"SILVA (only NR);Bacteria;Chloroflexi;Gitt-GS-136;";"0.0";"0";"39";"38";"0";"38";"1";"430486";"5766"
"LOK1378_1mm";"SILVA (only NR);Bacteria;Chloroflexi;JG30-KF-CM66;";"0.0";"0";"127";"121";"0";"121";"6";"430403";"5766"
"LOK1378_1mm";"SILVA (only NR);Bacteria;Chloroflexi;KD4-96;";"0.0";"0";"150";"147";"0";"147";"3";"430377";"5766"
"LOK1378_1mm";"SILVA (only NR);Bacteria;Chloroflexi;Ktedonobacteria;";"0.0";"0";"485";"468";"0";"468";"17";"430056";"5766"
"LOK1378_1mm";"SILVA (only NR);Bacteria;Chloroflexi;Ktedonobacteria;B10-SB3A;";"0.0";"0";"5";"5";"0";"5";"0";"430519";"5766"
"LOK1378_1mm";"SILVA (only NR);Bacteria;Chloroflexi;Ktedonobacteria;B12-WMSP1;";"0.0";"0";"19";"19";"0";"19";"0";"430505";"5766"
"LOK1378_1mm";"SILVA (only NR);Bacteria;Chloroflexi;Ktedonobacteria;C0119;";"0.0";"0";"54";"52";"0";"52";"2";"430472";"5766"
"LOK1378_1mm";"SILVA (only NR);Bacteria;Chloroflexi;Ktedonobacteria;Ktedonobacterales;";"0.0";"0";"390";"375";"0";"375";"15";"430149";"5766"
"LOK1378_1mm";"SILVA (only NR);Bacteria;Chloroflexi;Ktedonobacteria;Ktedonobacterales;JG30-KF-AS9;";"0.0";"0";"23";"23";"0";"23";"0";"430501";"5766"
"LOK1378_1mm";"SILVA (only NR);Bacteria;Chloroflexi;Ktedonobacteria;Ktedonobacterales;Ktedonobacteraceae;";"0.0";"0";"366";"351";"0";"351";"15";"430173";"5766"
"LOK1378_1mm";"SILVA (only NR);Bacteria;Chloroflexi;Ktedonobacteria;Ktedonobacterales;Ktedonobacteraceae;1921-2;";"0.0";"0";"12";"12";"0";"12";"0";"430512";"5766"
"LOK1378_1mm";"SILVA (only NR);Bacteria;Chloroflexi;Ktedonobacteria;Ktedonobacterales;Ktedonobacteraceae;1921-3;";"0.0";"0";"24";"24";"0";"24";"0";"430500";"5766"
"LOK1378_1mm";"SILVA (only NR);Bacteria;Chloroflexi;Ktedonobacteria;Ktedonobacterales;Ktedonobacteraceae;1959-1;";"0.0";"0";"13";"12";"0";"12";"1";"430512";"5766"
"LOK1378_1mm";"SILVA (only NR);Bacteria;Chloroflexi;Ktedonobacteria;Ktedonobacterales;Ktedonobacteraceae;BacC-u-018;";"0.0";"0";"7";"7";"0";"7";"0";"430517";"5766"
"LOK1378_1mm";"SILVA (only NR);Bacteria;Chloroflexi;Ktedonobacteria;Ktedonobacterales;Ktedonobacteraceae;FCPS473;";"0.0";"0";"29";"28";"0";"28";"1";"430496";"5766"
"LOK1378_1mm";"SILVA (only NR);Bacteria;Chloroflexi;Ktedonobacteria;Ktedonobacterales;Ktedonobacteraceae;G12-WMSP1;";"0.0";"0";"16";"16";"0";"16";"0";"430508";"5766"
"LOK1378_1mm";"SILVA (only NR);Bacteria;Chloroflexi;Ktedonobacteria;Ktedonobacterales;Ktedonobacteraceae;HSB OF53-F07;";"0.0";"0";"33";"33";"0";"33";"0";"430491";"5766"
"LOK1378_1mm";"SILVA (only NR);Bacteria;Chloroflexi;Ktedonobacteria;Ktedonobacterales;Ktedonobacteraceae;JG30a-KF-32;";"0.0";"0";"21";"19";"0";"19";"2";"430505";"5766"
"LOK1378_1mm";"SILVA (only NR);Bacteria;Chloroflexi;Ktedonobacteria;Ktedonobacterales;Ktedonobacteraceae;Ktedonobacter;";"0.0";"0";"28";"28";"0";"28";"0";"430496";"5766"
"LOK1378_1mm";"SILVA (only NR);Bacteria;Chloroflexi;Ktedonobacteria;Ktedonobacterales;Ktedonobacteraceae;Thermogemmatispora;";"0.0";"0";"8";"8";"0";"8";"0";"430516";"5766"
"LOK1378_1mm";"SILVA (only NR);Bacteria;Chloroflexi;Ktedonobacteria;Ktedonobacterales;Ktedonobacteraceae;Thermosporothrix;";"0.0";"0";"8";"8";"0";"8";"0";"430516";"5766"
"LOK1378_1mm";"SILVA (only NR);Bacteria;Chloroflexi;Ktedonobacteria;Ktedonobacterales;Ktedonobacteraceae;uncultured;";"0.0";"0";"164";"153";"0";"153";"11";"430371";"5766"
"LOK1378_1mm";"SILVA (only NR);Bacteria;Chloroflexi;Ktedonobacteria;MVP-21;";"0.0";"0";"16";"16";"0";"16";"0";"430508";"5766"
"LOK1378_1mm";"SILVA (only NR);Bacteria;Chloroflexi;N9D0;";"0.0";"0";"4";"4";"0";"4";"0";"430520";"5766"
"LOK1378_1mm";"SILVA (only NR);Bacteria;Chloroflexi;NLS2-31;";"0.0";"0";"2";"2";"0";"2";"0";"430522";"5766"
"LOK1378_1mm";"SILVA (only NR);Bacteria;Chloroflexi;OLB14;";"0.0";"0";"46";"46";"0";"46";"0";"430478";"5766"
"LOK1378_1mm";"SILVA (only NR);Bacteria;Chloroflexi;P2-11E;";"0.0";"0";"33";"33";"0";"33";"0";"430491";"5766"
"LOK1378_1mm";"SILVA (only NR);Bacteria;Chloroflexi;SHA-26;";"0.0";"0";"42";"41";"0";"41";"1";"430483";"5766"
"LOK1378_1mm";"SILVA (only NR);Bacteria;Chloroflexi;SL56 marine group;";"0.0";"0";"21";"21";"0";"21";"0";"430503";"5766"
"LOK1378_1mm";"SILVA (only NR);Bacteria;Chloroflexi;TK10;";"0.0";"0";"187";"178";"0";"178";"9";"430346";"5766"
"LOK1378_1mm";"SILVA (only NR);Bacteria;Chloroflexi;TK17;";"0.0";"0";"18";"18";"0";"18";"0";"430506";"5766"
"LOK1378_1mm";"SILVA (only NR);Bacteria;Chloroflexi;TK30;";"0.0";"0";"6";"5";"0";"5";"1";"430519";"5766"
"LOK1378_1mm";"SILVA (only NR);Bacteria;Chrysiogenetota;";"0.0";"0";"8";"8";"0";"8";"0";"430516";"5766"
"LOK1378_1mm";"SILVA (only NR);Bacteria;Chrysiogenetota;Chrysiogenetes;";"0.0";"0";"8";"8";"0";"8";"0";"430516";"5766"
"LOK1378_1mm";"SILVA (only NR);Bacteria;Chrysiogenetota;Chrysiogenetes;Chrysiogenales;";"0.0";"0";"8";"8";"0";"8";"0";"430516";"5766"
"LOK1378_1mm";"SILVA (only NR);Bacteria;Chrysiogenetota;Chrysiogenetes;Chrysiogenales;Chrysiogenaceae;";"0.0";"0";"8";"8";"0";"8";"0";"430516";"5766"
"LOK1378_1mm";"SILVA (only NR);Bacteria;Chrysiogenetota;Chrysiogenetes;Chrysiogenales;Chrysiogenaceae;Chrysiogenes;";"0.0";"0";"1";"1";"0";"1";"0";"430523";"5766"
"LOK1378_1mm";"SILVA (only NR);Bacteria;Chrysiogenetota;Chrysiogenetes;Chrysiogenales;Chrysiogenaceae;Desulfurispira;";"0.0";"0";"2";"2";"0";"2";"0";"430522";"5766"
"LOK1378_1mm";"SILVA (only NR);Bacteria;Chrysiogenetota;Chrysiogenetes;Chrysiogenales;Chrysiogenaceae;Desulfurispirillum;";"0.0";"0";"5";"5";"0";"5";"0";"430519";"5766"
"LOK1378_1mm";"SILVA (only NR);Bacteria;Cloacimonadota;";"0.0";"0";"299";"282";"0";"282";"17";"430242";"5766"
"LOK1378_1mm";"SILVA (only NR);Bacteria;Cloacimonadota;Cloacimonadia;";"0.0";"0";"299";"282";"0";"282";"17";"430242";"5766"
"LOK1378_1mm";"SILVA (only NR);Bacteria;Cloacimonadota;Cloacimonadia;Cloacimonadales;";"0.0";"0";"289";"273";"0";"273";"16";"430251";"5766"
"LOK1378_1mm";"SILVA (only NR);Bacteria;Cloacimonadota;Cloacimonadia;Cloacimonadales;CW-1 termite group;";"0.0";"0";"9";"8";"0";"8";"1";"430516";"5766"
"LOK1378_1mm";"SILVA (only NR);Bacteria;Cloacimonadota;Cloacimonadia;Cloacimonadales;Cloacimonadaceae;";"0.0";"0";"165";"158";"0";"158";"7";"430366";"5766"
"LOK1378_1mm";"SILVA (only NR);Bacteria;Cloacimonadota;Cloacimonadia;Cloacimonadales;Cloacimonadaceae;C-2;";"0.0";"0";"3";"3";"0";"3";"0";"430521";"5766"
"LOK1378_1mm";"SILVA (only NR);Bacteria;Cloacimonadota;Cloacimonadia;Cloacimonadales;Cloacimonadaceae;Candidatus Cloacimonas;";"0.0";"0";"90";"87";"0";"87";"3";"430437";"5766"
"LOK1378_1mm";"SILVA (only NR);Bacteria;Cloacimonadota;Cloacimonadia;Cloacimonadales;Cloacimonadaceae;LNR A2-18;";"0.0";"0";"11";"7";"0";"7";"4";"430517";"5766"
"LOK1378_1mm";"SILVA (only NR);Bacteria;Cloacimonadota;Cloacimonadia;Cloacimonadales;Cloacimonadaceae;W5;";"0.0";"0";"53";"53";"0";"53";"0";"430471";"5766"
"LOK1378_1mm";"SILVA (only NR);Bacteria;Cloacimonadota;Cloacimonadia;Cloacimonadales;GZKB75;";"0.0";"0";"9";"8";"0";"8";"1";"430516";"5766"
"LOK1378_1mm";"SILVA (only NR);Bacteria;Cloacimonadota;Cloacimonadia;Cloacimonadales;LK-44f;";"0.0";"0";"13";"13";"0";"13";"0";"430511";"5766"
"LOK1378_1mm";"SILVA (only NR);Bacteria;Cloacimonadota;Cloacimonadia;Cloacimonadales;MSBL8;";"0.0";"0";"26";"26";"0";"26";"0";"430498";"5766"
"LOK1378_1mm";"SILVA (only NR);Bacteria;Cloacimonadota;Cloacimonadia;Cloacimonadales;NK-L14;";"0.0";"0";"4";"4";"0";"4";"0";"430520";"5766"
"LOK1378_1mm";"SILVA (only NR);Bacteria;Cloacimonadota;Cloacimonadia;Cloacimonadales;PBS-18;";"0.0";"0";"16";"14";"0";"14";"2";"430510";"5766"
"LOK1378_1mm";"SILVA (only NR);Bacteria;Cloacimonadota;Cloacimonadia;Cloacimonadales;SHA-41;";"0.0";"0";"5";"5";"0";"5";"0";"430519";"5766"
"LOK1378_1mm";"SILVA (only NR);Bacteria;Cloacimonadota;Cloacimonadia;Cloacimonadales;SHA-4;";"0.0";"0";"5";"5";"0";"5";"0";"430519";"5766"
"LOK1378_1mm";"SILVA (only NR);Bacteria;Cloacimonadota;Cloacimonadia;Cloacimonadales;W27;";"0.0";"0";"31";"26";"0";"26";"5";"430498";"5766"
"LOK1378_1mm";"SILVA (only NR);Bacteria;Cloacimonadota;Cloacimonadia;MSBL2;";"0.0";"0";"10";"9";"0";"9";"1";"430515";"5766"
"LOK1378_1mm";"SILVA (only NR);Bacteria;Coprothermobacterota;";"0.0";"0";"98";"98";"0";"98";"0";"430426";"5766"
"LOK1378_1mm";"SILVA (only NR);Bacteria;Coprothermobacterota;Coprothermobacteria;";"0.0";"0";"98";"98";"0";"98";"0";"430426";"5766"
"LOK1378_1mm";"SILVA (only NR);Bacteria;Coprothermobacterota;Coprothermobacteria;Coprothermobacterales;";"0.0";"0";"98";"98";"0";"98";"0";"430426";"5766"
"LOK1378_1mm";"SILVA (only NR);Bacteria;Coprothermobacterota;Coprothermobacteria;Coprothermobacterales;Coprothermobacteraceae;";"0.0";"0";"98";"98";"0";"98";"0";"430426";"5766"
"LOK1378_1mm";"SILVA (only NR);Bacteria;Coprothermobacterota;Coprothermobacteria;Coprothermobacterales;Coprothermobacteraceae;Coprothermobacter;";"0.0";"0";"98";"98";"0";"98";"0";"430426";"5766"
"LOK1378_1mm";"SILVA (only NR);Bacteria;Cyanobacteria;";"0.0";"0";"9718";"9427";"0";"9427";"291";"421097";"5766"
"LOK1378_1mm";"SILVA (only NR);Bacteria;Cyanobacteria;Cyanobacteriia;";"0.0";"0";"9141";"8872";"0";"8872";"269";"421652";"5766"
"LOK1378_1mm";"SILVA (only NR);Bacteria;Cyanobacteria;Cyanobacteriia;Chloroplast;";"0.0";"0";"4441";"4341";"0";"4341";"100";"426183";"5766"
"LOK1378_1mm";"SILVA (only NR);Bacteria;Cyanobacteria;Cyanobacteriia;Cyanobacteriales;";"0.0";"0";"2985";"2867";"0";"2867";"118";"427657";"5766"
"LOK1378_1mm";"SILVA (only NR);Bacteria;Cyanobacteria;Cyanobacteriia;Cyanobacteriales;Chamaesiphonaceae;";"0.0";"0";"4";"3";"0";"3";"1";"430521";"5766"
"LOK1378_1mm";"SILVA (only NR);Bacteria;Cyanobacteria;Cyanobacteriia;Cyanobacteriales;Chamaesiphonaceae;Chamaesiphon PCC-6605;";"0.0";"0";"4";"3";"0";"3";"1";"430521";"5766"
"LOK1378_1mm";"SILVA (only NR);Bacteria;Cyanobacteria;Cyanobacteriia;Cyanobacteriales;Chroococcidiopsaceae;";"0.0";"0";"298";"275";"0";"275";"23";"430249";"5766"
"LOK1378_1mm";"SILVA (only NR);Bacteria;Cyanobacteria;Cyanobacteriia;Cyanobacteriales;Chroococcidiopsaceae;Aliterella;";"0.0";"0";"37";"35";"0";"35";"2";"430489";"5766"
"LOK1378_1mm";"SILVA (only NR);Bacteria;Cyanobacteria;Cyanobacteriia;Cyanobacteriales;Chroococcidiopsaceae;Chlorogloea SAG 10.99;";"0.0";"0";"3";"3";"0";"3";"0";"430521";"5766"
"LOK1378_1mm";"SILVA (only NR);Bacteria;Cyanobacteria;Cyanobacteriia;Cyanobacteriales;Chroococcidiopsaceae;Chroococcidiopsis CC1;";"0.0";"0";"8";"7";"0";"7";"1";"430517";"5766"
"LOK1378_1mm";"SILVA (only NR);Bacteria;Cyanobacteria;Cyanobacteriia;Cyanobacteriales;Chroococcidiopsaceae;Chroococcidiopsis PCC 7203;";"0.0";"0";"19";"14";"0";"14";"5";"430510";"5766"
"LOK1378_1mm";"SILVA (only NR);Bacteria;Cyanobacteria;Cyanobacteriia;Cyanobacteriales;Chroococcidiopsaceae;Chroococcidiopsis SAG 2023;";"0.0";"0";"29";"25";"0";"25";"4";"430499";"5766"
"LOK1378_1mm";"SILVA (only NR);Bacteria;Cyanobacteria;Cyanobacteriia;Cyanobacteriales;Chroococcidiopsaceae;Crinalium SAG 22.89;";"0.0";"0";"10";"10";"0";"10";"0";"430514";"5766"
"LOK1378_1mm";"SILVA (only NR);Bacteria;Cyanobacteria;Cyanobacteriia;Cyanobacteriales;Chroococcidiopsaceae;Dapisostemonum CCIBt 3536;";"0.0";"0";"10";"10";"0";"10";"0";"430514";"5766"
"LOK1378_1mm";"SILVA (only NR);Bacteria;Cyanobacteria;Cyanobacteriia;Cyanobacteriales;Chroococcidiopsaceae;Gloeocapsa PCC-7428;";"0.0";"0";"8";"8";"0";"8";"0";"430516";"5766"
"LOK1378_1mm";"SILVA (only NR);Bacteria;Cyanobacteria;Cyanobacteriia;Cyanobacteriales;Chroococcidiopsaceae;Myxosarcina SAG 30.84;";"0.0";"0";"10";"10";"0";"10";"0";"430514";"5766"
"LOK1378_1mm";"SILVA (only NR);Bacteria;Cyanobacteria;Cyanobacteriia;Cyanobacteriales;Chroococcidiopsaceae;uncultured;";"0.0";"0";"161";"150";"0";"150";"11";"430374";"5766"
"LOK1378_1mm";"SILVA (only NR);Bacteria;Cyanobacteria;Cyanobacteriia;Cyanobacteriales;Coleofasciculaceae;";"0.0";"0";"402";"376";"0";"376";"26";"430148";"5766"
"LOK1378_1mm";"SILVA (only NR);Bacteria;Cyanobacteria;Cyanobacteriia;Cyanobacteriales;Coleofasciculaceae;Caldora VP642b;";"0.0";"0";"6";"6";"0";"6";"0";"430518";"5766"
"LOK1378_1mm";"SILVA (only NR);Bacteria;Cyanobacteria;Cyanobacteriia;Cyanobacteriales;Coleofasciculaceae;Coleofasciculus PCC-7420;";"0.0";"0";"291";"269";"0";"269";"22";"430255";"5766"
"LOK1378_1mm";"SILVA (only NR);Bacteria;Cyanobacteria;Cyanobacteriia;Cyanobacteriales;Coleofasciculaceae;Microcoleus CENA344;";"0.0";"0";"2";"2";"0";"2";"0";"430522";"5766"
"LOK1378_1mm";"SILVA (only NR);Bacteria;Cyanobacteria;Cyanobacteriia;Cyanobacteriales;Coleofasciculaceae;Microcoleus Es-Yyy1400;";"0.0";"0";"7";"7";"0";"7";"0";"430517";"5766"
"LOK1378_1mm";"SILVA (only NR);Bacteria;Cyanobacteria;Cyanobacteriia;Cyanobacteriales;Coleofasciculaceae;Microcoleus PCC-7113;";"0.0";"0";"4";"4";"0";"4";"0";"430520";"5766"
"LOK1378_1mm";"SILVA (only NR);Bacteria;Cyanobacteria;Cyanobacteriia;Cyanobacteriales;Coleofasciculaceae;Microcoleus SAG 1449-1a;";"0.0";"0";"20";"18";"0";"18";"2";"430506";"5766"
"LOK1378_1mm";"SILVA (only NR);Bacteria;Cyanobacteria;Cyanobacteriia;Cyanobacteriales;Coleofasciculaceae;Moorea;";"0.0";"0";"9";"9";"0";"9";"0";"430515";"5766"
"LOK1378_1mm";"SILVA (only NR);Bacteria;Cyanobacteria;Cyanobacteriia;Cyanobacteriales;Coleofasciculaceae;Potamolinea 1PC;";"0.0";"0";"6";"6";"0";"6";"0";"430518";"5766"
"LOK1378_1mm";"SILVA (only NR);Bacteria;Cyanobacteria;Cyanobacteriia;Cyanobacteriales;Coleofasciculaceae;Symploca PCC-8002;";"0.0";"0";"5";"5";"0";"5";"0";"430519";"5766"
"LOK1378_1mm";"SILVA (only NR);Bacteria;Cyanobacteria;Cyanobacteriia;Cyanobacteriales;Coleofasciculaceae;Symplocastrum CPER-KK1;";"0.0";"0";"4";"4";"0";"4";"0";"430520";"5766"
"LOK1378_1mm";"SILVA (only NR);Bacteria;Cyanobacteria;Cyanobacteriia;Cyanobacteriales;Coleofasciculaceae;Wilmottia Ant-Ph58;";"0.0";"0";"26";"26";"0";"26";"0";"430498";"5766"
"LOK1378_1mm";"SILVA (only NR);Bacteria;Cyanobacteria;Cyanobacteriia;Cyanobacteriales;Coleofasciculaceae;uncultured;";"0.0";"0";"17";"17";"0";"17";"0";"430507";"5766"
"LOK1378_1mm";"SILVA (only NR);Bacteria;Cyanobacteria;Cyanobacteriia;Cyanobacteriales;Cyanobacteriaceae;";"0.0";"0";"125";"119";"0";"119";"6";"430405";"5766"
"LOK1378_1mm";"SILVA (only NR);Bacteria;Cyanobacteria;Cyanobacteriia;Cyanobacteriales;Cyanobacteriaceae;Annamia HOs24;";"0.0";"0";"10";"10";"0";"10";"0";"430514";"5766"
"LOK1378_1mm";"SILVA (only NR);Bacteria;Cyanobacteria;Cyanobacteriia;Cyanobacteriales;Cyanobacteriaceae;Chroococcus HUW 799;";"0.0";"0";"2";"2";"0";"2";"0";"430522";"5766"
"LOK1378_1mm";"SILVA (only NR);Bacteria;Cyanobacteria;Cyanobacteriia;Cyanobacteriales;Cyanobacteriaceae;Cyanobacterium PCC-10605;";"0.0";"0";"7";"4";"0";"4";"3";"430520";"5766"
"LOK1378_1mm";"SILVA (only NR);Bacteria;Cyanobacteria;Cyanobacteriia;Cyanobacteriales;Cyanobacteriaceae;Cyanobacterium PCC-7202;";"0.0";"0";"9";"9";"0";"9";"0";"430515";"5766"
"LOK1378_1mm";"SILVA (only NR);Bacteria;Cyanobacteria;Cyanobacteriia;Cyanobacteriales;Cyanobacteriaceae;Geitlerinema LD9;";"0.0";"0";"3";"3";"0";"3";"0";"430521";"5766"
"LOK1378_1mm";"SILVA (only NR);Bacteria;Cyanobacteria;Cyanobacteriia;Cyanobacteriales;Cyanobacteriaceae;Geminobacterium;";"0.0";"0";"17";"16";"0";"16";"1";"430508";"5766"
"LOK1378_1mm";"SILVA (only NR);Bacteria;Cyanobacteria;Cyanobacteriia;Cyanobacteriales;Cyanobacteriaceae;Geminocystis PCC-6308;";"0.0";"0";"17";"16";"0";"16";"1";"430508";"5766"
"LOK1378_1mm";"SILVA (only NR);Bacteria;Cyanobacteria;Cyanobacteriia;Cyanobacteriales;Cyanobacteriaceae;Merismopedia AICB1015;";"0.0";"0";"2";"2";"0";"2";"0";"430522";"5766"
"LOK1378_1mm";"SILVA (only NR);Bacteria;Cyanobacteria;Cyanobacteriia;Cyanobacteriales;Cyanobacteriaceae;Symphothece PCC-7002;";"0.0";"0";"29";"29";"0";"29";"0";"430495";"5766"
"LOK1378_1mm";"SILVA (only NR);Bacteria;Cyanobacteria;Cyanobacteriia;Cyanobacteriales;Cyanobacteriaceae;Synechocystis SAG 90.79;";"0.0";"0";"3";"3";"0";"3";"0";"430521";"5766"
"LOK1378_1mm";"SILVA (only NR);Bacteria;Cyanobacteria;Cyanobacteriia;Cyanobacteriales;Cyanobacteriaceae;uncultured;";"0.0";"0";"23";"22";"0";"22";"1";"430502";"5766"
"LOK1378_1mm";"SILVA (only NR);Bacteria;Cyanobacteria;Cyanobacteriia;Cyanobacteriales;Cyanobacteriales Incertae Sedis;";"0.0";"0";"17";"17";"0";"17";"0";"430507";"5766"
"LOK1378_1mm";"SILVA (only NR);Bacteria;Cyanobacteria;Cyanobacteriia;Cyanobacteriales;Cyanobacteriales Incertae Sedis;Microseira Carmichael-Alabama;";"0.0";"0";"11";"11";"0";"11";"0";"430513";"5766"
"LOK1378_1mm";"SILVA (only NR);Bacteria;Cyanobacteria;Cyanobacteriia;Cyanobacteriales;Cyanobacteriales Incertae Sedis;Phormidium SAG 81.79;";"0.0";"0";"2";"2";"0";"2";"0";"430522";"5766"
"LOK1378_1mm";"SILVA (only NR);Bacteria;Cyanobacteria;Cyanobacteriia;Cyanobacteriales;Cyanobacteriales Incertae Sedis;uncultured;";"0.0";"0";"2";"2";"0";"2";"0";"430522";"5766"
"LOK1378_1mm";"SILVA (only NR);Bacteria;Cyanobacteria;Cyanobacteriia;Cyanobacteriales;Desertifilaceae;";"0.0";"0";"31";"31";"0";"31";"0";"430493";"5766"
"LOK1378_1mm";"SILVA (only NR);Bacteria;Cyanobacteria;Cyanobacteriia;Cyanobacteriales;Desertifilaceae;CENA533;";"0.0";"0";"2";"2";"0";"2";"0";"430522";"5766"
"LOK1378_1mm";"SILVA (only NR);Bacteria;Cyanobacteria;Cyanobacteriia;Cyanobacteriales;Desertifilaceae;Desertifilum KR2012-2;";"0.0";"0";"3";"3";"0";"3";"0";"430521";"5766"
"LOK1378_1mm";"SILVA (only NR);Bacteria;Cyanobacteria;Cyanobacteriia;Cyanobacteriales;Desertifilaceae;Hormoscilla SI04-45;";"0.0";"0";"12";"12";"0";"12";"0";"430512";"5766"
"LOK1378_1mm";"SILVA (only NR);Bacteria;Cyanobacteria;Cyanobacteriia;Cyanobacteriales;Desertifilaceae;Oscillatoria SAG8.92;";"0.0";"0";"2";"2";"0";"2";"0";"430522";"5766"
"LOK1378_1mm";"SILVA (only NR);Bacteria;Cyanobacteria;Cyanobacteriia;Cyanobacteriales;Desertifilaceae;Oscillatoria;";"0.0";"0";"1";"1";"0";"1";"0";"430523";"5766"
"LOK1378_1mm";"SILVA (only NR);Bacteria;Cyanobacteria;Cyanobacteriia;Cyanobacteriales;Desertifilaceae;Roseofilum AO1-A;";"0.0";"0";"9";"9";"0";"9";"0";"430515";"5766"
"LOK1378_1mm";"SILVA (only NR);Bacteria;Cyanobacteria;Cyanobacteriia;Cyanobacteriales;Geitlerinemaceae;";"0.0";"0";"27";"25";"0";"25";"2";"430499";"5766"
"LOK1378_1mm";"SILVA (only NR);Bacteria;Cyanobacteria;Cyanobacteriia;Cyanobacteriales;Geitlerinemaceae;Geitlerinema PCC-7105;";"0.0";"0";"22";"20";"0";"20";"2";"430504";"5766"
"LOK1378_1mm";"SILVA (only NR);Bacteria;Cyanobacteria;Cyanobacteriia;Cyanobacteriales;Geitlerinemaceae;Geitlerinema PCC-9228;";"0.0";"0";"4";"4";"0";"4";"0";"430520";"5766"
"LOK1378_1mm";"SILVA (only NR);Bacteria;Cyanobacteria;Cyanobacteriia;Cyanobacteriales;Gloeocapsaceae;";"0.0";"0";"18";"18";"0";"18";"0";"430506";"5766"
"LOK1378_1mm";"SILVA (only NR);Bacteria;Cyanobacteria;Cyanobacteriia;Cyanobacteriales;Gloeocapsaceae;Gloeocapsa;";"0.0";"0";"18";"18";"0";"18";"0";"430506";"5766"
"LOK1378_1mm";"SILVA (only NR);Bacteria;Cyanobacteria;Cyanobacteriia;Cyanobacteriales;Microcystaceae;";"0.0";"0";"182";"176";"0";"176";"6";"430348";"5766"
"LOK1378_1mm";"SILVA (only NR);Bacteria;Cyanobacteria;Cyanobacteriia;Cyanobacteriales;Microcystaceae;Aphanotece;";"0.0";"0";"1";"1";"0";"1";"0";"430523";"5766"
"LOK1378_1mm";"SILVA (only NR);Bacteria;Cyanobacteria;Cyanobacteriia;Cyanobacteriales;Microcystaceae;Atelocyanobacterium (UCYN-A);";"0.0";"0";"3";"3";"0";"3";"0";"430521";"5766"
"LOK1378_1mm";"SILVA (only NR);Bacteria;Cyanobacteria;Cyanobacteriia;Cyanobacteriales;Microcystaceae;Chalicogloea CCALA 975;";"0.0";"0";"11";"11";"0";"11";"0";"430513";"5766"
"LOK1378_1mm";"SILVA (only NR);Bacteria;Cyanobacteria;Cyanobacteriia;Cyanobacteriales;Microcystaceae;Crocosphaera;";"0.0";"0";"1";"1";"0";"1";"0";"430523";"5766"
"LOK1378_1mm";"SILVA (only NR);Bacteria;Cyanobacteria;Cyanobacteriia;Cyanobacteriales;Microcystaceae;Cyanothece ATCC 51142 (UCYN-C);";"0.0";"0";"3";"3";"0";"3";"0";"430521";"5766"
"LOK1378_1mm";"SILVA (only NR);Bacteria;Cyanobacteria;Cyanobacteriia;Cyanobacteriales;Microcystaceae;Cyanothece PCC-7424;";"0.0";"0";"6";"6";"0";"6";"0";"430518";"5766"
"LOK1378_1mm";"SILVA (only NR);Bacteria;Cyanobacteria;Cyanobacteriia;Cyanobacteriales;Microcystaceae;Cyanothece PCC-8801;";"0.0";"0";"4";"4";"0";"4";"0";"430520";"5766"
"LOK1378_1mm";"SILVA (only NR);Bacteria;Cyanobacteria;Cyanobacteriia;Cyanobacteriales;Microcystaceae;Gloeothece PCC-6501;";"0.0";"0";"3";"3";"0";"3";"0";"430521";"5766"
"LOK1378_1mm";"SILVA (only NR);Bacteria;Cyanobacteria;Cyanobacteriia;Cyanobacteriales;Microcystaceae;Merismopedia 0BB39S01;";"0.0";"0";"3";"3";"0";"3";"0";"430521";"5766"
"LOK1378_1mm";"SILVA (only NR);Bacteria;Cyanobacteria;Cyanobacteriia;Cyanobacteriales;Microcystaceae;Microcystis PCC-7914;";"0.0";"0";"73";"73";"0";"73";"0";"430451";"5766"
"LOK1378_1mm";"SILVA (only NR);Bacteria;Cyanobacteria;Cyanobacteriia;Cyanobacteriales;Microcystaceae;Pleurocapsa PCC-7327;";"0.0";"0";"5";"4";"0";"4";"1";"430520";"5766"
"LOK1378_1mm";"SILVA (only NR);Bacteria;Cyanobacteria;Cyanobacteriia;Cyanobacteriales;Microcystaceae;SU2 symbiont group;";"0.0";"0";"7";"7";"0";"7";"0";"430517";"5766"
"LOK1378_1mm";"SILVA (only NR);Bacteria;Cyanobacteria;Cyanobacteriia;Cyanobacteriales;Microcystaceae;Snowella 0TU37S04;";"0.0";"0";"12";"12";"0";"12";"0";"430512";"5766"
"LOK1378_1mm";"SILVA (only NR);Bacteria;Cyanobacteria;Cyanobacteriia;Cyanobacteriales;Microcystaceae;Synechocystis BDHKU-20401;";"0.0";"0";"12";"12";"0";"12";"0";"430512";"5766"
"LOK1378_1mm";"SILVA (only NR);Bacteria;Cyanobacteria;Cyanobacteriia;Cyanobacteriales;Microcystaceae;Synechocystis CCALA 700;";"0.0";"0";"4";"3";"0";"3";"1";"430521";"5766"
"LOK1378_1mm";"SILVA (only NR);Bacteria;Cyanobacteria;Cyanobacteriia;Cyanobacteriales;Microcystaceae;Synechocystis PCC-6803;";"0.0";"0";"27";"24";"0";"24";"3";"430500";"5766"
"LOK1378_1mm";"SILVA (only NR);Bacteria;Cyanobacteria;Cyanobacteriia;Cyanobacteriales;Microcystaceae;UCYN-C;";"0.0";"0";"2";"2";"0";"2";"0";"430522";"5766"
"LOK1378_1mm";"SILVA (only NR);Bacteria;Cyanobacteria;Cyanobacteriia;Cyanobacteriales;Microcystaceae;uncultured;";"0.0";"0";"2";"2";"0";"2";"0";"430522";"5766"
"LOK1378_1mm";"SILVA (only NR);Bacteria;Cyanobacteria;Cyanobacteriia;Cyanobacteriales;Nostocaceae;";"0.0";"0";"1092";"1071";"0";"1071";"21";"429453";"5766"
"LOK1378_1mm";"SILVA (only NR);Bacteria;Cyanobacteria;Cyanobacteriia;Cyanobacteriales;Nostocaceae;Aetokthonos AEL04;";"0.0";"0";"2";"2";"0";"2";"0";"430522";"5766"
"LOK1378_1mm";"SILVA (only NR);Bacteria;Cyanobacteria;Cyanobacteriia;Cyanobacteriales;Nostocaceae;Anabaena BECID22;";"0.0";"0";"3";"3";"0";"3";"0";"430521";"5766"
"LOK1378_1mm";"SILVA (only NR);Bacteria;Cyanobacteria;Cyanobacteriia;Cyanobacteriales;Nostocaceae;Anabaena HBU1;";"0.0";"0";"2";"2";"0";"2";"0";"430522";"5766"
"LOK1378_1mm";"SILVA (only NR);Bacteria;Cyanobacteria;Cyanobacteriia;Cyanobacteriales;Nostocaceae;Anabaena PCC-7108;";"0.0";"0";"5";"5";"0";"5";"0";"430519";"5766"
"LOK1378_1mm";"SILVA (only NR);Bacteria;Cyanobacteria;Cyanobacteriia;Cyanobacteriales;Nostocaceae;Anabaena PCC-7122;";"0.0";"0";"23";"22";"0";"22";"1";"430502";"5766"
"LOK1378_1mm";"SILVA (only NR);Bacteria;Cyanobacteria;Cyanobacteriia;Cyanobacteriales;Nostocaceae;Anabaena XPORK15F;";"0.0";"0";"5";"5";"0";"5";"0";"430519";"5766"
"LOK1378_1mm";"SILVA (only NR);Bacteria;Cyanobacteria;Cyanobacteriia;Cyanobacteriales;Nostocaceae;Anabaenopsis;";"0.0";"0";"1";"1";"0";"1";"0";"430523";"5766"
"LOK1378_1mm";"SILVA (only NR);Bacteria;Cyanobacteria;Cyanobacteriia;Cyanobacteriales;Nostocaceae;Ancylothrix 8PC;";"0.0";"0";"4";"4";"0";"4";"0";"430520";"5766"
"LOK1378_1mm";"SILVA (only NR);Bacteria;Cyanobacteria;Cyanobacteriia;Cyanobacteriales;Nostocaceae;Aphanizomenon MDT14a;";"0.0";"0";"11";"11";"0";"11";"0";"430513";"5766"
"LOK1378_1mm";"SILVA (only NR);Bacteria;Cyanobacteria;Cyanobacteriia;Cyanobacteriales;Nostocaceae;Aphanizomenon NIES81;";"0.0";"0";"27";"27";"0";"27";"0";"430497";"5766"
"LOK1378_1mm";"SILVA (only NR);Bacteria;Cyanobacteria;Cyanobacteriia;Cyanobacteriales;Nostocaceae;Calothrix NIES-2100;";"0.0";"0";"2";"2";"0";"2";"0";"430522";"5766"
"LOK1378_1mm";"SILVA (only NR);Bacteria;Cyanobacteria;Cyanobacteriia;Cyanobacteriales;Nostocaceae;Calothrix PCC-6303;";"0.0";"0";"89";"87";"0";"87";"2";"430437";"5766"
"LOK1378_1mm";"SILVA (only NR);Bacteria;Cyanobacteria;Cyanobacteriia;Cyanobacteriales;Nostocaceae;Calothrix PCC-7507;";"0.0";"0";"3";"3";"0";"3";"0";"430521";"5766"
"LOK1378_1mm";"SILVA (only NR);Bacteria;Cyanobacteria;Cyanobacteriia;Cyanobacteriales;Nostocaceae;Calothrix PMC232.04;";"0.0";"0";"3";"3";"0";"3";"0";"430521";"5766"
"LOK1378_1mm";"SILVA (only NR);Bacteria;Cyanobacteria;Cyanobacteriia;Cyanobacteriales;Nostocaceae;Calothrix UAM 374;";"0.0";"0";"11";"11";"0";"11";"0";"430513";"5766"
"LOK1378_1mm";"SILVA (only NR);Bacteria;Cyanobacteria;Cyanobacteriia;Cyanobacteriales;Nostocaceae;Chlorogloeopsis PCC-7518;";"0.0";"0";"8";"8";"0";"8";"0";"430516";"5766"
"LOK1378_1mm";"SILVA (only NR);Bacteria;Cyanobacteria;Cyanobacteriia;Cyanobacteriales;Nostocaceae;Cuspidothrix LMECYA 163;";"0.0";"0";"10";"9";"0";"9";"1";"430515";"5766"
"LOK1378_1mm";"SILVA (only NR);Bacteria;Cyanobacteria;Cyanobacteriia;Cyanobacteriales;Nostocaceae;Cylindrospermopsis CRJ1;";"0.0";"0";"17";"17";"0";"17";"0";"430507";"5766"
"LOK1378_1mm";"SILVA (only NR);Bacteria;Cyanobacteria;Cyanobacteriia;Cyanobacteriales;Nostocaceae;Cylindrospermum CENA33;";"0.0";"0";"2";"2";"0";"2";"0";"430522";"5766"
"LOK1378_1mm";"SILVA (only NR);Bacteria;Cyanobacteria;Cyanobacteriia;Cyanobacteriales;Nostocaceae;Cylindrospermum NQAIF308;";"0.0";"0";"2";"1";"0";"1";"1";"430523";"5766"
"LOK1378_1mm";"SILVA (only NR);Bacteria;Cyanobacteria;Cyanobacteriia;Cyanobacteriales;Nostocaceae;Cylindrospermum PCC-7417;";"0.0";"0";"9";"8";"0";"8";"1";"430516";"5766"
"LOK1378_1mm";"SILVA (only NR);Bacteria;Cyanobacteria;Cyanobacteriia;Cyanobacteriales;Nostocaceae;Cylindrospermum PMC238.04;";"0.0";"0";"2";"2";"0";"2";"0";"430522";"5766"
"LOK1378_1mm";"SILVA (only NR);Bacteria;Cyanobacteria;Cyanobacteriia;Cyanobacteriales;Nostocaceae;Cylindrospermum SAG 11.82;";"0.0";"0";"2";"2";"0";"2";"0";"430522";"5766"
"LOK1378_1mm";"SILVA (only NR);Bacteria;Cyanobacteria;Cyanobacteriia;Cyanobacteriales;Nostocaceae;Desmonostoc PCC-6302;";"0.0";"0";"3";"3";"0";"3";"0";"430521";"5766"
"LOK1378_1mm";"SILVA (only NR);Bacteria;Cyanobacteria;Cyanobacteriia;Cyanobacteriales;Nostocaceae;Desmonostoc PCC-7422;";"0.0";"0";"38";"38";"0";"38";"0";"430486";"5766"
"LOK1378_1mm";"SILVA (only NR);Bacteria;Cyanobacteria;Cyanobacteriia;Cyanobacteriales;Nostocaceae;Dolichospermum NIES41;";"0.0";"0";"52";"50";"0";"50";"2";"430474";"5766"
"LOK1378_1mm";"SILVA (only NR);Bacteria;Cyanobacteria;Cyanobacteriia;Cyanobacteriales;Nostocaceae;Ewamiania TS0513;";"0.0";"0";"2";"2";"0";"2";"0";"430522";"5766"
"LOK1378_1mm";"SILVA (only NR);Bacteria;Cyanobacteria;Cyanobacteriia;Cyanobacteriales;Nostocaceae;Fischerella CENA298;";"0.0";"0";"2";"2";"0";"2";"0";"430522";"5766"
"LOK1378_1mm";"SILVA (only NR);Bacteria;Cyanobacteria;Cyanobacteriia;Cyanobacteriales;Nostocaceae;Fischerella PCC-9339;";"0.0";"0";"54";"54";"0";"54";"0";"430470";"5766"
"LOK1378_1mm";"SILVA (only NR);Bacteria;Cyanobacteria;Cyanobacteriia;Cyanobacteriales;Nostocaceae;Fortiea PCC-7126;";"0.0";"0";"1";"1";"0";"1";"0";"430523";"5766"
"LOK1378_1mm";"SILVA (only NR);Bacteria;Cyanobacteria;Cyanobacteriia;Cyanobacteriales;Nostocaceae;Gloeotrichia PYH6;";"0.0";"0";"2";"2";"0";"2";"0";"430522";"5766"
"LOK1378_1mm";"SILVA (only NR);Bacteria;Cyanobacteria;Cyanobacteriia;Cyanobacteriales;Nostocaceae;Gloeotrichia SAG 32.84;";"0.0";"0";"3";"2";"0";"2";"1";"430522";"5766"
"LOK1378_1mm";"SILVA (only NR);Bacteria;Cyanobacteria;Cyanobacteriia;Cyanobacteriales;Nostocaceae;Halotia CENA158;";"0.0";"0";"3";"3";"0";"3";"0";"430521";"5766"
"LOK1378_1mm";"SILVA (only NR);Bacteria;Cyanobacteria;Cyanobacteriia;Cyanobacteriales;Nostocaceae;Iphinoe LOS-B1;";"0.0";"0";"4";"4";"0";"4";"0";"430520";"5766"
"LOK1378_1mm";"SILVA (only NR);Bacteria;Cyanobacteria;Cyanobacteriia;Cyanobacteriales;Nostocaceae;Mastigocladopsis PCC-10914;";"0.0";"0";"18";"17";"0";"17";"1";"430507";"5766"
"LOK1378_1mm";"SILVA (only NR);Bacteria;Cyanobacteria;Cyanobacteriia;Cyanobacteriales;Nostocaceae;Mastigocoleus BC008;";"0.0";"0";"2";"2";"0";"2";"0";"430522";"5766"
"LOK1378_1mm";"SILVA (only NR);Bacteria;Cyanobacteria;Cyanobacteriia;Cyanobacteriales;Nostocaceae;Nodularia PCC-9350;";"0.0";"0";"41";"41";"0";"41";"0";"430483";"5766"
"LOK1378_1mm";"SILVA (only NR);Bacteria;Cyanobacteria;Cyanobacteriia;Cyanobacteriales;Nostocaceae;Nostoc 0708;";"0.0";"0";"1";"1";"0";"1";"0";"430523";"5766"
"LOK1378_1mm";"SILVA (only NR);Bacteria;Cyanobacteria;Cyanobacteriia;Cyanobacteriales;Nostocaceae;Nostoc BDU-40302;";"0.0";"0";"7";"6";"0";"6";"1";"430518";"5766"
"LOK1378_1mm";"SILVA (only NR);Bacteria;Cyanobacteria;Cyanobacteriia;Cyanobacteriales;Nostocaceae;Nostoc PCC-7107;";"0.0";"0";"48";"48";"0";"48";"0";"430476";"5766"
"LOK1378_1mm";"SILVA (only NR);Bacteria;Cyanobacteria;Cyanobacteriia;Cyanobacteriales;Nostocaceae;Nostoc PCC-73102;";"0.0";"0";"145";"143";"0";"143";"2";"430381";"5766"
"LOK1378_1mm";"SILVA (only NR);Bacteria;Cyanobacteria;Cyanobacteriia;Cyanobacteriales;Nostocaceae;Nostoc PCC-7524;";"0.0";"0";"55";"53";"0";"53";"2";"430471";"5766"
"LOK1378_1mm";"SILVA (only NR);Bacteria;Cyanobacteria;Cyanobacteriia;Cyanobacteriales;Nostocaceae;Nostoc PCC-8976;";"0.0";"0";"31";"31";"0";"31";"0";"430493";"5766"
"LOK1378_1mm";"SILVA (only NR);Bacteria;Cyanobacteria;Cyanobacteriia;Cyanobacteriales;Nostocaceae;Nostoc SAG 60.79;";"0.0";"0";"6";"6";"0";"6";"0";"430518";"5766"
"LOK1378_1mm";"SILVA (only NR);Bacteria;Cyanobacteria;Cyanobacteriia;Cyanobacteriales;Nostocaceae;Nostoc;";"0.0";"0";"1";"1";"0";"1";"0";"430523";"5766"
"LOK1378_1mm";"SILVA (only NR);Bacteria;Cyanobacteria;Cyanobacteriia;Cyanobacteriales;Nostocaceae;Petalonema ANT.LG2.8;";"0.0";"0";"8";"8";"0";"8";"0";"430516";"5766"
"LOK1378_1mm";"SILVA (only NR);Bacteria;Cyanobacteria;Cyanobacteriia;Cyanobacteriales;Nostocaceae;Phyllonema CENA325;";"0.0";"0";"2";"2";"0";"2";"0";"430522";"5766"
"LOK1378_1mm";"SILVA (only NR);Bacteria;Cyanobacteria;Cyanobacteriia;Cyanobacteriales;Nostocaceae;Richelia HH01;";"0.0";"0";"5";"5";"0";"5";"0";"430519";"5766"
"LOK1378_1mm";"SILVA (only NR);Bacteria;Cyanobacteria;Cyanobacteriia;Cyanobacteriales;Nostocaceae;Rivularia PCC-7116;";"0.0";"0";"42";"42";"0";"42";"0";"430482";"5766"
"LOK1378_1mm";"SILVA (only NR);Bacteria;Cyanobacteria;Cyanobacteriia;Cyanobacteriales;Nostocaceae;Scytonema PCC-7110;";"0.0";"0";"19";"19";"0";"19";"0";"430505";"5766"
"LOK1378_1mm";"SILVA (only NR);Bacteria;Cyanobacteria;Cyanobacteriia;Cyanobacteriales;Nostocaceae;Scytonema UCFS19;";"0.0";"0";"4";"4";"0";"4";"0";"430520";"5766"
"LOK1378_1mm";"SILVA (only NR);Bacteria;Cyanobacteria;Cyanobacteriia;Cyanobacteriales;Nostocaceae;Scytonema UTEX 2349;";"0.0";"0";"37";"37";"0";"37";"0";"430487";"5766"
"LOK1378_1mm";"SILVA (only NR);Bacteria;Cyanobacteria;Cyanobacteriia;Cyanobacteriales;Nostocaceae;Scytonema VB-61278;";"0.0";"0";"25";"25";"0";"25";"0";"430499";"5766"
"LOK1378_1mm";"SILVA (only NR);Bacteria;Cyanobacteria;Cyanobacteriia;Cyanobacteriales;Nostocaceae;Sphaerospermopsis BCCUSP55;";"0.0";"0";"26";"24";"0";"24";"2";"430500";"5766"
"LOK1378_1mm";"SILVA (only NR);Bacteria;Cyanobacteria;Cyanobacteriia;Cyanobacteriales;Nostocaceae;Stigonema SAG 48.90;";"0.0";"0";"31";"31";"0";"31";"0";"430493";"5766"
"LOK1378_1mm";"SILVA (only NR);Bacteria;Cyanobacteria;Cyanobacteriia;Cyanobacteriales;Nostocaceae;Synechococcus PCC-7902;";"0.0";"0";"2";"1";"0";"1";"1";"430523";"5766"
"LOK1378_1mm";"SILVA (only NR);Bacteria;Cyanobacteria;Cyanobacteriia;Cyanobacteriales;Nostocaceae;Tolypothrix;";"0.0";"0";"63";"62";"0";"62";"1";"430462";"5766"
"LOK1378_1mm";"SILVA (only NR);Bacteria;Cyanobacteria;Cyanobacteriia;Cyanobacteriales;Nostocaceae;Trichormus HINDAK 2001-4;";"0.0";"0";"5";"5";"0";"5";"0";"430519";"5766"
"LOK1378_1mm";"SILVA (only NR);Bacteria;Cyanobacteria;Cyanobacteriia;Cyanobacteriales;Nostocaceae;uncultured;";"0.0";"0";"30";"28";"0";"28";"2";"430496";"5766"
"LOK1378_1mm";"SILVA (only NR);Bacteria;Cyanobacteria;Cyanobacteriia;Cyanobacteriales;Oscillatoriaceae;";"0.0";"0";"65";"59";"0";"59";"6";"430465";"5766"
"LOK1378_1mm";"SILVA (only NR);Bacteria;Cyanobacteria;Cyanobacteriia;Cyanobacteriales;Oscillatoriaceae;Oscillatoria PCC-10802;";"0.0";"0";"21";"18";"0";"18";"3";"430506";"5766"
"LOK1378_1mm";"SILVA (only NR);Bacteria;Cyanobacteria;Cyanobacteriia;Cyanobacteriales;Oscillatoriaceae;Oscillatoria PCC-6304;";"0.0";"0";"19";"17";"0";"17";"2";"430507";"5766"
"LOK1378_1mm";"SILVA (only NR);Bacteria;Cyanobacteria;Cyanobacteriia;Cyanobacteriales;Oscillatoriaceae;Oxynema BDU 92071;";"0.0";"0";"5";"5";"0";"5";"0";"430519";"5766"
"LOK1378_1mm";"SILVA (only NR);Bacteria;Cyanobacteria;Cyanobacteriia;Cyanobacteriales;Oscillatoriaceae;Phormidium ETS-05;";"0.0";"0";"5";"5";"0";"5";"0";"430519";"5766"
"LOK1378_1mm";"SILVA (only NR);Bacteria;Cyanobacteria;Cyanobacteriia;Cyanobacteriales;Oscillatoriaceae;Planktothricoides SR001;";"0.0";"0";"9";"9";"0";"9";"0";"430515";"5766"
"LOK1378_1mm";"SILVA (only NR);Bacteria;Cyanobacteria;Cyanobacteriia;Cyanobacteriales;Oscillatoriaceae;uncultured;";"0.0";"0";"6";"5";"0";"5";"1";"430519";"5766"
"LOK1378_1mm";"SILVA (only NR);Bacteria;Cyanobacteria;Cyanobacteriia;Cyanobacteriales;Paraspirulinaceae;";"0.0";"0";"62";"58";"0";"58";"4";"430466";"5766"
"LOK1378_1mm";"SILVA (only NR);Bacteria;Cyanobacteria;Cyanobacteriia;Cyanobacteriales;Paraspirulinaceae;ESFC-1;";"0.0";"0";"13";"10";"0";"10";"3";"430514";"5766"
"LOK1378_1mm";"SILVA (only NR);Bacteria;Cyanobacteria;Cyanobacteriia;Cyanobacteriales;Paraspirulinaceae;Halospirulina CCC Baja-95 Cl.2;";"0.0";"0";"10";"10";"0";"10";"0";"430514";"5766"
"LOK1378_1mm";"SILVA (only NR);Bacteria;Cyanobacteria;Cyanobacteriia;Cyanobacteriales;Paraspirulinaceae;Spirulina CCC Snake P-Y-85;";"0.0";"0";"12";"11";"0";"11";"1";"430513";"5766"
"LOK1378_1mm";"SILVA (only NR);Bacteria;Cyanobacteria;Cyanobacteriia;Cyanobacteriales;Paraspirulinaceae;Spirulina DRTO-55.2;";"0.0";"0";"4";"4";"0";"4";"0";"430520";"5766"
"LOK1378_1mm";"SILVA (only NR);Bacteria;Cyanobacteria;Cyanobacteriia;Cyanobacteriales;Paraspirulinaceae;Spirulina P7;";"0.0";"0";"4";"4";"0";"4";"0";"430520";"5766"
"LOK1378_1mm";"SILVA (only NR);Bacteria;Cyanobacteria;Cyanobacteriia;Cyanobacteriales;Paraspirulinaceae;Spirulina PCC-6313;";"0.0";"0";"6";"6";"0";"6";"0";"430518";"5766"
"LOK1378_1mm";"SILVA (only NR);Bacteria;Cyanobacteria;Cyanobacteriia;Cyanobacteriales;Paraspirulinaceae;Spirulina PCC-9445;";"0.0";"0";"5";"5";"0";"5";"0";"430519";"5766"
"LOK1378_1mm";"SILVA (only NR);Bacteria;Cyanobacteria;Cyanobacteriia;Cyanobacteriales;Paraspirulinaceae;uncultured;";"0.0";"0";"5";"5";"0";"5";"0";"430519";"5766"
"LOK1378_1mm";"SILVA (only NR);Bacteria;Cyanobacteria;Cyanobacteriia;Cyanobacteriales;Phormidiaceae;";"0.0";"0";"307";"302";"0";"302";"5";"430222";"5766"
"LOK1378_1mm";"SILVA (only NR);Bacteria;Cyanobacteria;Cyanobacteriia;Cyanobacteriales;Phormidiaceae;Aerosakkonema Lao26;";"0.0";"0";"2";"2";"0";"2";"0";"430522";"5766"
"LOK1378_1mm";"SILVA (only NR);Bacteria;Cyanobacteria;Cyanobacteriia;Cyanobacteriales;Phormidiaceae;Arthrospira PCC-7345;";"0.0";"0";"38";"37";"0";"37";"1";"430487";"5766"
"LOK1378_1mm";"SILVA (only NR);Bacteria;Cyanobacteria;Cyanobacteriia;Cyanobacteriales;Phormidiaceae;Cephalothrix SAG 75.79;";"0.0";"0";"14";"14";"0";"14";"0";"430510";"5766"
"LOK1378_1mm";"SILVA (only NR);Bacteria;Cyanobacteria;Cyanobacteriia;Cyanobacteriales;Phormidiaceae;Kamptonema PCC-6407;";"0.0";"0";"10";"10";"0";"10";"0";"430514";"5766"
"LOK1378_1mm";"SILVA (only NR);Bacteria;Cyanobacteria;Cyanobacteriia;Cyanobacteriales;Phormidiaceae;Lyngbya PCC-7419;";"0.0";"0";"44";"42";"0";"42";"2";"430482";"5766"
"LOK1378_1mm";"SILVA (only NR);Bacteria;Cyanobacteria;Cyanobacteriia;Cyanobacteriales;Phormidiaceae;Phormidium IAM M-71;";"0.0";"0";"17";"16";"0";"16";"1";"430508";"5766"
"LOK1378_1mm";"SILVA (only NR);Bacteria;Cyanobacteria;Cyanobacteriia;Cyanobacteriales;Phormidiaceae;Planktothrix NIVA-CYA 15;";"0.0";"0";"61";"61";"0";"61";"0";"430463";"5766"
"LOK1378_1mm";"SILVA (only NR);Bacteria;Cyanobacteria;Cyanobacteriia;Cyanobacteriales;Phormidiaceae;Trichocoleus SAG 26.92;";"0.0";"0";"6";"6";"0";"6";"0";"430518";"5766"
"LOK1378_1mm";"SILVA (only NR);Bacteria;Cyanobacteria;Cyanobacteriia;Cyanobacteriales;Phormidiaceae;Trichodesmium IMS101;";"0.0";"0";"40";"40";"0";"40";"0";"430484";"5766"
"LOK1378_1mm";"SILVA (only NR);Bacteria;Cyanobacteria;Cyanobacteriia;Cyanobacteriales;Phormidiaceae;Tychonema CCAP 1459-11B;";"0.0";"0";"57";"56";"0";"56";"1";"430468";"5766"
"LOK1378_1mm";"SILVA (only NR);Bacteria;Cyanobacteria;Cyanobacteriia;Cyanobacteriales;Phormidiaceae;uncultured;";"0.0";"0";"13";"13";"0";"13";"0";"430511";"5766"
"LOK1378_1mm";"SILVA (only NR);Bacteria;Cyanobacteria;Cyanobacteriia;Cyanobacteriales;Prochloraceae;";"0.0";"0";"14";"13";"0";"13";"1";"430511";"5766"
"LOK1378_1mm";"SILVA (only NR);Bacteria;Cyanobacteria;Cyanobacteriia;Cyanobacteriales;Prochloraceae;Prochloron P1-Palau;";"0.0";"0";"14";"13";"0";"13";"1";"430511";"5766"
"LOK1378_1mm";"SILVA (only NR);Bacteria;Cyanobacteria;Cyanobacteriia;Cyanobacteriales;Rubidibacteraceae;";"0.0";"0";"89";"87";"0";"87";"2";"430437";"5766"
"LOK1378_1mm";"SILVA (only NR);Bacteria;Cyanobacteria;Cyanobacteriia;Cyanobacteriales;Rubidibacteraceae;Dactylococcopsis PCC-8305;";"0.0";"0";"82";"80";"0";"80";"2";"430444";"5766"
"LOK1378_1mm";"SILVA (only NR);Bacteria;Cyanobacteria;Cyanobacteriia;Cyanobacteriales;Rubidibacteraceae;Rubidibacter KORDI 51-2;";"0.0";"0";"2";"2";"0";"2";"0";"430522";"5766"
"LOK1378_1mm";"SILVA (only NR);Bacteria;Cyanobacteria;Cyanobacteriia;Cyanobacteriales;Rubidibacteraceae;uncultured;";"0.0";"0";"5";"5";"0";"5";"0";"430519";"5766"
"LOK1378_1mm";"SILVA (only NR);Bacteria;Cyanobacteria;Cyanobacteriia;Cyanobacteriales;Xenococcaceae;";"0.0";"0";"123";"118";"0";"118";"5";"430406";"5766"
"LOK1378_1mm";"SILVA (only NR);Bacteria;Cyanobacteria;Cyanobacteriia;Cyanobacteriales;Xenococcaceae;Chroococcidiopsis PCC-6712;";"0.0";"0";"6";"6";"0";"6";"0";"430518";"5766"
"LOK1378_1mm";"SILVA (only NR);Bacteria;Cyanobacteria;Cyanobacteriia;Cyanobacteriales;Xenococcaceae;Chroococcopsis;";"0.0";"0";"1";"1";"0";"1";"0";"430523";"5766"
"LOK1378_1mm";"SILVA (only NR);Bacteria;Cyanobacteria;Cyanobacteriia;Cyanobacteriales;Xenococcaceae;Foliisarcina;";"0.0";"0";"1";"1";"0";"1";"0";"430523";"5766"
"LOK1378_1mm";"SILVA (only NR);Bacteria;Cyanobacteria;Cyanobacteriia;Cyanobacteriales;Xenococcaceae;Gloeocapsopsis BDHKU 35101;";"0.0";"0";"2";"2";"0";"2";"0";"430522";"5766"
"LOK1378_1mm";"SILVA (only NR);Bacteria;Cyanobacteria;Cyanobacteriia;Cyanobacteriales;Xenococcaceae;Myxosarcina GI1;";"0.0";"0";"2";"1";"0";"1";"1";"430523";"5766"
"LOK1378_1mm";"SILVA (only NR);Bacteria;Cyanobacteria;Cyanobacteriia;Cyanobacteriales;Xenococcaceae;Pleurocapsa PCC-7319;";"0.0";"0";"58";"54";"0";"54";"4";"430470";"5766"
"LOK1378_1mm";"SILVA (only NR);Bacteria;Cyanobacteria;Cyanobacteriia;Cyanobacteriales;Xenococcaceae;Stanieria PCC-7437;";"0.0";"0";"4";"4";"0";"4";"0";"430520";"5766"
"LOK1378_1mm";"SILVA (only NR);Bacteria;Cyanobacteria;Cyanobacteriia;Cyanobacteriales;Xenococcaceae;Xenococcus CRM;";"0.0";"0";"7";"7";"0";"7";"0";"430517";"5766"
"LOK1378_1mm";"SILVA (only NR);Bacteria;Cyanobacteria;Cyanobacteriia;Cyanobacteriales;Xenococcaceae;Xenococcus PCC-7305;";"0.0";"0";"18";"18";"0";"18";"0";"430506";"5766"
"LOK1378_1mm";"SILVA (only NR);Bacteria;Cyanobacteria;Cyanobacteriia;Cyanobacteriales;Xenococcaceae;uncultured;";"0.0";"0";"23";"23";"0";"23";"0";"430501";"5766"
"LOK1378_1mm";"SILVA (only NR);Bacteria;Cyanobacteria;Cyanobacteriia;Cyanobacteriales;uncultured;";"0.0";"0";"128";"118";"0";"118";"10";"430406";"5766"
"LOK1378_1mm";"SILVA (only NR);Bacteria;Cyanobacteria;Cyanobacteriia;Eurycoccales;";"0.0";"0";"41";"41";"0";"41";"0";"430483";"5766"
"LOK1378_1mm";"SILVA (only NR);Bacteria;Cyanobacteria;Cyanobacteriia;Eurycoccales;Eurycoccales Incertae Sedis;";"0.0";"0";"20";"20";"0";"20";"0";"430504";"5766"
"LOK1378_1mm";"SILVA (only NR);Bacteria;Cyanobacteria;Cyanobacteriia;Eurycoccales;Eurycoccales Incertae Sedis;Candidatus Gloeomargarita;";"0.0";"0";"12";"12";"0";"12";"0";"430512";"5766"
"LOK1378_1mm";"SILVA (only NR);Bacteria;Cyanobacteria;Cyanobacteriia;Eurycoccales;Eurycoccales Incertae Sedis;Synechococcus PCC-7336;";"0.0";"0";"8";"8";"0";"8";"0";"430516";"5766"
"LOK1378_1mm";"SILVA (only NR);Bacteria;Cyanobacteria;Cyanobacteriia;Eurycoccales;Leptococcaceae;";"0.0";"0";"11";"11";"0";"11";"0";"430513";"5766"
"LOK1378_1mm";"SILVA (only NR);Bacteria;Cyanobacteria;Cyanobacteriia;Eurycoccales;Leptococcaceae;Leptococcus JA-3-3Ab;";"0.0";"0";"11";"11";"0";"11";"0";"430513";"5766"
"LOK1378_1mm";"SILVA (only NR);Bacteria;Cyanobacteria;Cyanobacteriia;Eurycoccales;uncultured;";"0.0";"0";"10";"10";"0";"10";"0";"430514";"5766"
"LOK1378_1mm";"SILVA (only NR);Bacteria;Cyanobacteria;Cyanobacteriia;Geitlerinematales;";"0.0";"0";"1";"1";"0";"1";"0";"430523";"5766"
"LOK1378_1mm";"SILVA (only NR);Bacteria;Cyanobacteria;Cyanobacteriia;Geitlerinematales;Geitlerinemataceae;";"0.0";"0";"1";"1";"0";"1";"0";"430523";"5766"
"LOK1378_1mm";"SILVA (only NR);Bacteria;Cyanobacteria;Cyanobacteriia;Geitlerinematales;Geitlerinemataceae;Geitlerinema;";"0.0";"0";"1";"1";"0";"1";"0";"430523";"5766"
"LOK1378_1mm";"SILVA (only NR);Bacteria;Cyanobacteria;Cyanobacteriia;Gloeobacterales;";"0.0";"0";"6";"6";"0";"6";"0";"430518";"5766"
"LOK1378_1mm";"SILVA (only NR);Bacteria;Cyanobacteria;Cyanobacteriia;Gloeobacterales;Gloeobacteraceae;";"0.0";"0";"6";"6";"0";"6";"0";"430518";"5766"
"LOK1378_1mm";"SILVA (only NR);Bacteria;Cyanobacteria;Cyanobacteriia;Gloeobacterales;Gloeobacteraceae;Gloeobacter PCC-7421;";"0.0";"0";"6";"6";"0";"6";"0";"430518";"5766"
"LOK1378_1mm";"SILVA (only NR);Bacteria;Cyanobacteria;Cyanobacteriia;Leptolyngbyales;";"0.0";"0";"617";"586";"0";"586";"31";"429938";"5766"
"LOK1378_1mm";"SILVA (only NR);Bacteria;Cyanobacteria;Cyanobacteriia;Leptolyngbyales;Leptolyngbyaceae;";"0.0";"0";"617";"586";"0";"586";"31";"429938";"5766"
"LOK1378_1mm";"SILVA (only NR);Bacteria;Cyanobacteria;Cyanobacteriia;Leptolyngbyales;Leptolyngbyaceae;Alkalinema CENA528;";"0.0";"0";"2";"2";"0";"2";"0";"430522";"5766"
"LOK1378_1mm";"SILVA (only NR);Bacteria;Cyanobacteria;Cyanobacteriia;Leptolyngbyales;Leptolyngbyaceae;Arthronema SAG 12.89;";"0.0";"0";"4";"4";"0";"4";"0";"430520";"5766"
"LOK1378_1mm";"SILVA (only NR);Bacteria;Cyanobacteria;Cyanobacteriia;Leptolyngbyales;Leptolyngbyaceae;BMM02;";"0.0";"0";"3";"3";"0";"3";"0";"430521";"5766"
"LOK1378_1mm";"SILVA (only NR);Bacteria;Cyanobacteria;Cyanobacteriia;Leptolyngbyales;Leptolyngbyaceae;CENA359;";"0.0";"0";"13";"12";"0";"12";"1";"430512";"5766"
"LOK1378_1mm";"SILVA (only NR);Bacteria;Cyanobacteria;Cyanobacteriia;Leptolyngbyales;Leptolyngbyaceae;CENA384;";"0.0";"0";"2";"2";"0";"2";"0";"430522";"5766"
"LOK1378_1mm";"SILVA (only NR);Bacteria;Cyanobacteria;Cyanobacteriia;Leptolyngbyales;Leptolyngbyaceae;CENA518;";"0.0";"0";"3";"3";"0";"3";"0";"430521";"5766"
"LOK1378_1mm";"SILVA (only NR);Bacteria;Cyanobacteria;Cyanobacteriia;Leptolyngbyales;Leptolyngbyaceae;Calenema;";"0.0";"0";"7";"7";"0";"7";"0";"430517";"5766"
"LOK1378_1mm";"SILVA (only NR);Bacteria;Cyanobacteria;Cyanobacteriia;Leptolyngbyales;Leptolyngbyaceae;Calothrix KVSF5;";"0.0";"0";"14";"13";"0";"13";"1";"430511";"5766"
"LOK1378_1mm";"SILVA (only NR);Bacteria;Cyanobacteria;Cyanobacteriia;Leptolyngbyales;Leptolyngbyaceae;Chamaesiphon PCC-7430;";"0.0";"0";"19";"18";"0";"18";"1";"430506";"5766"
"LOK1378_1mm";"SILVA (only NR);Bacteria;Cyanobacteria;Cyanobacteriia;Leptolyngbyales;Leptolyngbyaceae;EcFYyy-200;";"0.0";"0";"6";"6";"0";"6";"0";"430518";"5766"
"LOK1378_1mm";"SILVA (only NR);Bacteria;Cyanobacteria;Cyanobacteriia;Leptolyngbyales;Leptolyngbyaceae;Fr127;";"0.0";"0";"5";"5";"0";"5";"0";"430519";"5766"
"LOK1378_1mm";"SILVA (only NR);Bacteria;Cyanobacteria;Cyanobacteriia;Leptolyngbyales;Leptolyngbyaceae;Geitlerinema PCC-8501;";"0.0";"0";"18";"16";"0";"16";"2";"430508";"5766"
"LOK1378_1mm";"SILVA (only NR);Bacteria;Cyanobacteria;Cyanobacteriia;Leptolyngbyales;Leptolyngbyaceae;Greenland-10;";"0.0";"0";"2";"2";"0";"2";"0";"430522";"5766"
"LOK1378_1mm";"SILVA (only NR);Bacteria;Cyanobacteria;Cyanobacteriia;Leptolyngbyales;Leptolyngbyaceae;HAVOmat113;";"0.0";"0";"8";"8";"0";"8";"0";"430516";"5766"
"LOK1378_1mm";"SILVA (only NR);Bacteria;Cyanobacteria;Cyanobacteriia;Leptolyngbyales;Leptolyngbyaceae;JSC-12;";"0.0";"0";"9";"9";"0";"9";"0";"430515";"5766"
"LOK1378_1mm";"SILVA (only NR);Bacteria;Cyanobacteria;Cyanobacteriia;Leptolyngbyales;Leptolyngbyaceae;LB3-76;";"0.0";"0";"9";"9";"0";"9";"0";"430515";"5766"
"LOK1378_1mm";"SILVA (only NR);Bacteria;Cyanobacteria;Cyanobacteriia;Leptolyngbyales;Leptolyngbyaceae;Leptolyngbya ANT.L52.2;";"0.0";"0";"41";"37";"0";"37";"4";"430487";"5766"
"LOK1378_1mm";"SILVA (only NR);Bacteria;Cyanobacteria;Cyanobacteriia;Leptolyngbyales;Leptolyngbyaceae;Leptolyngbya ANT.L67.1;";"0.0";"0";"11";"11";"0";"11";"0";"430513";"5766"
"LOK1378_1mm";"SILVA (only NR);Bacteria;Cyanobacteria;Cyanobacteriia;Leptolyngbyales;Leptolyngbyaceae;Leptolyngbya BN43;";"0.0";"0";"3";"2";"0";"2";"1";"430522";"5766"
"LOK1378_1mm";"SILVA (only NR);Bacteria;Cyanobacteria;Cyanobacteriia;Leptolyngbyales;Leptolyngbyaceae;Leptolyngbya Es-Yyy1000;";"0.0";"0";"5";"5";"0";"5";"0";"430519";"5766"
"LOK1378_1mm";"SILVA (only NR);Bacteria;Cyanobacteria;Cyanobacteriia;Leptolyngbyales;Leptolyngbyaceae;Leptolyngbya FYG;";"0.0";"0";"8";"8";"0";"8";"0";"430516";"5766"
"LOK1378_1mm";"SILVA (only NR);Bacteria;Cyanobacteria;Cyanobacteriia;Leptolyngbyales;Leptolyngbyaceae;Leptolyngbya PCC-6306;";"0.0";"0";"35";"33";"0";"33";"2";"430491";"5766"
"LOK1378_1mm";"SILVA (only NR);Bacteria;Cyanobacteria;Cyanobacteriia;Leptolyngbyales;Leptolyngbyaceae;Leptolyngbya RV74;";"0.0";"0";"5";"5";"0";"5";"0";"430519";"5766"
"LOK1378_1mm";"SILVA (only NR);Bacteria;Cyanobacteria;Cyanobacteriia;Leptolyngbyales;Leptolyngbyaceae;Leptolyngbya SAG 2411;";"0.0";"0";"3";"3";"0";"3";"0";"430521";"5766"
"LOK1378_1mm";"SILVA (only NR);Bacteria;Cyanobacteria;Cyanobacteriia;Leptolyngbyales;Leptolyngbyaceae;Leptolyngbya VRUC 135;";"0.0";"0";"28";"28";"0";"28";"0";"430496";"5766"
"LOK1378_1mm";"SILVA (only NR);Bacteria;Cyanobacteria;Cyanobacteriia;Leptolyngbyales;Leptolyngbyaceae;Limnolyngbya CHAB4449;";"0.0";"0";"4";"4";"0";"4";"0";"430520";"5766"
"LOK1378_1mm";"SILVA (only NR);Bacteria;Cyanobacteria;Cyanobacteriia;Leptolyngbyales;Leptolyngbyaceae;MIZ36;";"0.0";"0";"7";"7";"0";"7";"0";"430517";"5766"
"LOK1378_1mm";"SILVA (only NR);Bacteria;Cyanobacteria;Cyanobacteriia;Leptolyngbyales;Leptolyngbyaceae;MTP1;";"0.0";"0";"3";"3";"0";"3";"0";"430521";"5766"
"LOK1378_1mm";"SILVA (only NR);Bacteria;Cyanobacteria;Cyanobacteriia;Leptolyngbyales;Leptolyngbyaceae;Oscillatoria SAG 1459-8;";"0.0";"0";"6";"6";"0";"6";"0";"430518";"5766"
"LOK1378_1mm";"SILVA (only NR);Bacteria;Cyanobacteria;Cyanobacteriia;Leptolyngbyales;Leptolyngbyaceae;Pantalinema;";"0.0";"0";"4";"4";"0";"4";"0";"430520";"5766"
"LOK1378_1mm";"SILVA (only NR);Bacteria;Cyanobacteria;Cyanobacteriia;Leptolyngbyales;Leptolyngbyaceae;Phormidesmis ANT.L52.6;";"0.0";"0";"26";"26";"0";"26";"0";"430498";"5766"
"LOK1378_1mm";"SILVA (only NR);Bacteria;Cyanobacteria;Cyanobacteriia;Leptolyngbyales;Leptolyngbyaceae;Phormidium CYN64;";"0.0";"0";"13";"13";"0";"13";"0";"430511";"5766"
"LOK1378_1mm";"SILVA (only NR);Bacteria;Cyanobacteria;Cyanobacteriia;Leptolyngbyales;Leptolyngbyaceae;Phormidium SAG 37.90;";"0.0";"0";"16";"14";"0";"14";"2";"430510";"5766"
"LOK1378_1mm";"SILVA (only NR);Bacteria;Cyanobacteria;Cyanobacteriia;Leptolyngbyales;Leptolyngbyaceae;RD011;";"0.0";"0";"7";"7";"0";"7";"0";"430517";"5766"
"LOK1378_1mm";"SILVA (only NR);Bacteria;Cyanobacteria;Cyanobacteriia;Leptolyngbyales;Leptolyngbyaceae;Scytolyngbya XSP1;";"0.0";"0";"2";"2";"0";"2";"0";"430522";"5766"
"LOK1378_1mm";"SILVA (only NR);Bacteria;Cyanobacteria;Cyanobacteriia;Leptolyngbyales;Leptolyngbyaceae;TG-45;";"0.0";"0";"2";"2";"0";"2";"0";"430522";"5766"
"LOK1378_1mm";"SILVA (only NR);Bacteria;Cyanobacteria;Cyanobacteriia;Leptolyngbyales;Leptolyngbyaceae;YB-42;";"0.0";"0";"5";"5";"0";"5";"0";"430519";"5766"
"LOK1378_1mm";"SILVA (only NR);Bacteria;Cyanobacteria;Cyanobacteriia;Leptolyngbyales;Leptolyngbyaceae;YT-3;";"0.0";"0";"2";"2";"0";"2";"0";"430522";"5766"
"LOK1378_1mm";"SILVA (only NR);Bacteria;Cyanobacteria;Cyanobacteriia;Leptolyngbyales;Leptolyngbyaceae;uncultured;";"0.0";"0";"239";"223";"0";"223";"16";"430301";"5766"
"LOK1378_1mm";"SILVA (only NR);Bacteria;Cyanobacteria;Cyanobacteriia;Limnotrichales;";"0.0";"0";"33";"33";"0";"33";"0";"430491";"5766"
"LOK1378_1mm";"SILVA (only NR);Bacteria;Cyanobacteria;Cyanobacteriia;Limnotrichales;Limnotrichaceae;";"0.0";"0";"33";"33";"0";"33";"0";"430491";"5766"
"LOK1378_1mm";"SILVA (only NR);Bacteria;Cyanobacteria;Cyanobacteriia;Limnotrichales;Limnotrichaceae;Limnothrix;";"0.0";"0";"33";"33";"0";"33";"0";"430491";"5766"
"LOK1378_1mm";"SILVA (only NR);Bacteria;Cyanobacteria;Cyanobacteriia;Neosynechococcales;";"0.0";"0";"1";"1";"0";"1";"0";"430523";"5766"
"LOK1378_1mm";"SILVA (only NR);Bacteria;Cyanobacteria;Cyanobacteriia;Neosynechococcales;Neosynechococcaceae;";"0.0";"0";"1";"1";"0";"1";"0";"430523";"5766"
"LOK1378_1mm";"SILVA (only NR);Bacteria;Cyanobacteria;Cyanobacteriia;Neosynechococcales;Neosynechococcaceae;Neosynechococcus;";"0.0";"0";"1";"1";"0";"1";"0";"430523";"5766"
"LOK1378_1mm";"SILVA (only NR);Bacteria;Cyanobacteria;Cyanobacteriia;Oxyphotobacteria Incertae Sedis;";"0.0";"0";"33";"33";"0";"33";"0";"430491";"5766"
"LOK1378_1mm";"SILVA (only NR);Bacteria;Cyanobacteria;Cyanobacteriia;Oxyphotobacteria Incertae Sedis;Unknown Family;";"0.0";"0";"33";"33";"0";"33";"0";"430491";"5766"
"LOK1378_1mm";"SILVA (only NR);Bacteria;Cyanobacteria;Cyanobacteriia;Oxyphotobacteria Incertae Sedis;Unknown Family;Leptolyngbya EcFYyyy-00;";"0.0";"0";"12";"12";"0";"12";"0";"430512";"5766"
"LOK1378_1mm";"SILVA (only NR);Bacteria;Cyanobacteria;Cyanobacteriia;Oxyphotobacteria Incertae Sedis;Unknown Family;Leptolyngbya LEGE-06070;";"0.0";"0";"3";"3";"0";"3";"0";"430521";"5766"
"LOK1378_1mm";"SILVA (only NR);Bacteria;Cyanobacteria;Cyanobacteriia;Oxyphotobacteria Incertae Sedis;Unknown Family;Pseudanabaena NgrPSln22;";"0.0";"0";"3";"3";"0";"3";"0";"430521";"5766"
"LOK1378_1mm";"SILVA (only NR);Bacteria;Cyanobacteria;Cyanobacteriia;Oxyphotobacteria Incertae Sedis;Unknown Family;uncultured;";"0.0";"0";"12";"12";"0";"12";"0";"430512";"5766"
"LOK1378_1mm";"SILVA (only NR);Bacteria;Cyanobacteria;Cyanobacteriia;Phormidesmiales;";"0.0";"0";"248";"242";"0";"242";"6";"430282";"5766"
"LOK1378_1mm";"SILVA (only NR);Bacteria;Cyanobacteria;Cyanobacteriia;Phormidesmiales;Nodosilineaceae;";"0.0";"0";"129";"125";"0";"125";"4";"430399";"5766"
"LOK1378_1mm";"SILVA (only NR);Bacteria;Cyanobacteria;Cyanobacteriia;Phormidesmiales;Nodosilineaceae;Halomicronema C2206;";"0.0";"0";"2";"2";"0";"2";"0";"430522";"5766"
"LOK1378_1mm";"SILVA (only NR);Bacteria;Cyanobacteria;Cyanobacteriia;Phormidesmiales;Nodosilineaceae;Halomicronema TFEP1;";"0.0";"0";"6";"6";"0";"6";"0";"430518";"5766"
"LOK1378_1mm";"SILVA (only NR);Bacteria;Cyanobacteria;Cyanobacteriia;Phormidesmiales;Nodosilineaceae;Halomicronema;";"0.0";"0";"1";"1";"0";"1";"0";"430523";"5766"
"LOK1378_1mm";"SILVA (only NR);Bacteria;Cyanobacteria;Cyanobacteriia;Phormidesmiales;Nodosilineaceae;Leptolyngbya PCC-6406;";"0.0";"0";"5";"5";"0";"5";"0";"430519";"5766"
"LOK1378_1mm";"SILVA (only NR);Bacteria;Cyanobacteria;Cyanobacteriia;Phormidesmiales;Nodosilineaceae;MBIC10086;";"0.0";"0";"5";"5";"0";"5";"0";"430519";"5766"
"LOK1378_1mm";"SILVA (only NR);Bacteria;Cyanobacteria;Cyanobacteriia;Phormidesmiales;Nodosilineaceae;Nodosilinea PCC-7104;";"0.0";"0";"88";"87";"0";"87";"1";"430437";"5766"
"LOK1378_1mm";"SILVA (only NR);Bacteria;Cyanobacteria;Cyanobacteriia;Phormidesmiales;Nodosilineaceae;uncultured;";"0.0";"0";"18";"15";"0";"15";"3";"430509";"5766"
"LOK1378_1mm";"SILVA (only NR);Bacteria;Cyanobacteria;Cyanobacteriia;Phormidesmiales;Phormidesmiaceae;";"0.0";"0";"117";"115";"0";"115";"2";"430409";"5766"
"LOK1378_1mm";"SILVA (only NR);Bacteria;Cyanobacteria;Cyanobacteriia;Phormidesmiales;Phormidesmiaceae;Acrophormium PCC-7375;";"0.0";"0";"24";"24";"0";"24";"0";"430500";"5766"
"LOK1378_1mm";"SILVA (only NR);Bacteria;Cyanobacteria;Cyanobacteriia;Phormidesmiales;Phormidesmiaceae;Phormidesmis ANT.LACV5.1;";"0.0";"0";"37";"37";"0";"37";"0";"430487";"5766"
"LOK1378_1mm";"SILVA (only NR);Bacteria;Cyanobacteria;Cyanobacteriia;Phormidesmiales;Phormidesmiaceae;Phormidium MBIC10002;";"0.0";"0";"3";"3";"0";"3";"0";"430521";"5766"
"LOK1378_1mm";"SILVA (only NR);Bacteria;Cyanobacteria;Cyanobacteriia;Phormidesmiales;Phormidesmiaceae;Phormidium MBIC10003;";"0.0";"0";"42";"40";"0";"40";"2";"430484";"5766"
"LOK1378_1mm";"SILVA (only NR);Bacteria;Cyanobacteria;Cyanobacteriia;Phormidesmiales;Phormidesmiaceae;uncultured;";"0.0";"0";"9";"9";"0";"9";"0";"430515";"5766"
"LOK1378_1mm";"SILVA (only NR);Bacteria;Cyanobacteria;Cyanobacteriia;Phormidesmiales;uncultured;";"0.0";"0";"2";"2";"0";"2";"0";"430522";"5766"
"LOK1378_1mm";"SILVA (only NR);Bacteria;Cyanobacteria;Cyanobacteriia;Pseudanabaenales;";"0.0";"0";"96";"95";"0";"95";"1";"430429";"5766"
"LOK1378_1mm";"SILVA (only NR);Bacteria;Cyanobacteria;Cyanobacteriia;Pseudanabaenales;Pseudanabaenaceae;";"0.0";"0";"96";"95";"0";"95";"1";"430429";"5766"
"LOK1378_1mm";"SILVA (only NR);Bacteria;Cyanobacteria;Cyanobacteriia;Pseudanabaenales;Pseudanabaenaceae;Pseudanabaena PCC-6802;";"0.0";"0";"4";"4";"0";"4";"0";"430520";"5766"
"LOK1378_1mm";"SILVA (only NR);Bacteria;Cyanobacteria;Cyanobacteriia;Pseudanabaenales;Pseudanabaenaceae;Pseudanabaena PCC-7367;";"0.0";"0";"9";"9";"0";"9";"0";"430515";"5766"
"LOK1378_1mm";"SILVA (only NR);Bacteria;Cyanobacteria;Cyanobacteriia;Pseudanabaenales;Pseudanabaenaceae;Pseudanabaena PCC-7403;";"0.0";"0";"2";"2";"0";"2";"0";"430522";"5766"
"LOK1378_1mm";"SILVA (only NR);Bacteria;Cyanobacteria;Cyanobacteriia;Pseudanabaenales;Pseudanabaenaceae;Pseudanabaena PCC-7429;";"0.0";"0";"36";"36";"0";"36";"0";"430488";"5766"
"LOK1378_1mm";"SILVA (only NR);Bacteria;Cyanobacteria;Cyanobacteriia;Pseudanabaenales;Pseudanabaenaceae;Synechococcus PCC-7502;";"0.0";"0";"12";"12";"0";"12";"0";"430512";"5766"
"LOK1378_1mm";"SILVA (only NR);Bacteria;Cyanobacteria;Cyanobacteriia;Pseudanabaenales;Pseudanabaenaceae;uncultured;";"0.0";"0";"30";"29";"0";"29";"1";"430495";"5766"
"LOK1378_1mm";"SILVA (only NR);Bacteria;Cyanobacteria;Cyanobacteriia;RD017;";"0.0";"0";"13";"13";"0";"13";"0";"430511";"5766"
"LOK1378_1mm";"SILVA (only NR);Bacteria;Cyanobacteria;Cyanobacteriia;SepB-3;";"0.0";"0";"8";"7";"0";"7";"1";"430517";"5766"
"LOK1378_1mm";"SILVA (only NR);Bacteria;Cyanobacteria;Cyanobacteriia;Synechococcales;";"0.0";"0";"563";"552";"0";"552";"11";"429972";"5766"
"LOK1378_1mm";"SILVA (only NR);Bacteria;Cyanobacteria;Cyanobacteriia;Synechococcales;Cyanobiaceae;";"0.0";"0";"529";"519";"0";"519";"10";"430005";"5766"
"LOK1378_1mm";"SILVA (only NR);Bacteria;Cyanobacteria;Cyanobacteriia;Synechococcales;Cyanobiaceae;Cyanobium PCC-6307;";"0.0";"0";"204";"204";"0";"204";"0";"430320";"5766"
"LOK1378_1mm";"SILVA (only NR);Bacteria;Cyanobacteria;Cyanobacteriia;Synechococcales;Cyanobiaceae;Prochlorococcus MIT9313;";"0.0";"0";"136";"133";"0";"133";"3";"430391";"5766"
"LOK1378_1mm";"SILVA (only NR);Bacteria;Cyanobacteria;Cyanobacteriia;Synechococcales;Cyanobiaceae;Synechococcus CC9902;";"0.0";"0";"168";"164";"0";"164";"4";"430360";"5766"
"LOK1378_1mm";"SILVA (only NR);Bacteria;Cyanobacteria;Cyanobacteriia;Synechococcales;Cyanobiaceae;Synechococcus MBIC10613;";"0.0";"0";"4";"4";"0";"4";"0";"430520";"5766"
"LOK1378_1mm";"SILVA (only NR);Bacteria;Cyanobacteria;Cyanobacteriia;Synechococcales;Cyanobiaceae;[Synechococcus] spongiarum group;";"0.0";"0";"14";"11";"0";"11";"3";"430513";"5766"
"LOK1378_1mm";"SILVA (only NR);Bacteria;Cyanobacteria;Cyanobacteriia;Synechococcales;Prochlorotrichaceae;";"0.0";"0";"9";"9";"0";"9";"0";"430515";"5766"
"LOK1378_1mm";"SILVA (only NR);Bacteria;Cyanobacteria;Cyanobacteriia;Synechococcales;Prochlorotrichaceae;Prochlorothrix PCC-9006;";"0.0";"0";"9";"9";"0";"9";"0";"430515";"5766"
"LOK1378_1mm";"SILVA (only NR);Bacteria;Cyanobacteria;Cyanobacteriia;Synechococcales;Synechococcaceae;";"0.0";"0";"15";"15";"0";"15";"0";"430509";"5766"
"LOK1378_1mm";"SILVA (only NR);Bacteria;Cyanobacteria;Cyanobacteriia;Synechococcales;Synechococcaceae;Microcystis NIES42;";"0.0";"0";"2";"2";"0";"2";"0";"430522";"5766"
"LOK1378_1mm";"SILVA (only NR);Bacteria;Cyanobacteria;Cyanobacteriia;Synechococcales;Synechococcaceae;Synechococcus PCC-7942;";"0.0";"0";"10";"10";"0";"10";"0";"430514";"5766"
"LOK1378_1mm";"SILVA (only NR);Bacteria;Cyanobacteria;Cyanobacteriia;Synechococcales;Synechococcaceae;uncultured;";"0.0";"0";"3";"3";"0";"3";"0";"430521";"5766"
"LOK1378_1mm";"SILVA (only NR);Bacteria;Cyanobacteria;Cyanobacteriia;Synechococcales;Synechococcales Incertae Sedis;";"0.0";"0";"10";"9";"0";"9";"1";"430515";"5766"
"LOK1378_1mm";"SILVA (only NR);Bacteria;Cyanobacteria;Cyanobacteriia;Synechococcales;Synechococcales Incertae Sedis;Schizothrix LEGE 07164;";"0.0";"0";"10";"9";"0";"9";"1";"430515";"5766"
"LOK1378_1mm";"SILVA (only NR);Bacteria;Cyanobacteria;Cyanobacteriia;Thermosynechococcales;";"0.0";"0";"48";"47";"0";"47";"1";"430477";"5766"
"LOK1378_1mm";"SILVA (only NR);Bacteria;Cyanobacteria;Cyanobacteriia;Thermosynechococcales;Acaryochloridaceae;";"0.0";"0";"12";"12";"0";"12";"0";"430512";"5766"
"LOK1378_1mm";"SILVA (only NR);Bacteria;Cyanobacteria;Cyanobacteriia;Thermosynechococcales;Acaryochloridaceae;Acaryochloris MBIC11017;";"0.0";"0";"12";"12";"0";"12";"0";"430512";"5766"
"LOK1378_1mm";"SILVA (only NR);Bacteria;Cyanobacteria;Cyanobacteriia;Thermosynechococcales;Thermosynechococcaceae;";"0.0";"0";"36";"35";"0";"35";"1";"430489";"5766"
"LOK1378_1mm";"SILVA (only NR);Bacteria;Cyanobacteria;Cyanobacteriia;Thermosynechococcales;Thermosynechococcaceae;Cyanothece PCC 7425;";"0.0";"0";"9";"9";"0";"9";"0";"430515";"5766"
"LOK1378_1mm";"SILVA (only NR);Bacteria;Cyanobacteria;Cyanobacteriia;Thermosynechococcales;Thermosynechococcaceae;Loriellopsis LF-B5;";"0.0";"0";"6";"5";"0";"5";"1";"430519";"5766"
"LOK1378_1mm";"SILVA (only NR);Bacteria;Cyanobacteria;Cyanobacteriia;Thermosynechococcales;Thermosynechococcaceae;Synechococcus IR11;";"0.0";"0";"6";"6";"0";"6";"0";"430518";"5766"
"LOK1378_1mm";"SILVA (only NR);Bacteria;Cyanobacteria;Cyanobacteriia;Thermosynechococcales;Thermosynechococcaceae;Synechococcus PCC-6312;";"0.0";"0";"2";"2";"0";"2";"0";"430522";"5766"
"LOK1378_1mm";"SILVA (only NR);Bacteria;Cyanobacteria;Cyanobacteriia;Thermosynechococcales;Thermosynechococcaceae;Synechococcus;";"0.0";"0";"1";"1";"0";"1";"0";"430523";"5766"
"LOK1378_1mm";"SILVA (only NR);Bacteria;Cyanobacteria;Cyanobacteriia;Thermosynechococcales;Thermosynechococcaceae;Thermosynechococcus BP-1;";"0.0";"0";"9";"9";"0";"9";"0";"430515";"5766"
"LOK1378_1mm";"SILVA (only NR);Bacteria;Cyanobacteria;Cyanobacteriia;Thermosynechococcales;Thermosynechococcaceae;uncultured;";"0.0";"0";"3";"3";"0";"3";"0";"430521";"5766"
"LOK1378_1mm";"SILVA (only NR);Bacteria;Cyanobacteria;Cyanobacteriia;uncultured;";"0.0";"0";"5";"5";"0";"5";"0";"430519";"5766"
"LOK1378_1mm";"SILVA (only NR);Bacteria;Cyanobacteria;Sericytochromatia;";"0.0";"0";"83";"82";"0";"82";"1";"430442";"5766"
"LOK1378_1mm";"SILVA (only NR);Bacteria;Cyanobacteria;Vampirivibrionia;";"0.0";"0";"494";"473";"0";"473";"21";"430051";"5766"
"LOK1378_1mm";"SILVA (only NR);Bacteria;Cyanobacteria;Vampirivibrionia;Caenarcaniphilales;";"0.0";"0";"19";"16";"0";"16";"3";"430508";"5766"
"LOK1378_1mm";"SILVA (only NR);Bacteria;Cyanobacteria;Vampirivibrionia;Gastranaerophilales;";"0.0";"0";"324";"315";"0";"315";"9";"430209";"5766"
"LOK1378_1mm";"SILVA (only NR);Bacteria;Cyanobacteria;Vampirivibrionia;Obscuribacterales;";"0.0";"0";"77";"73";"0";"73";"4";"430451";"5766"
"LOK1378_1mm";"SILVA (only NR);Bacteria;Cyanobacteria;Vampirivibrionia;Obscuribacterales;Obscuribacteraceae;";"0.0";"0";"77";"73";"0";"73";"4";"430451";"5766"
"LOK1378_1mm";"SILVA (only NR);Bacteria;Cyanobacteria;Vampirivibrionia;Obscuribacterales;Obscuribacteraceae;Candidatus Obscuribacter;";"0.0";"0";"13";"13";"0";"13";"0";"430511";"5766"
"LOK1378_1mm";"SILVA (only NR);Bacteria;Cyanobacteria;Vampirivibrionia;Vampirovibrionales;";"0.0";"0";"74";"69";"0";"69";"5";"430455";"5766"
"LOK1378_1mm";"SILVA (only NR);Bacteria;Cyanobacteria;Vampirivibrionia;Vampirovibrionales;Vampirovibrionaceae;";"0.0";"0";"35";"35";"0";"35";"0";"430489";"5766"
"LOK1378_1mm";"SILVA (only NR);Bacteria;Cyanobacteria;Vampirivibrionia;Vampirovibrionales;Vampirovibrionaceae;Vampirovibrio;";"0.0";"0";"21";"21";"0";"21";"0";"430503";"5766"
"LOK1378_1mm";"SILVA (only NR);Bacteria;DTB120;";"0.0";"0";"78";"78";"0";"78";"0";"430446";"5766"
"LOK1378_1mm";"SILVA (only NR);Bacteria;Dadabacteria;";"0.0";"0";"172";"165";"0";"165";"7";"430359";"5766"
"LOK1378_1mm";"SILVA (only NR);Bacteria;Dadabacteria;Dadabacteriia;";"0.0";"0";"172";"165";"0";"165";"7";"430359";"5766"
"LOK1378_1mm";"SILVA (only NR);Bacteria;Dadabacteria;Dadabacteriia;Dadabacteriales;";"0.0";"0";"172";"165";"0";"165";"7";"430359";"5766"
"LOK1378_1mm";"SILVA (only NR);Bacteria;Deferribacterota;";"0.0";"0";"118";"113";"0";"113";"5";"430411";"5766"
"LOK1378_1mm";"SILVA (only NR);Bacteria;Deferribacterota;Deferribacteres;";"0.0";"0";"118";"113";"0";"113";"5";"430411";"5766"
"LOK1378_1mm";"SILVA (only NR);Bacteria;Deferribacterota;Deferribacteres;Deferribacterales;";"0.0";"0";"118";"113";"0";"113";"5";"430411";"5766"
"LOK1378_1mm";"SILVA (only NR);Bacteria;Deferribacterota;Deferribacteres;Deferribacterales;Deferribacteraceae;";"0.0";"0";"118";"113";"0";"113";"5";"430411";"5766"
"LOK1378_1mm";"SILVA (only NR);Bacteria;Deferribacterota;Deferribacteres;Deferribacterales;Deferribacteraceae;Calditerrivibrio;";"0.0";"0";"11";"10";"0";"10";"1";"430514";"5766"
"LOK1378_1mm";"SILVA (only NR);Bacteria;Deferribacterota;Deferribacteres;Deferribacterales;Deferribacteraceae;Deferribacter;";"0.0";"0";"10";"10";"0";"10";"0";"430514";"5766"
"LOK1378_1mm";"SILVA (only NR);Bacteria;Deferribacterota;Deferribacteres;Deferribacterales;Deferribacteraceae;Denitrovibrio;";"0.0";"0";"4";"4";"0";"4";"0";"430520";"5766"
"LOK1378_1mm";"SILVA (only NR);Bacteria;Deferribacterota;Deferribacteres;Deferribacterales;Deferribacteraceae;Flexistipes;";"0.0";"0";"5";"5";"0";"5";"0";"430519";"5766"
"LOK1378_1mm";"SILVA (only NR);Bacteria;Deferribacterota;Deferribacteres;Deferribacterales;Deferribacteraceae;Geovibrio;";"0.0";"0";"8";"8";"0";"8";"0";"430516";"5766"
"LOK1378_1mm";"SILVA (only NR);Bacteria;Deferribacterota;Deferribacteres;Deferribacterales;Deferribacteraceae;Mucispirillum;";"0.0";"0";"26";"25";"0";"25";"1";"430499";"5766"
"LOK1378_1mm";"SILVA (only NR);Bacteria;Deferribacterota;Deferribacteres;Deferribacterales;Deferribacteraceae;Seleniivibrio;";"0.0";"0";"3";"3";"0";"3";"0";"430521";"5766"
"LOK1378_1mm";"SILVA (only NR);Bacteria;Deferribacterota;Deferribacteres;Deferribacterales;Deferribacteraceae;uncultured;";"0.0";"0";"50";"47";"0";"47";"3";"430477";"5766"
"LOK1378_1mm";"SILVA (only NR);Bacteria;Deferrisomatota;";"0.0";"0";"26";"25";"0";"25";"1";"430499";"5766"
"LOK1378_1mm";"SILVA (only NR);Bacteria;Deferrisomatota;Defferrisomatia;";"0.0";"0";"26";"25";"0";"25";"1";"430499";"5766"
"LOK1378_1mm";"SILVA (only NR);Bacteria;Deferrisomatota;Defferrisomatia;Defferrisomatales;";"0.0";"0";"26";"25";"0";"25";"1";"430499";"5766"
"LOK1378_1mm";"SILVA (only NR);Bacteria;Deferrisomatota;Defferrisomatia;Defferrisomatales;Defferrisomataceae;";"0.0";"0";"26";"25";"0";"25";"1";"430499";"5766"
"LOK1378_1mm";"SILVA (only NR);Bacteria;Deferrisomatota;Defferrisomatia;Defferrisomatales;Defferrisomataceae;Deferrisoma;";"0.0";"0";"26";"25";"0";"25";"1";"430499";"5766"
"LOK1378_1mm";"SILVA (only NR);Bacteria;Deinococcota;";"0.0";"0";"832";"805";"0";"805";"27";"429719";"5766"
"LOK1378_1mm";"SILVA (only NR);Bacteria;Deinococcota;Deinococci;";"0.0";"0";"832";"805";"0";"805";"27";"429719";"5766"
"LOK1378_1mm";"SILVA (only NR);Bacteria;Deinococcota;Deinococci;Deinococcales;";"0.0";"0";"557";"546";"0";"546";"11";"429978";"5766"
"LOK1378_1mm";"SILVA (only NR);Bacteria;Deinococcota;Deinococci;Deinococcales;Deinococcaceae;";"0.0";"0";"328";"319";"0";"319";"9";"430205";"5766"
"LOK1378_1mm";"SILVA (only NR);Bacteria;Deinococcota;Deinococci;Deinococcales;Deinococcaceae;Deinobacterium;";"0.0";"0";"2";"2";"0";"2";"0";"430522";"5766"
"LOK1378_1mm";"SILVA (only NR);Bacteria;Deinococcota;Deinococci;Deinococcales;Deinococcaceae;Deinococcus;";"0.0";"0";"302";"293";"0";"293";"9";"430231";"5766"
"LOK1378_1mm";"SILVA (only NR);Bacteria;Deinococcota;Deinococci;Deinococcales;Deinococcaceae;uncultured;";"0.0";"0";"23";"23";"0";"23";"0";"430501";"5766"
"LOK1378_1mm";"SILVA (only NR);Bacteria;Deinococcota;Deinococci;Deinococcales;Trueperaceae;";"0.0";"0";"229";"227";"0";"227";"2";"430297";"5766"
"LOK1378_1mm";"SILVA (only NR);Bacteria;Deinococcota;Deinococci;Deinococcales;Trueperaceae;Truepera;";"0.0";"0";"229";"227";"0";"227";"2";"430297";"5766"
"LOK1378_1mm";"SILVA (only NR);Bacteria;Deinococcota;Deinococci;Thermales;";"0.0";"0";"275";"259";"0";"259";"16";"430265";"5766"
"LOK1378_1mm";"SILVA (only NR);Bacteria;Deinococcota;Deinococci;Thermales;Thermaceae;";"0.0";"0";"275";"259";"0";"259";"16";"430265";"5766"
"LOK1378_1mm";"SILVA (only NR);Bacteria;Deinococcota;Deinococci;Thermales;Thermaceae;Marinithermus;";"0.0";"0";"2";"2";"0";"2";"0";"430522";"5766"
"LOK1378_1mm";"SILVA (only NR);Bacteria;Deinococcota;Deinococci;Thermales;Thermaceae;Meiothermus;";"0.0";"0";"86";"85";"0";"85";"1";"430439";"5766"
"LOK1378_1mm";"SILVA (only NR);Bacteria;Deinococcota;Deinococci;Thermales;Thermaceae;Oceanithermus;";"0.0";"0";"7";"7";"0";"7";"0";"430517";"5766"
"LOK1378_1mm";"SILVA (only NR);Bacteria;Deinococcota;Deinococci;Thermales;Thermaceae;Rhabdothermus;";"0.0";"0";"2";"2";"0";"2";"0";"430522";"5766"
"LOK1378_1mm";"SILVA (only NR);Bacteria;Deinococcota;Deinococci;Thermales;Thermaceae;Thermus;";"0.0";"0";"175";"160";"0";"160";"15";"430364";"5766"
"LOK1378_1mm";"SILVA (only NR);Bacteria;Deinococcota;Deinococci;Thermales;Thermaceae;Vulcanithermus;";"0.0";"0";"1";"1";"0";"1";"0";"430523";"5766"
"LOK1378_1mm";"SILVA (only NR);Bacteria;Dependentiae;";"0.0";"0";"583";"570";"0";"570";"13";"429954";"5766"
"LOK1378_1mm";"SILVA (only NR);Bacteria;Dependentiae;Babeliae;";"0.0";"0";"583";"570";"0";"570";"13";"429954";"5766"
"LOK1378_1mm";"SILVA (only NR);Bacteria;Dependentiae;Babeliae;Babeliales;";"0.0";"0";"583";"570";"0";"570";"13";"429954";"5766"
"LOK1378_1mm";"SILVA (only NR);Bacteria;Dependentiae;Babeliae;Babeliales;Babeliaceae;";"0.0";"0";"68";"65";"0";"65";"3";"430459";"5766"
"LOK1378_1mm";"SILVA (only NR);Bacteria;Dependentiae;Babeliae;Babeliales;Babeliaceae;Candidatus Babela;";"0.0";"0";"3";"3";"0";"3";"0";"430521";"5766"
"LOK1378_1mm";"SILVA (only NR);Bacteria;Dependentiae;Babeliae;Babeliales;UBA12409;";"0.0";"0";"68";"68";"0";"68";"0";"430456";"5766"
"LOK1378_1mm";"SILVA (only NR);Bacteria;Dependentiae;Babeliae;Babeliales;UBA12411;";"0.0";"0";"17";"17";"0";"17";"0";"430507";"5766"
"LOK1378_1mm";"SILVA (only NR);Bacteria;Dependentiae;Babeliae;Babeliales;Vermiphilaceae;";"0.0";"0";"211";"208";"0";"208";"3";"430316";"5766"
"LOK1378_1mm";"SILVA (only NR);Bacteria;Desantisbacteria;";"0.0";"0";"2";"2";"0";"2";"0";"430522";"5766"
"LOK1378_1mm";"SILVA (only NR);Bacteria;Desulfobacterota;";"0.0";"0";"7818";"7538";"0";"7538";"280";"422986";"5766"
"LOK1378_1mm";"SILVA (only NR);Bacteria;Desulfobacterota;Desulfarculia;";"0.0";"0";"29";"28";"0";"28";"1";"430496";"5766"
"LOK1378_1mm";"SILVA (only NR);Bacteria;Desulfobacterota;Desulfarculia;Desulfarculales;";"0.0";"0";"29";"28";"0";"28";"1";"430496";"5766"
"LOK1378_1mm";"SILVA (only NR);Bacteria;Desulfobacterota;Desulfarculia;Desulfarculales;Desulfarculaceae;";"0.0";"0";"28";"27";"0";"27";"1";"430497";"5766"
"LOK1378_1mm";"SILVA (only NR);Bacteria;Desulfobacterota;Desulfarculia;Desulfarculales;Desulfarculaceae;Desulfarculus;";"0.0";"0";"4";"4";"0";"4";"0";"430520";"5766"
"LOK1378_1mm";"SILVA (only NR);Bacteria;Desulfobacterota;Desulfarculia;Desulfarculales;Desulfarculaceae;Desulfocarbo;";"0.0";"0";"13";"13";"0";"13";"0";"430511";"5766"
"LOK1378_1mm";"SILVA (only NR);Bacteria;Desulfobacterota;Desulfarculia;Desulfarculales;Desulfarculaceae;Dethiosulfatarculus;";"0.0";"0";"1";"1";"0";"1";"0";"430523";"5766"
"LOK1378_1mm";"SILVA (only NR);Bacteria;Desulfobacterota;Desulfarculia;Desulfarculales;Desulfarculaceae;uncultured;";"0.0";"0";"10";"9";"0";"9";"1";"430515";"5766"
"LOK1378_1mm";"SILVA (only NR);Bacteria;Desulfobacterota;Desulfobaccia;";"0.0";"0";"74";"64";"0";"64";"10";"430460";"5766"
"LOK1378_1mm";"SILVA (only NR);Bacteria;Desulfobacterota;Desulfobaccia;Desulfobaccales;";"0.0";"0";"74";"64";"0";"64";"10";"430460";"5766"
"LOK1378_1mm";"SILVA (only NR);Bacteria;Desulfobacterota;Desulfobaccia;Desulfobaccales;Desulfobaccaceae;";"0.0";"0";"74";"64";"0";"64";"10";"430460";"5766"
"LOK1378_1mm";"SILVA (only NR);Bacteria;Desulfobacterota;Desulfobaccia;Desulfobaccales;Desulfobaccaceae;Desulfobacca;";"0.0";"0";"74";"64";"0";"64";"10";"430460";"5766"
"LOK1378_1mm";"SILVA (only NR);Bacteria;Desulfobacterota;Desulfobacteria;";"0.0";"0";"2521";"2420";"0";"2420";"101";"428104";"5766"
"LOK1378_1mm";"SILVA (only NR);Bacteria;Desulfobacterota;Desulfobacteria;Desulfatiglandales;";"0.0";"0";"447";"427";"0";"427";"20";"430097";"5766"
"LOK1378_1mm";"SILVA (only NR);Bacteria;Desulfobacterota;Desulfobacteria;Desulfatiglandales;Desulfatiglandaceae;";"0.0";"0";"447";"427";"0";"427";"20";"430097";"5766"
"LOK1378_1mm";"SILVA (only NR);Bacteria;Desulfobacterota;Desulfobacteria;Desulfatiglandales;Desulfatiglandaceae;Desulfatiglans;";"0.0";"0";"447";"427";"0";"427";"20";"430097";"5766"
"LOK1378_1mm";"SILVA (only NR);Bacteria;Desulfobacterota;Desulfobacteria;Desulfobacterales;";"0.0";"0";"2074";"1993";"0";"1993";"81";"428531";"5766"
"LOK1378_1mm";"SILVA (only NR);Bacteria;Desulfobacterota;Desulfobacteria;Desulfobacterales;Desulfatiferula;";"0.0";"0";"13";"13";"0";"13";"0";"430511";"5766"
"LOK1378_1mm";"SILVA (only NR);Bacteria;Desulfobacterota;Desulfobacteria;Desulfobacterales;Desulfobacteraceae;";"0.0";"0";"415";"405";"0";"405";"10";"430119";"5766"
"LOK1378_1mm";"SILVA (only NR);Bacteria;Desulfobacterota;Desulfobacteria;Desulfobacterales;Desulfobacteraceae;Candidatus Desulfamplus;";"0.0";"0";"2";"2";"0";"2";"0";"430522";"5766"
"LOK1378_1mm";"SILVA (only NR);Bacteria;Desulfobacterota;Desulfobacteria;Desulfobacterales;Desulfobacteraceae;Desulfobacter;";"0.0";"0";"87";"82";"0";"82";"5";"430442";"5766"
"LOK1378_1mm";"SILVA (only NR);Bacteria;Desulfobacterota;Desulfobacteria;Desulfobacterales;Desulfobacteraceae;Desulfobacterium;";"0.0";"0";"37";"36";"0";"36";"1";"430488";"5766"
"LOK1378_1mm";"SILVA (only NR);Bacteria;Desulfobacterota;Desulfobacteria;Desulfobacterales;Desulfobacteraceae;Desulfobacula;";"0.0";"0";"17";"17";"0";"17";"0";"430507";"5766"
"LOK1378_1mm";"SILVA (only NR);Bacteria;Desulfobacterota;Desulfobacteria;Desulfobacterales;Desulfobacteraceae;Desulfobotulus;";"0.0";"0";"10";"10";"0";"10";"0";"430514";"5766"
"LOK1378_1mm";"SILVA (only NR);Bacteria;Desulfobacterota;Desulfobacteria;Desulfobacterales;Desulfobacteraceae;Desulfocella;";"0.0";"0";"15";"15";"0";"15";"0";"430509";"5766"
"LOK1378_1mm";"SILVA (only NR);Bacteria;Desulfobacterota;Desulfobacteria;Desulfobacterales;Desulfobacteraceae;Desulfoconvexum;";"0.0";"0";"30";"29";"0";"29";"1";"430495";"5766"
"LOK1378_1mm";"SILVA (only NR);Bacteria;Desulfobacterota;Desulfobacteria;Desulfobacterales;Desulfobacteraceae;Desulfospira;";"0.0";"0";"2";"2";"0";"2";"0";"430522";"5766"
"LOK1378_1mm";"SILVA (only NR);Bacteria;Desulfobacterota;Desulfobacteria;Desulfobacterales;Desulfobacteraceae;Desulfotignum;";"0.0";"0";"44";"43";"0";"43";"1";"430481";"5766"
"LOK1378_1mm";"SILVA (only NR);Bacteria;Desulfobacterota;Desulfobacteria;Desulfobacterales;Desulfobacteraceae;uncultured;";"0.0";"0";"165";"163";"0";"163";"2";"430361";"5766"
"LOK1378_1mm";"SILVA (only NR);Bacteria;Desulfobacterota;Desulfobacteria;Desulfobacterales;Desulfococcaceae;";"0.0";"0";"483";"451";"0";"451";"32";"430073";"5766"
"LOK1378_1mm";"SILVA (only NR);Bacteria;Desulfobacterota;Desulfobacteria;Desulfobacterales;Desulfococcaceae;Desulfococcus;";"0.0";"0";"8";"8";"0";"8";"0";"430516";"5766"
"LOK1378_1mm";"SILVA (only NR);Bacteria;Desulfobacterota;Desulfobacteria;Desulfobacterales;Desulfococcaceae;Desulfonema;";"0.0";"0";"234";"222";"0";"222";"12";"430302";"5766"
"LOK1378_1mm";"SILVA (only NR);Bacteria;Desulfobacterota;Desulfobacteria;Desulfobacterales;Desulfococcaceae;uncultured;";"0.0";"0";"240";"220";"0";"220";"20";"430304";"5766"
"LOK1378_1mm";"SILVA (only NR);Bacteria;Desulfobacterota;Desulfobacteria;Desulfobacterales;Desulfolunaceae;";"0.0";"0";"39";"37";"0";"37";"2";"430487";"5766"
"LOK1378_1mm";"SILVA (only NR);Bacteria;Desulfobacterota;Desulfobacteria;Desulfobacterales;Desulfolunaceae;Desulfofaba;";"0.0";"0";"11";"10";"0";"10";"1";"430514";"5766"
"LOK1378_1mm";"SILVA (only NR);Bacteria;Desulfobacterota;Desulfobacteria;Desulfobacterales;Desulfolunaceae;Desulfofrigus;";"0.0";"0";"12";"11";"0";"11";"1";"430513";"5766"
"LOK1378_1mm";"SILVA (only NR);Bacteria;Desulfobacterota;Desulfobacteria;Desulfobacterales;Desulfolunaceae;Desulfoluna;";"0.0";"0";"3";"3";"0";"3";"0";"430521";"5766"
"LOK1378_1mm";"SILVA (only NR);Bacteria;Desulfobacterota;Desulfobacteria;Desulfobacterales;Desulfolunaceae;uncultured;";"0.0";"0";"12";"12";"0";"12";"0";"430512";"5766"
"LOK1378_1mm";"SILVA (only NR);Bacteria;Desulfobacterota;Desulfobacteria;Desulfobacterales;Desulforegulaceae;";"0.0";"0";"4";"4";"0";"4";"0";"430520";"5766"
"LOK1378_1mm";"SILVA (only NR);Bacteria;Desulfobacterota;Desulfobacteria;Desulfobacterales;Desulforegulaceae;Desulforegula;";"0.0";"0";"4";"4";"0";"4";"0";"430520";"5766"
"LOK1378_1mm";"SILVA (only NR);Bacteria;Desulfobacterota;Desulfobacteria;Desulfobacterales;Desulfosarcinaceae;";"0.0";"0";"1073";"1037";"0";"1037";"36";"429487";"5766"
"LOK1378_1mm";"SILVA (only NR);Bacteria;Desulfobacterota;Desulfobacteria;Desulfobacterales;Desulfosarcinaceae;Algorimarina;";"0.0";"0";"1";"1";"0";"1";"0";"430523";"5766"
"LOK1378_1mm";"SILVA (only NR);Bacteria;Desulfobacterota;Desulfobacteria;Desulfobacterales;Desulfosarcinaceae;Candidatus Magnetananas;";"0.0";"0";"14";"14";"0";"14";"0";"430510";"5766"
"LOK1378_1mm";"SILVA (only NR);Bacteria;Desulfobacterota;Desulfobacteria;Desulfobacterales;Desulfosarcinaceae;Candidatus Magnetoglobus;";"0.0";"0";"14";"14";"0";"14";"0";"430510";"5766"
"LOK1378_1mm";"SILVA (only NR);Bacteria;Desulfobacterota;Desulfobacteria;Desulfobacterales;Desulfosarcinaceae;Candidatus Magnetomorum;";"0.0";"0";"1";"1";"0";"1";"0";"430523";"5766"
"LOK1378_1mm";"SILVA (only NR);Bacteria;Desulfobacterota;Desulfobacteria;Desulfobacterales;Desulfosarcinaceae;Desulfatibacillum;";"0.0";"0";"14";"14";"0";"14";"0";"430510";"5766"
"LOK1378_1mm";"SILVA (only NR);Bacteria;Desulfobacterota;Desulfobacteria;Desulfobacterales;Desulfosarcinaceae;Desulfatirhabdium;";"0.0";"0";"34";"33";"0";"33";"1";"430491";"5766"
"LOK1378_1mm";"SILVA (only NR);Bacteria;Desulfobacterota;Desulfobacteria;Desulfobacterales;Desulfosarcinaceae;Desulfatitalea;";"0.0";"0";"22";"22";"0";"22";"0";"430502";"5766"
"LOK1378_1mm";"SILVA (only NR);Bacteria;Desulfobacterota;Desulfobacteria;Desulfobacterales;Desulfosarcinaceae;Desulfonatronobacter;";"0.0";"0";"10";"10";"0";"10";"0";"430514";"5766"
"LOK1378_1mm";"SILVA (only NR);Bacteria;Desulfobacterota;Desulfobacteria;Desulfobacterales;Desulfosarcinaceae;Desulfosalsimonas;";"0.0";"0";"10";"10";"0";"10";"0";"430514";"5766"
"LOK1378_1mm";"SILVA (only NR);Bacteria;Desulfobacterota;Desulfobacteria;Desulfobacterales;Desulfosarcinaceae;Desulfosarcina;";"0.0";"0";"45";"45";"0";"45";"0";"430479";"5766"
"LOK1378_1mm";"SILVA (only NR);Bacteria;Desulfobacterota;Desulfobacteria;Desulfobacterales;Desulfosarcinaceae;Incertae Sedis;";"0.0";"0";"35";"32";"0";"32";"3";"430492";"5766"
"LOK1378_1mm";"SILVA (only NR);Bacteria;Desulfobacterota;Desulfobacteria;Desulfobacterales;Desulfosarcinaceae;LCP-80;";"0.0";"0";"51";"49";"0";"49";"2";"430475";"5766"
"LOK1378_1mm";"SILVA (only NR);Bacteria;Desulfobacterota;Desulfobacteria;Desulfobacterales;Desulfosarcinaceae;SEEP-SRB1;";"0.0";"0";"304";"289";"0";"289";"15";"430235";"5766"
"LOK1378_1mm";"SILVA (only NR);Bacteria;Desulfobacterota;Desulfobacteria;Desulfobacterales;Desulfosarcinaceae;Sva0081 sediment group;";"0.0";"0";"206";"202";"0";"202";"4";"430322";"5766"
"LOK1378_1mm";"SILVA (only NR);Bacteria;Desulfobacterota;Desulfobacteria;Desulfobacterales;Desulfosarcinaceae;uncultured;";"0.0";"0";"301";"290";"0";"290";"11";"430234";"5766"
"LOK1378_1mm";"SILVA (only NR);Bacteria;Desulfobacterota;Desulfobacteria;Desulfobacterales;uncultured;";"0.0";"0";"46";"45";"0";"45";"1";"430479";"5766"
"LOK1378_1mm";"SILVA (only NR);Bacteria;Desulfobacterota;Desulfobulbia;";"0.0";"0";"1427";"1384";"0";"1384";"43";"429140";"5766"
"LOK1378_1mm";"SILVA (only NR);Bacteria;Desulfobacterota;Desulfobulbia;Desulfobulbales;";"0.0";"0";"1427";"1384";"0";"1384";"43";"429140";"5766"
"LOK1378_1mm";"SILVA (only NR);Bacteria;Desulfobacterota;Desulfobulbia;Desulfobulbales;Desulfobulbaceae;";"0.0";"0";"410";"403";"0";"403";"7";"430121";"5766"
"LOK1378_1mm";"SILVA (only NR);Bacteria;Desulfobacterota;Desulfobulbia;Desulfobulbales;Desulfobulbaceae;Candidatus Electronema;";"0.0";"0";"11";"11";"0";"11";"0";"430513";"5766"
"LOK1378_1mm";"SILVA (only NR);Bacteria;Desulfobacterota;Desulfobulbia;Desulfobulbales;Desulfobulbaceae;Candidatus Electrothrix;";"0.0";"0";"13";"12";"0";"12";"1";"430512";"5766"
"LOK1378_1mm";"SILVA (only NR);Bacteria;Desulfobacterota;Desulfobulbia;Desulfobulbales;Desulfobulbaceae;Desulfobulbus;";"0.0";"0";"210";"205";"0";"205";"5";"430319";"5766"
"LOK1378_1mm";"SILVA (only NR);Bacteria;Desulfobacterota;Desulfobulbia;Desulfobulbales;Desulfobulbaceae;uncultured;";"0.0";"0";"173";"172";"0";"172";"1";"430352";"5766"
"LOK1378_1mm";"SILVA (only NR);Bacteria;Desulfobacterota;Desulfobulbia;Desulfobulbales;Desulfocapsaceae;";"0.0";"0";"878";"847";"0";"847";"31";"429677";"5766"
"LOK1378_1mm";"SILVA (only NR);Bacteria;Desulfobacterota;Desulfobulbia;Desulfobulbales;Desulfocapsaceae;Desulfocapsa;";"0.0";"0";"213";"206";"0";"206";"7";"430318";"5766"
"LOK1378_1mm";"SILVA (only NR);Bacteria;Desulfobacterota;Desulfobulbia;Desulfobulbales;Desulfocapsaceae;Desulfofustis;";"0.0";"0";"35";"34";"0";"34";"1";"430490";"5766"
"LOK1378_1mm";"SILVA (only NR);Bacteria;Desulfobacterota;Desulfobulbia;Desulfobulbales;Desulfocapsaceae;Desulfopila;";"0.0";"0";"54";"51";"0";"51";"3";"430473";"5766"
"LOK1378_1mm";"SILVA (only NR);Bacteria;Desulfobacterota;Desulfobulbia;Desulfobulbales;Desulfocapsaceae;Desulfoprunum;";"0.0";"0";"13";"13";"0";"13";"0";"430511";"5766"
"LOK1378_1mm";"SILVA (only NR);Bacteria;Desulfobacterota;Desulfobulbia;Desulfobulbales;Desulfocapsaceae;Desulforhopalus;";"0.0";"0";"113";"110";"0";"110";"3";"430414";"5766"
"LOK1378_1mm";"SILVA (only NR);Bacteria;Desulfobacterota;Desulfobulbia;Desulfobulbales;Desulfocapsaceae;Desulfotalea;";"0.0";"0";"20";"19";"0";"19";"1";"430505";"5766"
"LOK1378_1mm";"SILVA (only NR);Bacteria;Desulfobacterota;Desulfobulbia;Desulfobulbales;Desulfocapsaceae;SEEP-SRB4;";"0.0";"0";"47";"46";"0";"46";"1";"430478";"5766"
"LOK1378_1mm";"SILVA (only NR);Bacteria;Desulfobacterota;Desulfobulbia;Desulfobulbales;Desulfocapsaceae;[Desulfobacterium] catecholicum group;";"0.0";"0";"128";"124";"0";"124";"4";"430400";"5766"
"LOK1378_1mm";"SILVA (only NR);Bacteria;Desulfobacterota;Desulfobulbia;Desulfobulbales;Desulfocapsaceae;uncultured;";"0.0";"0";"251";"240";"0";"240";"11";"430284";"5766"
"LOK1378_1mm";"SILVA (only NR);Bacteria;Desulfobacterota;Desulfobulbia;Desulfobulbales;Desulfurivibrionaceae;";"0.0";"0";"96";"93";"0";"93";"3";"430431";"5766"
"LOK1378_1mm";"SILVA (only NR);Bacteria;Desulfobacterota;Desulfobulbia;Desulfobulbales;Desulfurivibrionaceae;Desulfurivibrio;";"0.0";"0";"43";"40";"0";"40";"3";"430484";"5766"
"LOK1378_1mm";"SILVA (only NR);Bacteria;Desulfobacterota;Desulfobulbia;Desulfobulbales;Desulfurivibrionaceae;MSBL7;";"0.0";"0";"51";"51";"0";"51";"0";"430473";"5766"
"LOK1378_1mm";"SILVA (only NR);Bacteria;Desulfobacterota;Desulfobulbia;Desulfobulbales;Desulfurivibrionaceae;uncultured;";"0.0";"0";"2";"2";"0";"2";"0";"430522";"5766"
"LOK1378_1mm";"SILVA (only NR);Bacteria;Desulfobacterota;Desulfobulbia;Desulfobulbales;uncultured;";"0.0";"0";"43";"41";"0";"41";"2";"430483";"5766"
"LOK1378_1mm";"SILVA (only NR);Bacteria;Desulfobacterota;Desulfofervidia;";"0.0";"0";"9";"9";"0";"9";"0";"430515";"5766"
"LOK1378_1mm";"SILVA (only NR);Bacteria;Desulfobacterota;Desulfofervidia;Desulfofervidales;";"0.0";"0";"9";"9";"0";"9";"0";"430515";"5766"
"LOK1378_1mm";"SILVA (only NR);Bacteria;Desulfobacterota;Desulfofervidia;Desulfofervidales;Desulfofervidaceae;";"0.0";"0";"9";"9";"0";"9";"0";"430515";"5766"
"LOK1378_1mm";"SILVA (only NR);Bacteria;Desulfobacterota;Desulfofervidia;Desulfofervidales;Desulfofervidaceae;Candidatus Desulfofervidus;";"0.0";"0";"9";"9";"0";"9";"0";"430515";"5766"
"LOK1378_1mm";"SILVA (only NR);Bacteria;Desulfobacterota;Desulfomonilia;";"0.0";"0";"61";"60";"0";"60";"1";"430464";"5766"
"LOK1378_1mm";"SILVA (only NR);Bacteria;Desulfobacterota;Desulfomonilia;Desulfomonilales;";"0.0";"0";"61";"60";"0";"60";"1";"430464";"5766"
"LOK1378_1mm";"SILVA (only NR);Bacteria;Desulfobacterota;Desulfomonilia;Desulfomonilales;Desulfomonilaceae;";"0.0";"0";"61";"60";"0";"60";"1";"430464";"5766"
"LOK1378_1mm";"SILVA (only NR);Bacteria;Desulfobacterota;Desulfomonilia;Desulfomonilales;Desulfomonilaceae;Desulfomonile;";"0.0";"0";"61";"60";"0";"60";"1";"430464";"5766"
"LOK1378_1mm";"SILVA (only NR);Bacteria;Desulfobacterota;Desulfovibrionia;";"0.0";"0";"1124";"1087";"0";"1087";"37";"429437";"5766"
"LOK1378_1mm";"SILVA (only NR);Bacteria;Desulfobacterota;Desulfovibrionia;Desulfovibrionales;";"0.0";"0";"1124";"1087";"0";"1087";"37";"429437";"5766"
"LOK1378_1mm";"SILVA (only NR);Bacteria;Desulfobacterota;Desulfovibrionia;Desulfovibrionales;Desulfohalobiaceae;";"0.0";"0";"134";"124";"0";"124";"10";"430400";"5766"
"LOK1378_1mm";"SILVA (only NR);Bacteria;Desulfobacterota;Desulfovibrionia;Desulfovibrionales;Desulfohalobiaceae;Desulfohalobium;";"0.0";"0";"3";"3";"0";"3";"0";"430521";"5766"
"LOK1378_1mm";"SILVA (only NR);Bacteria;Desulfobacterota;Desulfovibrionia;Desulfovibrionales;Desulfohalobiaceae;Desulfovermiculus;";"0.0";"0";"131";"121";"0";"121";"10";"430403";"5766"
"LOK1378_1mm";"SILVA (only NR);Bacteria;Desulfobacterota;Desulfovibrionia;Desulfovibrionales;Desulfomicrobiaceae;";"0.0";"0";"94";"92";"0";"92";"2";"430432";"5766"
"LOK1378_1mm";"SILVA (only NR);Bacteria;Desulfobacterota;Desulfovibrionia;Desulfovibrionales;Desulfomicrobiaceae;Desulfomicrobium;";"0.0";"0";"94";"92";"0";"92";"2";"430432";"5766"
"LOK1378_1mm";"SILVA (only NR);Bacteria;Desulfobacterota;Desulfovibrionia;Desulfovibrionales;Desulfonatronaceae;";"0.0";"0";"19";"18";"0";"18";"1";"430506";"5766"
"LOK1378_1mm";"SILVA (only NR);Bacteria;Desulfobacterota;Desulfovibrionia;Desulfovibrionales;Desulfonatronaceae;Desulfonatronum;";"0.0";"0";"19";"18";"0";"18";"1";"430506";"5766"
"LOK1378_1mm";"SILVA (only NR);Bacteria;Desulfobacterota;Desulfovibrionia;Desulfovibrionales;Desulfonatronovibrionaceae;";"0.0";"0";"20";"20";"0";"20";"0";"430504";"5766"
"LOK1378_1mm";"SILVA (only NR);Bacteria;Desulfobacterota;Desulfovibrionia;Desulfovibrionales;Desulfonatronovibrionaceae;Desulfonatronospira;";"0.0";"0";"10";"10";"0";"10";"0";"430514";"5766"
"LOK1378_1mm";"SILVA (only NR);Bacteria;Desulfobacterota;Desulfovibrionia;Desulfovibrionales;Desulfonatronovibrionaceae;Desulfonatronovibrio;";"0.0";"0";"9";"9";"0";"9";"0";"430515";"5766"
"LOK1378_1mm";"SILVA (only NR);Bacteria;Desulfobacterota;Desulfovibrionia;Desulfovibrionales;Desulfonauticaceae;";"0.0";"0";"8";"8";"0";"8";"0";"430516";"5766"
"LOK1378_1mm";"SILVA (only NR);Bacteria;Desulfobacterota;Desulfovibrionia;Desulfovibrionales;Desulfonauticaceae;Desulfonauticus;";"0.0";"0";"4";"4";"0";"4";"0";"430520";"5766"
"LOK1378_1mm";"SILVA (only NR);Bacteria;Desulfobacterota;Desulfovibrionia;Desulfovibrionales;Desulfonauticaceae;Desulfothermus;";"0.0";"0";"3";"3";"0";"3";"0";"430521";"5766"
"LOK1378_1mm";"SILVA (only NR);Bacteria;Desulfobacterota;Desulfovibrionia;Desulfovibrionales;Desulfoplanaceae;";"0.0";"0";"25";"25";"0";"25";"0";"430499";"5766"
"LOK1378_1mm";"SILVA (only NR);Bacteria;Desulfobacterota;Desulfovibrionia;Desulfovibrionales;Desulfoplanaceae;Desulfoplanes;";"0.0";"0";"25";"25";"0";"25";"0";"430499";"5766"
"LOK1378_1mm";"SILVA (only NR);Bacteria;Desulfobacterota;Desulfovibrionia;Desulfovibrionales;Desulfovibrionaceae;";"0.0";"0";"824";"800";"0";"800";"24";"429724";"5766"
"LOK1378_1mm";"SILVA (only NR);Bacteria;Desulfobacterota;Desulfovibrionia;Desulfovibrionales;Desulfovibrionaceae;Bilophila;";"0.0";"0";"24";"21";"0";"21";"3";"430503";"5766"
"LOK1378_1mm";"SILVA (only NR);Bacteria;Desulfobacterota;Desulfovibrionia;Desulfovibrionales;Desulfovibrionaceae;Desulfobaculum;";"0.0";"0";"1";"1";"0";"1";"0";"430523";"5766"
"LOK1378_1mm";"SILVA (only NR);Bacteria;Desulfobacterota;Desulfovibrionia;Desulfovibrionales;Desulfovibrionaceae;Desulfocurvus;";"0.0";"0";"8";"7";"0";"7";"1";"430517";"5766"
"LOK1378_1mm";"SILVA (only NR);Bacteria;Desulfobacterota;Desulfovibrionia;Desulfovibrionales;Desulfovibrionaceae;Desulfovibrio;";"0.0";"0";"616";"601";"0";"601";"15";"429923";"5766"
"LOK1378_1mm";"SILVA (only NR);Bacteria;Desulfobacterota;Desulfovibrionia;Desulfovibrionales;Desulfovibrionaceae;Halodesulfovibrio;";"0.0";"0";"37";"36";"0";"36";"1";"430488";"5766"
"LOK1378_1mm";"SILVA (only NR);Bacteria;Desulfobacterota;Desulfovibrionia;Desulfovibrionales;Desulfovibrionaceae;Lawsonia;";"0.0";"0";"7";"7";"0";"7";"0";"430517";"5766"
"LOK1378_1mm";"SILVA (only NR);Bacteria;Desulfobacterota;Desulfovibrionia;Desulfovibrionales;Desulfovibrionaceae;Mailhella;";"0.0";"0";"10";"8";"0";"8";"2";"430516";"5766"
"LOK1378_1mm";"SILVA (only NR);Bacteria;Desulfobacterota;Desulfovibrionia;Desulfovibrionales;Desulfovibrionaceae;uncultured;";"0.0";"0";"117";"115";"0";"115";"2";"430409";"5766"
"LOK1378_1mm";"SILVA (only NR);Bacteria;Desulfobacterota;Desulfuromonadia;";"0.0";"0";"1402";"1367";"0";"1367";"35";"429157";"5766"
"LOK1378_1mm";"SILVA (only NR);Bacteria;Desulfobacterota;Desulfuromonadia;Bradymonadales;";"0.0";"0";"235";"234";"0";"234";"1";"430290";"5766"
"LOK1378_1mm";"SILVA (only NR);Bacteria;Desulfobacterota;Desulfuromonadia;Bradymonadales;Bradymonadaceae;";"0.0";"0";"97";"97";"0";"97";"0";"430427";"5766"
"LOK1378_1mm";"SILVA (only NR);Bacteria;Desulfobacterota;Desulfuromonadia;Bradymonadales;Bradymonadaceae;Bradymonas;";"0.0";"0";"4";"4";"0";"4";"0";"430520";"5766"
"LOK1378_1mm";"SILVA (only NR);Bacteria;Desulfobacterota;Desulfuromonadia;Desulfuromonadales;";"0.0";"0";"417";"410";"0";"410";"7";"430114";"5766"
"LOK1378_1mm";"SILVA (only NR);Bacteria;Desulfobacterota;Desulfuromonadia;Desulfuromonadales;C8S-102;";"0.0";"0";"5";"5";"0";"5";"0";"430519";"5766"
"LOK1378_1mm";"SILVA (only NR);Bacteria;Desulfobacterota;Desulfuromonadia;Desulfuromonadales;Desulfuromonadaceae;";"0.0";"0";"145";"142";"0";"142";"3";"430382";"5766"
"LOK1378_1mm";"SILVA (only NR);Bacteria;Desulfobacterota;Desulfuromonadia;Desulfuromonadales;Desulfuromonadaceae;Candidatus Deferrimonas;";"0.0";"0";"3";"3";"0";"3";"0";"430521";"5766"
"LOK1378_1mm";"SILVA (only NR);Bacteria;Desulfobacterota;Desulfuromonadia;Desulfuromonadales;Desulfuromonadaceae;Desulfuromonas;";"0.0";"0";"103";"100";"0";"100";"3";"430424";"5766"
"LOK1378_1mm";"SILVA (only NR);Bacteria;Desulfobacterota;Desulfuromonadia;Desulfuromonadales;Desulfuromonadaceae;Trichloromonas;";"0.0";"0";"12";"12";"0";"12";"0";"430512";"5766"
"LOK1378_1mm";"SILVA (only NR);Bacteria;Desulfobacterota;Desulfuromonadia;Desulfuromonadales;Geoalkalibacteraceae;";"0.0";"0";"20";"19";"0";"19";"1";"430505";"5766"
"LOK1378_1mm";"SILVA (only NR);Bacteria;Desulfobacterota;Desulfuromonadia;Desulfuromonadales;Geoalkalibacteraceae;Geoalkalibacter;";"0.0";"0";"20";"19";"0";"19";"1";"430505";"5766"
"LOK1378_1mm";"SILVA (only NR);Bacteria;Desulfobacterota;Desulfuromonadia;Desulfuromonadales;Geopsychrobacteraceae;";"0.0";"0";"93";"92";"0";"92";"1";"430432";"5766"
"LOK1378_1mm";"SILVA (only NR);Bacteria;Desulfobacterota;Desulfuromonadia;Desulfuromonadales;Geopsychrobacteraceae;Desulfuromusa;";"0.0";"0";"63";"62";"0";"62";"1";"430462";"5766"
"LOK1378_1mm";"SILVA (only NR);Bacteria;Desulfobacterota;Desulfuromonadia;Desulfuromonadales;Geopsychrobacteraceae;Geopsychrobacter;";"0.0";"0";"16";"16";"0";"16";"0";"430508";"5766"
"LOK1378_1mm";"SILVA (only NR);Bacteria;Desulfobacterota;Desulfuromonadia;Desulfuromonadales;Geopsychrobacteraceae;Malonomonas;";"0.0";"0";"8";"8";"0";"8";"0";"430516";"5766"
"LOK1378_1mm";"SILVA (only NR);Bacteria;Desulfobacterota;Desulfuromonadia;Desulfuromonadales;Geopsychrobacteraceae;Pelobacter;";"0.0";"0";"5";"5";"0";"5";"0";"430519";"5766"
"LOK1378_1mm";"SILVA (only NR);Bacteria;Desulfobacterota;Desulfuromonadia;Desulfuromonadales;Geothermobacteraceae;";"0.0";"0";"44";"43";"0";"43";"1";"430481";"5766"
"LOK1378_1mm";"SILVA (only NR);Bacteria;Desulfobacterota;Desulfuromonadia;Desulfuromonadales;Geothermobacteraceae;Geothermobacter;";"0.0";"0";"44";"43";"0";"43";"1";"430481";"5766"
"LOK1378_1mm";"SILVA (only NR);Bacteria;Desulfobacterota;Desulfuromonadia;Desulfuromonadales;MA-28-I98C;";"0.0";"0";"7";"7";"0";"7";"0";"430517";"5766"
"LOK1378_1mm";"SILVA (only NR);Bacteria;Desulfobacterota;Desulfuromonadia;Desulfuromonadales;Sva1033;";"0.0";"0";"63";"62";"0";"62";"1";"430462";"5766"
"LOK1378_1mm";"SILVA (only NR);Bacteria;Desulfobacterota;Desulfuromonadia;Desulfuromonadales;Syntrophotaleaceae;";"0.0";"0";"35";"35";"0";"35";"0";"430489";"5766"
"LOK1378_1mm";"SILVA (only NR);Bacteria;Desulfobacterota;Desulfuromonadia;Desulfuromonadales;Syntrophotaleaceae;Syntrophotalea;";"0.0";"0";"35";"35";"0";"35";"0";"430489";"5766"
"LOK1378_1mm";"SILVA (only NR);Bacteria;Desulfobacterota;Desulfuromonadia;Desulfuromonadales;uncultured;";"0.0";"0";"2";"2";"0";"2";"0";"430522";"5766"
"LOK1378_1mm";"SILVA (only NR);Bacteria;Desulfobacterota;Desulfuromonadia;Geobacterales;";"0.0";"0";"575";"553";"0";"553";"22";"429971";"5766"
"LOK1378_1mm";"SILVA (only NR);Bacteria;Desulfobacterota;Desulfuromonadia;Geobacterales;Geobacteraceae;";"0.0";"0";"571";"549";"0";"549";"22";"429975";"5766"
"LOK1378_1mm";"SILVA (only NR);Bacteria;Desulfobacterota;Desulfuromonadia;Geobacterales;Geobacteraceae;Citrifermentans;";"0.0";"0";"121";"114";"0";"114";"7";"430410";"5766"
"LOK1378_1mm";"SILVA (only NR);Bacteria;Desulfobacterota;Desulfuromonadia;Geobacterales;Geobacteraceae;Geobacter;";"0.0";"0";"219";"214";"0";"214";"5";"430310";"5766"
"LOK1378_1mm";"SILVA (only NR);Bacteria;Desulfobacterota;Desulfuromonadia;Geobacterales;Geobacteraceae;Geotalea;";"0.0";"0";"14";"14";"0";"14";"0";"430510";"5766"
"LOK1378_1mm";"SILVA (only NR);Bacteria;Desulfobacterota;Desulfuromonadia;Geobacterales;Geobacteraceae;Trichlorobacter;";"0.0";"0";"33";"33";"0";"33";"0";"430491";"5766"
"LOK1378_1mm";"SILVA (only NR);Bacteria;Desulfobacterota;Desulfuromonadia;Geobacterales;Geobacteraceae;uncultured;";"0.0";"0";"162";"153";"0";"153";"9";"430371";"5766"
"LOK1378_1mm";"SILVA (only NR);Bacteria;Desulfobacterota;Desulfuromonadia;Geobacterales;Pseudopelobacteraceae;";"0.0";"0";"4";"4";"0";"4";"0";"430520";"5766"
"LOK1378_1mm";"SILVA (only NR);Bacteria;Desulfobacterota;Desulfuromonadia;Geobacterales;Pseudopelobacteraceae;Pseudopelobacter;";"0.0";"0";"4";"4";"0";"4";"0";"430520";"5766"
"LOK1378_1mm";"SILVA (only NR);Bacteria;Desulfobacterota;Desulfuromonadia;PB19;";"0.0";"0";"171";"166";"0";"166";"5";"430358";"5766"
"LOK1378_1mm";"SILVA (only NR);Bacteria;Desulfobacterota;Desulfuromonadia;uncultured;";"0.0";"0";"2";"2";"0";"2";"0";"430522";"5766"
"LOK1378_1mm";"SILVA (only NR);Bacteria;Desulfobacterota;Dissulfuribacteria;";"0.0";"0";"80";"75";"0";"75";"5";"430449";"5766"
"LOK1378_1mm";"SILVA (only NR);Bacteria;Desulfobacterota;Dissulfuribacteria;Dissulfuribacterales;";"0.0";"0";"80";"75";"0";"75";"5";"430449";"5766"
"LOK1378_1mm";"SILVA (only NR);Bacteria;Desulfobacterota;Dissulfuribacteria;Dissulfuribacterales;Dissulfuribacteraceae;";"0.0";"0";"80";"75";"0";"75";"5";"430449";"5766"
"LOK1378_1mm";"SILVA (only NR);Bacteria;Desulfobacterota;Dissulfuribacteria;Dissulfuribacterales;Dissulfuribacteraceae;Dissulfuribacter;";"0.0";"0";"3";"3";"0";"3";"0";"430521";"5766"
"LOK1378_1mm";"SILVA (only NR);Bacteria;Desulfobacterota;Dissulfuribacteria;Dissulfuribacterales;Dissulfuribacteraceae;Dissulfurimicrobium;";"0.0";"0";"12";"12";"0";"12";"0";"430512";"5766"
"LOK1378_1mm";"SILVA (only NR);Bacteria;Desulfobacterota;Dissulfuribacteria;Dissulfuribacterales;Dissulfuribacteraceae;Dissulfurirhabdus;";"0.0";"0";"2";"2";"0";"2";"0";"430522";"5766"
"LOK1378_1mm";"SILVA (only NR);Bacteria;Desulfobacterota;Dissulfuribacteria;Dissulfuribacterales;Dissulfuribacteraceae;SEEP-SRB2;";"0.0";"0";"36";"34";"0";"34";"2";"430490";"5766"
"LOK1378_1mm";"SILVA (only NR);Bacteria;Desulfobacterota;Dissulfuribacteria;Dissulfuribacterales;Dissulfuribacteraceae;uncultured;";"0.0";"0";"24";"21";"0";"21";"3";"430503";"5766"
"LOK1378_1mm";"SILVA (only NR);Bacteria;Desulfobacterota;Incertae Sedis;";"0.0";"0";"9";"9";"0";"9";"0";"430515";"5766"
"LOK1378_1mm";"SILVA (only NR);Bacteria;Desulfobacterota;Syntrophia;";"0.0";"0";"451";"434";"0";"434";"17";"430090";"5766"
"LOK1378_1mm";"SILVA (only NR);Bacteria;Desulfobacterota;Syntrophia;Syntrophales;";"0.0";"0";"451";"434";"0";"434";"17";"430090";"5766"
"LOK1378_1mm";"SILVA (only NR);Bacteria;Desulfobacterota;Syntrophia;Syntrophales;Smithellaceae;";"0.0";"0";"119";"115";"0";"115";"4";"430409";"5766"
"LOK1378_1mm";"SILVA (only NR);Bacteria;Desulfobacterota;Syntrophia;Syntrophales;Smithellaceae;Smithella;";"0.0";"0";"119";"115";"0";"115";"4";"430409";"5766"
"LOK1378_1mm";"SILVA (only NR);Bacteria;Desulfobacterota;Syntrophia;Syntrophales;Syntrophaceae;";"0.0";"0";"221";"218";"0";"218";"3";"430306";"5766"
"LOK1378_1mm";"SILVA (only NR);Bacteria;Desulfobacterota;Syntrophia;Syntrophales;Syntrophaceae;Syntrophus;";"0.0";"0";"221";"218";"0";"218";"3";"430306";"5766"
"LOK1378_1mm";"SILVA (only NR);Bacteria;Desulfobacterota;Syntrophia;Syntrophales;uncultured;";"0.0";"0";"109";"99";"0";"99";"10";"430425";"5766"
"LOK1378_1mm";"SILVA (only NR);Bacteria;Desulfobacterota;Syntrophobacteria;";"0.0";"0";"228";"221";"0";"221";"7";"430303";"5766"
"LOK1378_1mm";"SILVA (only NR);Bacteria;Desulfobacterota;Syntrophobacteria;Syntrophobacterales;";"0.0";"0";"228";"221";"0";"221";"7";"430303";"5766"
"LOK1378_1mm";"SILVA (only NR);Bacteria;Desulfobacterota;Syntrophobacteria;Syntrophobacterales;Syntrophobacteraceae;";"0.0";"0";"161";"154";"0";"154";"7";"430370";"5766"
"LOK1378_1mm";"SILVA (only NR);Bacteria;Desulfobacterota;Syntrophobacteria;Syntrophobacterales;Syntrophobacteraceae;Desulfacinum;";"0.0";"0";"4";"4";"0";"4";"0";"430520";"5766"
"LOK1378_1mm";"SILVA (only NR);Bacteria;Desulfobacterota;Syntrophobacteria;Syntrophobacterales;Syntrophobacteraceae;Desulfoglaeba;";"0.0";"0";"1";"1";"0";"1";"0";"430523";"5766"
"LOK1378_1mm";"SILVA (only NR);Bacteria;Desulfobacterota;Syntrophobacteria;Syntrophobacterales;Syntrophobacteraceae;Desulforhabdus;";"0.0";"0";"11";"10";"0";"10";"1";"430514";"5766"
"LOK1378_1mm";"SILVA (only NR);Bacteria;Desulfobacterota;Syntrophobacteria;Syntrophobacterales;Syntrophobacteraceae;Desulfosoma;";"0.0";"0";"2";"2";"0";"2";"0";"430522";"5766"
"LOK1378_1mm";"SILVA (only NR);Bacteria;Desulfobacterota;Syntrophobacteria;Syntrophobacterales;Syntrophobacteraceae;Desulfovirga;";"0.0";"0";"12";"12";"0";"12";"0";"430512";"5766"
"LOK1378_1mm";"SILVA (only NR);Bacteria;Desulfobacterota;Syntrophobacteria;Syntrophobacterales;Syntrophobacteraceae;Syntrophobacter;";"0.0";"0";"94";"89";"0";"89";"5";"430435";"5766"
"LOK1378_1mm";"SILVA (only NR);Bacteria;Desulfobacterota;Syntrophobacteria;Syntrophobacterales;Syntrophobacteraceae;uncultured;";"0.0";"0";"35";"34";"0";"34";"1";"430490";"5766"
"LOK1378_1mm";"SILVA (only NR);Bacteria;Desulfobacterota;Syntrophobacteria;Syntrophobacterales;Thermodesulforhabdaceae;";"0.0";"0";"6";"6";"0";"6";"0";"430518";"5766"
"LOK1378_1mm";"SILVA (only NR);Bacteria;Desulfobacterota;Syntrophobacteria;Syntrophobacterales;Thermodesulforhabdaceae;Thermodesulforhabdus;";"0.0";"0";"6";"6";"0";"6";"0";"430518";"5766"
"LOK1378_1mm";"SILVA (only NR);Bacteria;Desulfobacterota;Syntrophobacteria;Syntrophobacterales;uncultured;";"0.0";"0";"61";"61";"0";"61";"0";"430463";"5766"
"LOK1378_1mm";"SILVA (only NR);Bacteria;Desulfobacterota;Syntrophorhabdia;";"0.0";"0";"168";"157";"0";"157";"11";"430367";"5766"
"LOK1378_1mm";"SILVA (only NR);Bacteria;Desulfobacterota;Syntrophorhabdia;Syntrophorhabdales;";"0.0";"0";"168";"157";"0";"157";"11";"430367";"5766"
"LOK1378_1mm";"SILVA (only NR);Bacteria;Desulfobacterota;Syntrophorhabdia;Syntrophorhabdales;Syntrophorhabdaceae;";"0.0";"0";"168";"157";"0";"157";"11";"430367";"5766"
"LOK1378_1mm";"SILVA (only NR);Bacteria;Desulfobacterota;Syntrophorhabdia;Syntrophorhabdales;Syntrophorhabdaceae;Syntrophorhabdus;";"0.0";"0";"168";"157";"0";"157";"11";"430367";"5766"
"LOK1378_1mm";"SILVA (only NR);Bacteria;Desulfobacterota;Thermodesulfobacteria;";"0.0";"0";"62";"60";"0";"60";"2";"430464";"5766"
"LOK1378_1mm";"SILVA (only NR);Bacteria;Desulfobacterota;Thermodesulfobacteria;Thermodesulfobacteriales;";"0.0";"0";"62";"60";"0";"60";"2";"430464";"5766"
"LOK1378_1mm";"SILVA (only NR);Bacteria;Desulfobacterota;Thermodesulfobacteria;Thermodesulfobacteriales;Thermodesulfobacteriaceae;";"0.0";"0";"62";"60";"0";"60";"2";"430464";"5766"
"LOK1378_1mm";"SILVA (only NR);Bacteria;Desulfobacterota;Thermodesulfobacteria;Thermodesulfobacteriales;Thermodesulfobacteriaceae;Caldimicrobium;";"0.0";"0";"28";"27";"0";"27";"1";"430497";"5766"
"LOK1378_1mm";"SILVA (only NR);Bacteria;Desulfobacterota;Thermodesulfobacteria;Thermodesulfobacteriales;Thermodesulfobacteriaceae;Geothermobacterium;";"0.0";"0";"4";"4";"0";"4";"0";"430520";"5766"
"LOK1378_1mm";"SILVA (only NR);Bacteria;Desulfobacterota;Thermodesulfobacteria;Thermodesulfobacteriales;Thermodesulfobacteriaceae;Thermodesulfatator;";"0.0";"0";"5";"5";"0";"5";"0";"430519";"5766"
"LOK1378_1mm";"SILVA (only NR);Bacteria;Desulfobacterota;Thermodesulfobacteria;Thermodesulfobacteriales;Thermodesulfobacteriaceae;Thermodesulfobacterium;";"0.0";"0";"10";"9";"0";"9";"1";"430515";"5766"
"LOK1378_1mm";"SILVA (only NR);Bacteria;Desulfobacterota;Thermodesulfobacteria;Thermodesulfobacteriales;Thermodesulfobacteriaceae;Thermosulfurimonas;";"0.0";"0";"2";"2";"0";"2";"0";"430522";"5766"
"LOK1378_1mm";"SILVA (only NR);Bacteria;Desulfobacterota;Thermodesulfobacteria;Thermodesulfobacteriales;Thermodesulfobacteriaceae;Thermosulfuriphilus;";"0.0";"0";"1";"1";"0";"1";"0";"430523";"5766"
"LOK1378_1mm";"SILVA (only NR);Bacteria;Desulfobacterota;Thermodesulfobacteria;Thermodesulfobacteriales;Thermodesulfobacteriaceae;uncultured;";"0.0";"0";"10";"10";"0";"10";"0";"430514";"5766"
"LOK1378_1mm";"SILVA (only NR);Bacteria;Desulfobacterota;uncultured;";"0.0";"0";"173";"163";"0";"163";"10";"430361";"5766"
"LOK1378_1mm";"SILVA (only NR);Bacteria;Dictyoglomota;";"0.0";"0";"8";"8";"0";"8";"0";"430516";"5766"
"LOK1378_1mm";"SILVA (only NR);Bacteria;Dictyoglomota;Dictyoglomia;";"0.0";"0";"8";"8";"0";"8";"0";"430516";"5766"
"LOK1378_1mm";"SILVA (only NR);Bacteria;Dictyoglomota;Dictyoglomia;Dictyoglomales;";"0.0";"0";"8";"8";"0";"8";"0";"430516";"5766"
"LOK1378_1mm";"SILVA (only NR);Bacteria;Dictyoglomota;Dictyoglomia;Dictyoglomales;Dictyoglomaceae;";"0.0";"0";"8";"8";"0";"8";"0";"430516";"5766"
"LOK1378_1mm";"SILVA (only NR);Bacteria;Dictyoglomota;Dictyoglomia;Dictyoglomales;Dictyoglomaceae;Dictyoglomus;";"0.0";"0";"8";"8";"0";"8";"0";"430516";"5766"
"LOK1378_1mm";"SILVA (only NR);Bacteria;Edwardsbacteria;";"0.0";"0";"4";"4";"0";"4";"0";"430520";"5766"
"LOK1378_1mm";"SILVA (only NR);Bacteria;Elusimicrobiota;";"0.0";"0";"418";"405";"0";"405";"13";"430119";"5766"
"LOK1378_1mm";"SILVA (only NR);Bacteria;Elusimicrobiota;4-29;";"0.0";"0";"25";"23";"0";"23";"2";"430501";"5766"
"LOK1378_1mm";"SILVA (only NR);Bacteria;Elusimicrobiota;Elusimicrobia;";"0.0";"0";"114";"110";"0";"110";"4";"430414";"5766"
"LOK1378_1mm";"SILVA (only NR);Bacteria;Elusimicrobiota;Elusimicrobia;Elusimicrobiales;";"0.0";"0";"17";"17";"0";"17";"0";"430507";"5766"
"LOK1378_1mm";"SILVA (only NR);Bacteria;Elusimicrobiota;Elusimicrobia;Elusimicrobiales;Elusimicrobiaceae;";"0.0";"0";"17";"17";"0";"17";"0";"430507";"5766"
"LOK1378_1mm";"SILVA (only NR);Bacteria;Elusimicrobiota;Elusimicrobia;Elusimicrobiales;Elusimicrobiaceae;Elusimicrobium;";"0.0";"0";"17";"17";"0";"17";"0";"430507";"5766"
"LOK1378_1mm";"SILVA (only NR);Bacteria;Elusimicrobiota;Elusimicrobia;FCPU453;";"0.0";"0";"2";"1";"0";"1";"1";"430523";"5766"
"LOK1378_1mm";"SILVA (only NR);Bacteria;Elusimicrobiota;Elusimicrobia;Lineage IV;";"0.0";"0";"68";"66";"0";"66";"2";"430458";"5766"
"LOK1378_1mm";"SILVA (only NR);Bacteria;Elusimicrobiota;Elusimicrobia;MD2894-B20;";"0.0";"0";"6";"6";"0";"6";"0";"430518";"5766"
"LOK1378_1mm";"SILVA (only NR);Bacteria;Elusimicrobiota;Elusimicrobia;MVP-88;";"0.0";"0";"21";"20";"0";"20";"1";"430504";"5766"
"LOK1378_1mm";"SILVA (only NR);Bacteria;Elusimicrobiota;Endomicrobia;";"0.0";"0";"158";"157";"0";"157";"1";"430367";"5766"
"LOK1378_1mm";"SILVA (only NR);Bacteria;Elusimicrobiota;Endomicrobia;Endomicrobiales;";"0.0";"0";"158";"157";"0";"157";"1";"430367";"5766"
"LOK1378_1mm";"SILVA (only NR);Bacteria;Elusimicrobiota;Endomicrobia;Endomicrobiales;Endomicrobiaceae;";"0.0";"0";"158";"157";"0";"157";"1";"430367";"5766"
"LOK1378_1mm";"SILVA (only NR);Bacteria;Elusimicrobiota;Endomicrobia;Endomicrobiales;Endomicrobiaceae;Endomicrobium;";"0.0";"0";"158";"157";"0";"157";"1";"430367";"5766"
"LOK1378_1mm";"SILVA (only NR);Bacteria;Elusimicrobiota;Lineage IIa;";"0.0";"0";"52";"51";"0";"51";"1";"430473";"5766"
"LOK1378_1mm";"SILVA (only NR);Bacteria;Elusimicrobiota;Lineage IIb;";"0.0";"0";"32";"28";"0";"28";"4";"430496";"5766"
"LOK1378_1mm";"SILVA (only NR);Bacteria;Elusimicrobiota;Lineage IIc;";"0.0";"0";"21";"20";"0";"20";"1";"430504";"5766"
"LOK1378_1mm";"SILVA (only NR);Bacteria;Elusimicrobiota;Rs-M47;";"0.0";"0";"13";"13";"0";"13";"0";"430511";"5766"
"LOK1378_1mm";"SILVA (only NR);Bacteria;Entotheonellaeota;";"0.0";"0";"152";"144";"0";"144";"8";"430380";"5766"
"LOK1378_1mm";"SILVA (only NR);Bacteria;Entotheonellaeota;Entotheonellia;";"0.0";"0";"152";"144";"0";"144";"8";"430380";"5766"
"LOK1378_1mm";"SILVA (only NR);Bacteria;Entotheonellaeota;Entotheonellia;Entotheonellales;";"0.0";"0";"152";"144";"0";"144";"8";"430380";"5766"
"LOK1378_1mm";"SILVA (only NR);Bacteria;Entotheonellaeota;Entotheonellia;Entotheonellales;Entotheonellaceae;";"0.0";"0";"152";"144";"0";"144";"8";"430380";"5766"
"LOK1378_1mm";"SILVA (only NR);Bacteria;Entotheonellaeota;Entotheonellia;Entotheonellales;Entotheonellaceae;Candidatus Entotheonella;";"0.0";"0";"31";"31";"0";"31";"0";"430493";"5766"
"LOK1378_1mm";"SILVA (only NR);Bacteria;FCPU426;";"0.0";"0";"38";"36";"0";"36";"2";"430488";"5766"
"LOK1378_1mm";"SILVA (only NR);Bacteria;FW113;";"0.0";"0";"19";"17";"0";"17";"2";"430507";"5766"
"LOK1378_1mm";"SILVA (only NR);Bacteria;Fermentibacterota;";"0.0";"0";"54";"53";"0";"53";"1";"430471";"5766"
"LOK1378_1mm";"SILVA (only NR);Bacteria;Fermentibacterota;Fermentibacteria;";"0.0";"0";"54";"53";"0";"53";"1";"430471";"5766"
"LOK1378_1mm";"SILVA (only NR);Bacteria;Fermentibacterota;Fermentibacteria;Fermentibacterales;";"0.0";"0";"54";"53";"0";"53";"1";"430471";"5766"
"LOK1378_1mm";"SILVA (only NR);Bacteria;Fermentibacterota;Fermentibacteria;Fermentibacterales;Fermentibacteraceae;";"0.0";"0";"54";"53";"0";"53";"1";"430471";"5766"
"LOK1378_1mm";"SILVA (only NR);Bacteria;Fervidibacteria;";"0.0";"0";"4";"4";"0";"4";"0";"430520";"5766"
"LOK1378_1mm";"SILVA (only NR);Bacteria;Fibrobacterota;";"0.0";"0";"739";"675";"0";"675";"64";"429849";"5766"
"LOK1378_1mm";"SILVA (only NR);Bacteria;Fibrobacterota;Chitinivibrionia;";"0.0";"0";"55";"54";"0";"54";"1";"430470";"5766"
"LOK1378_1mm";"SILVA (only NR);Bacteria;Fibrobacterota;Chitinivibrionia;Chitinivibrionales;";"0.0";"0";"10";"10";"0";"10";"0";"430514";"5766"
"LOK1378_1mm";"SILVA (only NR);Bacteria;Fibrobacterota;Chitinivibrionia;Chitinivibrionales;Chitinivibrionaceae;";"0.0";"0";"10";"10";"0";"10";"0";"430514";"5766"
"LOK1378_1mm";"SILVA (only NR);Bacteria;Fibrobacterota;Chitinivibrionia;Chitinivibrionales;Chitinivibrionaceae;Chitinivibrio;";"0.0";"0";"2";"2";"0";"2";"0";"430522";"5766"
"LOK1378_1mm";"SILVA (only NR);Bacteria;Fibrobacterota;Chitinivibrionia;Chitinivibrionales;Chitinivibrionaceae;possible genus 03;";"0.0";"0";"8";"8";"0";"8";"0";"430516";"5766"
"LOK1378_1mm";"SILVA (only NR);Bacteria;Fibrobacterota;Chitinivibrionia;Chitinivibrionia Incertae Sedis;";"0.0";"0";"13";"13";"0";"13";"0";"430511";"5766"
"LOK1378_1mm";"SILVA (only NR);Bacteria;Fibrobacterota;Chitinivibrionia;Chitinivibrionia Incertae Sedis;Unknown Family;";"0.0";"0";"13";"13";"0";"13";"0";"430511";"5766"
"LOK1378_1mm";"SILVA (only NR);Bacteria;Fibrobacterota;Chitinivibrionia;Chitinivibrionia Incertae Sedis;Unknown Family;possible genus 02;";"0.0";"0";"13";"13";"0";"13";"0";"430511";"5766"
"LOK1378_1mm";"SILVA (only NR);Bacteria;Fibrobacterota;Chitinivibrionia;uncultured;";"0.0";"0";"32";"31";"0";"31";"1";"430493";"5766"
"LOK1378_1mm";"SILVA (only NR);Bacteria;Fibrobacterota;Fibrobacteria;";"0.0";"0";"684";"621";"0";"621";"63";"429903";"5766"
"LOK1378_1mm";"SILVA (only NR);Bacteria;Fibrobacterota;Fibrobacteria;Fibrobacterales;";"0.0";"0";"684";"621";"0";"621";"63";"429903";"5766"
"LOK1378_1mm";"SILVA (only NR);Bacteria;Fibrobacterota;Fibrobacteria;Fibrobacterales;09D2Z48;";"0.0";"0";"41";"36";"0";"36";"5";"430488";"5766"
"LOK1378_1mm";"SILVA (only NR);Bacteria;Fibrobacterota;Fibrobacteria;Fibrobacterales;B122;";"0.0";"0";"10";"10";"0";"10";"0";"430514";"5766"
"LOK1378_1mm";"SILVA (only NR);Bacteria;Fibrobacterota;Fibrobacteria;Fibrobacterales;B18;";"0.0";"0";"6";"6";"0";"6";"0";"430518";"5766"
"LOK1378_1mm";"SILVA (only NR);Bacteria;Fibrobacterota;Fibrobacteria;Fibrobacterales;B5-096;";"0.0";"0";"2";"2";"0";"2";"0";"430522";"5766"
"LOK1378_1mm";"SILVA (only NR);Bacteria;Fibrobacterota;Fibrobacteria;Fibrobacterales;BBMC-4;";"0.0";"0";"38";"37";"0";"37";"1";"430487";"5766"
"LOK1378_1mm";"SILVA (only NR);Bacteria;Fibrobacterota;Fibrobacteria;Fibrobacterales;Candidatus Raymondbacteria;";"0.0";"0";"13";"13";"0";"13";"0";"430511";"5766"
"LOK1378_1mm";"SILVA (only NR);Bacteria;Fibrobacterota;Fibrobacteria;Fibrobacterales;Chitinispirillum;";"0.0";"0";"1";"1";"0";"1";"0";"430523";"5766"
"LOK1378_1mm";"SILVA (only NR);Bacteria;Fibrobacterota;Fibrobacteria;Fibrobacterales;Fibrobacteraceae;";"0.0";"0";"324";"288";"0";"288";"36";"430236";"5766"
"LOK1378_1mm";"SILVA (only NR);Bacteria;Fibrobacterota;Fibrobacteria;Fibrobacterales;Fibrobacteraceae;Fibrobacter;";"0.0";"0";"177";"148";"0";"148";"29";"430376";"5766"
"LOK1378_1mm";"SILVA (only NR);Bacteria;Fibrobacterota;Fibrobacteria;Fibrobacterales;Fibrobacteraceae;possible genus 04;";"0.0";"0";"20";"19";"0";"19";"1";"430505";"5766"
"LOK1378_1mm";"SILVA (only NR);Bacteria;Fibrobacterota;Fibrobacteria;Fibrobacterales;Fibrobacteraceae;possible genus 05;";"0.0";"0";"51";"51";"0";"51";"0";"430473";"5766"
"LOK1378_1mm";"SILVA (only NR);Bacteria;Fibrobacterota;Fibrobacteria;Fibrobacterales;Fibrobacteraceae;possible genus 06;";"0.0";"0";"2";"2";"0";"2";"0";"430522";"5766"
"LOK1378_1mm";"SILVA (only NR);Bacteria;Fibrobacterota;Fibrobacteria;Fibrobacterales;Fibrobacteraceae;uncultured;";"0.0";"0";"72";"67";"0";"67";"5";"430457";"5766"
"LOK1378_1mm";"SILVA (only NR);Bacteria;Fibrobacterota;Fibrobacteria;Fibrobacterales;MAT-CR-H6-H10;";"0.0";"0";"72";"61";"0";"61";"11";"430463";"5766"
"LOK1378_1mm";"SILVA (only NR);Bacteria;Fibrobacterota;Fibrobacteria;Fibrobacterales;SBXY-748;";"0.0";"0";"11";"11";"0";"11";"0";"430513";"5766"
"LOK1378_1mm";"SILVA (only NR);Bacteria;Fibrobacterota;Fibrobacteria;Fibrobacterales;SBYC;";"0.0";"0";"20";"18";"0";"18";"2";"430506";"5766"
"LOK1378_1mm";"SILVA (only NR);Bacteria;Fibrobacterota;Fibrobacteria;Fibrobacterales;SBYS-2995;";"0.0";"0";"4";"4";"0";"4";"0";"430520";"5766"
"LOK1378_1mm";"SILVA (only NR);Bacteria;Fibrobacterota;Fibrobacteria;Fibrobacterales;SBYZ-1017;";"0.0";"0";"11";"11";"0";"11";"0";"430513";"5766"
"LOK1378_1mm";"SILVA (only NR);Bacteria;Fibrobacterota;Fibrobacteria;Fibrobacterales;TG3;";"0.0";"0";"40";"32";"0";"32";"8";"430492";"5766"
"LOK1378_1mm";"SILVA (only NR);Bacteria;Fibrobacterota;Fibrobacteria;Fibrobacterales;uncultured;";"0.0";"0";"90";"90";"0";"90";"0";"430434";"5766"
"LOK1378_1mm";"SILVA (only NR);Bacteria;Firestonebacteria;";"0.0";"0";"4";"4";"0";"4";"0";"430520";"5766"
"LOK1378_1mm";"SILVA (only NR);Bacteria;Firmicutes;";"0.0";"0";"100538";"95852";"0";"95852";"4686";"334672";"5766"
"LOK1378_1mm";"SILVA (only NR);Bacteria;Firmicutes;BRH-c20a;";"0.0";"0";"32";"32";"0";"32";"0";"430492";"5766"
"LOK1378_1mm";"SILVA (only NR);Bacteria;Firmicutes;Bacilli;";"0.0";"0";"42707";"40299";"0";"40299";"2408";"390225";"5766"
"LOK1378_1mm";"SILVA (only NR);Bacteria;Firmicutes;Bacilli;Acholeplasmatales;";"0.0";"0";"752";"729";"0";"729";"23";"429795";"5766"
"LOK1378_1mm";"SILVA (only NR);Bacteria;Firmicutes;Bacilli;Acholeplasmatales;Acholeplasmataceae;";"0.0";"0";"752";"729";"0";"729";"23";"429795";"5766"
"LOK1378_1mm";"SILVA (only NR);Bacteria;Firmicutes;Bacilli;Acholeplasmatales;Acholeplasmataceae;Acholeplasma;";"0.0";"0";"203";"193";"0";"193";"10";"430331";"5766"
"LOK1378_1mm";"SILVA (only NR);Bacteria;Firmicutes;Bacilli;Acholeplasmatales;Acholeplasmataceae;Anaeroplasma;";"0.0";"0";"63";"62";"0";"62";"1";"430462";"5766"
"LOK1378_1mm";"SILVA (only NR);Bacteria;Firmicutes;Bacilli;Acholeplasmatales;Acholeplasmataceae;Candidatus Phytoplasma;";"0.0";"0";"468";"456";"0";"456";"12";"430068";"5766"
"LOK1378_1mm";"SILVA (only NR);Bacteria;Firmicutes;Bacilli;Acholeplasmatales;Acholeplasmataceae;DMI;";"0.0";"0";"4";"4";"0";"4";"0";"430520";"5766"
"LOK1378_1mm";"SILVA (only NR);Bacteria;Firmicutes;Bacilli;Acholeplasmatales;Acholeplasmataceae;EMP-G18;";"0.0";"0";"4";"4";"0";"4";"0";"430520";"5766"
"LOK1378_1mm";"SILVA (only NR);Bacteria;Firmicutes;Bacilli;Acholeplasmatales;Acholeplasmataceae;EUB33-2;";"0.0";"0";"5";"5";"0";"5";"0";"430519";"5766"
"LOK1378_1mm";"SILVA (only NR);Bacteria;Firmicutes;Bacilli;Acholeplasmatales;Acholeplasmataceae;NED5E9;";"0.0";"0";"3";"3";"0";"3";"0";"430521";"5766"
"LOK1378_1mm";"SILVA (only NR);Bacteria;Firmicutes;Bacilli;Acholeplasmatales;Acholeplasmataceae;T2WK15B57;";"0.0";"0";"2";"2";"0";"2";"0";"430522";"5766"
"LOK1378_1mm";"SILVA (only NR);Bacteria;Firmicutes;Bacilli;Alicyclobacillales;";"0.0";"0";"327";"311";"0";"311";"16";"430213";"5766"
"LOK1378_1mm";"SILVA (only NR);Bacteria;Firmicutes;Bacilli;Alicyclobacillales;Alicyclobacillaceae;";"0.0";"0";"327";"311";"0";"311";"16";"430213";"5766"
"LOK1378_1mm";"SILVA (only NR);Bacteria;Firmicutes;Bacilli;Alicyclobacillales;Alicyclobacillaceae;Acidibacillus;";"0.0";"0";"36";"31";"0";"31";"5";"430493";"5766"
"LOK1378_1mm";"SILVA (only NR);Bacteria;Firmicutes;Bacilli;Alicyclobacillales;Alicyclobacillaceae;Alicyclobacillus;";"0.0";"0";"161";"152";"0";"152";"9";"430372";"5766"
"LOK1378_1mm";"SILVA (only NR);Bacteria;Firmicutes;Bacilli;Alicyclobacillales;Alicyclobacillaceae;Effusibacillus;";"0.0";"0";"23";"23";"0";"23";"0";"430501";"5766"
"LOK1378_1mm";"SILVA (only NR);Bacteria;Firmicutes;Bacilli;Alicyclobacillales;Alicyclobacillaceae;Tumebacillus;";"0.0";"0";"107";"105";"0";"105";"2";"430419";"5766"
"LOK1378_1mm";"SILVA (only NR);Bacteria;Firmicutes;Bacilli;Aneurinibacillales;";"0.0";"0";"67";"65";"0";"65";"2";"430459";"5766"
"LOK1378_1mm";"SILVA (only NR);Bacteria;Firmicutes;Bacilli;Aneurinibacillales;Aneurinibacillaceae;";"0.0";"0";"67";"65";"0";"65";"2";"430459";"5766"
"LOK1378_1mm";"SILVA (only NR);Bacteria;Firmicutes;Bacilli;Aneurinibacillales;Aneurinibacillaceae;Aneurinibacillus;";"0.0";"0";"67";"65";"0";"65";"2";"430459";"5766"
"LOK1378_1mm";"SILVA (only NR);Bacteria;Firmicutes;Bacilli;Bacillales;";"0.0";"0";"15844";"14710";"0";"14710";"1134";"415814";"5766"
"LOK1378_1mm";"SILVA (only NR);Bacteria;Firmicutes;Bacilli;Bacillales;Bacillaceae;";"0.0";"0";"13753";"12754";"0";"12754";"999";"417770";"5766"
"LOK1378_1mm";"SILVA (only NR);Bacteria;Firmicutes;Bacilli;Bacillales;Bacillaceae;Aeribacillus;";"0.0";"0";"51";"47";"0";"47";"4";"430477";"5766"
"LOK1378_1mm";"SILVA (only NR);Bacteria;Firmicutes;Bacilli;Bacillales;Bacillaceae;Alkalibacillus;";"0.0";"0";"17";"16";"0";"16";"1";"430508";"5766"
"LOK1378_1mm";"SILVA (only NR);Bacteria;Firmicutes;Bacilli;Bacillales;Bacillaceae;Allobacillus;";"0.0";"0";"7";"7";"0";"7";"0";"430517";"5766"
"LOK1378_1mm";"SILVA (only NR);Bacteria;Firmicutes;Bacilli;Bacillales;Bacillaceae;Amphibacillus;";"0.0";"0";"22";"22";"0";"22";"0";"430502";"5766"
"LOK1378_1mm";"SILVA (only NR);Bacteria;Firmicutes;Bacilli;Bacillales;Bacillaceae;Anaerobacillus;";"0.0";"0";"43";"41";"0";"41";"2";"430483";"5766"
"LOK1378_1mm";"SILVA (only NR);Bacteria;Firmicutes;Bacilli;Bacillales;Bacillaceae;Anoxybacillus;";"0.0";"0";"753";"741";"0";"741";"12";"429783";"5766"
"LOK1378_1mm";"SILVA (only NR);Bacteria;Firmicutes;Bacilli;Bacillales;Bacillaceae;Aquibacillus;";"0.0";"0";"8";"8";"0";"8";"0";"430516";"5766"
"LOK1378_1mm";"SILVA (only NR);Bacteria;Firmicutes;Bacilli;Bacillales;Bacillaceae;Aquisalibacillus;";"0.0";"0";"3";"3";"0";"3";"0";"430521";"5766"
"LOK1378_1mm";"SILVA (only NR);Bacteria;Firmicutes;Bacilli;Bacillales;Bacillaceae;Aureibacillus;";"0.0";"0";"4";"3";"0";"3";"1";"430521";"5766"
"LOK1378_1mm";"SILVA (only NR);Bacteria;Firmicutes;Bacilli;Bacillales;Bacillaceae;Bacillus;";"0.0";"0";"11146";"10225";"0";"10225";"921";"420299";"5766"
"LOK1378_1mm";"SILVA (only NR);Bacteria;Firmicutes;Bacilli;Bacillales;Bacillaceae;Caldibacillus;";"0.0";"0";"15";"15";"0";"15";"0";"430509";"5766"
"LOK1378_1mm";"SILVA (only NR);Bacteria;Firmicutes;Bacilli;Bacillales;Bacillaceae;Calditerricola;";"0.0";"0";"4";"4";"0";"4";"0";"430520";"5766"
"LOK1378_1mm";"SILVA (only NR);Bacteria;Firmicutes;Bacilli;Bacillales;Bacillaceae;Cerasibacillus;";"0.0";"0";"8";"8";"0";"8";"0";"430516";"5766"
"LOK1378_1mm";"SILVA (only NR);Bacteria;Firmicutes;Bacilli;Bacillales;Bacillaceae;Falsibacillus;";"0.0";"0";"2";"2";"0";"2";"0";"430522";"5766"
"LOK1378_1mm";"SILVA (only NR);Bacteria;Firmicutes;Bacilli;Bacillales;Bacillaceae;Fictibacillus;";"0.0";"0";"86";"81";"0";"81";"5";"430443";"5766"
"LOK1378_1mm";"SILVA (only NR);Bacteria;Firmicutes;Bacilli;Bacillales;Bacillaceae;Filobacillus;";"0.0";"0";"2";"2";"0";"2";"0";"430522";"5766"
"LOK1378_1mm";"SILVA (only NR);Bacteria;Firmicutes;Bacilli;Bacillales;Bacillaceae;Geobacillus;";"0.0";"0";"595";"583";"0";"583";"12";"429941";"5766"
"LOK1378_1mm";"SILVA (only NR);Bacteria;Firmicutes;Bacilli;Bacillales;Bacillaceae;Gracilibacillus;";"0.0";"0";"48";"48";"0";"48";"0";"430476";"5766"
"LOK1378_1mm";"SILVA (only NR);Bacteria;Firmicutes;Bacilli;Bacillales;Bacillaceae;Halalkalibacillus;";"0.0";"0";"3";"3";"0";"3";"0";"430521";"5766"
"LOK1378_1mm";"SILVA (only NR);Bacteria;Firmicutes;Bacilli;Bacillales;Bacillaceae;Halobacillus;";"0.0";"0";"164";"156";"0";"156";"8";"430368";"5766"
"LOK1378_1mm";"SILVA (only NR);Bacteria;Firmicutes;Bacilli;Bacillales;Bacillaceae;Halolactibacillus;";"0.0";"0";"33";"33";"0";"33";"0";"430491";"5766"
"LOK1378_1mm";"SILVA (only NR);Bacteria;Firmicutes;Bacilli;Bacillales;Bacillaceae;Lentibacillus;";"0.0";"0";"21";"20";"0";"20";"1";"430504";"5766"
"LOK1378_1mm";"SILVA (only NR);Bacteria;Firmicutes;Bacilli;Bacillales;Bacillaceae;Microaerobacter;";"0.0";"0";"1";"1";"0";"1";"0";"430523";"5766"
"LOK1378_1mm";"SILVA (only NR);Bacteria;Firmicutes;Bacilli;Bacillales;Bacillaceae;Natronobacillus;";"0.0";"0";"1";"1";"0";"1";"0";"430523";"5766"
"LOK1378_1mm";"SILVA (only NR);Bacteria;Firmicutes;Bacilli;Bacillales;Bacillaceae;Oceanobacillus;";"0.0";"0";"198";"190";"0";"190";"8";"430334";"5766"
"LOK1378_1mm";"SILVA (only NR);Bacteria;Firmicutes;Bacilli;Bacillales;Bacillaceae;Ornithinibacillus;";"0.0";"0";"23";"20";"0";"20";"3";"430504";"5766"
"LOK1378_1mm";"SILVA (only NR);Bacteria;Firmicutes;Bacilli;Bacillales;Bacillaceae;Paraliobacillus;";"0.0";"0";"18";"15";"0";"15";"3";"430509";"5766"
"LOK1378_1mm";"SILVA (only NR);Bacteria;Firmicutes;Bacilli;Bacillales;Bacillaceae;Paucisalibacillus;";"0.0";"0";"10";"9";"0";"9";"1";"430515";"5766"
"LOK1378_1mm";"SILVA (only NR);Bacteria;Firmicutes;Bacilli;Bacillales;Bacillaceae;Pelagirhabdus;";"0.0";"0";"3";"3";"0";"3";"0";"430521";"5766"
"LOK1378_1mm";"SILVA (only NR);Bacteria;Firmicutes;Bacilli;Bacillales;Bacillaceae;Piscibacillus;";"0.0";"0";"11";"10";"0";"10";"1";"430514";"5766"
"LOK1378_1mm";"SILVA (only NR);Bacteria;Firmicutes;Bacilli;Bacillales;Bacillaceae;Pontibacillus;";"0.0";"0";"27";"27";"0";"27";"0";"430497";"5766"
"LOK1378_1mm";"SILVA (only NR);Bacteria;Firmicutes;Bacilli;Bacillales;Bacillaceae;Pseudogracilibacillus;";"0.0";"0";"18";"17";"0";"17";"1";"430507";"5766"
"LOK1378_1mm";"SILVA (only NR);Bacteria;Firmicutes;Bacilli;Bacillales;Bacillaceae;Saccharococcus;";"0.0";"0";"2";"2";"0";"2";"0";"430522";"5766"
"LOK1378_1mm";"SILVA (only NR);Bacteria;Firmicutes;Bacilli;Bacillales;Bacillaceae;Salimicrobium;";"0.0";"0";"26";"25";"0";"25";"1";"430499";"5766"
"LOK1378_1mm";"SILVA (only NR);Bacteria;Firmicutes;Bacilli;Bacillales;Bacillaceae;Salinibacillus;";"0.0";"0";"4";"4";"0";"4";"0";"430520";"5766"
"LOK1378_1mm";"SILVA (only NR);Bacteria;Firmicutes;Bacilli;Bacillales;Bacillaceae;Salirhabdus;";"0.0";"0";"6";"6";"0";"6";"0";"430518";"5766"
"LOK1378_1mm";"SILVA (only NR);Bacteria;Firmicutes;Bacilli;Bacillales;Bacillaceae;Saliterribacillus;";"0.0";"0";"3";"3";"0";"3";"0";"430521";"5766"
"LOK1378_1mm";"SILVA (only NR);Bacteria;Firmicutes;Bacilli;Bacillales;Bacillaceae;Sediminibacillus;";"0.0";"0";"7";"7";"0";"7";"0";"430517";"5766"
"LOK1378_1mm";"SILVA (only NR);Bacteria;Firmicutes;Bacilli;Bacillales;Bacillaceae;Sinibacillus;";"0.0";"0";"4";"4";"0";"4";"0";"430520";"5766"
"LOK1378_1mm";"SILVA (only NR);Bacteria;Firmicutes;Bacilli;Bacillales;Bacillaceae;Streptohalobacillus;";"0.0";"0";"1";"1";"0";"1";"0";"430523";"5766"
"LOK1378_1mm";"SILVA (only NR);Bacteria;Firmicutes;Bacilli;Bacillales;Bacillaceae;Tenuibacillus;";"0.0";"0";"3";"3";"0";"3";"0";"430521";"5766"
"LOK1378_1mm";"SILVA (only NR);Bacteria;Firmicutes;Bacilli;Bacillales;Bacillaceae;Tepidibacillus;";"0.0";"0";"6";"6";"0";"6";"0";"430518";"5766"
"LOK1378_1mm";"SILVA (only NR);Bacteria;Firmicutes;Bacilli;Bacillales;Bacillaceae;Terribacillus;";"0.0";"0";"22";"21";"0";"21";"1";"430503";"5766"
"LOK1378_1mm";"SILVA (only NR);Bacteria;Firmicutes;Bacilli;Bacillales;Bacillaceae;Thalassobacillus;";"0.0";"0";"19";"17";"0";"17";"2";"430507";"5766"
"LOK1378_1mm";"SILVA (only NR);Bacteria;Firmicutes;Bacilli;Bacillales;Bacillaceae;Thermolongibacillus;";"0.0";"0";"2";"2";"0";"2";"0";"430522";"5766"
"LOK1378_1mm";"SILVA (only NR);Bacteria;Firmicutes;Bacilli;Bacillales;Bacillaceae;Ureibacillus;";"0.0";"0";"28";"27";"0";"27";"1";"430497";"5766"
"LOK1378_1mm";"SILVA (only NR);Bacteria;Firmicutes;Bacilli;Bacillales;Bacillaceae;Virgibacillus;";"0.0";"0";"172";"165";"0";"165";"7";"430359";"5766"
"LOK1378_1mm";"SILVA (only NR);Bacteria;Firmicutes;Bacilli;Bacillales;Bacillaceae;Vulcanibacillus;";"0.0";"0";"16";"16";"0";"16";"0";"430508";"5766"
"LOK1378_1mm";"SILVA (only NR);Bacteria;Firmicutes;Bacilli;Bacillales;Bacillaceae;uncultured;";"0.0";"0";"62";"60";"0";"60";"2";"430464";"5766"
"LOK1378_1mm";"SILVA (only NR);Bacteria;Firmicutes;Bacilli;Bacillales;Marinococcaceae;";"0.0";"0";"105";"85";"0";"85";"20";"430439";"5766"
"LOK1378_1mm";"SILVA (only NR);Bacteria;Firmicutes;Bacilli;Bacillales;Marinococcaceae;Alteribacillus;";"0.0";"0";"20";"20";"0";"20";"0";"430504";"5766"
"LOK1378_1mm";"SILVA (only NR);Bacteria;Firmicutes;Bacilli;Bacillales;Marinococcaceae;Geomicrobium;";"0.0";"0";"9";"9";"0";"9";"0";"430515";"5766"
"LOK1378_1mm";"SILVA (only NR);Bacteria;Firmicutes;Bacilli;Bacillales;Marinococcaceae;Marinococcus;";"0.0";"0";"47";"28";"0";"28";"19";"430496";"5766"
"LOK1378_1mm";"SILVA (only NR);Bacteria;Firmicutes;Bacilli;Bacillales;Marinococcaceae;Natribacillus;";"0.0";"0";"5";"5";"0";"5";"0";"430519";"5766"
"LOK1378_1mm";"SILVA (only NR);Bacteria;Firmicutes;Bacilli;Bacillales;Marinococcaceae;Salibacterium;";"0.0";"0";"11";"11";"0";"11";"0";"430513";"5766"
"LOK1378_1mm";"SILVA (only NR);Bacteria;Firmicutes;Bacilli;Bacillales;Marinococcaceae;Salsuginibacillus;";"0.0";"0";"5";"5";"0";"5";"0";"430519";"5766"
"LOK1378_1mm";"SILVA (only NR);Bacteria;Firmicutes;Bacilli;Bacillales;Marinococcaceae;Sinobaca;";"0.0";"0";"4";"3";"0";"3";"1";"430521";"5766"
"LOK1378_1mm";"SILVA (only NR);Bacteria;Firmicutes;Bacilli;Bacillales;Planococcaceae;";"0.0";"0";"1802";"1690";"0";"1690";"112";"428834";"5766"
"LOK1378_1mm";"SILVA (only NR);Bacteria;Firmicutes;Bacilli;Bacillales;Planococcaceae;Bhargavaea;";"0.0";"0";"30";"28";"0";"28";"2";"430496";"5766"
"LOK1378_1mm";"SILVA (only NR);Bacteria;Firmicutes;Bacilli;Bacillales;Planococcaceae;Caryophanon;";"0.0";"0";"9";"9";"0";"9";"0";"430515";"5766"
"LOK1378_1mm";"SILVA (only NR);Bacteria;Firmicutes;Bacilli;Bacillales;Planococcaceae;Chryseomicrobium;";"0.0";"0";"27";"27";"0";"27";"0";"430497";"5766"
"LOK1378_1mm";"SILVA (only NR);Bacteria;Firmicutes;Bacilli;Bacillales;Planococcaceae;Chungangia;";"0.0";"0";"6";"5";"0";"5";"1";"430519";"5766"
"LOK1378_1mm";"SILVA (only NR);Bacteria;Firmicutes;Bacilli;Bacillales;Planococcaceae;Domibacillus;";"0.0";"0";"42";"38";"0";"38";"4";"430486";"5766"
"LOK1378_1mm";"SILVA (only NR);Bacteria;Firmicutes;Bacilli;Bacillales;Planococcaceae;Filibacter;";"0.0";"0";"3";"3";"0";"3";"0";"430521";"5766"
"LOK1378_1mm";"SILVA (only NR);Bacteria;Firmicutes;Bacilli;Bacillales;Planococcaceae;Jeotgalibacillus;";"0.0";"0";"31";"29";"0";"29";"2";"430495";"5766"
"LOK1378_1mm";"SILVA (only NR);Bacteria;Firmicutes;Bacilli;Bacillales;Planococcaceae;Kurthia;";"0.0";"0";"55";"53";"0";"53";"2";"430471";"5766"
"LOK1378_1mm";"SILVA (only NR);Bacteria;Firmicutes;Bacilli;Bacillales;Planococcaceae;Lysinibacillus;";"0.0";"0";"709";"668";"0";"668";"41";"429856";"5766"
"LOK1378_1mm";"SILVA (only NR);Bacteria;Firmicutes;Bacilli;Bacillales;Planococcaceae;Paenisporosarcina;";"0.0";"0";"47";"47";"0";"47";"0";"430477";"5766"
"LOK1378_1mm";"SILVA (only NR);Bacteria;Firmicutes;Bacilli;Bacillales;Planococcaceae;Planococcus;";"0.0";"0";"199";"182";"0";"182";"17";"430342";"5766"
"LOK1378_1mm";"SILVA (only NR);Bacteria;Firmicutes;Bacilli;Bacillales;Planococcaceae;Planomicrobium;";"0.0";"0";"128";"126";"0";"126";"2";"430398";"5766"
"LOK1378_1mm";"SILVA (only NR);Bacteria;Firmicutes;Bacilli;Bacillales;Planococcaceae;Psychrobacillus;";"0.0";"0";"64";"58";"0";"58";"6";"430466";"5766"
"LOK1378_1mm";"SILVA (only NR);Bacteria;Firmicutes;Bacilli;Bacillales;Planococcaceae;Rummeliibacillus;";"0.0";"0";"31";"29";"0";"29";"2";"430495";"5766"
"LOK1378_1mm";"SILVA (only NR);Bacteria;Firmicutes;Bacilli;Bacillales;Planococcaceae;Savagea;";"0.0";"0";"3";"3";"0";"3";"0";"430521";"5766"
"LOK1378_1mm";"SILVA (only NR);Bacteria;Firmicutes;Bacilli;Bacillales;Planococcaceae;Solibacillus;";"0.0";"0";"132";"127";"0";"127";"5";"430397";"5766"
"LOK1378_1mm";"SILVA (only NR);Bacteria;Firmicutes;Bacilli;Bacillales;Planococcaceae;Sporosarcina;";"0.0";"0";"204";"180";"0";"180";"24";"430344";"5766"
"LOK1378_1mm";"SILVA (only NR);Bacteria;Firmicutes;Bacilli;Bacillales;Planococcaceae;Viridibacillus;";"0.0";"0";"9";"8";"0";"8";"1";"430516";"5766"
"LOK1378_1mm";"SILVA (only NR);Bacteria;Firmicutes;Bacilli;Bacillales;Planococcaceae;[Renibacterium] salmoninarum group;";"0.0";"0";"2";"2";"0";"2";"0";"430522";"5766"
"LOK1378_1mm";"SILVA (only NR);Bacteria;Firmicutes;Bacilli;Bacillales;Planococcaceae;uncultured;";"0.0";"0";"62";"61";"0";"61";"1";"430463";"5766"
"LOK1378_1mm";"SILVA (only NR);Bacteria;Firmicutes;Bacilli;Bacillales;Salisediminibacteriaceae;";"0.0";"0";"91";"88";"0";"88";"3";"430436";"5766"
"LOK1378_1mm";"SILVA (only NR);Bacteria;Firmicutes;Bacilli;Bacillales;Salisediminibacteriaceae;Alkalicoccus;";"0.0";"0";"13";"12";"0";"12";"1";"430512";"5766"
"LOK1378_1mm";"SILVA (only NR);Bacteria;Firmicutes;Bacilli;Bacillales;Salisediminibacteriaceae;Salipaludibacillus;";"0.0";"0";"69";"67";"0";"67";"2";"430457";"5766"
"LOK1378_1mm";"SILVA (only NR);Bacteria;Firmicutes;Bacilli;Bacillales;Salisediminibacteriaceae;Salisediminibacterium;";"0.0";"0";"7";"7";"0";"7";"0";"430517";"5766"
"LOK1378_1mm";"SILVA (only NR);Bacteria;Firmicutes;Bacilli;Bacillales;Salisediminibacteriaceae;Texcoconibacillus;";"0.0";"0";"2";"2";"0";"2";"0";"430522";"5766"
"LOK1378_1mm";"SILVA (only NR);Bacteria;Firmicutes;Bacilli;Bacillales;Sporolactobacillaceae;";"0.0";"0";"93";"93";"0";"93";"0";"430431";"5766"
"LOK1378_1mm";"SILVA (only NR);Bacteria;Firmicutes;Bacilli;Bacillales;Sporolactobacillaceae;Pullulanibacillus;";"0.0";"0";"12";"12";"0";"12";"0";"430512";"5766"
"LOK1378_1mm";"SILVA (only NR);Bacteria;Firmicutes;Bacilli;Bacillales;Sporolactobacillaceae;Scopulibacillus;";"0.0";"0";"4";"4";"0";"4";"0";"430520";"5766"
"LOK1378_1mm";"SILVA (only NR);Bacteria;Firmicutes;Bacilli;Bacillales;Sporolactobacillaceae;Sporolactobacillus;";"0.0";"0";"67";"67";"0";"67";"0";"430457";"5766"
"LOK1378_1mm";"SILVA (only NR);Bacteria;Firmicutes;Bacilli;Bacillales;Sporolactobacillaceae;Terrilactibacillus;";"0.0";"0";"3";"3";"0";"3";"0";"430521";"5766"
"LOK1378_1mm";"SILVA (only NR);Bacteria;Firmicutes;Bacilli;Bacillales;Sporolactobacillaceae;Tuberibacillus;";"0.0";"0";"5";"5";"0";"5";"0";"430519";"5766"
"LOK1378_1mm";"SILVA (only NR);Bacteria;Firmicutes;Bacilli;Bacillales;Sporolactobacillaceae;uncultured;";"0.0";"0";"2";"2";"0";"2";"0";"430522";"5766"
"LOK1378_1mm";"SILVA (only NR);Bacteria;Firmicutes;Bacilli;Brevibacillales;";"0.0";"0";"405";"386";"0";"386";"19";"430138";"5766"
"LOK1378_1mm";"SILVA (only NR);Bacteria;Firmicutes;Bacilli;Brevibacillales;Brevibacillaceae;";"0.0";"0";"405";"386";"0";"386";"19";"430138";"5766"
"LOK1378_1mm";"SILVA (only NR);Bacteria;Firmicutes;Bacilli;Brevibacillales;Brevibacillaceae;Brevibacillus;";"0.0";"0";"405";"386";"0";"386";"19";"430138";"5766"
"LOK1378_1mm";"SILVA (only NR);Bacteria;Firmicutes;Bacilli;Caldalkalibacillales;";"0.0";"0";"7";"7";"0";"7";"0";"430517";"5766"
"LOK1378_1mm";"SILVA (only NR);Bacteria;Firmicutes;Bacilli;Caldalkalibacillales;Caldalkalibacillaceae;";"0.0";"0";"7";"7";"0";"7";"0";"430517";"5766"
"LOK1378_1mm";"SILVA (only NR);Bacteria;Firmicutes;Bacilli;Caldalkalibacillales;Caldalkalibacillaceae;Caldalkalibacillus;";"0.0";"0";"7";"7";"0";"7";"0";"430517";"5766"
"LOK1378_1mm";"SILVA (only NR);Bacteria;Firmicutes;Bacilli;Desulfuribacillales;";"0.0";"0";"11";"11";"0";"11";"0";"430513";"5766"
"LOK1378_1mm";"SILVA (only NR);Bacteria;Firmicutes;Bacilli;Desulfuribacillales;Desulfuribacillaceae;";"0.0";"0";"11";"11";"0";"11";"0";"430513";"5766"
"LOK1378_1mm";"SILVA (only NR);Bacteria;Firmicutes;Bacilli;Desulfuribacillales;Desulfuribacillaceae;Desulfuribacillus;";"0.0";"0";"11";"11";"0";"11";"0";"430513";"5766"
"LOK1378_1mm";"SILVA (only NR);Bacteria;Firmicutes;Bacilli;Entomoplasmatales;";"0.0";"0";"307";"289";"0";"289";"18";"430235";"5766"
"LOK1378_1mm";"SILVA (only NR);Bacteria;Firmicutes;Bacilli;Entomoplasmatales;Candidatus Spiroplasma;";"0.0";"0";"7";"7";"0";"7";"0";"430517";"5766"
"LOK1378_1mm";"SILVA (only NR);Bacteria;Firmicutes;Bacilli;Entomoplasmatales;Entomoplasmataceae;";"0.0";"0";"101";"100";"0";"100";"1";"430424";"5766"
"LOK1378_1mm";"SILVA (only NR);Bacteria;Firmicutes;Bacilli;Entomoplasmatales;Entomoplasmataceae;Entomoplasma;";"0.0";"0";"11";"10";"0";"10";"1";"430514";"5766"
"LOK1378_1mm";"SILVA (only NR);Bacteria;Firmicutes;Bacilli;Entomoplasmatales;Entomoplasmataceae;Mesoplasma;";"0.0";"0";"48";"48";"0";"48";"0";"430476";"5766"
"LOK1378_1mm";"SILVA (only NR);Bacteria;Firmicutes;Bacilli;Entomoplasmatales;Entomoplasmataceae;[Mycoplasma] group;";"0.0";"0";"42";"42";"0";"42";"0";"430482";"5766"
"LOK1378_1mm";"SILVA (only NR);Bacteria;Firmicutes;Bacilli;Entomoplasmatales;Entomoplasmatales Incertae Sedis;";"0.0";"0";"34";"30";"0";"30";"4";"430494";"5766"
"LOK1378_1mm";"SILVA (only NR);Bacteria;Firmicutes;Bacilli;Entomoplasmatales;Entomoplasmatales Incertae Sedis;Candidatus Hepatoplasma;";"0.0";"0";"34";"30";"0";"30";"4";"430494";"5766"
"LOK1378_1mm";"SILVA (only NR);Bacteria;Firmicutes;Bacilli;Entomoplasmatales;Spiroplasmataceae;";"0.0";"0";"154";"141";"0";"141";"13";"430383";"5766"
"LOK1378_1mm";"SILVA (only NR);Bacteria;Firmicutes;Bacilli;Entomoplasmatales;Spiroplasmataceae;Spiroplasma;";"0.0";"0";"154";"141";"0";"141";"13";"430383";"5766"
"LOK1378_1mm";"SILVA (only NR);Bacteria;Firmicutes;Bacilli;Entomoplasmatales;type III;";"0.0";"0";"11";"11";"0";"11";"0";"430513";"5766"
"LOK1378_1mm";"SILVA (only NR);Bacteria;Firmicutes;Bacilli;Erysipelotrichales;";"0.0";"0";"2343";"2218";"0";"2218";"125";"428306";"5766"
"LOK1378_1mm";"SILVA (only NR);Bacteria;Firmicutes;Bacilli;Erysipelotrichales;Erysipelatoclostridiaceae;";"0.0";"0";"743";"693";"0";"693";"50";"429831";"5766"
"LOK1378_1mm";"SILVA (only NR);Bacteria;Firmicutes;Bacilli;Erysipelotrichales;Erysipelatoclostridiaceae;Asteroleplasma;";"0.0";"0";"18";"17";"0";"17";"1";"430507";"5766"
"LOK1378_1mm";"SILVA (only NR);Bacteria;Firmicutes;Bacilli;Erysipelotrichales;Erysipelatoclostridiaceae;Candidatus Stoquefichus;";"0.0";"0";"40";"39";"0";"39";"1";"430485";"5766"
"LOK1378_1mm";"SILVA (only NR);Bacteria;Firmicutes;Bacilli;Erysipelotrichales;Erysipelatoclostridiaceae;Catenibacterium;";"0.0";"0";"130";"121";"0";"121";"9";"430403";"5766"
"LOK1378_1mm";"SILVA (only NR);Bacteria;Firmicutes;Bacilli;Erysipelotrichales;Erysipelatoclostridiaceae;Coprobacillus;";"0.0";"0";"10";"9";"0";"9";"1";"430515";"5766"
"LOK1378_1mm";"SILVA (only NR);Bacteria;Firmicutes;Bacilli;Erysipelotrichales;Erysipelatoclostridiaceae;Eggerthia;";"0.0";"0";"10";"10";"0";"10";"0";"430514";"5766"
"LOK1378_1mm";"SILVA (only NR);Bacteria;Firmicutes;Bacilli;Erysipelotrichales;Erysipelatoclostridiaceae;Erysipelatoclostridium;";"0.0";"0";"158";"148";"0";"148";"10";"430376";"5766"
"LOK1378_1mm";"SILVA (only NR);Bacteria;Firmicutes;Bacilli;Erysipelotrichales;Erysipelatoclostridiaceae;Erysipelotrichaceae UCG-002;";"0.0";"0";"40";"25";"0";"25";"15";"430499";"5766"
"LOK1378_1mm";"SILVA (only NR);Bacteria;Firmicutes;Bacilli;Erysipelotrichales;Erysipelatoclostridiaceae;Erysipelotrichaceae UCG-003;";"0.0";"0";"118";"114";"0";"114";"4";"430410";"5766"
"LOK1378_1mm";"SILVA (only NR);Bacteria;Firmicutes;Bacilli;Erysipelotrichales;Erysipelatoclostridiaceae;Kandleria;";"0.0";"0";"2";"2";"0";"2";"0";"430522";"5766"
"LOK1378_1mm";"SILVA (only NR);Bacteria;Firmicutes;Bacilli;Erysipelotrichales;Erysipelatoclostridiaceae;Sharpea;";"0.0";"0";"7";"4";"0";"4";"3";"430520";"5766"
"LOK1378_1mm";"SILVA (only NR);Bacteria;Firmicutes;Bacilli;Erysipelotrichales;Erysipelatoclostridiaceae;UCG-004;";"0.0";"0";"187";"182";"0";"182";"5";"430342";"5766"
"LOK1378_1mm";"SILVA (only NR);Bacteria;Firmicutes;Bacilli;Erysipelotrichales;Erysipelatoclostridiaceae;uncultured;";"0.0";"0";"17";"16";"0";"16";"1";"430508";"5766"
"LOK1378_1mm";"SILVA (only NR);Bacteria;Firmicutes;Bacilli;Erysipelotrichales;Erysipelotrichaceae;";"0.0";"0";"1589";"1514";"0";"1514";"75";"429010";"5766"
"LOK1378_1mm";"SILVA (only NR);Bacteria;Firmicutes;Bacilli;Erysipelotrichales;Erysipelotrichaceae;Allobaculum;";"0.0";"0";"16";"16";"0";"16";"0";"430508";"5766"
"LOK1378_1mm";"SILVA (only NR);Bacteria;Firmicutes;Bacilli;Erysipelotrichales;Erysipelotrichaceae;Breznakia;";"0.0";"0";"10";"9";"0";"9";"1";"430515";"5766"
"LOK1378_1mm";"SILVA (only NR);Bacteria;Firmicutes;Bacilli;Erysipelotrichales;Erysipelotrichaceae;Bulleidia;";"0.0";"0";"4";"4";"0";"4";"0";"430520";"5766"
"LOK1378_1mm";"SILVA (only NR);Bacteria;Firmicutes;Bacilli;Erysipelotrichales;Erysipelotrichaceae;Catenisphaera;";"0.0";"0";"21";"21";"0";"21";"0";"430503";"5766"
"LOK1378_1mm";"SILVA (only NR);Bacteria;Firmicutes;Bacilli;Erysipelotrichales;Erysipelotrichaceae;Dielma;";"0.0";"0";"26";"26";"0";"26";"0";"430498";"5766"
"LOK1378_1mm";"SILVA (only NR);Bacteria;Firmicutes;Bacilli;Erysipelotrichales;Erysipelotrichaceae;Dubosiella;";"0.0";"0";"73";"72";"0";"72";"1";"430452";"5766"
"LOK1378_1mm";"SILVA (only NR);Bacteria;Firmicutes;Bacilli;Erysipelotrichales;Erysipelotrichaceae;Erysipelothrix;";"0.0";"0";"190";"175";"0";"175";"15";"430349";"5766"
"LOK1378_1mm";"SILVA (only NR);Bacteria;Firmicutes;Bacilli;Erysipelotrichales;Erysipelotrichaceae;Erysipelotrichaceae UCG-006;";"0.0";"0";"17";"17";"0";"17";"0";"430507";"5766"
"LOK1378_1mm";"SILVA (only NR);Bacteria;Firmicutes;Bacilli;Erysipelotrichales;Erysipelotrichaceae;Erysipelotrichaceae UCG-007;";"0.0";"0";"18";"15";"0";"15";"3";"430509";"5766"
"LOK1378_1mm";"SILVA (only NR);Bacteria;Firmicutes;Bacilli;Erysipelotrichales;Erysipelotrichaceae;Erysipelotrichaceae UCG-008;";"0.0";"0";"2";"2";"0";"2";"0";"430522";"5766"
"LOK1378_1mm";"SILVA (only NR);Bacteria;Firmicutes;Bacilli;Erysipelotrichales;Erysipelotrichaceae;Erysipelotrichaceae UCG-009;";"0.0";"0";"14";"14";"0";"14";"0";"430510";"5766"
"LOK1378_1mm";"SILVA (only NR);Bacteria;Firmicutes;Bacilli;Erysipelotrichales;Erysipelotrichaceae;Faecalibaculum;";"0.0";"0";"424";"400";"0";"400";"24";"430124";"5766"
"LOK1378_1mm";"SILVA (only NR);Bacteria;Firmicutes;Bacilli;Erysipelotrichales;Erysipelotrichaceae;Faecalicoccus;";"0.0";"0";"5";"5";"0";"5";"0";"430519";"5766"
"LOK1378_1mm";"SILVA (only NR);Bacteria;Firmicutes;Bacilli;Erysipelotrichales;Erysipelotrichaceae;Faecalitalea;";"0.0";"0";"48";"44";"0";"44";"4";"430480";"5766"
"LOK1378_1mm";"SILVA (only NR);Bacteria;Firmicutes;Bacilli;Erysipelotrichales;Erysipelotrichaceae;Holdemanella;";"0.0";"0";"182";"175";"0";"175";"7";"430349";"5766"
"LOK1378_1mm";"SILVA (only NR);Bacteria;Firmicutes;Bacilli;Erysipelotrichales;Erysipelotrichaceae;Holdemania;";"0.0";"0";"7";"7";"0";"7";"0";"430517";"5766"
"LOK1378_1mm";"SILVA (only NR);Bacteria;Firmicutes;Bacilli;Erysipelotrichales;Erysipelotrichaceae;Ileibacterium;";"0.0";"0";"7";"7";"0";"7";"0";"430517";"5766"
"LOK1378_1mm";"SILVA (only NR);Bacteria;Firmicutes;Bacilli;Erysipelotrichales;Erysipelotrichaceae;Merdibacter;";"0.0";"0";"5";"5";"0";"5";"0";"430519";"5766"
"LOK1378_1mm";"SILVA (only NR);Bacteria;Firmicutes;Bacilli;Erysipelotrichales;Erysipelotrichaceae;Solobacterium;";"0.0";"0";"89";"85";"0";"85";"4";"430439";"5766"
"LOK1378_1mm";"SILVA (only NR);Bacteria;Firmicutes;Bacilli;Erysipelotrichales;Erysipelotrichaceae;Turicibacter;";"0.0";"0";"144";"138";"0";"138";"6";"430386";"5766"
"LOK1378_1mm";"SILVA (only NR);Bacteria;Firmicutes;Bacilli;Erysipelotrichales;Erysipelotrichaceae;ZOR0006;";"0.0";"0";"40";"40";"0";"40";"0";"430484";"5766"
"LOK1378_1mm";"SILVA (only NR);Bacteria;Firmicutes;Bacilli;Erysipelotrichales;Erysipelotrichaceae;[Anaerorhabdus] furcosa group;";"0.0";"0";"44";"43";"0";"43";"1";"430481";"5766"
"LOK1378_1mm";"SILVA (only NR);Bacteria;Firmicutes;Bacilli;Erysipelotrichales;Erysipelotrichaceae;[Clostridium] innocuum group;";"0.0";"0";"105";"100";"0";"100";"5";"430424";"5766"
"LOK1378_1mm";"SILVA (only NR);Bacteria;Firmicutes;Bacilli;Erysipelotrichales;Erysipelotrichaceae;uncultured;";"0.0";"0";"95";"91";"0";"91";"4";"430433";"5766"
"LOK1378_1mm";"SILVA (only NR);Bacteria;Firmicutes;Bacilli;Erysipelotrichales;uncultured;";"0.0";"0";"11";"11";"0";"11";"0";"430513";"5766"
"LOK1378_1mm";"SILVA (only NR);Bacteria;Firmicutes;Bacilli;Exiguobacterales;";"0.0";"0";"317";"294";"0";"294";"23";"430230";"5766"
"LOK1378_1mm";"SILVA (only NR);Bacteria;Firmicutes;Bacilli;Exiguobacterales;Exiguobacteraceae;";"0.0";"0";"317";"294";"0";"294";"23";"430230";"5766"
"LOK1378_1mm";"SILVA (only NR);Bacteria;Firmicutes;Bacilli;Exiguobacterales;Exiguobacteraceae;Exiguobacterium;";"0.0";"0";"317";"294";"0";"294";"23";"430230";"5766"
"LOK1378_1mm";"SILVA (only NR);Bacteria;Firmicutes;Bacilli;Haloplasmatales;";"0.0";"0";"28";"26";"0";"26";"2";"430498";"5766"
"LOK1378_1mm";"SILVA (only NR);Bacteria;Firmicutes;Bacilli;Haloplasmatales;Haloplasmataceae;";"0.0";"0";"28";"26";"0";"26";"2";"430498";"5766"
"LOK1378_1mm";"SILVA (only NR);Bacteria;Firmicutes;Bacilli;Haloplasmatales;Haloplasmataceae;Haloplasma;";"0.0";"0";"28";"26";"0";"26";"2";"430498";"5766"
"LOK1378_1mm";"SILVA (only NR);Bacteria;Firmicutes;Bacilli;Izemoplasmatales;";"0.0";"0";"107";"103";"0";"103";"4";"430421";"5766"
"LOK1378_1mm";"SILVA (only NR);Bacteria;Firmicutes;Bacilli;Izemoplasmatales;Izemoplasmataceae;";"0.0";"0";"38";"38";"0";"38";"0";"430486";"5766"
"LOK1378_1mm";"SILVA (only NR);Bacteria;Firmicutes;Bacilli;Izemoplasmatales;Izemoplasmataceae;Izimaplasma;";"0.0";"0";"23";"23";"0";"23";"0";"430501";"5766"
"LOK1378_1mm";"SILVA (only NR);Bacteria;Firmicutes;Bacilli;Kyrpidiales;";"0.0";"0";"20";"20";"0";"20";"0";"430504";"5766"
"LOK1378_1mm";"SILVA (only NR);Bacteria;Firmicutes;Bacilli;Kyrpidiales;Kyrpidiaceae;";"0.0";"0";"20";"20";"0";"20";"0";"430504";"5766"
"LOK1378_1mm";"SILVA (only NR);Bacteria;Firmicutes;Bacilli;Kyrpidiales;Kyrpidiaceae;Kyrpidia;";"0.0";"0";"20";"20";"0";"20";"0";"430504";"5766"
"LOK1378_1mm";"SILVA (only NR);Bacteria;Firmicutes;Bacilli;Lactobacillales;";"0.0";"0";"13176";"12463";"0";"12463";"713";"418061";"5766"
"LOK1378_1mm";"SILVA (only NR);Bacteria;Firmicutes;Bacilli;Lactobacillales;Aerococcaceae;";"0.0";"0";"264";"258";"0";"258";"6";"430266";"5766"
"LOK1378_1mm";"SILVA (only NR);Bacteria;Firmicutes;Bacilli;Lactobacillales;Aerococcaceae;Abiotrophia;";"0.0";"0";"43";"43";"0";"43";"0";"430481";"5766"
"LOK1378_1mm";"SILVA (only NR);Bacteria;Firmicutes;Bacilli;Lactobacillales;Aerococcaceae;Aerococcus;";"0.0";"0";"113";"112";"0";"112";"1";"430412";"5766"
"LOK1378_1mm";"SILVA (only NR);Bacteria;Firmicutes;Bacilli;Lactobacillales;Aerococcaceae;Aerosphaera;";"0.0";"0";"11";"11";"0";"11";"0";"430513";"5766"
"LOK1378_1mm";"SILVA (only NR);Bacteria;Firmicutes;Bacilli;Lactobacillales;Aerococcaceae;Atopobacter;";"0.0";"0";"1";"1";"0";"1";"0";"430523";"5766"
"LOK1378_1mm";"SILVA (only NR);Bacteria;Firmicutes;Bacilli;Lactobacillales;Aerococcaceae;Bavariicoccus;";"0.0";"0";"3";"3";"0";"3";"0";"430521";"5766"
"LOK1378_1mm";"SILVA (only NR);Bacteria;Firmicutes;Bacilli;Lactobacillales;Aerococcaceae;Dolosicoccus;";"0.0";"0";"2";"1";"0";"1";"1";"430523";"5766"
"LOK1378_1mm";"SILVA (only NR);Bacteria;Firmicutes;Bacilli;Lactobacillales;Aerococcaceae;Eremococcus;";"0.0";"0";"7";"7";"0";"7";"0";"430517";"5766"
"LOK1378_1mm";"SILVA (only NR);Bacteria;Firmicutes;Bacilli;Lactobacillales;Aerococcaceae;Facklamia;";"0.0";"0";"41";"40";"0";"40";"1";"430484";"5766"
"LOK1378_1mm";"SILVA (only NR);Bacteria;Firmicutes;Bacilli;Lactobacillales;Aerococcaceae;Globicatella;";"0.0";"0";"14";"14";"0";"14";"0";"430510";"5766"
"LOK1378_1mm";"SILVA (only NR);Bacteria;Firmicutes;Bacilli;Lactobacillales;Aerococcaceae;Ignavigranum;";"0.0";"0";"17";"15";"0";"15";"2";"430509";"5766"
"LOK1378_1mm";"SILVA (only NR);Bacteria;Firmicutes;Bacilli;Lactobacillales;Aerococcaceae;uncultured;";"0.0";"0";"9";"8";"0";"8";"1";"430516";"5766"
"LOK1378_1mm";"SILVA (only NR);Bacteria;Firmicutes;Bacilli;Lactobacillales;Carnobacteriaceae;";"0.0";"0";"772";"748";"0";"748";"24";"429776";"5766"
"LOK1378_1mm";"SILVA (only NR);Bacteria;Firmicutes;Bacilli;Lactobacillales;Carnobacteriaceae;Alkalibacterium;";"0.0";"0";"40";"40";"0";"40";"0";"430484";"5766"
"LOK1378_1mm";"SILVA (only NR);Bacteria;Firmicutes;Bacilli;Lactobacillales;Carnobacteriaceae;Allofustis;";"0.0";"0";"4";"4";"0";"4";"0";"430520";"5766"
"LOK1378_1mm";"SILVA (only NR);Bacteria;Firmicutes;Bacilli;Lactobacillales;Carnobacteriaceae;Alloiococcus;";"0.0";"0";"26";"21";"0";"21";"5";"430503";"5766"
"LOK1378_1mm";"SILVA (only NR);Bacteria;Firmicutes;Bacilli;Lactobacillales;Carnobacteriaceae;Atopococcus;";"0.0";"0";"8";"8";"0";"8";"0";"430516";"5766"
"LOK1378_1mm";"SILVA (only NR);Bacteria;Firmicutes;Bacilli;Lactobacillales;Carnobacteriaceae;Atopostipes;";"0.0";"0";"60";"54";"0";"54";"6";"430470";"5766"
"LOK1378_1mm";"SILVA (only NR);Bacteria;Firmicutes;Bacilli;Lactobacillales;Carnobacteriaceae;Carnobacterium;";"0.0";"0";"68";"67";"0";"67";"1";"430457";"5766"
"LOK1378_1mm";"SILVA (only NR);Bacteria;Firmicutes;Bacilli;Lactobacillales;Carnobacteriaceae;Desemzia;";"0.0";"0";"27";"27";"0";"27";"0";"430497";"5766"
"LOK1378_1mm";"SILVA (only NR);Bacteria;Firmicutes;Bacilli;Lactobacillales;Carnobacteriaceae;Dolosigranulum;";"0.0";"0";"125";"122";"0";"122";"3";"430402";"5766"
"LOK1378_1mm";"SILVA (only NR);Bacteria;Firmicutes;Bacilli;Lactobacillales;Carnobacteriaceae;Granulicatella;";"0.0";"0";"225";"220";"0";"220";"5";"430304";"5766"
"LOK1378_1mm";"SILVA (only NR);Bacteria;Firmicutes;Bacilli;Lactobacillales;Carnobacteriaceae;Isobaculum;";"0.0";"0";"1";"1";"0";"1";"0";"430523";"5766"
"LOK1378_1mm";"SILVA (only NR);Bacteria;Firmicutes;Bacilli;Lactobacillales;Carnobacteriaceae;Jeotgalibaca;";"0.0";"0";"44";"43";"0";"43";"1";"430481";"5766"
"LOK1378_1mm";"SILVA (only NR);Bacteria;Firmicutes;Bacilli;Lactobacillales;Carnobacteriaceae;Lacticigenium;";"0.0";"0";"5";"5";"0";"5";"0";"430519";"5766"
"LOK1378_1mm";"SILVA (only NR);Bacteria;Firmicutes;Bacilli;Lactobacillales;Carnobacteriaceae;Marinilactibacillus;";"0.0";"0";"33";"33";"0";"33";"0";"430491";"5766"
"LOK1378_1mm";"SILVA (only NR);Bacteria;Firmicutes;Bacilli;Lactobacillales;Carnobacteriaceae;Nostocoida;";"0.0";"0";"1";"1";"0";"1";"0";"430523";"5766"
"LOK1378_1mm";"SILVA (only NR);Bacteria;Firmicutes;Bacilli;Lactobacillales;Carnobacteriaceae;Pisciglobus;";"0.0";"0";"3";"3";"0";"3";"0";"430521";"5766"
"LOK1378_1mm";"SILVA (only NR);Bacteria;Firmicutes;Bacilli;Lactobacillales;Carnobacteriaceae;Trichococcus;";"0.0";"0";"75";"74";"0";"74";"1";"430450";"5766"
"LOK1378_1mm";"SILVA (only NR);Bacteria;Firmicutes;Bacilli;Lactobacillales;Carnobacteriaceae;uncultured;";"0.0";"0";"22";"20";"0";"20";"2";"430504";"5766"
"LOK1378_1mm";"SILVA (only NR);Bacteria;Firmicutes;Bacilli;Lactobacillales;Catellicoccaceae;";"0.0";"0";"7";"7";"0";"7";"0";"430517";"5766"
"LOK1378_1mm";"SILVA (only NR);Bacteria;Firmicutes;Bacilli;Lactobacillales;Catellicoccaceae;Catellicoccus;";"0.0";"0";"7";"7";"0";"7";"0";"430517";"5766"
"LOK1378_1mm";"SILVA (only NR);Bacteria;Firmicutes;Bacilli;Lactobacillales;Enterococcaceae;";"0.0";"0";"1600";"1515";"0";"1515";"85";"429009";"5766"
"LOK1378_1mm";"SILVA (only NR);Bacteria;Firmicutes;Bacilli;Lactobacillales;Enterococcaceae;Enterococcus;";"0.0";"0";"1551";"1467";"0";"1467";"84";"429057";"5766"
"LOK1378_1mm";"SILVA (only NR);Bacteria;Firmicutes;Bacilli;Lactobacillales;Enterococcaceae;Melissococcus;";"0.0";"0";"9";"9";"0";"9";"0";"430515";"5766"
"LOK1378_1mm";"SILVA (only NR);Bacteria;Firmicutes;Bacilli;Lactobacillales;Enterococcaceae;Tetragenococcus;";"0.0";"0";"39";"38";"0";"38";"1";"430486";"5766"
"LOK1378_1mm";"SILVA (only NR);Bacteria;Firmicutes;Bacilli;Lactobacillales;Lactobacillaceae;";"0.0";"0";"4739";"4339";"0";"4339";"400";"426185";"5766"
"LOK1378_1mm";"SILVA (only NR);Bacteria;Firmicutes;Bacilli;Lactobacillales;Lactobacillaceae;Agrilactobacillus;";"0.0";"0";"3";"3";"0";"3";"0";"430521";"5766"
"LOK1378_1mm";"SILVA (only NR);Bacteria;Firmicutes;Bacilli;Lactobacillales;Lactobacillaceae;Amylolactobacillus;";"0.0";"0";"10";"10";"0";"10";"0";"430514";"5766"
"LOK1378_1mm";"SILVA (only NR);Bacteria;Firmicutes;Bacilli;Lactobacillales;Lactobacillaceae;Apilactobacillus;";"0.0";"0";"42";"39";"0";"39";"3";"430485";"5766"
"LOK1378_1mm";"SILVA (only NR);Bacteria;Firmicutes;Bacilli;Lactobacillales;Lactobacillaceae;Bombilactobacillus;";"0.0";"0";"19";"17";"0";"17";"2";"430507";"5766"
"LOK1378_1mm";"SILVA (only NR);Bacteria;Firmicutes;Bacilli;Lactobacillales;Lactobacillaceae;Companilactobacillus;";"0.0";"0";"73";"73";"0";"73";"0";"430451";"5766"
"LOK1378_1mm";"SILVA (only NR);Bacteria;Firmicutes;Bacilli;Lactobacillales;Lactobacillaceae;Dellaglioa;";"0.0";"0";"2";"2";"0";"2";"0";"430522";"5766"
"LOK1378_1mm";"SILVA (only NR);Bacteria;Firmicutes;Bacilli;Lactobacillales;Lactobacillaceae;Fructilactobacillus;";"0.0";"0";"31";"31";"0";"31";"0";"430493";"5766"
"LOK1378_1mm";"SILVA (only NR);Bacteria;Firmicutes;Bacilli;Lactobacillales;Lactobacillaceae;Fructobacillus;";"0.0";"0";"23";"20";"0";"20";"3";"430504";"5766"
"LOK1378_1mm";"SILVA (only NR);Bacteria;Firmicutes;Bacilli;Lactobacillales;Lactobacillaceae;Furfurilactobacillus;";"0.0";"0";"12";"10";"0";"10";"2";"430514";"5766"
"LOK1378_1mm";"SILVA (only NR);Bacteria;Firmicutes;Bacilli;Lactobacillales;Lactobacillaceae;HT002;";"0.0";"0";"12";"12";"0";"12";"0";"430512";"5766"
"LOK1378_1mm";"SILVA (only NR);Bacteria;Firmicutes;Bacilli;Lactobacillales;Lactobacillaceae;Holzapfelia;";"0.0";"0";"1";"1";"0";"1";"0";"430523";"5766"
"LOK1378_1mm";"SILVA (only NR);Bacteria;Firmicutes;Bacilli;Lactobacillales;Lactobacillaceae;Lacticaseibacillus;";"0.0";"0";"411";"393";"0";"393";"18";"430131";"5766"
"LOK1378_1mm";"SILVA (only NR);Bacteria;Firmicutes;Bacilli;Lactobacillales;Lactobacillaceae;Lactiplantibacillus;";"0.0";"0";"671";"561";"0";"561";"110";"429963";"5766"
"LOK1378_1mm";"SILVA (only NR);Bacteria;Firmicutes;Bacilli;Lactobacillales;Lactobacillaceae;Lactobacillus;";"0.0";"0";"1068";"996";"0";"996";"72";"429528";"5766"
"LOK1378_1mm";"SILVA (only NR);Bacteria;Firmicutes;Bacilli;Lactobacillales;Lactobacillaceae;Lapidilactobacillus;";"0.0";"0";"4";"4";"0";"4";"0";"430520";"5766"
"LOK1378_1mm";"SILVA (only NR);Bacteria;Firmicutes;Bacilli;Lactobacillales;Lactobacillaceae;Latilactobacillus;";"0.0";"0";"130";"119";"0";"119";"11";"430405";"5766"
"LOK1378_1mm";"SILVA (only NR);Bacteria;Firmicutes;Bacilli;Lactobacillales;Lactobacillaceae;Lentilactobacillus;";"0.0";"0";"120";"113";"0";"113";"7";"430411";"5766"
"LOK1378_1mm";"SILVA (only NR);Bacteria;Firmicutes;Bacilli;Lactobacillales;Lactobacillaceae;Leuconostoc;";"0.0";"0";"336";"332";"0";"332";"4";"430192";"5766"
"LOK1378_1mm";"SILVA (only NR);Bacteria;Firmicutes;Bacilli;Lactobacillales;Lactobacillaceae;Levilactobacillus;";"0.0";"0";"158";"152";"0";"152";"6";"430372";"5766"
"LOK1378_1mm";"SILVA (only NR);Bacteria;Firmicutes;Bacilli;Lactobacillales;Lactobacillaceae;Ligilactobacillus;";"0.0";"0";"328";"281";"0";"281";"47";"430243";"5766"
"LOK1378_1mm";"SILVA (only NR);Bacteria;Firmicutes;Bacilli;Lactobacillales;Lactobacillaceae;Limosilactobacillus;";"0.0";"0";"616";"581";"0";"581";"35";"429943";"5766"
"LOK1378_1mm";"SILVA (only NR);Bacteria;Firmicutes;Bacilli;Lactobacillales;Lactobacillaceae;Liquorilactobacillus;";"0.0";"0";"37";"36";"0";"36";"1";"430488";"5766"
"LOK1378_1mm";"SILVA (only NR);Bacteria;Firmicutes;Bacilli;Lactobacillales;Lactobacillaceae;Loigolactobacillus;";"0.0";"0";"45";"45";"0";"45";"0";"430479";"5766"
"LOK1378_1mm";"SILVA (only NR);Bacteria;Firmicutes;Bacilli;Lactobacillales;Lactobacillaceae;Oenococcus;";"0.0";"0";"16";"16";"0";"16";"0";"430508";"5766"
"LOK1378_1mm";"SILVA (only NR);Bacteria;Firmicutes;Bacilli;Lactobacillales;Lactobacillaceae;Paralactobacillus;";"0.0";"0";"3";"3";"0";"3";"0";"430521";"5766"
"LOK1378_1mm";"SILVA (only NR);Bacteria;Firmicutes;Bacilli;Lactobacillales;Lactobacillaceae;Paucilactobacillus;";"0.0";"0";"25";"25";"0";"25";"0";"430499";"5766"
"LOK1378_1mm";"SILVA (only NR);Bacteria;Firmicutes;Bacilli;Lactobacillales;Lactobacillaceae;Pediococcus;";"0.0";"0";"229";"202";"0";"202";"27";"430322";"5766"
"LOK1378_1mm";"SILVA (only NR);Bacteria;Firmicutes;Bacilli;Lactobacillales;Lactobacillaceae;Schleiferilactobacillus;";"0.0";"0";"14";"14";"0";"14";"0";"430510";"5766"
"LOK1378_1mm";"SILVA (only NR);Bacteria;Firmicutes;Bacilli;Lactobacillales;Lactobacillaceae;Secundilactobacillus;";"0.0";"0";"30";"29";"0";"29";"1";"430495";"5766"
"LOK1378_1mm";"SILVA (only NR);Bacteria;Firmicutes;Bacilli;Lactobacillales;Lactobacillaceae;Weissella;";"0.0";"0";"256";"207";"0";"207";"49";"430317";"5766"
"LOK1378_1mm";"SILVA (only NR);Bacteria;Firmicutes;Bacilli;Lactobacillales;Lactobacillaceae;uncultured;";"0.0";"0";"12";"11";"0";"11";"1";"430513";"5766"
"LOK1378_1mm";"SILVA (only NR);Bacteria;Firmicutes;Bacilli;Lactobacillales;Listeriaceae;";"0.0";"0";"337";"330";"0";"330";"7";"430194";"5766"
"LOK1378_1mm";"SILVA (only NR);Bacteria;Firmicutes;Bacilli;Lactobacillales;Listeriaceae;Brochothrix;";"0.0";"0";"30";"29";"0";"29";"1";"430495";"5766"
"LOK1378_1mm";"SILVA (only NR);Bacteria;Firmicutes;Bacilli;Lactobacillales;Listeriaceae;Listeria;";"0.0";"0";"307";"301";"0";"301";"6";"430223";"5766"
"LOK1378_1mm";"SILVA (only NR);Bacteria;Firmicutes;Bacilli;Lactobacillales;P5D1-392;";"0.0";"0";"22";"22";"0";"22";"0";"430502";"5766"
"LOK1378_1mm";"SILVA (only NR);Bacteria;Firmicutes;Bacilli;Lactobacillales;Streptococcaceae;";"0.0";"0";"5371";"5181";"0";"5181";"190";"425343";"5766"
"LOK1378_1mm";"SILVA (only NR);Bacteria;Firmicutes;Bacilli;Lactobacillales;Streptococcaceae;Floricoccus;";"0.0";"0";"5";"5";"0";"5";"0";"430519";"5766"
"LOK1378_1mm";"SILVA (only NR);Bacteria;Firmicutes;Bacilli;Lactobacillales;Streptococcaceae;Lactococcus;";"0.0";"0";"420";"396";"0";"396";"24";"430128";"5766"
"LOK1378_1mm";"SILVA (only NR);Bacteria;Firmicutes;Bacilli;Lactobacillales;Streptococcaceae;Lactovum;";"0.0";"0";"15";"15";"0";"15";"0";"430509";"5766"
"LOK1378_1mm";"SILVA (only NR);Bacteria;Firmicutes;Bacilli;Lactobacillales;Streptococcaceae;Pilibacter;";"0.0";"0";"7";"7";"0";"7";"0";"430517";"5766"
"LOK1378_1mm";"SILVA (only NR);Bacteria;Firmicutes;Bacilli;Lactobacillales;Streptococcaceae;Streptococcus;";"0.0";"0";"4924";"4758";"0";"4758";"166";"425766";"5766"
"LOK1378_1mm";"SILVA (only NR);Bacteria;Firmicutes;Bacilli;Lactobacillales;Vagococcaceae;";"0.0";"0";"46";"45";"0";"45";"1";"430479";"5766"
"LOK1378_1mm";"SILVA (only NR);Bacteria;Firmicutes;Bacilli;Lactobacillales;Vagococcaceae;Vagococcus;";"0.0";"0";"46";"45";"0";"45";"1";"430479";"5766"
"LOK1378_1mm";"SILVA (only NR);Bacteria;Firmicutes;Bacilli;Lactobacillales;uncultured;";"0.0";"0";"15";"15";"0";"15";"0";"430509";"5766"
"LOK1378_1mm";"SILVA (only NR);Bacteria;Firmicutes;Bacilli;Mycoplasmatales;";"0.0";"0";"743";"719";"0";"719";"24";"429805";"5766"
"LOK1378_1mm";"SILVA (only NR);Bacteria;Firmicutes;Bacilli;Mycoplasmatales;Mycoplasmataceae;";"0.0";"0";"743";"719";"0";"719";"24";"429805";"5766"
"LOK1378_1mm";"SILVA (only NR);Bacteria;Firmicutes;Bacilli;Mycoplasmatales;Mycoplasmataceae;Candidatus Bacilloplasma;";"0.0";"0";"13";"13";"0";"13";"0";"430511";"5766"
"LOK1378_1mm";"SILVA (only NR);Bacteria;Firmicutes;Bacilli;Mycoplasmatales;Mycoplasmataceae;Candidatus Lumbricincola;";"0.0";"0";"5";"2";"0";"2";"3";"430522";"5766"
"LOK1378_1mm";"SILVA (only NR);Bacteria;Firmicutes;Bacilli;Mycoplasmatales;Mycoplasmataceae;Mycoplasma;";"0.0";"0";"607";"587";"0";"587";"20";"429937";"5766"
"LOK1378_1mm";"SILVA (only NR);Bacteria;Firmicutes;Bacilli;Mycoplasmatales;Mycoplasmataceae;Ureaplasma;";"0.0";"0";"107";"106";"0";"106";"1";"430418";"5766"
"LOK1378_1mm";"SILVA (only NR);Bacteria;Firmicutes;Bacilli;Mycoplasmatales;Mycoplasmataceae;uncultured;";"0.0";"0";"11";"11";"0";"11";"0";"430513";"5766"
"LOK1378_1mm";"SILVA (only NR);Bacteria;Firmicutes;Bacilli;Paenibacillales;";"0.0";"0";"2551";"2431";"0";"2431";"120";"428093";"5766"
"LOK1378_1mm";"SILVA (only NR);Bacteria;Firmicutes;Bacilli;Paenibacillales;Paenibacillaceae;";"0.0";"0";"2551";"2431";"0";"2431";"120";"428093";"5766"
"LOK1378_1mm";"SILVA (only NR);Bacteria;Firmicutes;Bacilli;Paenibacillales;Paenibacillaceae;Ammoniibacillus;";"0.0";"0";"4";"4";"0";"4";"0";"430520";"5766"
"LOK1378_1mm";"SILVA (only NR);Bacteria;Firmicutes;Bacilli;Paenibacillales;Paenibacillaceae;Ammoniphilus;";"0.0";"0";"24";"23";"0";"23";"1";"430501";"5766"
"LOK1378_1mm";"SILVA (only NR);Bacteria;Firmicutes;Bacilli;Paenibacillales;Paenibacillaceae;Cohnella;";"0.0";"0";"154";"149";"0";"149";"5";"430375";"5766"
"LOK1378_1mm";"SILVA (only NR);Bacteria;Firmicutes;Bacilli;Paenibacillales;Paenibacillaceae;Fontibacillus;";"0.0";"0";"9";"9";"0";"9";"0";"430515";"5766"
"LOK1378_1mm";"SILVA (only NR);Bacteria;Firmicutes;Bacilli;Paenibacillales;Paenibacillaceae;Oxalophagus;";"0.0";"0";"3";"3";"0";"3";"0";"430521";"5766"
"LOK1378_1mm";"SILVA (only NR);Bacteria;Firmicutes;Bacilli;Paenibacillales;Paenibacillaceae;Paenibacillus;";"0.0";"0";"2264";"2152";"0";"2152";"112";"428372";"5766"
"LOK1378_1mm";"SILVA (only NR);Bacteria;Firmicutes;Bacilli;Paenibacillales;Paenibacillaceae;Saccharibacillus;";"0.0";"0";"18";"18";"0";"18";"0";"430506";"5766"
"LOK1378_1mm";"SILVA (only NR);Bacteria;Firmicutes;Bacilli;Paenibacillales;Paenibacillaceae;Thermobacillus;";"0.0";"0";"32";"32";"0";"32";"0";"430492";"5766"
"LOK1378_1mm";"SILVA (only NR);Bacteria;Firmicutes;Bacilli;Paenibacillales;Paenibacillaceae;Xylanibacillus;";"0.0";"0";"5";"5";"0";"5";"0";"430519";"5766"
"LOK1378_1mm";"SILVA (only NR);Bacteria;Firmicutes;Bacilli;Paenibacillales;Paenibacillaceae;uncultured;";"0.0";"0";"28";"26";"0";"26";"2";"430498";"5766"
"LOK1378_1mm";"SILVA (only NR);Bacteria;Firmicutes;Bacilli;RF39;";"0.0";"0";"635";"608";"0";"608";"27";"429916";"5766"
"LOK1378_1mm";"SILVA (only NR);Bacteria;Firmicutes;Bacilli;RsaHf231;";"0.0";"0";"8";"8";"0";"8";"0";"430516";"5766"
"LOK1378_1mm";"SILVA (only NR);Bacteria;Firmicutes;Bacilli;Staphylococcales;";"0.0";"0";"4825";"4671";"0";"4671";"154";"425853";"5766"
"LOK1378_1mm";"SILVA (only NR);Bacteria;Firmicutes;Bacilli;Staphylococcales;Gemellaceae;";"0.0";"0";"355";"349";"0";"349";"6";"430175";"5766"
"LOK1378_1mm";"SILVA (only NR);Bacteria;Firmicutes;Bacilli;Staphylococcales;Gemellaceae;Gemella;";"0.0";"0";"355";"349";"0";"349";"6";"430175";"5766"
"LOK1378_1mm";"SILVA (only NR);Bacteria;Firmicutes;Bacilli;Staphylococcales;Staphylococcaceae;";"0.0";"0";"4470";"4322";"0";"4322";"148";"426202";"5766"
"LOK1378_1mm";"SILVA (only NR);Bacteria;Firmicutes;Bacilli;Staphylococcales;Staphylococcaceae;Aliicoccus;";"0.0";"0";"4";"4";"0";"4";"0";"430520";"5766"
"LOK1378_1mm";"SILVA (only NR);Bacteria;Firmicutes;Bacilli;Staphylococcales;Staphylococcaceae;Auricoccus-Abyssicoccus;";"0.0";"0";"5";"5";"0";"5";"0";"430519";"5766"
"LOK1378_1mm";"SILVA (only NR);Bacteria;Firmicutes;Bacilli;Staphylococcales;Staphylococcaceae;Corticicoccus;";"0.0";"0";"2";"2";"0";"2";"0";"430522";"5766"
"LOK1378_1mm";"SILVA (only NR);Bacteria;Firmicutes;Bacilli;Staphylococcales;Staphylococcaceae;Jeotgalicoccus;";"0.0";"0";"60";"56";"0";"56";"4";"430468";"5766"
"LOK1378_1mm";"SILVA (only NR);Bacteria;Firmicutes;Bacilli;Staphylococcales;Staphylococcaceae;Macrococcus;";"0.0";"0";"36";"35";"0";"35";"1";"430489";"5766"
"LOK1378_1mm";"SILVA (only NR);Bacteria;Firmicutes;Bacilli;Staphylococcales;Staphylococcaceae;Nosocomiicoccus;";"0.0";"0";"18";"18";"0";"18";"0";"430506";"5766"
"LOK1378_1mm";"SILVA (only NR);Bacteria;Firmicutes;Bacilli;Staphylococcales;Staphylococcaceae;Salinicoccus;";"0.0";"0";"69";"65";"0";"65";"4";"430459";"5766"
"LOK1378_1mm";"SILVA (only NR);Bacteria;Firmicutes;Bacilli;Staphylococcales;Staphylococcaceae;Staphylococcus;";"0.0";"0";"4274";"4135";"0";"4135";"139";"426389";"5766"
"LOK1378_1mm";"SILVA (only NR);Bacteria;Firmicutes;Bacilli;Thermicanales;";"0.0";"0";"41";"40";"0";"40";"1";"430484";"5766"
"LOK1378_1mm";"SILVA (only NR);Bacteria;Firmicutes;Bacilli;Thermicanales;Thermicanaceae;";"0.0";"0";"41";"40";"0";"40";"1";"430484";"5766"
"LOK1378_1mm";"SILVA (only NR);Bacteria;Firmicutes;Bacilli;Thermicanales;Thermicanaceae;Hydrogenibacillus;";"0.0";"0";"5";"5";"0";"5";"0";"430519";"5766"
"LOK1378_1mm";"SILVA (only NR);Bacteria;Firmicutes;Bacilli;Thermicanales;Thermicanaceae;Thermicanus;";"0.0";"0";"36";"35";"0";"35";"1";"430489";"5766"
"LOK1378_1mm";"SILVA (only NR);Bacteria;Firmicutes;Bacilli;Thermoactinomycetales;";"0.0";"0";"183";"180";"0";"180";"3";"430344";"5766"
"LOK1378_1mm";"SILVA (only NR);Bacteria;Firmicutes;Bacilli;Thermoactinomycetales;Thermoactinomycetaceae;";"0.0";"0";"183";"180";"0";"180";"3";"430344";"5766"
"LOK1378_1mm";"SILVA (only NR);Bacteria;Firmicutes;Bacilli;Thermoactinomycetales;Thermoactinomycetaceae;Baia;";"0.0";"0";"5";"4";"0";"4";"1";"430520";"5766"
"LOK1378_1mm";"SILVA (only NR);Bacteria;Firmicutes;Bacilli;Thermoactinomycetales;Thermoactinomycetaceae;Desmospora;";"0.0";"0";"2";"2";"0";"2";"0";"430522";"5766"
"LOK1378_1mm";"SILVA (only NR);Bacteria;Firmicutes;Bacilli;Thermoactinomycetales;Thermoactinomycetaceae;Geothermomicrobium;";"0.0";"0";"4";"4";"0";"4";"0";"430520";"5766"
"LOK1378_1mm";"SILVA (only NR);Bacteria;Firmicutes;Bacilli;Thermoactinomycetales;Thermoactinomycetaceae;Hazenella;";"0.0";"0";"3";"3";"0";"3";"0";"430521";"5766"
"LOK1378_1mm";"SILVA (only NR);Bacteria;Firmicutes;Bacilli;Thermoactinomycetales;Thermoactinomycetaceae;Kroppenstedtia;";"0.0";"0";"11";"11";"0";"11";"0";"430513";"5766"
"LOK1378_1mm";"SILVA (only NR);Bacteria;Firmicutes;Bacilli;Thermoactinomycetales;Thermoactinomycetaceae;Laceyella;";"0.0";"0";"17";"17";"0";"17";"0";"430507";"5766"
"LOK1378_1mm";"SILVA (only NR);Bacteria;Firmicutes;Bacilli;Thermoactinomycetales;Thermoactinomycetaceae;Lihuaxuella;";"0.0";"0";"3";"3";"0";"3";"0";"430521";"5766"
"LOK1378_1mm";"SILVA (only NR);Bacteria;Firmicutes;Bacilli;Thermoactinomycetales;Thermoactinomycetaceae;Marininema;";"0.0";"0";"2";"2";"0";"2";"0";"430522";"5766"
"LOK1378_1mm";"SILVA (only NR);Bacteria;Firmicutes;Bacilli;Thermoactinomycetales;Thermoactinomycetaceae;Mechercharimyces;";"0.0";"0";"4";"4";"0";"4";"0";"430520";"5766"
"LOK1378_1mm";"SILVA (only NR);Bacteria;Firmicutes;Bacilli;Thermoactinomycetales;Thermoactinomycetaceae;Melghirimyces;";"0.0";"0";"7";"7";"0";"7";"0";"430517";"5766"
"LOK1378_1mm";"SILVA (only NR);Bacteria;Firmicutes;Bacilli;Thermoactinomycetales;Thermoactinomycetaceae;Novibacillus;";"0.0";"0";"7";"7";"0";"7";"0";"430517";"5766"
"LOK1378_1mm";"SILVA (only NR);Bacteria;Firmicutes;Bacilli;Thermoactinomycetales;Thermoactinomycetaceae;Pasteuria;";"0.0";"0";"23";"23";"0";"23";"0";"430501";"5766"
"LOK1378_1mm";"SILVA (only NR);Bacteria;Firmicutes;Bacilli;Thermoactinomycetales;Thermoactinomycetaceae;Planifilum;";"0.0";"0";"14";"14";"0";"14";"0";"430510";"5766"
"LOK1378_1mm";"SILVA (only NR);Bacteria;Firmicutes;Bacilli;Thermoactinomycetales;Thermoactinomycetaceae;Polycladomyces;";"0.0";"0";"3";"3";"0";"3";"0";"430521";"5766"
"LOK1378_1mm";"SILVA (only NR);Bacteria;Firmicutes;Bacilli;Thermoactinomycetales;Thermoactinomycetaceae;Risungbinella;";"0.0";"0";"4";"4";"0";"4";"0";"430520";"5766"
"LOK1378_1mm";"SILVA (only NR);Bacteria;Firmicutes;Bacilli;Thermoactinomycetales;Thermoactinomycetaceae;Salinithrix;";"0.0";"0";"1";"1";"0";"1";"0";"430523";"5766"
"LOK1378_1mm";"SILVA (only NR);Bacteria;Firmicutes;Bacilli;Thermoactinomycetales;Thermoactinomycetaceae;Seinonella;";"0.0";"0";"2";"2";"0";"2";"0";"430522";"5766"
"LOK1378_1mm";"SILVA (only NR);Bacteria;Firmicutes;Bacilli;Thermoactinomycetales;Thermoactinomycetaceae;Shimazuella;";"0.0";"0";"18";"16";"0";"16";"2";"430508";"5766"
"LOK1378_1mm";"SILVA (only NR);Bacteria;Firmicutes;Bacilli;Thermoactinomycetales;Thermoactinomycetaceae;Thermoactinomyces;";"0.0";"0";"20";"20";"0";"20";"0";"430504";"5766"
"LOK1378_1mm";"SILVA (only NR);Bacteria;Firmicutes;Bacilli;Thermoactinomycetales;Thermoactinomycetaceae;Thermoflavimicrobium;";"0.0";"0";"7";"7";"0";"7";"0";"430517";"5766"
"LOK1378_1mm";"SILVA (only NR);Bacteria;Firmicutes;Bacilli;Thermoactinomycetales;Thermoactinomycetaceae;uncultured;";"0.0";"0";"21";"21";"0";"21";"0";"430503";"5766"
"LOK1378_1mm";"SILVA (only NR);Bacteria;Firmicutes;Bacilli;uncultured;";"0.0";"0";"7";"7";"0";"7";"0";"430517";"5766"
"LOK1378_1mm";"SILVA (only NR);Bacteria;Firmicutes;Clostridia;";"0.0";"0";"50639";"48602";"0";"48602";"2037";"381922";"5766"
"LOK1378_1mm";"SILVA (only NR);Bacteria;Firmicutes;Clostridia;Caldicoprobacterales;";"0.0";"0";"121";"120";"0";"120";"1";"430404";"5766"
"LOK1378_1mm";"SILVA (only NR);Bacteria;Firmicutes;Clostridia;Caldicoprobacterales;Caldicoprobacteraceae;";"0.0";"0";"121";"120";"0";"120";"1";"430404";"5766"
"LOK1378_1mm";"SILVA (only NR);Bacteria;Firmicutes;Clostridia;Caldicoprobacterales;Caldicoprobacteraceae;Caldicoprobacter;";"0.0";"0";"121";"120";"0";"120";"1";"430404";"5766"
"LOK1378_1mm";"SILVA (only NR);Bacteria;Firmicutes;Clostridia;Christensenellales;";"0.0";"0";"2472";"2419";"0";"2419";"53";"428105";"5766"
"LOK1378_1mm";"SILVA (only NR);Bacteria;Firmicutes;Clostridia;Christensenellales;Christensenellaceae;";"0.0";"0";"2472";"2419";"0";"2419";"53";"428105";"5766"
"LOK1378_1mm";"SILVA (only NR);Bacteria;Firmicutes;Clostridia;Christensenellales;Christensenellaceae;Catabacter;";"0.0";"0";"3";"3";"0";"3";"0";"430521";"5766"
"LOK1378_1mm";"SILVA (only NR);Bacteria;Firmicutes;Clostridia;Christensenellales;Christensenellaceae;Christensenella;";"0.0";"0";"5";"5";"0";"5";"0";"430519";"5766"
"LOK1378_1mm";"SILVA (only NR);Bacteria;Firmicutes;Clostridia;Christensenellales;Christensenellaceae;Christensenellaceae R-7 group;";"0.0";"0";"2301";"2253";"0";"2253";"48";"428271";"5766"
"LOK1378_1mm";"SILVA (only NR);Bacteria;Firmicutes;Clostridia;Christensenellales;Christensenellaceae;uncultured;";"0.0";"0";"157";"152";"0";"152";"5";"430372";"5766"
"LOK1378_1mm";"SILVA (only NR);Bacteria;Firmicutes;Clostridia;Clostridia UCG-014;";"0.0";"0";"1146";"1128";"0";"1128";"18";"429396";"5766"
"LOK1378_1mm";"SILVA (only NR);Bacteria;Firmicutes;Clostridia;Clostridia vadinBB60 group;";"0.0";"0";"432";"419";"0";"419";"13";"430105";"5766"
"LOK1378_1mm";"SILVA (only NR);Bacteria;Firmicutes;Clostridia;Clostridiales;";"0.0";"0";"2914";"2775";"0";"2775";"139";"427749";"5766"
"LOK1378_1mm";"SILVA (only NR);Bacteria;Firmicutes;Clostridia;Clostridiales;Caloramatoraceae;";"0.0";"0";"247";"240";"0";"240";"7";"430284";"5766"
"LOK1378_1mm";"SILVA (only NR);Bacteria;Firmicutes;Clostridia;Clostridiales;Caloramatoraceae;Caloramator;";"0.0";"0";"92";"88";"0";"88";"4";"430436";"5766"
"LOK1378_1mm";"SILVA (only NR);Bacteria;Firmicutes;Clostridia;Clostridiales;Caloramatoraceae;Clostridium;";"0.0";"0";"1";"1";"0";"1";"0";"430523";"5766"
"LOK1378_1mm";"SILVA (only NR);Bacteria;Firmicutes;Clostridia;Clostridiales;Caloramatoraceae;Fervidicella;";"0.0";"0";"2";"2";"0";"2";"0";"430522";"5766"
"LOK1378_1mm";"SILVA (only NR);Bacteria;Firmicutes;Clostridia;Clostridiales;Caloramatoraceae;Fonticella;";"0.0";"0";"66";"65";"0";"65";"1";"430459";"5766"
"LOK1378_1mm";"SILVA (only NR);Bacteria;Firmicutes;Clostridia;Clostridiales;Caloramatoraceae;Thermobrachium;";"0.0";"0";"43";"43";"0";"43";"0";"430481";"5766"
"LOK1378_1mm";"SILVA (only NR);Bacteria;Firmicutes;Clostridia;Clostridiales;Caloramatoraceae;uncultured;";"0.0";"0";"38";"38";"0";"38";"0";"430486";"5766"
"LOK1378_1mm";"SILVA (only NR);Bacteria;Firmicutes;Clostridia;Clostridiales;Clostridiaceae;";"0.0";"0";"2571";"2442";"0";"2442";"129";"428082";"5766"
"LOK1378_1mm";"SILVA (only NR);Bacteria;Firmicutes;Clostridia;Clostridiales;Clostridiaceae;Anaerobacter;";"0.0";"0";"3";"3";"0";"3";"0";"430521";"5766"
"LOK1378_1mm";"SILVA (only NR);Bacteria;Firmicutes;Clostridia;Clostridiales;Clostridiaceae;Candidatus Arthromitus;";"0.0";"0";"34";"33";"0";"33";"1";"430491";"5766"
"LOK1378_1mm";"SILVA (only NR);Bacteria;Firmicutes;Clostridia;Clostridiales;Clostridiaceae;Clostridium sensu stricto 10;";"0.0";"0";"35";"33";"0";"33";"2";"430491";"5766"
"LOK1378_1mm";"SILVA (only NR);Bacteria;Firmicutes;Clostridia;Clostridiales;Clostridiaceae;Clostridium sensu stricto 11;";"0.0";"0";"53";"46";"0";"46";"7";"430478";"5766"
"LOK1378_1mm";"SILVA (only NR);Bacteria;Firmicutes;Clostridia;Clostridiales;Clostridiaceae;Clostridium sensu stricto 12;";"0.0";"0";"172";"169";"0";"169";"3";"430355";"5766"
"LOK1378_1mm";"SILVA (only NR);Bacteria;Firmicutes;Clostridia;Clostridiales;Clostridiaceae;Clostridium sensu stricto 13;";"0.0";"0";"150";"144";"0";"144";"6";"430380";"5766"
"LOK1378_1mm";"SILVA (only NR);Bacteria;Firmicutes;Clostridia;Clostridiales;Clostridiaceae;Clostridium sensu stricto 14;";"0.0";"0";"12";"12";"0";"12";"0";"430512";"5766"
"LOK1378_1mm";"SILVA (only NR);Bacteria;Firmicutes;Clostridia;Clostridiales;Clostridiaceae;Clostridium sensu stricto 15;";"0.0";"0";"13";"12";"0";"12";"1";"430512";"5766"
"LOK1378_1mm";"SILVA (only NR);Bacteria;Firmicutes;Clostridia;Clostridiales;Clostridiaceae;Clostridium sensu stricto 16;";"0.0";"0";"10";"9";"0";"9";"1";"430515";"5766"
"LOK1378_1mm";"SILVA (only NR);Bacteria;Firmicutes;Clostridia;Clostridiales;Clostridiaceae;Clostridium sensu stricto 17;";"0.0";"0";"2";"2";"0";"2";"0";"430522";"5766"
"LOK1378_1mm";"SILVA (only NR);Bacteria;Firmicutes;Clostridia;Clostridiales;Clostridiaceae;Clostridium sensu stricto 18;";"0.0";"0";"101";"101";"0";"101";"0";"430423";"5766"
"LOK1378_1mm";"SILVA (only NR);Bacteria;Firmicutes;Clostridia;Clostridiales;Clostridiaceae;Clostridium sensu stricto 19;";"0.0";"0";"4";"4";"0";"4";"0";"430520";"5766"
"LOK1378_1mm";"SILVA (only NR);Bacteria;Firmicutes;Clostridia;Clostridiales;Clostridiaceae;Clostridium sensu stricto 1;";"0.0";"0";"1447";"1366";"0";"1366";"81";"429158";"5766"
"LOK1378_1mm";"SILVA (only NR);Bacteria;Firmicutes;Clostridia;Clostridiales;Clostridiaceae;Clostridium sensu stricto 2;";"0.0";"0";"11";"11";"0";"11";"0";"430513";"5766"
"LOK1378_1mm";"SILVA (only NR);Bacteria;Firmicutes;Clostridia;Clostridiales;Clostridiaceae;Clostridium sensu stricto 3;";"0.0";"0";"32";"29";"0";"29";"3";"430495";"5766"
"LOK1378_1mm";"SILVA (only NR);Bacteria;Firmicutes;Clostridia;Clostridiales;Clostridiaceae;Clostridium sensu stricto 4;";"0.0";"0";"4";"4";"0";"4";"0";"430520";"5766"
"LOK1378_1mm";"SILVA (only NR);Bacteria;Firmicutes;Clostridia;Clostridiales;Clostridiaceae;Clostridium sensu stricto 5;";"0.0";"0";"22";"21";"0";"21";"1";"430503";"5766"
"LOK1378_1mm";"SILVA (only NR);Bacteria;Firmicutes;Clostridia;Clostridiales;Clostridiaceae;Clostridium sensu stricto 6;";"0.0";"0";"16";"16";"0";"16";"0";"430508";"5766"
"LOK1378_1mm";"SILVA (only NR);Bacteria;Firmicutes;Clostridia;Clostridiales;Clostridiaceae;Clostridium sensu stricto 7;";"0.0";"0";"57";"56";"0";"56";"1";"430468";"5766"
"LOK1378_1mm";"SILVA (only NR);Bacteria;Firmicutes;Clostridia;Clostridiales;Clostridiaceae;Clostridium sensu stricto 8;";"0.0";"0";"50";"48";"0";"48";"2";"430476";"5766"
"LOK1378_1mm";"SILVA (only NR);Bacteria;Firmicutes;Clostridia;Clostridiales;Clostridiaceae;Clostridium sensu stricto 9;";"0.0";"0";"29";"27";"0";"27";"2";"430497";"5766"
"LOK1378_1mm";"SILVA (only NR);Bacteria;Firmicutes;Clostridia;Clostridiales;Clostridiaceae;Haloimpatiens;";"0.0";"0";"20";"20";"0";"20";"0";"430504";"5766"
"LOK1378_1mm";"SILVA (only NR);Bacteria;Firmicutes;Clostridia;Clostridiales;Clostridiaceae;Hathewaya;";"0.0";"0";"10";"10";"0";"10";"0";"430514";"5766"
"LOK1378_1mm";"SILVA (only NR);Bacteria;Firmicutes;Clostridia;Clostridiales;Clostridiaceae;Oceanirhabdus;";"0.0";"0";"3";"3";"0";"3";"0";"430521";"5766"
"LOK1378_1mm";"SILVA (only NR);Bacteria;Firmicutes;Clostridia;Clostridiales;Clostridiaceae;Proteiniclasticum;";"0.0";"0";"63";"58";"0";"58";"5";"430466";"5766"
"LOK1378_1mm";"SILVA (only NR);Bacteria;Firmicutes;Clostridia;Clostridiales;Clostridiaceae;Sarcina;";"0.0";"0";"169";"158";"0";"158";"11";"430366";"5766"
"LOK1378_1mm";"SILVA (only NR);Bacteria;Firmicutes;Clostridia;Clostridiales;Clostridiaceae;Youngiibacter;";"0.0";"0";"9";"9";"0";"9";"0";"430515";"5766"
"LOK1378_1mm";"SILVA (only NR);Bacteria;Firmicutes;Clostridia;Clostridiales;Clostridiaceae;uncultured;";"0.0";"0";"36";"35";"0";"35";"1";"430489";"5766"
"LOK1378_1mm";"SILVA (only NR);Bacteria;Firmicutes;Clostridia;Clostridiales;Oxobacteraceae;";"0.0";"0";"62";"60";"0";"60";"2";"430464";"5766"
"LOK1378_1mm";"SILVA (only NR);Bacteria;Firmicutes;Clostridia;Clostridiales;Oxobacteraceae;Oxobacter;";"0.0";"0";"62";"60";"0";"60";"2";"430464";"5766"
"LOK1378_1mm";"SILVA (only NR);Bacteria;Firmicutes;Clostridia;Clostridiales;uncultured;";"0.0";"0";"34";"33";"0";"33";"1";"430491";"5766"
"LOK1378_1mm";"SILVA (only NR);Bacteria;Firmicutes;Clostridia;Eubacteriales;";"0.0";"0";"247";"242";"0";"242";"5";"430282";"5766"
"LOK1378_1mm";"SILVA (only NR);Bacteria;Firmicutes;Clostridia;Eubacteriales;Alkalibacteraceae;";"0.0";"0";"10";"9";"0";"9";"1";"430515";"5766"
"LOK1378_1mm";"SILVA (only NR);Bacteria;Firmicutes;Clostridia;Eubacteriales;Alkalibacteraceae;Alkalibacter;";"0.0";"0";"10";"9";"0";"9";"1";"430515";"5766"
"LOK1378_1mm";"SILVA (only NR);Bacteria;Firmicutes;Clostridia;Eubacteriales;Alkalibaculum;";"0.0";"0";"5";"5";"0";"5";"0";"430519";"5766"
"LOK1378_1mm";"SILVA (only NR);Bacteria;Firmicutes;Clostridia;Eubacteriales;Anaerofustaceae;";"0.0";"0";"37";"34";"0";"34";"3";"430490";"5766"
"LOK1378_1mm";"SILVA (only NR);Bacteria;Firmicutes;Clostridia;Eubacteriales;Anaerofustaceae;Anaerofustis;";"0.0";"0";"37";"34";"0";"34";"3";"430490";"5766"
"LOK1378_1mm";"SILVA (only NR);Bacteria;Firmicutes;Clostridia;Eubacteriales;Eubacteriaceae;";"0.0";"0";"177";"176";"0";"176";"1";"430348";"5766"
"LOK1378_1mm";"SILVA (only NR);Bacteria;Firmicutes;Clostridia;Eubacteriales;Eubacteriaceae;Acetobacterium;";"0.0";"0";"92";"91";"0";"91";"1";"430433";"5766"
"LOK1378_1mm";"SILVA (only NR);Bacteria;Firmicutes;Clostridia;Eubacteriales;Eubacteriaceae;Eubacterium;";"0.0";"0";"56";"56";"0";"56";"0";"430468";"5766"
"LOK1378_1mm";"SILVA (only NR);Bacteria;Firmicutes;Clostridia;Eubacteriales;Eubacteriaceae;Pseudoramibacter;";"0.0";"0";"14";"14";"0";"14";"0";"430510";"5766"
"LOK1378_1mm";"SILVA (only NR);Bacteria;Firmicutes;Clostridia;Eubacteriales;Eubacteriaceae;uncultured;";"0.0";"0";"14";"14";"0";"14";"0";"430510";"5766"
"LOK1378_1mm";"SILVA (only NR);Bacteria;Firmicutes;Clostridia;Eubacteriales;Garciellaceae;";"0.0";"0";"18";"18";"0";"18";"0";"430506";"5766"
"LOK1378_1mm";"SILVA (only NR);Bacteria;Firmicutes;Clostridia;Eubacteriales;Garciellaceae;Garciella;";"0.0";"0";"8";"8";"0";"8";"0";"430516";"5766"
"LOK1378_1mm";"SILVA (only NR);Bacteria;Firmicutes;Clostridia;Eubacteriales;Garciellaceae;Irregularibacter;";"0.0";"0";"9";"9";"0";"9";"0";"430515";"5766"
"LOK1378_1mm";"SILVA (only NR);Bacteria;Firmicutes;Clostridia;Eubacteriales;Garciellaceae;Rhabdanaerobium;";"0.0";"0";"1";"1";"0";"1";"0";"430523";"5766"
"LOK1378_1mm";"SILVA (only NR);Bacteria;Firmicutes;Clostridia;Gracilibacteraceae;";"0.0";"0";"201";"182";"0";"182";"19";"430342";"5766"
"LOK1378_1mm";"SILVA (only NR);Bacteria;Firmicutes;Clostridia;Gracilibacteraceae;Gracilibacter;";"0.0";"0";"52";"48";"0";"48";"4";"430476";"5766"
"LOK1378_1mm";"SILVA (only NR);Bacteria;Firmicutes;Clostridia;Gracilibacteraceae;Lutispora;";"0.0";"0";"96";"84";"0";"84";"12";"430440";"5766"
"LOK1378_1mm";"SILVA (only NR);Bacteria;Firmicutes;Clostridia;Gracilibacteraceae;uncultured;";"0.0";"0";"52";"50";"0";"50";"2";"430474";"5766"
"LOK1378_1mm";"SILVA (only NR);Bacteria;Firmicutes;Clostridia;Lachnospirales;";"0.0";"0";"23121";"22000";"0";"22000";"1121";"408524";"5766"
"LOK1378_1mm";"SILVA (only NR);Bacteria;Firmicutes;Clostridia;Lachnospirales;Defluviitaleaceae;";"0.0";"0";"136";"131";"0";"131";"5";"430393";"5766"
"LOK1378_1mm";"SILVA (only NR);Bacteria;Firmicutes;Clostridia;Lachnospirales;Defluviitaleaceae;Defluviitalea;";"0.0";"0";"33";"32";"0";"32";"1";"430492";"5766"
"LOK1378_1mm";"SILVA (only NR);Bacteria;Firmicutes;Clostridia;Lachnospirales;Defluviitaleaceae;Defluviitaleaceae UCG-011;";"0.0";"0";"103";"99";"0";"99";"4";"430425";"5766"
"LOK1378_1mm";"SILVA (only NR);Bacteria;Firmicutes;Clostridia;Lachnospirales;Lachnospiraceae;";"0.0";"0";"22974";"21859";"0";"21859";"1115";"408665";"5766"
"LOK1378_1mm";"SILVA (only NR);Bacteria;Firmicutes;Clostridia;Lachnospirales;Lachnospiraceae;28-4;";"0.0";"0";"3";"3";"0";"3";"0";"430521";"5766"
"LOK1378_1mm";"SILVA (only NR);Bacteria;Firmicutes;Clostridia;Lachnospirales;Lachnospiraceae;A2;";"0.0";"0";"175";"159";"0";"159";"16";"430365";"5766"
"LOK1378_1mm";"SILVA (only NR);Bacteria;Firmicutes;Clostridia;Lachnospirales;Lachnospiraceae;ASF356;";"0.0";"0";"30";"27";"0";"27";"3";"430497";"5766"
"LOK1378_1mm";"SILVA (only NR);Bacteria;Firmicutes;Clostridia;Lachnospirales;Lachnospiraceae;Abyssivirga;";"0.0";"0";"4";"4";"0";"4";"0";"430520";"5766"
"LOK1378_1mm";"SILVA (only NR);Bacteria;Firmicutes;Clostridia;Lachnospirales;Lachnospiraceae;Acetatifactor;";"0.0";"0";"25";"23";"0";"23";"2";"430501";"5766"
"LOK1378_1mm";"SILVA (only NR);Bacteria;Firmicutes;Clostridia;Lachnospirales;Lachnospiraceae;Acetitomaculum;";"0.0";"0";"182";"178";"0";"178";"4";"430346";"5766"
"LOK1378_1mm";"SILVA (only NR);Bacteria;Firmicutes;Clostridia;Lachnospirales;Lachnospiraceae;Agathobacter;";"0.0";"0";"769";"730";"0";"730";"39";"429794";"5766"
"LOK1378_1mm";"SILVA (only NR);Bacteria;Firmicutes;Clostridia;Lachnospirales;Lachnospiraceae;Anaerobium;";"0.0";"0";"3";"3";"0";"3";"0";"430521";"5766"
"LOK1378_1mm";"SILVA (only NR);Bacteria;Firmicutes;Clostridia;Lachnospirales;Lachnospiraceae;Anaerocolumna;";"0.0";"0";"46";"42";"0";"42";"4";"430482";"5766"
"LOK1378_1mm";"SILVA (only NR);Bacteria;Firmicutes;Clostridia;Lachnospirales;Lachnospiraceae;Anaerosporobacter;";"0.0";"0";"83";"79";"0";"79";"4";"430445";"5766"
"LOK1378_1mm";"SILVA (only NR);Bacteria;Firmicutes;Clostridia;Lachnospirales;Lachnospiraceae;Anaerostignum;";"0.0";"0";"37";"37";"0";"37";"0";"430487";"5766"
"LOK1378_1mm";"SILVA (only NR);Bacteria;Firmicutes;Clostridia;Lachnospirales;Lachnospiraceae;Anaerostipes;";"0.0";"0";"483";"463";"0";"463";"20";"430061";"5766"
"LOK1378_1mm";"SILVA (only NR);Bacteria;Firmicutes;Clostridia;Lachnospirales;Lachnospiraceae;Blautia;";"0.0";"0";"3075";"2954";"0";"2954";"121";"427570";"5766"
"LOK1378_1mm";"SILVA (only NR);Bacteria;Firmicutes;Clostridia;Lachnospirales;Lachnospiraceae;Butyrivibrio;";"0.0";"0";"303";"299";"0";"299";"4";"430225";"5766"
"LOK1378_1mm";"SILVA (only NR);Bacteria;Firmicutes;Clostridia;Lachnospirales;Lachnospiraceae;CAG-56;";"0.0";"0";"30";"29";"0";"29";"1";"430495";"5766"
"LOK1378_1mm";"SILVA (only NR);Bacteria;Firmicutes;Clostridia;Lachnospirales;Lachnospiraceae;CHKCI001;";"0.0";"0";"5";"5";"0";"5";"0";"430519";"5766"
"LOK1378_1mm";"SILVA (only NR);Bacteria;Firmicutes;Clostridia;Lachnospirales;Lachnospiraceae;Catenibacillus;";"0.0";"0";"8";"8";"0";"8";"0";"430516";"5766"
"LOK1378_1mm";"SILVA (only NR);Bacteria;Firmicutes;Clostridia;Lachnospirales;Lachnospiraceae;Catonella;";"0.0";"0";"51";"48";"0";"48";"3";"430476";"5766"
"LOK1378_1mm";"SILVA (only NR);Bacteria;Firmicutes;Clostridia;Lachnospirales;Lachnospiraceae;Cellulosilyticum;";"0.0";"0";"41";"41";"0";"41";"0";"430483";"5766"
"LOK1378_1mm";"SILVA (only NR);Bacteria;Firmicutes;Clostridia;Lachnospirales;Lachnospiraceae;Coprococcus;";"0.0";"0";"372";"362";"0";"362";"10";"430162";"5766"
"LOK1378_1mm";"SILVA (only NR);Bacteria;Firmicutes;Clostridia;Lachnospirales;Lachnospiraceae;Cuneatibacter;";"0.0";"0";"1";"1";"0";"1";"0";"430523";"5766"
"LOK1378_1mm";"SILVA (only NR);Bacteria;Firmicutes;Clostridia;Lachnospirales;Lachnospiraceae;Dorea;";"0.0";"0";"409";"395";"0";"395";"14";"430129";"5766"
"LOK1378_1mm";"SILVA (only NR);Bacteria;Firmicutes;Clostridia;Lachnospirales;Lachnospiraceae;Eisenbergiella;";"0.0";"0";"74";"70";"0";"70";"4";"430454";"5766"
"LOK1378_1mm";"SILVA (only NR);Bacteria;Firmicutes;Clostridia;Lachnospirales;Lachnospiraceae;Epulopiscium;";"0.0";"0";"193";"193";"0";"193";"0";"430331";"5766"
"LOK1378_1mm";"SILVA (only NR);Bacteria;Firmicutes;Clostridia;Lachnospirales;Lachnospiraceae;FD2005;";"0.0";"0";"22";"18";"0";"18";"4";"430506";"5766"
"LOK1378_1mm";"SILVA (only NR);Bacteria;Firmicutes;Clostridia;Lachnospirales;Lachnospiraceae;Frisingicoccus;";"0.0";"0";"33";"32";"0";"32";"1";"430492";"5766"
"LOK1378_1mm";"SILVA (only NR);Bacteria;Firmicutes;Clostridia;Lachnospirales;Lachnospiraceae;Fusicatenibacter;";"0.0";"0";"403";"385";"0";"385";"18";"430139";"5766"
"LOK1378_1mm";"SILVA (only NR);Bacteria;Firmicutes;Clostridia;Lachnospirales;Lachnospiraceae;GCA-900066575;";"0.0";"0";"107";"103";"0";"103";"4";"430421";"5766"
"LOK1378_1mm";"SILVA (only NR);Bacteria;Firmicutes;Clostridia;Lachnospirales;Lachnospiraceae;GCA-900066755;";"0.0";"0";"6";"6";"0";"6";"0";"430518";"5766"
"LOK1378_1mm";"SILVA (only NR);Bacteria;Firmicutes;Clostridia;Lachnospirales;Lachnospiraceae;Herbinix;";"0.0";"0";"46";"46";"0";"46";"0";"430478";"5766"
"LOK1378_1mm";"SILVA (only NR);Bacteria;Firmicutes;Clostridia;Lachnospirales;Lachnospiraceae;Hespellia;";"0.0";"0";"6";"6";"0";"6";"0";"430518";"5766"
"LOK1378_1mm";"SILVA (only NR);Bacteria;Firmicutes;Clostridia;Lachnospirales;Lachnospiraceae;Howardella;";"0.0";"0";"30";"30";"0";"30";"0";"430494";"5766"
"LOK1378_1mm";"SILVA (only NR);Bacteria;Firmicutes;Clostridia;Lachnospirales;Lachnospiraceae;Hungatella;";"0.0";"0";"132";"131";"0";"131";"1";"430393";"5766"
"LOK1378_1mm";"SILVA (only NR);Bacteria;Firmicutes;Clostridia;Lachnospirales;Lachnospiraceae;Incertae Sedis;";"0.0";"0";"12";"11";"0";"11";"1";"430513";"5766"
"LOK1378_1mm";"SILVA (only NR);Bacteria;Firmicutes;Clostridia;Lachnospirales;Lachnospiraceae;Johnsonella;";"0.0";"0";"36";"36";"0";"36";"0";"430488";"5766"
"LOK1378_1mm";"SILVA (only NR);Bacteria;Firmicutes;Clostridia;Lachnospirales;Lachnospiraceae;Lachnoanaerobaculum;";"0.0";"0";"54";"53";"0";"53";"1";"430471";"5766"
"LOK1378_1mm";"SILVA (only NR);Bacteria;Firmicutes;Clostridia;Lachnospirales;Lachnospiraceae;Lachnobacterium;";"0.0";"0";"2";"2";"0";"2";"0";"430522";"5766"
"LOK1378_1mm";"SILVA (only NR);Bacteria;Firmicutes;Clostridia;Lachnospirales;Lachnospiraceae;Lachnoclostridium;";"0.0";"0";"1418";"1323";"0";"1323";"95";"429201";"5766"
"LOK1378_1mm";"SILVA (only NR);Bacteria;Firmicutes;Clostridia;Lachnospirales;Lachnospiraceae;Lachnospira;";"0.0";"0";"141";"136";"0";"136";"5";"430388";"5766"
"LOK1378_1mm";"SILVA (only NR);Bacteria;Firmicutes;Clostridia;Lachnospirales;Lachnospiraceae;Lachnospiraceae AC2044 group;";"0.0";"0";"209";"203";"0";"203";"6";"430321";"5766"
"LOK1378_1mm";"SILVA (only NR);Bacteria;Firmicutes;Clostridia;Lachnospirales;Lachnospiraceae;Lachnospiraceae FCS020 group;";"0.0";"0";"157";"153";"0";"153";"4";"430371";"5766"
"LOK1378_1mm";"SILVA (only NR);Bacteria;Firmicutes;Clostridia;Lachnospirales;Lachnospiraceae;Lachnospiraceae FE2018 group;";"0.0";"0";"15";"15";"0";"15";"0";"430509";"5766"
"LOK1378_1mm";"SILVA (only NR);Bacteria;Firmicutes;Clostridia;Lachnospirales;Lachnospiraceae;Lachnospiraceae NC2004 group;";"0.0";"0";"171";"168";"0";"168";"3";"430356";"5766"
"LOK1378_1mm";"SILVA (only NR);Bacteria;Firmicutes;Clostridia;Lachnospirales;Lachnospiraceae;Lachnospiraceae ND3007 group;";"0.0";"0";"239";"235";"0";"235";"4";"430289";"5766"
"LOK1378_1mm";"SILVA (only NR);Bacteria;Firmicutes;Clostridia;Lachnospirales;Lachnospiraceae;Lachnospiraceae NK3A20 group;";"0.0";"0";"359";"347";"0";"347";"12";"430177";"5766"
"LOK1378_1mm";"SILVA (only NR);Bacteria;Firmicutes;Clostridia;Lachnospirales;Lachnospiraceae;Lachnospiraceae NK4A136 group;";"0.0";"0";"2259";"2115";"0";"2115";"144";"428409";"5766"
"LOK1378_1mm";"SILVA (only NR);Bacteria;Firmicutes;Clostridia;Lachnospirales;Lachnospiraceae;Lachnospiraceae NK4B4 group;";"0.0";"0";"18";"17";"0";"17";"1";"430507";"5766"
"LOK1378_1mm";"SILVA (only NR);Bacteria;Firmicutes;Clostridia;Lachnospirales;Lachnospiraceae;Lachnospiraceae UCG-001;";"0.0";"0";"376";"342";"0";"342";"34";"430182";"5766"
"LOK1378_1mm";"SILVA (only NR);Bacteria;Firmicutes;Clostridia;Lachnospirales;Lachnospiraceae;Lachnospiraceae UCG-002;";"0.0";"0";"23";"22";"0";"22";"1";"430502";"5766"
"LOK1378_1mm";"SILVA (only NR);Bacteria;Firmicutes;Clostridia;Lachnospirales;Lachnospiraceae;Lachnospiraceae UCG-003;";"0.0";"0";"23";"23";"0";"23";"0";"430501";"5766"
"LOK1378_1mm";"SILVA (only NR);Bacteria;Firmicutes;Clostridia;Lachnospirales;Lachnospiraceae;Lachnospiraceae UCG-004;";"0.0";"0";"191";"184";"0";"184";"7";"430340";"5766"
"LOK1378_1mm";"SILVA (only NR);Bacteria;Firmicutes;Clostridia;Lachnospirales;Lachnospiraceae;Lachnospiraceae UCG-006;";"0.0";"0";"188";"173";"0";"173";"15";"430351";"5766"
"LOK1378_1mm";"SILVA (only NR);Bacteria;Firmicutes;Clostridia;Lachnospirales;Lachnospiraceae;Lachnospiraceae UCG-007;";"0.0";"0";"7";"7";"0";"7";"0";"430517";"5766"
"LOK1378_1mm";"SILVA (only NR);Bacteria;Firmicutes;Clostridia;Lachnospirales;Lachnospiraceae;Lachnospiraceae UCG-008;";"0.0";"0";"692";"652";"0";"652";"40";"429872";"5766"
"LOK1378_1mm";"SILVA (only NR);Bacteria;Firmicutes;Clostridia;Lachnospirales;Lachnospiraceae;Lachnospiraceae UCG-009;";"0.0";"0";"27";"27";"0";"27";"0";"430497";"5766"
"LOK1378_1mm";"SILVA (only NR);Bacteria;Firmicutes;Clostridia;Lachnospirales;Lachnospiraceae;Lachnospiraceae UCG-010;";"0.0";"0";"20";"19";"0";"19";"1";"430505";"5766"
"LOK1378_1mm";"SILVA (only NR);Bacteria;Firmicutes;Clostridia;Lachnospirales;Lachnospiraceae;Lachnospiraceae XPB1014 group;";"0.0";"0";"204";"203";"0";"203";"1";"430321";"5766"
"LOK1378_1mm";"SILVA (only NR);Bacteria;Firmicutes;Clostridia;Lachnospirales;Lachnospiraceae;Lachnotalea;";"0.0";"0";"6";"4";"0";"4";"2";"430520";"5766"
"LOK1378_1mm";"SILVA (only NR);Bacteria;Firmicutes;Clostridia;Lachnospirales;Lachnospiraceae;Lactonifactor;";"0.0";"0";"6";"6";"0";"6";"0";"430518";"5766"
"LOK1378_1mm";"SILVA (only NR);Bacteria;Firmicutes;Clostridia;Lachnospirales;Lachnospiraceae;Marvinbryantia;";"0.0";"0";"250";"240";"0";"240";"10";"430284";"5766"
"LOK1378_1mm";"SILVA (only NR);Bacteria;Firmicutes;Clostridia;Lachnospirales;Lachnospiraceae;Mobilisporobacter;";"0.0";"0";"1";"1";"0";"1";"0";"430523";"5766"
"LOK1378_1mm";"SILVA (only NR);Bacteria;Firmicutes;Clostridia;Lachnospirales;Lachnospiraceae;Mobilitalea;";"0.0";"0";"11";"11";"0";"11";"0";"430513";"5766"
"LOK1378_1mm";"SILVA (only NR);Bacteria;Firmicutes;Clostridia;Lachnospirales;Lachnospiraceae;Moryella;";"0.0";"0";"56";"52";"0";"52";"4";"430472";"5766"
"LOK1378_1mm";"SILVA (only NR);Bacteria;Firmicutes;Clostridia;Lachnospirales;Lachnospiraceae;Murimonas;";"0.0";"0";"2";"1";"0";"1";"1";"430523";"5766"
"LOK1378_1mm";"SILVA (only NR);Bacteria;Firmicutes;Clostridia;Lachnospirales;Lachnospiraceae;Natranaerovirga;";"0.0";"0";"5";"5";"0";"5";"0";"430519";"5766"
"LOK1378_1mm";"SILVA (only NR);Bacteria;Firmicutes;Clostridia;Lachnospirales;Lachnospiraceae;Oribacterium;";"0.0";"0";"154";"150";"0";"150";"4";"430374";"5766"
"LOK1378_1mm";"SILVA (only NR);Bacteria;Firmicutes;Clostridia;Lachnospirales;Lachnospiraceae;Parasporobacterium;";"0.0";"0";"1";"1";"0";"1";"0";"430523";"5766"
"LOK1378_1mm";"SILVA (only NR);Bacteria;Firmicutes;Clostridia;Lachnospirales;Lachnospiraceae;Pseudobutyrivibrio;";"0.0";"0";"116";"109";"0";"109";"7";"430415";"5766"
"LOK1378_1mm";"SILVA (only NR);Bacteria;Firmicutes;Clostridia;Lachnospirales;Lachnospiraceae;Robinsoniella;";"0.0";"0";"19";"19";"0";"19";"0";"430505";"5766"
"LOK1378_1mm";"SILVA (only NR);Bacteria;Firmicutes;Clostridia;Lachnospirales;Lachnospiraceae;Roseburia;";"0.0";"0";"1592";"1509";"0";"1509";"83";"429015";"5766"
"LOK1378_1mm";"SILVA (only NR);Bacteria;Firmicutes;Clostridia;Lachnospirales;Lachnospiraceae;Sellimonas;";"0.0";"0";"30";"27";"0";"27";"3";"430497";"5766"
"LOK1378_1mm";"SILVA (only NR);Bacteria;Firmicutes;Clostridia;Lachnospirales;Lachnospiraceae;Shuttleworthia;";"0.0";"0";"78";"73";"0";"73";"5";"430451";"5766"
"LOK1378_1mm";"SILVA (only NR);Bacteria;Firmicutes;Clostridia;Lachnospirales;Lachnospiraceae;Sporobacterium;";"0.0";"0";"1";"1";"0";"1";"0";"430523";"5766"
"LOK1378_1mm";"SILVA (only NR);Bacteria;Firmicutes;Clostridia;Lachnospirales;Lachnospiraceae;Stomatobaculum;";"0.0";"0";"12";"12";"0";"12";"0";"430512";"5766"
"LOK1378_1mm";"SILVA (only NR);Bacteria;Firmicutes;Clostridia;Lachnospirales;Lachnospiraceae;Syntrophococcus;";"0.0";"0";"54";"51";"0";"51";"3";"430473";"5766"
"LOK1378_1mm";"SILVA (only NR);Bacteria;Firmicutes;Clostridia;Lachnospirales;Lachnospiraceae;Tuzzerella;";"0.0";"0";"33";"30";"0";"30";"3";"430494";"5766"
"LOK1378_1mm";"SILVA (only NR);Bacteria;Firmicutes;Clostridia;Lachnospirales;Lachnospiraceae;Tyzzerella;";"0.0";"0";"389";"382";"0";"382";"7";"430142";"5766"
"LOK1378_1mm";"SILVA (only NR);Bacteria;Firmicutes;Clostridia;Lachnospirales;Lachnospiraceae;UC5-1-2E3;";"0.0";"0";"4";"4";"0";"4";"0";"430520";"5766"
"LOK1378_1mm";"SILVA (only NR);Bacteria;Firmicutes;Clostridia;Lachnospirales;Lachnospiraceae;Vallitalea;";"0.0";"0";"13";"13";"0";"13";"0";"430511";"5766"
"LOK1378_1mm";"SILVA (only NR);Bacteria;Firmicutes;Clostridia;Lachnospirales;Lachnospiraceae;XBB1006;";"0.0";"0";"17";"17";"0";"17";"0";"430507";"5766"
"LOK1378_1mm";"SILVA (only NR);Bacteria;Firmicutes;Clostridia;Lachnospirales;Lachnospiraceae;[Acetivibrio] ethanolgignens group;";"0.0";"0";"3";"3";"0";"3";"0";"430521";"5766"
"LOK1378_1mm";"SILVA (only NR);Bacteria;Firmicutes;Clostridia;Lachnospirales;Lachnospiraceae;[Bacteroides] pectinophilus group;";"0.0";"0";"16";"15";"0";"15";"1";"430509";"5766"
"LOK1378_1mm";"SILVA (only NR);Bacteria;Firmicutes;Clostridia;Lachnospirales;Lachnospiraceae;[Eubacterium] cellulosolvens group;";"0.0";"0";"6";"6";"0";"6";"0";"430518";"5766"
"LOK1378_1mm";"SILVA (only NR);Bacteria;Firmicutes;Clostridia;Lachnospirales;Lachnospiraceae;[Eubacterium] eligens group;";"0.0";"0";"76";"74";"0";"74";"2";"430450";"5766"
"LOK1378_1mm";"SILVA (only NR);Bacteria;Firmicutes;Clostridia;Lachnospirales;Lachnospiraceae;[Eubacterium] fissicatena group;";"0.0";"0";"43";"43";"0";"43";"0";"430481";"5766"
"LOK1378_1mm";"SILVA (only NR);Bacteria;Firmicutes;Clostridia;Lachnospirales;Lachnospiraceae;[Eubacterium] hallii group;";"0.0";"0";"448";"432";"0";"432";"16";"430092";"5766"
"LOK1378_1mm";"SILVA (only NR);Bacteria;Firmicutes;Clostridia;Lachnospirales;Lachnospiraceae;[Eubacterium] oxidoreducens group;";"0.0";"0";"124";"119";"0";"119";"5";"430405";"5766"
"LOK1378_1mm";"SILVA (only NR);Bacteria;Firmicutes;Clostridia;Lachnospirales;Lachnospiraceae;[Eubacterium] ruminantium group;";"0.0";"0";"160";"154";"0";"154";"6";"430370";"5766"
"LOK1378_1mm";"SILVA (only NR);Bacteria;Firmicutes;Clostridia;Lachnospirales;Lachnospiraceae;[Eubacterium] ventriosum group;";"0.0";"0";"113";"110";"0";"110";"3";"430414";"5766"
"LOK1378_1mm";"SILVA (only NR);Bacteria;Firmicutes;Clostridia;Lachnospirales;Lachnospiraceae;[Eubacterium] xylanophilum group;";"0.0";"0";"164";"151";"0";"151";"13";"430373";"5766"
"LOK1378_1mm";"SILVA (only NR);Bacteria;Firmicutes;Clostridia;Lachnospirales;Lachnospiraceae;[Ruminococcus] gauvreauii group;";"0.0";"0";"331";"324";"0";"324";"7";"430200";"5766"
"LOK1378_1mm";"SILVA (only NR);Bacteria;Firmicutes;Clostridia;Lachnospirales;Lachnospiraceae;[Ruminococcus] gnavus group;";"0.0";"0";"250";"244";"0";"244";"6";"430280";"5766"
"LOK1378_1mm";"SILVA (only NR);Bacteria;Firmicutes;Clostridia;Lachnospirales;Lachnospiraceae;[Ruminococcus] torques group;";"0.0";"0";"848";"820";"0";"820";"28";"429704";"5766"
"LOK1378_1mm";"SILVA (only NR);Bacteria;Firmicutes;Clostridia;Lachnospirales;Lachnospiraceae;possible genus Sk003-Sk004;";"0.0";"0";"9";"9";"0";"9";"0";"430515";"5766"
"LOK1378_1mm";"SILVA (only NR);Bacteria;Firmicutes;Clostridia;Lachnospirales;Lachnospiraceae;possible genus Sk018;";"0.0";"0";"4";"4";"0";"4";"0";"430520";"5766"
"LOK1378_1mm";"SILVA (only NR);Bacteria;Firmicutes;Clostridia;Lachnospirales;Lachnospiraceae;probable genus 10;";"0.0";"0";"36";"36";"0";"36";"0";"430488";"5766"
"LOK1378_1mm";"SILVA (only NR);Bacteria;Firmicutes;Clostridia;Lachnospirales;Lachnospiraceae;uncultured;";"0.0";"0";"3415";"3175";"0";"3175";"240";"427349";"5766"
"LOK1378_1mm";"SILVA (only NR);Bacteria;Firmicutes;Clostridia;Lachnospirales;uncultured;";"0.0";"0";"9";"8";"0";"8";"1";"430516";"5766"
"LOK1378_1mm";"SILVA (only NR);Bacteria;Firmicutes;Clostridia;MAT-CR-H4-C10;";"0.0";"0";"4";"4";"0";"4";"0";"430520";"5766"
"LOK1378_1mm";"SILVA (only NR);Bacteria;Firmicutes;Clostridia;Monoglobales;";"0.0";"0";"351";"338";"0";"338";"13";"430186";"5766"
"LOK1378_1mm";"SILVA (only NR);Bacteria;Firmicutes;Clostridia;Monoglobales;Monoglobaceae;";"0.0";"0";"351";"338";"0";"338";"13";"430186";"5766"
"LOK1378_1mm";"SILVA (only NR);Bacteria;Firmicutes;Clostridia;Monoglobales;Monoglobaceae;Monoglobus;";"0.0";"0";"351";"338";"0";"338";"13";"430186";"5766"
"LOK1378_1mm";"SILVA (only NR);Bacteria;Firmicutes;Clostridia;Oscillospirales;";"0.0";"0";"14250";"13761";"0";"13761";"489";"416763";"5766"
"LOK1378_1mm";"SILVA (only NR);Bacteria;Firmicutes;Clostridia;Oscillospirales;Butyricicoccaceae;";"0.0";"0";"316";"299";"0";"299";"17";"430225";"5766"
"LOK1378_1mm";"SILVA (only NR);Bacteria;Firmicutes;Clostridia;Oscillospirales;Butyricicoccaceae;Butyricicoccus;";"0.0";"0";"180";"169";"0";"169";"11";"430355";"5766"
"LOK1378_1mm";"SILVA (only NR);Bacteria;Firmicutes;Clostridia;Oscillospirales;Butyricicoccaceae;UCG-008;";"0.0";"0";"31";"29";"0";"29";"2";"430495";"5766"
"LOK1378_1mm";"SILVA (only NR);Bacteria;Firmicutes;Clostridia;Oscillospirales;Butyricicoccaceae;UCG-009;";"0.0";"0";"97";"94";"0";"94";"3";"430430";"5766"
"LOK1378_1mm";"SILVA (only NR);Bacteria;Firmicutes;Clostridia;Oscillospirales;Butyricicoccaceae;uncultured;";"0.0";"0";"8";"7";"0";"7";"1";"430517";"5766"
"LOK1378_1mm";"SILVA (only NR);Bacteria;Firmicutes;Clostridia;Oscillospirales;Ethanoligenenaceae;";"0.0";"0";"47";"47";"0";"47";"0";"430477";"5766"
"LOK1378_1mm";"SILVA (only NR);Bacteria;Firmicutes;Clostridia;Oscillospirales;Ethanoligenenaceae;Acetanaerobacterium;";"0.0";"0";"10";"10";"0";"10";"0";"430514";"5766"
"LOK1378_1mm";"SILVA (only NR);Bacteria;Firmicutes;Clostridia;Oscillospirales;Ethanoligenenaceae;Ethanoligenens;";"0.0";"0";"11";"11";"0";"11";"0";"430513";"5766"
"LOK1378_1mm";"SILVA (only NR);Bacteria;Firmicutes;Clostridia;Oscillospirales;Ethanoligenenaceae;Incertae Sedis;";"0.0";"0";"23";"23";"0";"23";"0";"430501";"5766"
"LOK1378_1mm";"SILVA (only NR);Bacteria;Firmicutes;Clostridia;Oscillospirales;Ethanoligenenaceae;uncultured;";"0.0";"0";"2";"2";"0";"2";"0";"430522";"5766"
"LOK1378_1mm";"SILVA (only NR);Bacteria;Firmicutes;Clostridia;Oscillospirales;Hungateiclostridiaceae;";"0.0";"0";"1418";"1366";"0";"1366";"52";"429158";"5766"
"LOK1378_1mm";"SILVA (only NR);Bacteria;Firmicutes;Clostridia;Oscillospirales;Hungateiclostridiaceae;Acetivibrio;";"0.0";"0";"28";"27";"0";"27";"1";"430497";"5766"
"LOK1378_1mm";"SILVA (only NR);Bacteria;Firmicutes;Clostridia;Oscillospirales;Hungateiclostridiaceae;Anaerobacterium;";"0.0";"0";"13";"13";"0";"13";"0";"430511";"5766"
"LOK1378_1mm";"SILVA (only NR);Bacteria;Firmicutes;Clostridia;Oscillospirales;Hungateiclostridiaceae;Cellulosibacter;";"0.0";"0";"2";"2";"0";"2";"0";"430522";"5766"
"LOK1378_1mm";"SILVA (only NR);Bacteria;Firmicutes;Clostridia;Oscillospirales;Hungateiclostridiaceae;Ercella;";"0.0";"0";"35";"34";"0";"34";"1";"430490";"5766"
"LOK1378_1mm";"SILVA (only NR);Bacteria;Firmicutes;Clostridia;Oscillospirales;Hungateiclostridiaceae;Fastidiosipila;";"0.0";"0";"290";"280";"0";"280";"10";"430244";"5766"
"LOK1378_1mm";"SILVA (only NR);Bacteria;Firmicutes;Clostridia;Oscillospirales;Hungateiclostridiaceae;HN-HF0106;";"0.0";"0";"80";"77";"0";"77";"3";"430447";"5766"
"LOK1378_1mm";"SILVA (only NR);Bacteria;Firmicutes;Clostridia;Oscillospirales;Hungateiclostridiaceae;Hungateiclostridium;";"0.0";"0";"25";"25";"0";"25";"0";"430499";"5766"
"LOK1378_1mm";"SILVA (only NR);Bacteria;Firmicutes;Clostridia;Oscillospirales;Hungateiclostridiaceae;Mageeibacillus;";"0.0";"0";"9";"8";"0";"8";"1";"430516";"5766"
"LOK1378_1mm";"SILVA (only NR);Bacteria;Firmicutes;Clostridia;Oscillospirales;Hungateiclostridiaceae;Pseudobacteroides;";"0.0";"0";"9";"8";"0";"8";"1";"430516";"5766"
"LOK1378_1mm";"SILVA (only NR);Bacteria;Firmicutes;Clostridia;Oscillospirales;Hungateiclostridiaceae;Pseudoclostridium;";"0.0";"0";"14";"14";"0";"14";"0";"430510";"5766"
"LOK1378_1mm";"SILVA (only NR);Bacteria;Firmicutes;Clostridia;Oscillospirales;Hungateiclostridiaceae;Ruminiclostridium;";"0.0";"0";"263";"258";"0";"258";"5";"430266";"5766"
"LOK1378_1mm";"SILVA (only NR);Bacteria;Firmicutes;Clostridia;Oscillospirales;Hungateiclostridiaceae;Saccharofermentans;";"0.0";"0";"201";"196";"0";"196";"5";"430328";"5766"
"LOK1378_1mm";"SILVA (only NR);Bacteria;Firmicutes;Clostridia;Oscillospirales;Hungateiclostridiaceae;Thermoclostridium;";"0.0";"0";"23";"23";"0";"23";"0";"430501";"5766"
"LOK1378_1mm";"SILVA (only NR);Bacteria;Firmicutes;Clostridia;Oscillospirales;Hungateiclostridiaceae;UCG-012;";"0.0";"0";"77";"77";"0";"77";"0";"430447";"5766"
"LOK1378_1mm";"SILVA (only NR);Bacteria;Firmicutes;Clostridia;Oscillospirales;Hungateiclostridiaceae;uncultured;";"0.0";"0";"344";"320";"0";"320";"24";"430204";"5766"
"LOK1378_1mm";"SILVA (only NR);Bacteria;Firmicutes;Clostridia;Oscillospirales;Hydrogenoanaerobacterium;";"0.0";"0";"27";"26";"0";"26";"1";"430498";"5766"
"LOK1378_1mm";"SILVA (only NR);Bacteria;Firmicutes;Clostridia;Oscillospirales;Oscillospiraceae;";"0.0";"0";"4400";"4237";"0";"4237";"163";"426287";"5766"
"LOK1378_1mm";"SILVA (only NR);Bacteria;Firmicutes;Clostridia;Oscillospirales;Oscillospiraceae;Colidextribacter;";"0.0";"0";"384";"371";"0";"371";"13";"430153";"5766"
"LOK1378_1mm";"SILVA (only NR);Bacteria;Firmicutes;Clostridia;Oscillospirales;Oscillospiraceae;Flavonifractor;";"0.0";"0";"48";"48";"0";"48";"0";"430476";"5766"
"LOK1378_1mm";"SILVA (only NR);Bacteria;Firmicutes;Clostridia;Oscillospirales;Oscillospiraceae;Intestinimonas;";"0.0";"0";"43";"40";"0";"40";"3";"430484";"5766"
"LOK1378_1mm";"SILVA (only NR);Bacteria;Firmicutes;Clostridia;Oscillospirales;Oscillospiraceae;NK4A214 group;";"0.0";"0";"687";"669";"0";"669";"18";"429855";"5766"
"LOK1378_1mm";"SILVA (only NR);Bacteria;Firmicutes;Clostridia;Oscillospirales;Oscillospiraceae;Oscillibacter;";"0.0";"0";"268";"253";"0";"253";"15";"430271";"5766"
"LOK1378_1mm";"SILVA (only NR);Bacteria;Firmicutes;Clostridia;Oscillospirales;Oscillospiraceae;Oscillospira;";"0.0";"0";"29";"29";"0";"29";"0";"430495";"5766"
"LOK1378_1mm";"SILVA (only NR);Bacteria;Firmicutes;Clostridia;Oscillospirales;Oscillospiraceae;Papillibacter;";"0.0";"0";"73";"73";"0";"73";"0";"430451";"5766"
"LOK1378_1mm";"SILVA (only NR);Bacteria;Firmicutes;Clostridia;Oscillospirales;Oscillospiraceae;Pseudoflavonifractor;";"0.0";"0";"4";"4";"0";"4";"0";"430520";"5766"
"LOK1378_1mm";"SILVA (only NR);Bacteria;Firmicutes;Clostridia;Oscillospirales;Oscillospiraceae;Sporobacter;";"0.0";"0";"14";"14";"0";"14";"0";"430510";"5766"
"LOK1378_1mm";"SILVA (only NR);Bacteria;Firmicutes;Clostridia;Oscillospirales;Oscillospiraceae;UCG-002;";"0.0";"0";"511";"494";"0";"494";"17";"430030";"5766"
"LOK1378_1mm";"SILVA (only NR);Bacteria;Firmicutes;Clostridia;Oscillospirales;Oscillospiraceae;UCG-003;";"0.0";"0";"71";"70";"0";"70";"1";"430454";"5766"
"LOK1378_1mm";"SILVA (only NR);Bacteria;Firmicutes;Clostridia;Oscillospirales;Oscillospiraceae;UCG-005;";"0.0";"0";"1479";"1423";"0";"1423";"56";"429101";"5766"
"LOK1378_1mm";"SILVA (only NR);Bacteria;Firmicutes;Clostridia;Oscillospirales;Oscillospiraceae;UCG-007;";"0.0";"0";"8";"8";"0";"8";"0";"430516";"5766"
"LOK1378_1mm";"SILVA (only NR);Bacteria;Firmicutes;Clostridia;Oscillospirales;Oscillospiraceae;V9D2013 group;";"0.0";"0";"31";"31";"0";"31";"0";"430493";"5766"
"LOK1378_1mm";"SILVA (only NR);Bacteria;Firmicutes;Clostridia;Oscillospirales;Oscillospiraceae;uncultured;";"0.0";"0";"741";"702";"0";"702";"39";"429822";"5766"
"LOK1378_1mm";"SILVA (only NR);Bacteria;Firmicutes;Clostridia;Oscillospirales;Ruminococcaceae;";"0.0";"0";"5875";"5676";"0";"5676";"199";"424848";"5766"
"LOK1378_1mm";"SILVA (only NR);Bacteria;Firmicutes;Clostridia;Oscillospirales;Ruminococcaceae;Anaerofilum;";"0.0";"0";"20";"20";"0";"20";"0";"430504";"5766"
"LOK1378_1mm";"SILVA (only NR);Bacteria;Firmicutes;Clostridia;Oscillospirales;Ruminococcaceae;Anaerotruncus;";"0.0";"0";"51";"45";"0";"45";"6";"430479";"5766"
"LOK1378_1mm";"SILVA (only NR);Bacteria;Firmicutes;Clostridia;Oscillospirales;Ruminococcaceae;Angelakisella;";"0.0";"0";"4";"4";"0";"4";"0";"430520";"5766"
"LOK1378_1mm";"SILVA (only NR);Bacteria;Firmicutes;Clostridia;Oscillospirales;Ruminococcaceae;CAG-352;";"0.0";"0";"73";"72";"0";"72";"1";"430452";"5766"
"LOK1378_1mm";"SILVA (only NR);Bacteria;Firmicutes;Clostridia;Oscillospirales;Ruminococcaceae;Candidatus Soleaferrea;";"0.0";"0";"146";"141";"0";"141";"5";"430383";"5766"
"LOK1378_1mm";"SILVA (only NR);Bacteria;Firmicutes;Clostridia;Oscillospirales;Ruminococcaceae;Caproiciproducens;";"0.0";"0";"109";"108";"0";"108";"1";"430416";"5766"
"LOK1378_1mm";"SILVA (only NR);Bacteria;Firmicutes;Clostridia;Oscillospirales;Ruminococcaceae;DTU089;";"0.0";"0";"10";"10";"0";"10";"0";"430514";"5766"
"LOK1378_1mm";"SILVA (only NR);Bacteria;Firmicutes;Clostridia;Oscillospirales;Ruminococcaceae;Faecalibacterium;";"0.0";"0";"1930";"1872";"0";"1872";"58";"428652";"5766"
"LOK1378_1mm";"SILVA (only NR);Bacteria;Firmicutes;Clostridia;Oscillospirales;Ruminococcaceae;Fournierella;";"0.0";"0";"31";"30";"0";"30";"1";"430494";"5766"
"LOK1378_1mm";"SILVA (only NR);Bacteria;Firmicutes;Clostridia;Oscillospirales;Ruminococcaceae;Harryflintia;";"0.0";"0";"11";"11";"0";"11";"0";"430513";"5766"
"LOK1378_1mm";"SILVA (only NR);Bacteria;Firmicutes;Clostridia;Oscillospirales;Ruminococcaceae;Incertae Sedis;";"0.0";"0";"335";"320";"0";"320";"15";"430204";"5766"
"LOK1378_1mm";"SILVA (only NR);Bacteria;Firmicutes;Clostridia;Oscillospirales;Ruminococcaceae;Negativibacillus;";"0.0";"0";"62";"60";"0";"60";"2";"430464";"5766"
"LOK1378_1mm";"SILVA (only NR);Bacteria;Firmicutes;Clostridia;Oscillospirales;Ruminococcaceae;Paludicola;";"0.0";"0";"29";"29";"0";"29";"0";"430495";"5766"
"LOK1378_1mm";"SILVA (only NR);Bacteria;Firmicutes;Clostridia;Oscillospirales;Ruminococcaceae;Phocea;";"0.0";"0";"4";"4";"0";"4";"0";"430520";"5766"
"LOK1378_1mm";"SILVA (only NR);Bacteria;Firmicutes;Clostridia;Oscillospirales;Ruminococcaceae;Pygmaiobacter;";"0.0";"0";"13";"13";"0";"13";"0";"430511";"5766"
"LOK1378_1mm";"SILVA (only NR);Bacteria;Firmicutes;Clostridia;Oscillospirales;Ruminococcaceae;Ruminococcus;";"0.0";"0";"1437";"1380";"0";"1380";"57";"429144";"5766"
"LOK1378_1mm";"SILVA (only NR);Bacteria;Firmicutes;Clostridia;Oscillospirales;Ruminococcaceae;Subdoligranulum;";"0.0";"0";"741";"723";"0";"723";"18";"429801";"5766"
"LOK1378_1mm";"SILVA (only NR);Bacteria;Firmicutes;Clostridia;Oscillospirales;Ruminococcaceae;UBA1819;";"0.0";"0";"40";"38";"0";"38";"2";"430486";"5766"
"LOK1378_1mm";"SILVA (only NR);Bacteria;Firmicutes;Clostridia;Oscillospirales;Ruminococcaceae;UCG-001;";"0.0";"0";"16";"16";"0";"16";"0";"430508";"5766"
"LOK1378_1mm";"SILVA (only NR);Bacteria;Firmicutes;Clostridia;Oscillospirales;Ruminococcaceae;[Eubacterium] siraeum group;";"0.0";"0";"73";"70";"0";"70";"3";"430454";"5766"
"LOK1378_1mm";"SILVA (only NR);Bacteria;Firmicutes;Clostridia;Oscillospirales;Ruminococcaceae;uncultured;";"0.0";"0";"649";"622";"0";"622";"27";"429902";"5766"
"LOK1378_1mm";"SILVA (only NR);Bacteria;Firmicutes;Clostridia;Oscillospirales;UCG-010;";"0.0";"0";"838";"816";"0";"816";"22";"429708";"5766"
"LOK1378_1mm";"SILVA (only NR);Bacteria;Firmicutes;Clostridia;Oscillospirales;UCG-011;";"0.0";"0";"79";"74";"0";"74";"5";"430450";"5766"
"LOK1378_1mm";"SILVA (only NR);Bacteria;Firmicutes;Clostridia;Oscillospirales;[Clostridium] methylpentosum group;";"0.0";"0";"23";"23";"0";"23";"0";"430501";"5766"
"LOK1378_1mm";"SILVA (only NR);Bacteria;Firmicutes;Clostridia;Oscillospirales;[Eubacterium] coprostanoligenes group;";"0.0";"0";"1058";"1028";"0";"1028";"30";"429496";"5766"
"LOK1378_1mm";"SILVA (only NR);Bacteria;Firmicutes;Clostridia;Oscillospirales;uncultured;";"0.0";"0";"167";"167";"0";"167";"0";"430357";"5766"
"LOK1378_1mm";"SILVA (only NR);Bacteria;Firmicutes;Clostridia;Peptococcales;";"0.0";"0";"229";"218";"0";"218";"11";"430306";"5766"
"LOK1378_1mm";"SILVA (only NR);Bacteria;Firmicutes;Clostridia;Peptococcales;Peptococcaceae;";"0.0";"0";"229";"218";"0";"218";"11";"430306";"5766"
"LOK1378_1mm";"SILVA (only NR);Bacteria;Firmicutes;Clostridia;Peptococcales;Peptococcaceae;Dehalobacterium;";"0.0";"0";"9";"9";"0";"9";"0";"430515";"5766"
"LOK1378_1mm";"SILVA (only NR);Bacteria;Firmicutes;Clostridia;Peptococcales;Peptococcaceae;Desulfitispora;";"0.0";"0";"4";"4";"0";"4";"0";"430520";"5766"
"LOK1378_1mm";"SILVA (only NR);Bacteria;Firmicutes;Clostridia;Peptococcales;Peptococcaceae;Desulfonispora;";"0.0";"0";"2";"2";"0";"2";"0";"430522";"5766"
"LOK1378_1mm";"SILVA (only NR);Bacteria;Firmicutes;Clostridia;Peptococcales;Peptococcaceae;Peptococcus;";"0.0";"0";"51";"49";"0";"49";"2";"430475";"5766"
"LOK1378_1mm";"SILVA (only NR);Bacteria;Firmicutes;Clostridia;Peptococcales;Peptococcaceae;uncultured;";"0.0";"0";"162";"153";"0";"153";"9";"430371";"5766"
"LOK1378_1mm";"SILVA (only NR);Bacteria;Firmicutes;Clostridia;Peptostreptococcales-Tissierellales;";"0.0";"0";"4931";"4786";"0";"4786";"145";"425738";"5766"
"LOK1378_1mm";"SILVA (only NR);Bacteria;Firmicutes;Clostridia;Peptostreptococcales-Tissierellales;Acidaminobacteraceae;";"0.0";"0";"49";"46";"0";"46";"3";"430478";"5766"
"LOK1378_1mm";"SILVA (only NR);Bacteria;Firmicutes;Clostridia;Peptostreptococcales-Tissierellales;Acidaminobacteraceae;Acidaminobacter;";"0.0";"0";"49";"46";"0";"46";"3";"430478";"5766"
"LOK1378_1mm";"SILVA (only NR);Bacteria;Firmicutes;Clostridia;Peptostreptococcales-Tissierellales;Alkaliphilus;";"0.0";"0";"70";"66";"0";"66";"4";"430458";"5766"
"LOK1378_1mm";"SILVA (only NR);Bacteria;Firmicutes;Clostridia;Peptostreptococcales-Tissierellales;Anaeromicrobium;";"0.0";"0";"8";"7";"0";"7";"1";"430517";"5766"
"LOK1378_1mm";"SILVA (only NR);Bacteria;Firmicutes;Clostridia;Peptostreptococcales-Tissierellales;Anaerovirgula;";"0.0";"0";"2";"2";"0";"2";"0";"430522";"5766"
"LOK1378_1mm";"SILVA (only NR);Bacteria;Firmicutes;Clostridia;Peptostreptococcales-Tissierellales;Anaerovoracaceae;";"0.0";"0";"1018";"991";"0";"991";"27";"429533";"5766"
"LOK1378_1mm";"SILVA (only NR);Bacteria;Firmicutes;Clostridia;Peptostreptococcales-Tissierellales;Anaerovoracaceae;Amnipila;";"0.0";"0";"20";"19";"0";"19";"1";"430505";"5766"
"LOK1378_1mm";"SILVA (only NR);Bacteria;Firmicutes;Clostridia;Peptostreptococcales-Tissierellales;Anaerovoracaceae;Anaerovorax;";"0.0";"0";"217";"211";"0";"211";"6";"430313";"5766"
"LOK1378_1mm";"SILVA (only NR);Bacteria;Firmicutes;Clostridia;Peptostreptococcales-Tissierellales;Anaerovoracaceae;Family XIII AD3011 group;";"0.0";"0";"183";"177";"0";"177";"6";"430347";"5766"
"LOK1378_1mm";"SILVA (only NR);Bacteria;Firmicutes;Clostridia;Peptostreptococcales-Tissierellales;Anaerovoracaceae;Family XIII UCG-001;";"0.0";"0";"37";"37";"0";"37";"0";"430487";"5766"
"LOK1378_1mm";"SILVA (only NR);Bacteria;Firmicutes;Clostridia;Peptostreptococcales-Tissierellales;Anaerovoracaceae;Mogibacterium;";"0.0";"0";"178";"172";"0";"172";"6";"430352";"5766"
"LOK1378_1mm";"SILVA (only NR);Bacteria;Firmicutes;Clostridia;Peptostreptococcales-Tissierellales;Anaerovoracaceae;S5-A14a;";"0.0";"0";"25";"25";"0";"25";"0";"430499";"5766"
"LOK1378_1mm";"SILVA (only NR);Bacteria;Firmicutes;Clostridia;Peptostreptococcales-Tissierellales;Anaerovoracaceae;[Eubacterium] brachy group;";"0.0";"0";"74";"71";"0";"71";"3";"430453";"5766"
"LOK1378_1mm";"SILVA (only NR);Bacteria;Firmicutes;Clostridia;Peptostreptococcales-Tissierellales;Anaerovoracaceae;[Eubacterium] nodatum group;";"0.0";"0";"167";"163";"0";"163";"4";"430361";"5766"
"LOK1378_1mm";"SILVA (only NR);Bacteria;Firmicutes;Clostridia;Peptostreptococcales-Tissierellales;Anaerovoracaceae;[Eubacterium] saphenum group;";"0.0";"0";"9";"9";"0";"9";"0";"430515";"5766"
"LOK1378_1mm";"SILVA (only NR);Bacteria;Firmicutes;Clostridia;Peptostreptococcales-Tissierellales;Anaerovoracaceae;uncultured;";"0.0";"0";"104";"103";"0";"103";"1";"430421";"5766"
"LOK1378_1mm";"SILVA (only NR);Bacteria;Firmicutes;Clostridia;Peptostreptococcales-Tissierellales;Anoxynatronum;";"0.0";"0";"16";"16";"0";"16";"0";"430508";"5766"
"LOK1378_1mm";"SILVA (only NR);Bacteria;Firmicutes;Clostridia;Peptostreptococcales-Tissierellales;Brassicibacter;";"0.0";"0";"15";"15";"0";"15";"0";"430509";"5766"
"LOK1378_1mm";"SILVA (only NR);Bacteria;Firmicutes;Clostridia;Peptostreptococcales-Tissierellales;Caldisalinibacter;";"0.0";"0";"1";"1";"0";"1";"0";"430523";"5766"
"LOK1378_1mm";"SILVA (only NR);Bacteria;Firmicutes;Clostridia;Peptostreptococcales-Tissierellales;Caloranaerobacter;";"0.0";"0";"17";"17";"0";"17";"0";"430507";"5766"
"LOK1378_1mm";"SILVA (only NR);Bacteria;Firmicutes;Clostridia;Peptostreptococcales-Tissierellales;Caminicellaceae;";"0.0";"0";"59";"59";"0";"59";"0";"430465";"5766"
"LOK1378_1mm";"SILVA (only NR);Bacteria;Firmicutes;Clostridia;Peptostreptococcales-Tissierellales;Caminicellaceae;Caminicella;";"0.0";"0";"39";"39";"0";"39";"0";"430485";"5766"
"LOK1378_1mm";"SILVA (only NR);Bacteria;Firmicutes;Clostridia;Peptostreptococcales-Tissierellales;Caminicellaceae;Paramaledivibacter;";"0.0";"0";"20";"20";"0";"20";"0";"430504";"5766"
"LOK1378_1mm";"SILVA (only NR);Bacteria;Firmicutes;Clostridia;Peptostreptococcales-Tissierellales;Clostridiisalibacter;";"0.0";"0";"30";"30";"0";"30";"0";"430494";"5766"
"LOK1378_1mm";"SILVA (only NR);Bacteria;Firmicutes;Clostridia;Peptostreptococcales-Tissierellales;Clostridium sensu stricto;";"0.0";"0";"13";"13";"0";"13";"0";"430511";"5766"
"LOK1378_1mm";"SILVA (only NR);Bacteria;Firmicutes;Clostridia;Peptostreptococcales-Tissierellales;Dethiosulfatibacteraceae;";"0.0";"0";"37";"37";"0";"37";"0";"430487";"5766"
"LOK1378_1mm";"SILVA (only NR);Bacteria;Firmicutes;Clostridia;Peptostreptococcales-Tissierellales;Dethiosulfatibacteraceae;Dethiosulfatibacter;";"0.0";"0";"37";"37";"0";"37";"0";"430487";"5766"
"LOK1378_1mm";"SILVA (only NR);Bacteria;Firmicutes;Clostridia;Peptostreptococcales-Tissierellales;Family XI;";"0.0";"0";"1632";"1605";"0";"1605";"27";"428919";"5766"
"LOK1378_1mm";"SILVA (only NR);Bacteria;Firmicutes;Clostridia;Peptostreptococcales-Tissierellales;Family XI;Anaerococcus;";"0.0";"0";"496";"490";"0";"490";"6";"430034";"5766"
"LOK1378_1mm";"SILVA (only NR);Bacteria;Firmicutes;Clostridia;Peptostreptococcales-Tissierellales;Family XI;Anaerosalibacter;";"0.0";"0";"19";"18";"0";"18";"1";"430506";"5766"
"LOK1378_1mm";"SILVA (only NR);Bacteria;Firmicutes;Clostridia;Peptostreptococcales-Tissierellales;Family XI;Anaerosphaera;";"0.0";"0";"3";"3";"0";"3";"0";"430521";"5766"
"LOK1378_1mm";"SILVA (only NR);Bacteria;Firmicutes;Clostridia;Peptostreptococcales-Tissierellales;Family XI;Ezakiella;";"0.0";"0";"36";"36";"0";"36";"0";"430488";"5766"
"LOK1378_1mm";"SILVA (only NR);Bacteria;Firmicutes;Clostridia;Peptostreptococcales-Tissierellales;Family XI;Fenollaria;";"0.0";"0";"54";"54";"0";"54";"0";"430470";"5766"
"LOK1378_1mm";"SILVA (only NR);Bacteria;Firmicutes;Clostridia;Peptostreptococcales-Tissierellales;Family XI;Finegoldia;";"0.0";"0";"161";"160";"0";"160";"1";"430364";"5766"
"LOK1378_1mm";"SILVA (only NR);Bacteria;Firmicutes;Clostridia;Peptostreptococcales-Tissierellales;Family XI;Gallicola;";"0.0";"0";"28";"27";"0";"27";"1";"430497";"5766"
"LOK1378_1mm";"SILVA (only NR);Bacteria;Firmicutes;Clostridia;Peptostreptococcales-Tissierellales;Family XI;Helcococcus;";"0.0";"0";"68";"67";"0";"67";"1";"430457";"5766"
"LOK1378_1mm";"SILVA (only NR);Bacteria;Firmicutes;Clostridia;Peptostreptococcales-Tissierellales;Family XI;Keratinibaculum;";"0.0";"0";"8";"8";"0";"8";"0";"430516";"5766"
"LOK1378_1mm";"SILVA (only NR);Bacteria;Firmicutes;Clostridia;Peptostreptococcales-Tissierellales;Family XI;Murdochiella;";"0.0";"0";"21";"20";"0";"20";"1";"430504";"5766"
"LOK1378_1mm";"SILVA (only NR);Bacteria;Firmicutes;Clostridia;Peptostreptococcales-Tissierellales;Family XI;Parvimonas;";"0.0";"0";"94";"94";"0";"94";"0";"430430";"5766"
"LOK1378_1mm";"SILVA (only NR);Bacteria;Firmicutes;Clostridia;Peptostreptococcales-Tissierellales;Family XI;Peptoniphilus;";"0.0";"0";"203";"201";"0";"201";"2";"430323";"5766"
"LOK1378_1mm";"SILVA (only NR);Bacteria;Firmicutes;Clostridia;Peptostreptococcales-Tissierellales;Family XI;Soehngenia;";"0.0";"0";"33";"33";"0";"33";"0";"430491";"5766"
"LOK1378_1mm";"SILVA (only NR);Bacteria;Firmicutes;Clostridia;Peptostreptococcales-Tissierellales;Family XI;Sporanaerobacter;";"0.0";"0";"27";"27";"0";"27";"0";"430497";"5766"
"LOK1378_1mm";"SILVA (only NR);Bacteria;Firmicutes;Clostridia;Peptostreptococcales-Tissierellales;Family XI;Tepidimicrobium;";"0.0";"0";"75";"75";"0";"75";"0";"430449";"5766"
"LOK1378_1mm";"SILVA (only NR);Bacteria;Firmicutes;Clostridia;Peptostreptococcales-Tissierellales;Family XI;Tissierella;";"0.0";"0";"162";"155";"0";"155";"7";"430369";"5766"
"LOK1378_1mm";"SILVA (only NR);Bacteria;Firmicutes;Clostridia;Peptostreptococcales-Tissierellales;Family XI;W5053;";"0.0";"0";"86";"84";"0";"84";"2";"430440";"5766"
"LOK1378_1mm";"SILVA (only NR);Bacteria;Firmicutes;Clostridia;Peptostreptococcales-Tissierellales;Family XI;uncultured;";"0.0";"0";"50";"46";"0";"46";"4";"430478";"5766"
"LOK1378_1mm";"SILVA (only NR);Bacteria;Firmicutes;Clostridia;Peptostreptococcales-Tissierellales;Fusibacteraceae;";"0.0";"0";"331";"324";"0";"324";"7";"430200";"5766"
"LOK1378_1mm";"SILVA (only NR);Bacteria;Firmicutes;Clostridia;Peptostreptococcales-Tissierellales;Fusibacteraceae;Fusibacter;";"0.0";"0";"331";"324";"0";"324";"7";"430200";"5766"
"LOK1378_1mm";"SILVA (only NR);Bacteria;Firmicutes;Clostridia;Peptostreptococcales-Tissierellales;GoM-GC232-4463-Bac1;";"0.0";"0";"7";"7";"0";"7";"0";"430517";"5766"
"LOK1378_1mm";"SILVA (only NR);Bacteria;Firmicutes;Clostridia;Peptostreptococcales-Tissierellales;Gottschalkia;";"0.0";"0";"13";"13";"0";"13";"0";"430511";"5766"
"LOK1378_1mm";"SILVA (only NR);Bacteria;Firmicutes;Clostridia;Peptostreptococcales-Tissierellales;Guggenheimella;";"0.0";"0";"63";"60";"0";"60";"3";"430464";"5766"
"LOK1378_1mm";"SILVA (only NR);Bacteria;Firmicutes;Clostridia;Peptostreptococcales-Tissierellales;JTB215;";"0.0";"0";"12";"12";"0";"12";"0";"430512";"5766"
"LOK1378_1mm";"SILVA (only NR);Bacteria;Firmicutes;Clostridia;Peptostreptococcales-Tissierellales;MCWD3;";"0.0";"0";"3";"3";"0";"3";"0";"430521";"5766"
"LOK1378_1mm";"SILVA (only NR);Bacteria;Firmicutes;Clostridia;Peptostreptococcales-Tissierellales;Natronincola;";"0.0";"0";"9";"9";"0";"9";"0";"430515";"5766"
"LOK1378_1mm";"SILVA (only NR);Bacteria;Firmicutes;Clostridia;Peptostreptococcales-Tissierellales;Peptostreptococcaceae;";"0.0";"0";"1217";"1158";"0";"1158";"59";"429366";"5766"
"LOK1378_1mm";"SILVA (only NR);Bacteria;Firmicutes;Clostridia;Peptostreptococcales-Tissierellales;Peptostreptococcaceae;Acetoanaerobium;";"0.0";"0";"30";"29";"0";"29";"1";"430495";"5766"
"LOK1378_1mm";"SILVA (only NR);Bacteria;Firmicutes;Clostridia;Peptostreptococcales-Tissierellales;Peptostreptococcaceae;Asaccharospora;";"0.0";"0";"2";"2";"0";"2";"0";"430522";"5766"
"LOK1378_1mm";"SILVA (only NR);Bacteria;Firmicutes;Clostridia;Peptostreptococcales-Tissierellales;Peptostreptococcaceae;Clostridioides;";"0.0";"0";"100";"99";"0";"99";"1";"430425";"5766"
"LOK1378_1mm";"SILVA (only NR);Bacteria;Firmicutes;Clostridia;Peptostreptococcales-Tissierellales;Peptostreptococcaceae;Criibacterium;";"0.0";"0";"1";"1";"0";"1";"0";"430523";"5766"
"LOK1378_1mm";"SILVA (only NR);Bacteria;Firmicutes;Clostridia;Peptostreptococcales-Tissierellales;Peptostreptococcaceae;Filifactor;";"0.0";"0";"15";"15";"0";"15";"0";"430509";"5766"
"LOK1378_1mm";"SILVA (only NR);Bacteria;Firmicutes;Clostridia;Peptostreptococcales-Tissierellales;Peptostreptococcaceae;Intestinibacter;";"0.0";"0";"58";"58";"0";"58";"0";"430466";"5766"
"LOK1378_1mm";"SILVA (only NR);Bacteria;Firmicutes;Clostridia;Peptostreptococcales-Tissierellales;Peptostreptococcaceae;Paeniclostridium;";"0.0";"0";"44";"40";"0";"40";"4";"430484";"5766"
"LOK1378_1mm";"SILVA (only NR);Bacteria;Firmicutes;Clostridia;Peptostreptococcales-Tissierellales;Peptostreptococcaceae;Paraclostridium;";"0.0";"0";"108";"103";"0";"103";"5";"430421";"5766"
"LOK1378_1mm";"SILVA (only NR);Bacteria;Firmicutes;Clostridia;Peptostreptococcales-Tissierellales;Peptostreptococcaceae;Peptoanaerobacter;";"0.0";"0";"2";"2";"0";"2";"0";"430522";"5766"
"LOK1378_1mm";"SILVA (only NR);Bacteria;Firmicutes;Clostridia;Peptostreptococcales-Tissierellales;Peptostreptococcaceae;Peptoclostridium;";"0.0";"0";"159";"145";"0";"145";"14";"430379";"5766"
"LOK1378_1mm";"SILVA (only NR);Bacteria;Firmicutes;Clostridia;Peptostreptococcales-Tissierellales;Peptostreptococcaceae;Peptostreptococcus;";"0.0";"0";"58";"58";"0";"58";"0";"430466";"5766"
"LOK1378_1mm";"SILVA (only NR);Bacteria;Firmicutes;Clostridia;Peptostreptococcales-Tissierellales;Peptostreptococcaceae;Proteocatella;";"0.0";"0";"18";"18";"0";"18";"0";"430506";"5766"
"LOK1378_1mm";"SILVA (only NR);Bacteria;Firmicutes;Clostridia;Peptostreptococcales-Tissierellales;Peptostreptococcaceae;Romboutsia;";"0.0";"0";"311";"300";"0";"300";"11";"430224";"5766"
"LOK1378_1mm";"SILVA (only NR);Bacteria;Firmicutes;Clostridia;Peptostreptococcales-Tissierellales;Peptostreptococcaceae;Sporacetigenium;";"0.0";"0";"11";"10";"0";"10";"1";"430514";"5766"
"LOK1378_1mm";"SILVA (only NR);Bacteria;Firmicutes;Clostridia;Peptostreptococcales-Tissierellales;Peptostreptococcaceae;Tepidibacter;";"0.0";"0";"16";"16";"0";"16";"0";"430508";"5766"
"LOK1378_1mm";"SILVA (only NR);Bacteria;Firmicutes;Clostridia;Peptostreptococcales-Tissierellales;Peptostreptococcaceae;Terrisporobacter;";"0.0";"0";"110";"103";"0";"103";"7";"430421";"5766"
"LOK1378_1mm";"SILVA (only NR);Bacteria;Firmicutes;Clostridia;Peptostreptococcales-Tissierellales;Peptostreptococcaceae;[Eubacterium] tenue group;";"0.0";"0";"3";"1";"0";"1";"2";"430523";"5766"
"LOK1378_1mm";"SILVA (only NR);Bacteria;Firmicutes;Clostridia;Peptostreptococcales-Tissierellales;Peptostreptococcaceae;[Eubacterium] yurii group;";"0.0";"0";"33";"31";"0";"31";"2";"430493";"5766"
"LOK1378_1mm";"SILVA (only NR);Bacteria;Firmicutes;Clostridia;Peptostreptococcales-Tissierellales;Peptostreptococcaceae;uncultured;";"0.0";"0";"128";"118";"0";"118";"10";"430406";"5766"
"LOK1378_1mm";"SILVA (only NR);Bacteria;Firmicutes;Clostridia;Peptostreptococcales-Tissierellales;Proteiniboraceae;";"0.0";"0";"11";"11";"0";"11";"0";"430513";"5766"
"LOK1378_1mm";"SILVA (only NR);Bacteria;Firmicutes;Clostridia;Peptostreptococcales-Tissierellales;Proteiniboraceae;Proteiniborus;";"0.0";"0";"11";"11";"0";"11";"0";"430513";"5766"
"LOK1378_1mm";"SILVA (only NR);Bacteria;Firmicutes;Clostridia;Peptostreptococcales-Tissierellales;Sedimentibacteraceae;";"0.0";"0";"186";"176";"0";"176";"10";"430348";"5766"
"LOK1378_1mm";"SILVA (only NR);Bacteria;Firmicutes;Clostridia;Peptostreptococcales-Tissierellales;Sedimentibacteraceae;Sedimentibacter;";"0.0";"0";"186";"176";"0";"176";"10";"430348";"5766"
"LOK1378_1mm";"SILVA (only NR);Bacteria;Firmicutes;Clostridia;Peptostreptococcales-Tissierellales;Serpentinicella;";"0.0";"0";"15";"14";"0";"14";"1";"430510";"5766"
"LOK1378_1mm";"SILVA (only NR);Bacteria;Firmicutes;Clostridia;Peptostreptococcales-Tissierellales;Sporosalibacterium;";"0.0";"0";"8";"8";"0";"8";"0";"430516";"5766"
"LOK1378_1mm";"SILVA (only NR);Bacteria;Firmicutes;Clostridia;Peptostreptococcales-Tissierellales;Thermohalobacter;";"0.0";"0";"2";"2";"0";"2";"0";"430522";"5766"
"LOK1378_1mm";"SILVA (only NR);Bacteria;Firmicutes;Clostridia;Peptostreptococcales-Tissierellales;Thermotaleaceae;";"0.0";"0";"30";"30";"0";"30";"0";"430494";"5766"
"LOK1378_1mm";"SILVA (only NR);Bacteria;Firmicutes;Clostridia;Peptostreptococcales-Tissierellales;Thermotaleaceae;Anaerosolibacter;";"0.0";"0";"7";"7";"0";"7";"0";"430517";"5766"
"LOK1378_1mm";"SILVA (only NR);Bacteria;Firmicutes;Clostridia;Peptostreptococcales-Tissierellales;Thermotaleaceae;Crassaminicella;";"0.0";"0";"10";"10";"0";"10";"0";"430514";"5766"
"LOK1378_1mm";"SILVA (only NR);Bacteria;Firmicutes;Clostridia;Peptostreptococcales-Tissierellales;Thermotaleaceae;Geosporobacter;";"0.0";"0";"4";"4";"0";"4";"0";"430520";"5766"
"LOK1378_1mm";"SILVA (only NR);Bacteria;Firmicutes;Clostridia;Peptostreptococcales-Tissierellales;Thermotaleaceae;Salimesophilobacter;";"0.0";"0";"3";"3";"0";"3";"0";"430521";"5766"
"LOK1378_1mm";"SILVA (only NR);Bacteria;Firmicutes;Clostridia;Peptostreptococcales-Tissierellales;Thermotaleaceae;Thermotalea;";"0.0";"0";"3";"3";"0";"3";"0";"430521";"5766"
"LOK1378_1mm";"SILVA (only NR);Bacteria;Firmicutes;Clostridia;Peptostreptococcales-Tissierellales;Thermotaleaceae;uncultured;";"0.0";"0";"3";"3";"0";"3";"0";"430521";"5766"
"LOK1378_1mm";"SILVA (only NR);Bacteria;Firmicutes;Clostridia;Peptostreptococcales-Tissierellales;Tindallia;";"0.0";"0";"11";"11";"0";"11";"0";"430513";"5766"
"LOK1378_1mm";"SILVA (only NR);Bacteria;Firmicutes;Clostridia;Peptostreptococcales-Tissierellales;livecontrolB21;";"0.0";"0";"4";"4";"0";"4";"0";"430520";"5766"
"LOK1378_1mm";"SILVA (only NR);Bacteria;Firmicutes;Clostridia;Peptostreptococcales-Tissierellales;uncultured;";"0.0";"0";"36";"33";"0";"33";"3";"430491";"5766"
"LOK1378_1mm";"SILVA (only NR);Bacteria;Firmicutes;Clostridia;Proteinivoracales;";"0.0";"0";"95";"87";"0";"87";"8";"430437";"5766"
"LOK1378_1mm";"SILVA (only NR);Bacteria;Firmicutes;Clostridia;Proteinivoracales;Anaerobranca;";"0.0";"0";"21";"21";"0";"21";"0";"430503";"5766"
"LOK1378_1mm";"SILVA (only NR);Bacteria;Firmicutes;Clostridia;Proteinivoracales;Proteinivorax;";"0.0";"0";"3";"3";"0";"3";"0";"430521";"5766"
"LOK1378_1mm";"SILVA (only NR);Bacteria;Firmicutes;Clostridia;Proteinivoracales;uncultured;";"0.0";"0";"69";"61";"0";"61";"8";"430463";"5766"
"LOK1378_1mm";"SILVA (only NR);Bacteria;Firmicutes;Clostridia;Thermincolales;";"0.0";"0";"80";"79";"0";"79";"1";"430445";"5766"
"LOK1378_1mm";"SILVA (only NR);Bacteria;Firmicutes;Clostridia;Thermincolales;Thermincolaceae;";"0.0";"0";"80";"79";"0";"79";"1";"430445";"5766"
"LOK1378_1mm";"SILVA (only NR);Bacteria;Firmicutes;Clostridia;Thermincolales;Thermincolaceae;Thermincola;";"0.0";"0";"80";"79";"0";"79";"1";"430445";"5766"
"LOK1378_1mm";"SILVA (only NR);Bacteria;Firmicutes;Clostridia;uncultured;";"0.0";"0";"44";"43";"0";"43";"1";"430481";"5766"
"LOK1378_1mm";"SILVA (only NR);Bacteria;Firmicutes;D8A-2;";"0.0";"0";"165";"158";"0";"158";"7";"430366";"5766"
"LOK1378_1mm";"SILVA (only NR);Bacteria;Firmicutes;Desulfitobacteriia;";"0.0";"0";"539";"520";"0";"520";"19";"430004";"5766"
"LOK1378_1mm";"SILVA (only NR);Bacteria;Firmicutes;Desulfitobacteriia;Desulfitobacteriales;";"0.0";"0";"539";"520";"0";"520";"19";"430004";"5766"
"LOK1378_1mm";"SILVA (only NR);Bacteria;Firmicutes;Desulfitobacteriia;Desulfitobacteriales;Desulfitobacteriaceae;";"0.0";"0";"354";"338";"0";"338";"16";"430186";"5766"
"LOK1378_1mm";"SILVA (only NR);Bacteria;Firmicutes;Desulfitobacteriia;Desulfitobacteriales;Desulfitobacteriaceae;Desulfitobacterium;";"0.0";"0";"68";"65";"0";"65";"3";"430459";"5766"
"LOK1378_1mm";"SILVA (only NR);Bacteria;Firmicutes;Desulfitobacteriia;Desulfitobacteriales;Desulfitobacteriaceae;Desulfosporosinus;";"0.0";"0";"286";"273";"0";"273";"13";"430251";"5766"
"LOK1378_1mm";"SILVA (only NR);Bacteria;Firmicutes;Desulfitobacteriia;Desulfitobacteriales;Heliobacteriaceae;";"0.0";"0";"52";"50";"0";"50";"2";"430474";"5766"
"LOK1378_1mm";"SILVA (only NR);Bacteria;Firmicutes;Desulfitobacteriia;Desulfitobacteriales;Heliobacteriaceae;Candidatus Heliomonas;";"0.0";"0";"1";"1";"0";"1";"0";"430523";"5766"
"LOK1378_1mm";"SILVA (only NR);Bacteria;Firmicutes;Desulfitobacteriia;Desulfitobacteriales;Heliobacteriaceae;Heliobacillus;";"0.0";"0";"7";"7";"0";"7";"0";"430517";"5766"
"LOK1378_1mm";"SILVA (only NR);Bacteria;Firmicutes;Desulfitobacteriia;Desulfitobacteriales;Heliobacteriaceae;Heliobacterium;";"0.0";"0";"10";"10";"0";"10";"0";"430514";"5766"
"LOK1378_1mm";"SILVA (only NR);Bacteria;Firmicutes;Desulfitobacteriia;Desulfitobacteriales;Heliobacteriaceae;Heliophilum;";"0.0";"0";"3";"3";"0";"3";"0";"430521";"5766"
"LOK1378_1mm";"SILVA (only NR);Bacteria;Firmicutes;Desulfitobacteriia;Desulfitobacteriales;Heliobacteriaceae;Heliorestis;";"0.0";"0";"5";"4";"0";"4";"1";"430520";"5766"
"LOK1378_1mm";"SILVA (only NR);Bacteria;Firmicutes;Desulfitobacteriia;Desulfitobacteriales;Heliobacteriaceae;uncultured;";"0.0";"0";"23";"22";"0";"22";"1";"430502";"5766"
"LOK1378_1mm";"SILVA (only NR);Bacteria;Firmicutes;Desulfitobacteriia;Desulfitobacteriales;Syntrophobotulaceae;";"0.0";"0";"33";"33";"0";"33";"0";"430491";"5766"
"LOK1378_1mm";"SILVA (only NR);Bacteria;Firmicutes;Desulfitobacteriia;Desulfitobacteriales;Syntrophobotulaceae;Candidatus Dichloromethanomonas;";"0.0";"0";"6";"6";"0";"6";"0";"430518";"5766"
"LOK1378_1mm";"SILVA (only NR);Bacteria;Firmicutes;Desulfitobacteriia;Desulfitobacteriales;Syntrophobotulaceae;Dehalobacter;";"0.0";"0";"26";"26";"0";"26";"0";"430498";"5766"
"LOK1378_1mm";"SILVA (only NR);Bacteria;Firmicutes;Desulfitobacteriia;Desulfitobacteriales;Syntrophobotulaceae;Syntrophobotulus;";"0.0";"0";"1";"1";"0";"1";"0";"430523";"5766"
"LOK1378_1mm";"SILVA (only NR);Bacteria;Firmicutes;Desulfitobacteriia;Desulfitobacteriales;TC1;";"0.0";"0";"10";"10";"0";"10";"0";"430514";"5766"
"LOK1378_1mm";"SILVA (only NR);Bacteria;Firmicutes;Desulfitobacteriia;Desulfitobacteriales;uncultured;";"0.0";"0";"89";"88";"0";"88";"1";"430436";"5766"
"LOK1378_1mm";"SILVA (only NR);Bacteria;Firmicutes;Desulfotomaculia;";"0.0";"0";"691";"672";"0";"672";"19";"429852";"5766"
"LOK1378_1mm";"SILVA (only NR);Bacteria;Firmicutes;Desulfotomaculia;Ammonifexales;";"0.0";"0";"44";"43";"0";"43";"1";"430481";"5766"
"LOK1378_1mm";"SILVA (only NR);Bacteria;Firmicutes;Desulfotomaculia;Ammonifexales;Ammonificaceae;";"0.0";"0";"20";"20";"0";"20";"0";"430504";"5766"
"LOK1378_1mm";"SILVA (only NR);Bacteria;Firmicutes;Desulfotomaculia;Ammonifexales;Ammonificaceae;Ammonifex;";"0.0";"0";"2";"2";"0";"2";"0";"430522";"5766"
"LOK1378_1mm";"SILVA (only NR);Bacteria;Firmicutes;Desulfotomaculia;Ammonifexales;Ammonificaceae;Desulfothermobacter;";"0.0";"0";"2";"2";"0";"2";"0";"430522";"5766"
"LOK1378_1mm";"SILVA (only NR);Bacteria;Firmicutes;Desulfotomaculia;Ammonifexales;Ammonificaceae;Thermodesulfitimonas;";"0.0";"0";"7";"7";"0";"7";"0";"430517";"5766"
"LOK1378_1mm";"SILVA (only NR);Bacteria;Firmicutes;Desulfotomaculia;Ammonifexales;Ammonificaceae;uncultured;";"0.0";"0";"6";"6";"0";"6";"0";"430518";"5766"
"LOK1378_1mm";"SILVA (only NR);Bacteria;Firmicutes;Desulfotomaculia;Ammonifexales;Desulforudaceae;";"0.0";"0";"23";"22";"0";"22";"1";"430502";"5766"
"LOK1378_1mm";"SILVA (only NR);Bacteria;Firmicutes;Desulfotomaculia;Ammonifexales;Desulforudaceae;Candidatus Desulforudis;";"0.0";"0";"23";"22";"0";"22";"1";"430502";"5766"
"LOK1378_1mm";"SILVA (only NR);Bacteria;Firmicutes;Desulfotomaculia;Carboxydothermales;";"0.0";"0";"11";"10";"0";"10";"1";"430514";"5766"
"LOK1378_1mm";"SILVA (only NR);Bacteria;Firmicutes;Desulfotomaculia;Carboxydothermales;Carboxydothermaceae;";"0.0";"0";"11";"10";"0";"10";"1";"430514";"5766"
"LOK1378_1mm";"SILVA (only NR);Bacteria;Firmicutes;Desulfotomaculia;Carboxydothermales;Carboxydothermaceae;Carboxydothermus;";"0.0";"0";"11";"10";"0";"10";"1";"430514";"5766"
"LOK1378_1mm";"SILVA (only NR);Bacteria;Firmicutes;Desulfotomaculia;Desulfotomaculales;";"0.0";"0";"636";"619";"0";"619";"17";"429905";"5766"
"LOK1378_1mm";"SILVA (only NR);Bacteria;Firmicutes;Desulfotomaculia;Desulfotomaculales;Desulfotomaculaceae;";"0.0";"0";"333";"324";"0";"324";"9";"430200";"5766"
"LOK1378_1mm";"SILVA (only NR);Bacteria;Firmicutes;Desulfotomaculia;Desulfotomaculales;Desulfotomaculaceae;Desulfofarcimen;";"0.0";"0";"244";"240";"0";"240";"4";"430284";"5766"
"LOK1378_1mm";"SILVA (only NR);Bacteria;Firmicutes;Desulfotomaculia;Desulfotomaculales;Desulfotomaculaceae;Desulfohalotomaculum;";"0.0";"0";"42";"40";"0";"40";"2";"430484";"5766"
"LOK1378_1mm";"SILVA (only NR);Bacteria;Firmicutes;Desulfotomaculia;Desulfotomaculales;Desulfotomaculaceae;Desulfotomaculum;";"0.0";"0";"47";"44";"0";"44";"3";"430480";"5766"
"LOK1378_1mm";"SILVA (only NR);Bacteria;Firmicutes;Desulfotomaculia;Desulfotomaculales;Desulfotomaculales Incertae Sedis;";"0.0";"0";"71";"70";"0";"70";"1";"430454";"5766"
"LOK1378_1mm";"SILVA (only NR);Bacteria;Firmicutes;Desulfotomaculia;Desulfotomaculales;Desulfotomaculales Incertae Sedis;Desulfallas-Sporotomaculum;";"0.0";"0";"61";"60";"0";"60";"1";"430464";"5766"
"LOK1378_1mm";"SILVA (only NR);Bacteria;Firmicutes;Desulfotomaculia;Desulfotomaculales;Desulfotomaculales Incertae Sedis;uncultured;";"0.0";"0";"10";"10";"0";"10";"0";"430514";"5766"
"LOK1378_1mm";"SILVA (only NR);Bacteria;Firmicutes;Desulfotomaculia;Desulfotomaculales;Desulfurisporaceae;";"0.0";"0";"118";"111";"0";"111";"7";"430413";"5766"
"LOK1378_1mm";"SILVA (only NR);Bacteria;Firmicutes;Desulfotomaculia;Desulfotomaculales;Desulfurisporaceae;Desulfofundulus;";"0.0";"0";"37";"37";"0";"37";"0";"430487";"5766"
"LOK1378_1mm";"SILVA (only NR);Bacteria;Firmicutes;Desulfotomaculia;Desulfotomaculales;Desulfurisporaceae;Desulfurispora;";"0.0";"0";"52";"48";"0";"48";"4";"430476";"5766"
"LOK1378_1mm";"SILVA (only NR);Bacteria;Firmicutes;Desulfotomaculia;Desulfotomaculales;Desulfurisporaceae;SCADC1-2-3;";"0.0";"0";"29";"26";"0";"26";"3";"430498";"5766"
"LOK1378_1mm";"SILVA (only NR);Bacteria;Firmicutes;Desulfotomaculia;Desulfotomaculales;Pelotomaculaceae;";"0.0";"0";"114";"114";"0";"114";"0";"430410";"5766"
"LOK1378_1mm";"SILVA (only NR);Bacteria;Firmicutes;Desulfotomaculia;Desulfotomaculales;Pelotomaculaceae;Cryptanaerobacter;";"0.0";"0";"34";"34";"0";"34";"0";"430490";"5766"
"LOK1378_1mm";"SILVA (only NR);Bacteria;Firmicutes;Desulfotomaculia;Desulfotomaculales;Pelotomaculaceae;Pelotomaculum;";"0.0";"0";"66";"66";"0";"66";"0";"430458";"5766"
"LOK1378_1mm";"SILVA (only NR);Bacteria;Firmicutes;Desulfotomaculia;Desulfotomaculales;Pelotomaculaceae;uncultured;";"0.0";"0";"14";"14";"0";"14";"0";"430510";"5766"
"LOK1378_1mm";"SILVA (only NR);Bacteria;Firmicutes;Dethiobacteria;";"0.0";"0";"137";"131";"0";"131";"6";"430393";"5766"
"LOK1378_1mm";"SILVA (only NR);Bacteria;Firmicutes;Dethiobacteria;Dethiobacterales;";"0.0";"0";"137";"131";"0";"131";"6";"430393";"5766"
"LOK1378_1mm";"SILVA (only NR);Bacteria;Firmicutes;Dethiobacteria;Dethiobacterales;Dethiobacteraceae;";"0.0";"0";"137";"131";"0";"131";"6";"430393";"5766"
"LOK1378_1mm";"SILVA (only NR);Bacteria;Firmicutes;Dethiobacteria;Dethiobacterales;Dethiobacteraceae;Candidatus Contubernalis;";"0.0";"0";"8";"8";"0";"8";"0";"430516";"5766"
"LOK1378_1mm";"SILVA (only NR);Bacteria;Firmicutes;Dethiobacteria;Dethiobacterales;Dethiobacteraceae;Dethiobacter;";"0.0";"0";"61";"58";"0";"58";"3";"430466";"5766"
"LOK1378_1mm";"SILVA (only NR);Bacteria;Firmicutes;Dethiobacteria;Dethiobacterales;Dethiobacteraceae;uncultured;";"0.0";"0";"67";"64";"0";"64";"3";"430460";"5766"
"LOK1378_1mm";"SILVA (only NR);Bacteria;Firmicutes;Incertae Sedis;";"0.0";"0";"250";"247";"0";"247";"3";"430277";"5766"
"LOK1378_1mm";"SILVA (only NR);Bacteria;Firmicutes;Incertae Sedis;DTU014;";"0.0";"0";"223";"221";"0";"221";"2";"430303";"5766"
"LOK1378_1mm";"SILVA (only NR);Bacteria;Firmicutes;Incertae Sedis;Gelria;";"0.0";"0";"14";"14";"0";"14";"0";"430510";"5766"
"LOK1378_1mm";"SILVA (only NR);Bacteria;Firmicutes;Incertae Sedis;Thermolithobacterales;";"0.0";"0";"13";"12";"0";"12";"1";"430512";"5766"
"LOK1378_1mm";"SILVA (only NR);Bacteria;Firmicutes;Incertae Sedis;Thermolithobacterales;Thermolithobacteraceae;";"0.0";"0";"13";"12";"0";"12";"1";"430512";"5766"
"LOK1378_1mm";"SILVA (only NR);Bacteria;Firmicutes;Incertae Sedis;Thermolithobacterales;Thermolithobacteraceae;Thermolithobacter;";"0.0";"0";"13";"12";"0";"12";"1";"430512";"5766"
"LOK1378_1mm";"SILVA (only NR);Bacteria;Firmicutes;Limnochordia;";"0.0";"0";"460";"444";"0";"444";"16";"430080";"5766"
"LOK1378_1mm";"SILVA (only NR);Bacteria;Firmicutes;Limnochordia;B55-F-B-G02;";"0.0";"0";"7";"7";"0";"7";"0";"430517";"5766"
"LOK1378_1mm";"SILVA (only NR);Bacteria;Firmicutes;Limnochordia;Hydrogenispora;";"0.0";"0";"146";"143";"0";"143";"3";"430381";"5766"
"LOK1378_1mm";"SILVA (only NR);Bacteria;Firmicutes;Limnochordia;Limnochordales;";"0.0";"0";"92";"92";"0";"92";"0";"430432";"5766"
"LOK1378_1mm";"SILVA (only NR);Bacteria;Firmicutes;Limnochordia;Limnochordales;Limnochordaceae;";"0.0";"0";"65";"65";"0";"65";"0";"430459";"5766"
"LOK1378_1mm";"SILVA (only NR);Bacteria;Firmicutes;Limnochordia;Limnochordales;Limnochordaceae;Limnochorda;";"0.0";"0";"6";"6";"0";"6";"0";"430518";"5766"
"LOK1378_1mm";"SILVA (only NR);Bacteria;Firmicutes;Limnochordia;Limnochordales;uncultured;";"0.0";"0";"27";"27";"0";"27";"0";"430497";"5766"
"LOK1378_1mm";"SILVA (only NR);Bacteria;Firmicutes;Limnochordia;M55-D21;";"0.0";"0";"23";"22";"0";"22";"1";"430502";"5766"
"LOK1378_1mm";"SILVA (only NR);Bacteria;Firmicutes;Limnochordia;MBA03;";"0.0";"0";"157";"145";"0";"145";"12";"430379";"5766"
"LOK1378_1mm";"SILVA (only NR);Bacteria;Firmicutes;Limnochordia;uncultured;";"0.0";"0";"18";"18";"0";"18";"0";"430506";"5766"
"LOK1378_1mm";"SILVA (only NR);Bacteria;Firmicutes;Moorellia;";"0.0";"0";"87";"80";"0";"80";"7";"430444";"5766"
"LOK1378_1mm";"SILVA (only NR);Bacteria;Firmicutes;Moorellia;Calderihabitantales;";"0.0";"0";"2";"2";"0";"2";"0";"430522";"5766"
"LOK1378_1mm";"SILVA (only NR);Bacteria;Firmicutes;Moorellia;Calderihabitantales;Calderihabitantaceae;";"0.0";"0";"2";"2";"0";"2";"0";"430522";"5766"
"LOK1378_1mm";"SILVA (only NR);Bacteria;Firmicutes;Moorellia;Calderihabitantales;Calderihabitantaceae;Calderihabitans;";"0.0";"0";"1";"1";"0";"1";"0";"430523";"5766"
"LOK1378_1mm";"SILVA (only NR);Bacteria;Firmicutes;Moorellia;Desulfitibacterales;";"0.0";"0";"41";"40";"0";"40";"1";"430484";"5766"
"LOK1378_1mm";"SILVA (only NR);Bacteria;Firmicutes;Moorellia;Desulfitibacterales;Desulfitibacteraceae;";"0.0";"0";"41";"40";"0";"40";"1";"430484";"5766"
"LOK1378_1mm";"SILVA (only NR);Bacteria;Firmicutes;Moorellia;Desulfitibacterales;Desulfitibacteraceae;Desulfitibacter;";"0.0";"0";"41";"40";"0";"40";"1";"430484";"5766"
"LOK1378_1mm";"SILVA (only NR);Bacteria;Firmicutes;Moorellia;Moorellales;";"0.0";"0";"38";"32";"0";"32";"6";"430492";"5766"
"LOK1378_1mm";"SILVA (only NR);Bacteria;Firmicutes;Moorellia;Moorellales;Moorellaceae;";"0.0";"0";"38";"32";"0";"32";"6";"430492";"5766"
"LOK1378_1mm";"SILVA (only NR);Bacteria;Firmicutes;Moorellia;Moorellales;Moorellaceae;Moorella;";"0.0";"0";"38";"32";"0";"32";"6";"430492";"5766"
"LOK1378_1mm";"SILVA (only NR);Bacteria;Firmicutes;Moorellia;NRB23;";"0.0";"0";"6";"6";"0";"6";"0";"430518";"5766"
"LOK1378_1mm";"SILVA (only NR);Bacteria;Firmicutes;Natranaerobiia;";"0.0";"0";"26";"26";"0";"26";"0";"430498";"5766"
"LOK1378_1mm";"SILVA (only NR);Bacteria;Firmicutes;Natranaerobiia;Natranaerobiales;";"0.0";"0";"26";"26";"0";"26";"0";"430498";"5766"
"LOK1378_1mm";"SILVA (only NR);Bacteria;Firmicutes;Natranaerobiia;Natranaerobiales;Natranaerobiaceae;";"0.0";"0";"26";"26";"0";"26";"0";"430498";"5766"
"LOK1378_1mm";"SILVA (only NR);Bacteria;Firmicutes;Natranaerobiia;Natranaerobiales;Natranaerobiaceae;Natranaerobius;";"0.0";"0";"14";"14";"0";"14";"0";"430510";"5766"
"LOK1378_1mm";"SILVA (only NR);Bacteria;Firmicutes;Natranaerobiia;Natranaerobiales;Natranaerobiaceae;Natronovirga;";"0.0";"0";"5";"5";"0";"5";"0";"430519";"5766"
"LOK1378_1mm";"SILVA (only NR);Bacteria;Firmicutes;Natranaerobiia;Natranaerobiales;Natranaerobiaceae;uncultured;";"0.0";"0";"6";"6";"0";"6";"0";"430518";"5766"
"LOK1378_1mm";"SILVA (only NR);Bacteria;Firmicutes;Negativicutes;";"0.0";"0";"3241";"3155";"0";"3155";"86";"427369";"5766"
"LOK1378_1mm";"SILVA (only NR);Bacteria;Firmicutes;Negativicutes;Acidaminococcales;";"0.0";"0";"464";"443";"0";"443";"21";"430081";"5766"
"LOK1378_1mm";"SILVA (only NR);Bacteria;Firmicutes;Negativicutes;Acidaminococcales;Acidaminococcaceae;";"0.0";"0";"464";"443";"0";"443";"21";"430081";"5766"
"LOK1378_1mm";"SILVA (only NR);Bacteria;Firmicutes;Negativicutes;Acidaminococcales;Acidaminococcaceae;Acidaminococcus;";"0.0";"0";"31";"29";"0";"29";"2";"430495";"5766"
"LOK1378_1mm";"SILVA (only NR);Bacteria;Firmicutes;Negativicutes;Acidaminococcales;Acidaminococcaceae;Phascolarctobacterium;";"0.0";"0";"205";"192";"0";"192";"13";"430332";"5766"
"LOK1378_1mm";"SILVA (only NR);Bacteria;Firmicutes;Negativicutes;Acidaminococcales;Acidaminococcaceae;Succiniclasticum;";"0.0";"0";"165";"160";"0";"160";"5";"430364";"5766"
"LOK1378_1mm";"SILVA (only NR);Bacteria;Firmicutes;Negativicutes;Acidaminococcales;Acidaminococcaceae;Succinispira;";"0.0";"0";"5";"5";"0";"5";"0";"430519";"5766"
"LOK1378_1mm";"SILVA (only NR);Bacteria;Firmicutes;Negativicutes;Acidaminococcales;Acidaminococcaceae;uncultured;";"0.0";"0";"58";"57";"0";"57";"1";"430467";"5766"
"LOK1378_1mm";"SILVA (only NR);Bacteria;Firmicutes;Negativicutes;Veillonellales-Selenomonadales;";"0.0";"0";"2757";"2693";"0";"2693";"64";"427831";"5766"
"LOK1378_1mm";"SILVA (only NR);Bacteria;Firmicutes;Negativicutes;Veillonellales-Selenomonadales;Selenomonadaceae;";"0.0";"0";"945";"923";"0";"923";"22";"429601";"5766"
"LOK1378_1mm";"SILVA (only NR);Bacteria;Firmicutes;Negativicutes;Veillonellales-Selenomonadales;Selenomonadaceae;Anaerovibrio;";"0.0";"0";"73";"71";"0";"71";"2";"430453";"5766"
"LOK1378_1mm";"SILVA (only NR);Bacteria;Firmicutes;Negativicutes;Veillonellales-Selenomonadales;Selenomonadaceae;Centipeda;";"0.0";"0";"13";"13";"0";"13";"0";"430511";"5766"
"LOK1378_1mm";"SILVA (only NR);Bacteria;Firmicutes;Negativicutes;Veillonellales-Selenomonadales;Selenomonadaceae;Megamonas;";"0.0";"0";"67";"67";"0";"67";"0";"430457";"5766"
"LOK1378_1mm";"SILVA (only NR);Bacteria;Firmicutes;Negativicutes;Veillonellales-Selenomonadales;Selenomonadaceae;Mitsuokella;";"0.0";"0";"39";"38";"0";"38";"1";"430486";"5766"
"LOK1378_1mm";"SILVA (only NR);Bacteria;Firmicutes;Negativicutes;Veillonellales-Selenomonadales;Selenomonadaceae;Pectinatus;";"0.0";"0";"14";"14";"0";"14";"0";"430510";"5766"
"LOK1378_1mm";"SILVA (only NR);Bacteria;Firmicutes;Negativicutes;Veillonellales-Selenomonadales;Selenomonadaceae;Propionispira;";"0.0";"0";"4";"2";"0";"2";"2";"430522";"5766"
"LOK1378_1mm";"SILVA (only NR);Bacteria;Firmicutes;Negativicutes;Veillonellales-Selenomonadales;Selenomonadaceae;Quinella;";"0.0";"0";"48";"48";"0";"48";"0";"430476";"5766"
"LOK1378_1mm";"SILVA (only NR);Bacteria;Firmicutes;Negativicutes;Veillonellales-Selenomonadales;Selenomonadaceae;Schwartzia;";"0.0";"0";"9";"8";"0";"8";"1";"430516";"5766"
"LOK1378_1mm";"SILVA (only NR);Bacteria;Firmicutes;Negativicutes;Veillonellales-Selenomonadales;Selenomonadaceae;Selenomonas;";"0.0";"0";"506";"495";"0";"495";"11";"430029";"5766"
"LOK1378_1mm";"SILVA (only NR);Bacteria;Firmicutes;Negativicutes;Veillonellales-Selenomonadales;Selenomonadaceae;Veillonellaceae UCG-001;";"0.0";"0";"41";"41";"0";"41";"0";"430483";"5766"
"LOK1378_1mm";"SILVA (only NR);Bacteria;Firmicutes;Negativicutes;Veillonellales-Selenomonadales;Selenomonadaceae;Zymophilus;";"0.0";"0";"4";"4";"0";"4";"0";"430520";"5766"
"LOK1378_1mm";"SILVA (only NR);Bacteria;Firmicutes;Negativicutes;Veillonellales-Selenomonadales;Selenomonadaceae;uncultured;";"0.0";"0";"125";"120";"0";"120";"5";"430404";"5766"
"LOK1378_1mm";"SILVA (only NR);Bacteria;Firmicutes;Negativicutes;Veillonellales-Selenomonadales;Sporomusaceae;";"0.0";"0";"402";"398";"0";"398";"4";"430126";"5766"
"LOK1378_1mm";"SILVA (only NR);Bacteria;Firmicutes;Negativicutes;Veillonellales-Selenomonadales;Sporomusaceae;Acetonema;";"0.0";"0";"5";"5";"0";"5";"0";"430519";"5766"
"LOK1378_1mm";"SILVA (only NR);Bacteria;Firmicutes;Negativicutes;Veillonellales-Selenomonadales;Sporomusaceae;Anaeromusa-Anaeroarcus;";"0.0";"0";"21";"21";"0";"21";"0";"430503";"5766"
"LOK1378_1mm";"SILVA (only NR);Bacteria;Firmicutes;Negativicutes;Veillonellales-Selenomonadales;Sporomusaceae;Anaerosinus;";"0.0";"0";"12";"12";"0";"12";"0";"430512";"5766"
"LOK1378_1mm";"SILVA (only NR);Bacteria;Firmicutes;Negativicutes;Veillonellales-Selenomonadales;Sporomusaceae;Anaerospora;";"0.0";"0";"34";"34";"0";"34";"0";"430490";"5766"
"LOK1378_1mm";"SILVA (only NR);Bacteria;Firmicutes;Negativicutes;Veillonellales-Selenomonadales;Sporomusaceae;Anaerosporomusa;";"0.0";"0";"17";"17";"0";"17";"0";"430507";"5766"
"LOK1378_1mm";"SILVA (only NR);Bacteria;Firmicutes;Negativicutes;Veillonellales-Selenomonadales;Sporomusaceae;Dendrosporobacter;";"0.0";"0";"7";"7";"0";"7";"0";"430517";"5766"
"LOK1378_1mm";"SILVA (only NR);Bacteria;Firmicutes;Negativicutes;Veillonellales-Selenomonadales;Sporomusaceae;Methylomusa;";"0.0";"0";"2";"2";"0";"2";"0";"430522";"5766"
"LOK1378_1mm";"SILVA (only NR);Bacteria;Firmicutes;Negativicutes;Veillonellales-Selenomonadales;Sporomusaceae;Pelosinus;";"0.0";"0";"92";"92";"0";"92";"0";"430432";"5766"
"LOK1378_1mm";"SILVA (only NR);Bacteria;Firmicutes;Negativicutes;Veillonellales-Selenomonadales;Sporomusaceae;Propionispora;";"0.0";"0";"7";"6";"0";"6";"1";"430518";"5766"
"LOK1378_1mm";"SILVA (only NR);Bacteria;Firmicutes;Negativicutes;Veillonellales-Selenomonadales;Sporomusaceae;Sporolituus;";"0.0";"0";"2";"2";"0";"2";"0";"430522";"5766"
"LOK1378_1mm";"SILVA (only NR);Bacteria;Firmicutes;Negativicutes;Veillonellales-Selenomonadales;Sporomusaceae;Sporomusa;";"0.0";"0";"97";"96";"0";"96";"1";"430428";"5766"
"LOK1378_1mm";"SILVA (only NR);Bacteria;Firmicutes;Negativicutes;Veillonellales-Selenomonadales;Sporomusaceae;Thermosinus;";"0.0";"0";"31";"31";"0";"31";"0";"430493";"5766"
"LOK1378_1mm";"SILVA (only NR);Bacteria;Firmicutes;Negativicutes;Veillonellales-Selenomonadales;Sporomusaceae;uncultured;";"0.0";"0";"72";"70";"0";"70";"2";"430454";"5766"
"LOK1378_1mm";"SILVA (only NR);Bacteria;Firmicutes;Negativicutes;Veillonellales-Selenomonadales;Veillonellaceae;";"0.0";"0";"1376";"1339";"0";"1339";"37";"429185";"5766"
"LOK1378_1mm";"SILVA (only NR);Bacteria;Firmicutes;Negativicutes;Veillonellales-Selenomonadales;Veillonellaceae;Allisonella;";"0.0";"0";"7";"6";"0";"6";"1";"430518";"5766"
"LOK1378_1mm";"SILVA (only NR);Bacteria;Firmicutes;Negativicutes;Veillonellales-Selenomonadales;Veillonellaceae;Anaeroglobus;";"0.0";"0";"5";"5";"0";"5";"0";"430519";"5766"
"LOK1378_1mm";"SILVA (only NR);Bacteria;Firmicutes;Negativicutes;Veillonellales-Selenomonadales;Veillonellaceae;Dialister;";"0.0";"0";"401";"390";"0";"390";"11";"430134";"5766"
"LOK1378_1mm";"SILVA (only NR);Bacteria;Firmicutes;Negativicutes;Veillonellales-Selenomonadales;Veillonellaceae;Megasphaera;";"0.0";"0";"135";"128";"0";"128";"7";"430396";"5766"
"LOK1378_1mm";"SILVA (only NR);Bacteria;Firmicutes;Negativicutes;Veillonellales-Selenomonadales;Veillonellaceae;Negativicoccus;";"0.0";"0";"11";"11";"0";"11";"0";"430513";"5766"
"LOK1378_1mm";"SILVA (only NR);Bacteria;Firmicutes;Negativicutes;Veillonellales-Selenomonadales;Veillonellaceae;Veillonella;";"0.0";"0";"805";"787";"0";"787";"18";"429737";"5766"
"LOK1378_1mm";"SILVA (only NR);Bacteria;Firmicutes;Negativicutes;Veillonellales-Selenomonadales;Veillonellaceae;uncultured;";"0.0";"0";"8";"8";"0";"8";"0";"430516";"5766"
"LOK1378_1mm";"SILVA (only NR);Bacteria;Firmicutes;Negativicutes;Veillonellales-Selenomonadales;uncultured;";"0.0";"0";"33";"32";"0";"32";"1";"430492";"5766"
"LOK1378_1mm";"SILVA (only NR);Bacteria;Firmicutes;Negativicutes;uncultured;";"0.0";"0";"20";"19";"0";"19";"1";"430505";"5766"
"LOK1378_1mm";"SILVA (only NR);Bacteria;Firmicutes;Sulfobacillia;";"0.0";"0";"105";"97";"0";"97";"8";"430427";"5766"
"LOK1378_1mm";"SILVA (only NR);Bacteria;Firmicutes;Sulfobacillia;Sulfobacillales;";"0.0";"0";"105";"97";"0";"97";"8";"430427";"5766"
"LOK1378_1mm";"SILVA (only NR);Bacteria;Firmicutes;Sulfobacillia;Sulfobacillales;Sulfobacillaceae;";"0.0";"0";"105";"97";"0";"97";"8";"430427";"5766"
"LOK1378_1mm";"SILVA (only NR);Bacteria;Firmicutes;Sulfobacillia;Sulfobacillales;Sulfobacillaceae;Sulfobacillus;";"0.0";"0";"72";"67";"0";"67";"5";"430457";"5766"
"LOK1378_1mm";"SILVA (only NR);Bacteria;Firmicutes;Sulfobacillia;Sulfobacillales;Sulfobacillaceae;uncultured;";"0.0";"0";"33";"30";"0";"30";"3";"430494";"5766"
"LOK1378_1mm";"SILVA (only NR);Bacteria;Firmicutes;Symbiobacteriia;";"0.0";"0";"452";"451";"0";"451";"1";"430073";"5766"
"LOK1378_1mm";"SILVA (only NR);Bacteria;Firmicutes;Symbiobacteriia;Symbiobacteriales;";"0.0";"0";"452";"451";"0";"451";"1";"430073";"5766"
"LOK1378_1mm";"SILVA (only NR);Bacteria;Firmicutes;Symbiobacteriia;Symbiobacteriales;Caldinitratiruptor;";"0.0";"0";"3";"3";"0";"3";"0";"430521";"5766"
"LOK1378_1mm";"SILVA (only NR);Bacteria;Firmicutes;Symbiobacteriia;Symbiobacteriales;Symbiobacteraceae;";"0.0";"0";"428";"427";"0";"427";"1";"430097";"5766"
"LOK1378_1mm";"SILVA (only NR);Bacteria;Firmicutes;Symbiobacteriia;Symbiobacteriales;Symbiobacteraceae;Symbiobacterium;";"0.0";"0";"19";"19";"0";"19";"0";"430505";"5766"
"LOK1378_1mm";"SILVA (only NR);Bacteria;Firmicutes;Symbiobacteriia;Symbiobacteriales;Symbiobacteraceae;uncultured;";"0.0";"0";"409";"408";"0";"408";"1";"430116";"5766"
"LOK1378_1mm";"SILVA (only NR);Bacteria;Firmicutes;Symbiobacteriia;Symbiobacteriales;uncultured;";"0.0";"0";"20";"20";"0";"20";"0";"430504";"5766"
"LOK1378_1mm";"SILVA (only NR);Bacteria;Firmicutes;Syntrophomonadia;";"0.0";"0";"309";"275";"0";"275";"34";"430249";"5766"
"LOK1378_1mm";"SILVA (only NR);Bacteria;Firmicutes;Syntrophomonadia;Syntrophomonadales;";"0.0";"0";"309";"275";"0";"275";"34";"430249";"5766"
"LOK1378_1mm";"SILVA (only NR);Bacteria;Firmicutes;Syntrophomonadia;Syntrophomonadales;Syntrophomonadaceae;";"0.0";"0";"309";"275";"0";"275";"34";"430249";"5766"
"LOK1378_1mm";"SILVA (only NR);Bacteria;Firmicutes;Syntrophomonadia;Syntrophomonadales;Syntrophomonadaceae;Pelospora;";"0.0";"0";"22";"22";"0";"22";"0";"430502";"5766"
"LOK1378_1mm";"SILVA (only NR);Bacteria;Firmicutes;Syntrophomonadia;Syntrophomonadales;Syntrophomonadaceae;Syntrophomonas;";"0.0";"0";"177";"150";"0";"150";"27";"430374";"5766"
"LOK1378_1mm";"SILVA (only NR);Bacteria;Firmicutes;Syntrophomonadia;Syntrophomonadales;Syntrophomonadaceae;Syntrophothermus;";"0.0";"0";"6";"6";"0";"6";"0";"430518";"5766"
"LOK1378_1mm";"SILVA (only NR);Bacteria;Firmicutes;Syntrophomonadia;Syntrophomonadales;Syntrophomonadaceae;Thermosyntropha;";"0.0";"0";"9";"9";"0";"9";"0";"430515";"5766"
"LOK1378_1mm";"SILVA (only NR);Bacteria;Firmicutes;Syntrophomonadia;Syntrophomonadales;Syntrophomonadaceae;uncultured;";"0.0";"0";"91";"86";"0";"86";"5";"430438";"5766"
"LOK1378_1mm";"SILVA (only NR);Bacteria;Firmicutes;TSAC18;";"0.0";"0";"37";"37";"0";"37";"0";"430487";"5766"
"LOK1378_1mm";"SILVA (only NR);Bacteria;Firmicutes;TTA-B61;";"0.0";"0";"9";"9";"0";"9";"0";"430515";"5766"
"LOK1378_1mm";"SILVA (only NR);Bacteria;Firmicutes;Thermacetogenia;";"0.0";"0";"59";"58";"0";"58";"1";"430466";"5766"
"LOK1378_1mm";"SILVA (only NR);Bacteria;Firmicutes;Thermacetogenia;Thermacetogeniales;";"0.0";"0";"59";"58";"0";"58";"1";"430466";"5766"
"LOK1378_1mm";"SILVA (only NR);Bacteria;Firmicutes;Thermacetogenia;Thermacetogeniales;Thermacetogeniaceae;";"0.0";"0";"59";"58";"0";"58";"1";"430466";"5766"
"LOK1378_1mm";"SILVA (only NR);Bacteria;Firmicutes;Thermacetogenia;Thermacetogeniales;Thermacetogeniaceae;Syntrophaceticus;";"0.0";"0";"20";"20";"0";"20";"0";"430504";"5766"
"LOK1378_1mm";"SILVA (only NR);Bacteria;Firmicutes;Thermacetogenia;Thermacetogeniales;Thermacetogeniaceae;Thermacetogenium;";"0.0";"0";"13";"13";"0";"13";"0";"430511";"5766"
"LOK1378_1mm";"SILVA (only NR);Bacteria;Firmicutes;Thermacetogenia;Thermacetogeniales;Thermacetogeniaceae;uncultured;";"0.0";"0";"25";"24";"0";"24";"1";"430500";"5766"
"LOK1378_1mm";"SILVA (only NR);Bacteria;Firmicutes;Thermaerobacteria;";"0.0";"0";"10";"10";"0";"10";"0";"430514";"5766"
"LOK1378_1mm";"SILVA (only NR);Bacteria;Firmicutes;Thermaerobacteria;Thermaerobacterales;";"0.0";"0";"10";"10";"0";"10";"0";"430514";"5766"
"LOK1378_1mm";"SILVA (only NR);Bacteria;Firmicutes;Thermaerobacteria;Thermaerobacterales;Thermaerobacteraceae;";"0.0";"0";"10";"10";"0";"10";"0";"430514";"5766"
"LOK1378_1mm";"SILVA (only NR);Bacteria;Firmicutes;Thermaerobacteria;Thermaerobacterales;Thermaerobacteraceae;Thermaerobacter;";"0.0";"0";"10";"10";"0";"10";"0";"430514";"5766"
"LOK1378_1mm";"SILVA (only NR);Bacteria;Firmicutes;Thermincolia;";"0.0";"0";"8";"7";"0";"7";"1";"430517";"5766"
"LOK1378_1mm";"SILVA (only NR);Bacteria;Firmicutes;Thermincolia;Carboxydocellales;";"0.0";"0";"8";"7";"0";"7";"1";"430517";"5766"
"LOK1378_1mm";"SILVA (only NR);Bacteria;Firmicutes;Thermincolia;Carboxydocellales;Carboxydocellaceae;";"0.0";"0";"8";"7";"0";"7";"1";"430517";"5766"
"LOK1378_1mm";"SILVA (only NR);Bacteria;Firmicutes;Thermincolia;Carboxydocellales;Carboxydocellaceae;Carboxydocella;";"0.0";"0";"8";"7";"0";"7";"1";"430517";"5766"
"LOK1378_1mm";"SILVA (only NR);Bacteria;Firmicutes;Thermoanaerobacteria;";"0.0";"0";"431";"402";"0";"402";"29";"430122";"5766"
"LOK1378_1mm";"SILVA (only NR);Bacteria;Firmicutes;Thermoanaerobacteria;Caldicellulosiruptorales;";"0.0";"0";"174";"159";"0";"159";"15";"430365";"5766"
"LOK1378_1mm";"SILVA (only NR);Bacteria;Firmicutes;Thermoanaerobacteria;Caldicellulosiruptorales;Caldicellulosiraptoraceae;";"0.0";"0";"153";"141";"0";"141";"12";"430383";"5766"
"LOK1378_1mm";"SILVA (only NR);Bacteria;Firmicutes;Thermoanaerobacteria;Caldicellulosiruptorales;Caldicellulosiraptoraceae;Caldicellulosiruptor;";"0.0";"0";"153";"141";"0";"141";"12";"430383";"5766"
"LOK1378_1mm";"SILVA (only NR);Bacteria;Firmicutes;Thermoanaerobacteria;Caldicellulosiruptorales;uncultured;";"0.0";"0";"21";"18";"0";"18";"3";"430506";"5766"
"LOK1378_1mm";"SILVA (only NR);Bacteria;Firmicutes;Thermoanaerobacteria;Thermoanaerobacterales;";"0.0";"0";"257";"243";"0";"243";"14";"430281";"5766"
"LOK1378_1mm";"SILVA (only NR);Bacteria;Firmicutes;Thermoanaerobacteria;Thermoanaerobacterales;Family III;";"0.0";"0";"47";"46";"0";"46";"1";"430478";"5766"
"LOK1378_1mm";"SILVA (only NR);Bacteria;Firmicutes;Thermoanaerobacteria;Thermoanaerobacterales;Family III;Thermoanaerobacterium;";"0.0";"0";"47";"46";"0";"46";"1";"430478";"5766"
"LOK1378_1mm";"SILVA (only NR);Bacteria;Firmicutes;Thermoanaerobacteria;Thermoanaerobacterales;Family IV;";"0.0";"0";"6";"6";"0";"6";"0";"430518";"5766"
"LOK1378_1mm";"SILVA (only NR);Bacteria;Firmicutes;Thermoanaerobacteria;Thermoanaerobacterales;Family IV;Mahella;";"0.0";"0";"6";"6";"0";"6";"0";"430518";"5766"
"LOK1378_1mm";"SILVA (only NR);Bacteria;Firmicutes;Thermoanaerobacteria;Thermoanaerobacterales;SRB2;";"0.0";"0";"32";"31";"0";"31";"1";"430493";"5766"
"LOK1378_1mm";"SILVA (only NR);Bacteria;Firmicutes;Thermoanaerobacteria;Thermoanaerobacterales;Thermoanaerobacteraceae;";"0.0";"0";"172";"160";"0";"160";"12";"430364";"5766"
"LOK1378_1mm";"SILVA (only NR);Bacteria;Firmicutes;Thermoanaerobacteria;Thermoanaerobacterales;Thermoanaerobacteraceae;Brockia;";"0.0";"0";"3";"3";"0";"3";"0";"430521";"5766"
"LOK1378_1mm";"SILVA (only NR);Bacteria;Firmicutes;Thermoanaerobacteria;Thermoanaerobacterales;Thermoanaerobacteraceae;Caldanaerobacter;";"0.0";"0";"53";"50";"0";"50";"3";"430474";"5766"
"LOK1378_1mm";"SILVA (only NR);Bacteria;Firmicutes;Thermoanaerobacteria;Thermoanaerobacterales;Thermoanaerobacteraceae;Caldanaerobius;";"0.0";"0";"8";"7";"0";"7";"1";"430517";"5766"
"LOK1378_1mm";"SILVA (only NR);Bacteria;Firmicutes;Thermoanaerobacteria;Thermoanaerobacterales;Thermoanaerobacteraceae;Caloribacterium;";"0.0";"0";"5";"5";"0";"5";"0";"430519";"5766"
"LOK1378_1mm";"SILVA (only NR);Bacteria;Firmicutes;Thermoanaerobacteria;Thermoanaerobacterales;Thermoanaerobacteraceae;Desulfovirgula;";"0.0";"0";"1";"1";"0";"1";"0";"430523";"5766"
"LOK1378_1mm";"SILVA (only NR);Bacteria;Firmicutes;Thermoanaerobacteria;Thermoanaerobacterales;Thermoanaerobacteraceae;Thermanaeromonas;";"0.0";"0";"13";"12";"0";"12";"1";"430512";"5766"
"LOK1378_1mm";"SILVA (only NR);Bacteria;Firmicutes;Thermoanaerobacteria;Thermoanaerobacterales;Thermoanaerobacteraceae;Thermoanaerobacter;";"0.0";"0";"89";"82";"0";"82";"7";"430442";"5766"
"LOK1378_1mm";"SILVA (only NR);Bacteria;Firmicutes;Thermovenabulia;";"0.0";"0";"63";"60";"0";"60";"3";"430464";"5766"
"LOK1378_1mm";"SILVA (only NR);Bacteria;Firmicutes;Thermovenabulia;Thermovenabulales;";"0.0";"0";"63";"60";"0";"60";"3";"430464";"5766"
"LOK1378_1mm";"SILVA (only NR);Bacteria;Firmicutes;Thermovenabulia;Thermovenabulales;Caldanaerovirga;";"0.0";"0";"1";"1";"0";"1";"0";"430523";"5766"
"LOK1378_1mm";"SILVA (only NR);Bacteria;Firmicutes;Thermovenabulia;Thermovenabulales;Fervidicola;";"0.0";"0";"1";"1";"0";"1";"0";"430523";"5766"
"LOK1378_1mm";"SILVA (only NR);Bacteria;Firmicutes;Thermovenabulia;Thermovenabulales;Tepidanaerobacter;";"0.0";"0";"40";"39";"0";"39";"1";"430485";"5766"
"LOK1378_1mm";"SILVA (only NR);Bacteria;Firmicutes;Thermovenabulia;Thermovenabulales;Thermosediminibacter;";"0.0";"0";"4";"4";"0";"4";"0";"430520";"5766"
"LOK1378_1mm";"SILVA (only NR);Bacteria;Firmicutes;Thermovenabulia;Thermovenabulales;Thermovenabulum;";"0.0";"0";"6";"5";"0";"5";"1";"430519";"5766"
"LOK1378_1mm";"SILVA (only NR);Bacteria;Firmicutes;Thermovenabulia;Thermovenabulales;Thermovorax;";"0.0";"0";"1";"1";"0";"1";"0";"430523";"5766"
"LOK1378_1mm";"SILVA (only NR);Bacteria;Firmicutes;Thermovenabulia;Thermovenabulales;uncultured;";"0.0";"0";"8";"7";"0";"7";"1";"430517";"5766"
"LOK1378_1mm";"SILVA (only NR);Bacteria;Firmicutes;YNPFFP2;";"0.0";"0";"3";"3";"0";"3";"0";"430521";"5766"
"LOK1378_1mm";"SILVA (only NR);Bacteria;Firmicutes;uncultured;";"0.0";"0";"77";"76";"0";"76";"1";"430448";"5766"
"LOK1378_1mm";"SILVA (only NR);Bacteria;Fusobacteriota;";"0.0";"0";"1628";"1569";"0";"1569";"59";"428955";"5766"
"LOK1378_1mm";"SILVA (only NR);Bacteria;Fusobacteriota;Fusobacteriia;";"0.0";"0";"1628";"1569";"0";"1569";"59";"428955";"5766"
"LOK1378_1mm";"SILVA (only NR);Bacteria;Fusobacteriota;Fusobacteriia;Fusobacteriales;";"0.0";"0";"1628";"1569";"0";"1569";"59";"428955";"5766"
"LOK1378_1mm";"SILVA (only NR);Bacteria;Fusobacteriota;Fusobacteriia;Fusobacteriales;Fusobacteriaceae;";"0.0";"0";"1166";"1131";"0";"1131";"35";"429393";"5766"
"LOK1378_1mm";"SILVA (only NR);Bacteria;Fusobacteriota;Fusobacteriia;Fusobacteriales;Fusobacteriaceae;Cetobacterium;";"0.0";"0";"136";"132";"0";"132";"4";"430392";"5766"
"LOK1378_1mm";"SILVA (only NR);Bacteria;Fusobacteriota;Fusobacteriia;Fusobacteriales;Fusobacteriaceae;Fusobacterium;";"0.0";"0";"988";"960";"0";"960";"28";"429564";"5766"
"LOK1378_1mm";"SILVA (only NR);Bacteria;Fusobacteriota;Fusobacteriia;Fusobacteriales;Fusobacteriaceae;Ilyobacter;";"0.0";"0";"6";"6";"0";"6";"0";"430518";"5766"
"LOK1378_1mm";"SILVA (only NR);Bacteria;Fusobacteriota;Fusobacteriia;Fusobacteriales;Fusobacteriaceae;Propionigenium;";"0.0";"0";"15";"15";"0";"15";"0";"430509";"5766"
"LOK1378_1mm";"SILVA (only NR);Bacteria;Fusobacteriota;Fusobacteriia;Fusobacteriales;Fusobacteriaceae;Psychrilyobacter;";"0.0";"0";"20";"17";"0";"17";"3";"430507";"5766"
"LOK1378_1mm";"SILVA (only NR);Bacteria;Fusobacteriota;Fusobacteriia;Fusobacteriales;Leptotrichiaceae;";"0.0";"0";"462";"438";"0";"438";"24";"430086";"5766"
"LOK1378_1mm";"SILVA (only NR);Bacteria;Fusobacteriota;Fusobacteriia;Fusobacteriales;Leptotrichiaceae;Caviibacter;";"0.0";"0";"3";"3";"0";"3";"0";"430521";"5766"
"LOK1378_1mm";"SILVA (only NR);Bacteria;Fusobacteriota;Fusobacteriia;Fusobacteriales;Leptotrichiaceae;Hypnocyclicus;";"0.0";"0";"18";"16";"0";"16";"2";"430508";"5766"
"LOK1378_1mm";"SILVA (only NR);Bacteria;Fusobacteriota;Fusobacteriia;Fusobacteriales;Leptotrichiaceae;Leptotrichia;";"0.0";"0";"334";"314";"0";"314";"20";"430210";"5766"
"LOK1378_1mm";"SILVA (only NR);Bacteria;Fusobacteriota;Fusobacteriia;Fusobacteriales;Leptotrichiaceae;Oceanivirga;";"0.0";"0";"40";"40";"0";"40";"0";"430484";"5766"
"LOK1378_1mm";"SILVA (only NR);Bacteria;Fusobacteriota;Fusobacteriia;Fusobacteriales;Leptotrichiaceae;Sebaldella;";"0.0";"0";"4";"4";"0";"4";"0";"430520";"5766"
"LOK1378_1mm";"SILVA (only NR);Bacteria;Fusobacteriota;Fusobacteriia;Fusobacteriales;Leptotrichiaceae;Sneathia;";"0.0";"0";"9";"9";"0";"9";"0";"430515";"5766"
"LOK1378_1mm";"SILVA (only NR);Bacteria;Fusobacteriota;Fusobacteriia;Fusobacteriales;Leptotrichiaceae;Streptobacillus;";"0.0";"0";"22";"22";"0";"22";"0";"430502";"5766"
"LOK1378_1mm";"SILVA (only NR);Bacteria;Fusobacteriota;Fusobacteriia;Fusobacteriales;Leptotrichiaceae;uncultured;";"0.0";"0";"32";"30";"0";"30";"2";"430494";"5766"
"LOK1378_1mm";"SILVA (only NR);Bacteria;GAL15;";"0.0";"0";"46";"46";"0";"46";"0";"430478";"5766"
"LOK1378_1mm";"SILVA (only NR);Bacteria;GN01;";"0.0";"0";"136";"124";"0";"124";"12";"430400";"5766"
"LOK1378_1mm";"SILVA (only NR);Bacteria;Gemmatimonadota;";"0.0";"0";"2119";"2043";"0";"2043";"76";"428481";"5766"
"LOK1378_1mm";"SILVA (only NR);Bacteria;Gemmatimonadota;AKAU4049;";"0.0";"0";"9";"9";"0";"9";"0";"430515";"5766"
"LOK1378_1mm";"SILVA (only NR);Bacteria;Gemmatimonadota;BD2-11 terrestrial group;";"0.0";"0";"386";"379";"0";"379";"7";"430145";"5766"
"LOK1378_1mm";"SILVA (only NR);Bacteria;Gemmatimonadota;Gemmatimonadetes;";"0.0";"0";"1196";"1138";"0";"1138";"58";"429386";"5766"
"LOK1378_1mm";"SILVA (only NR);Bacteria;Gemmatimonadota;Gemmatimonadetes;Gemmatimonadales;";"0.0";"0";"1196";"1138";"0";"1138";"58";"429386";"5766"
"LOK1378_1mm";"SILVA (only NR);Bacteria;Gemmatimonadota;Gemmatimonadetes;Gemmatimonadales;Gemmatimonadaceae;";"0.0";"0";"1196";"1138";"0";"1138";"58";"429386";"5766"
"LOK1378_1mm";"SILVA (only NR);Bacteria;Gemmatimonadota;Gemmatimonadetes;Gemmatimonadales;Gemmatimonadaceae;Gemmatimonas;";"0.0";"0";"259";"248";"0";"248";"11";"430276";"5766"
"LOK1378_1mm";"SILVA (only NR);Bacteria;Gemmatimonadota;Gemmatimonadetes;Gemmatimonadales;Gemmatimonadaceae;Gemmatirosa;";"0.0";"0";"7";"7";"0";"7";"0";"430517";"5766"
"LOK1378_1mm";"SILVA (only NR);Bacteria;Gemmatimonadota;Gemmatimonadetes;Gemmatimonadales;Gemmatimonadaceae;Roseisolibacter;";"0.0";"0";"8";"8";"0";"8";"0";"430516";"5766"
"LOK1378_1mm";"SILVA (only NR);Bacteria;Gemmatimonadota;Gemmatimonadetes;Gemmatimonadales;Gemmatimonadaceae;uncultured;";"0.0";"0";"916";"869";"0";"869";"47";"429655";"5766"
"LOK1378_1mm";"SILVA (only NR);Bacteria;Gemmatimonadota;Longimicrobia;";"0.0";"0";"219";"214";"0";"214";"5";"430310";"5766"
"LOK1378_1mm";"SILVA (only NR);Bacteria;Gemmatimonadota;Longimicrobia;Longimicrobiales;";"0.0";"0";"219";"214";"0";"214";"5";"430310";"5766"
"LOK1378_1mm";"SILVA (only NR);Bacteria;Gemmatimonadota;Longimicrobia;Longimicrobiales;Longimicrobiaceae;";"0.0";"0";"219";"214";"0";"214";"5";"430310";"5766"
"LOK1378_1mm";"SILVA (only NR);Bacteria;Gemmatimonadota;Longimicrobia;Longimicrobiales;Longimicrobiaceae;Longimicrobium;";"0.0";"0";"15";"15";"0";"15";"0";"430509";"5766"
"LOK1378_1mm";"SILVA (only NR);Bacteria;Gemmatimonadota;Longimicrobia;Longimicrobiales;Longimicrobiaceae;YC-ZSS-LKJ147;";"0.0";"0";"38";"36";"0";"36";"2";"430488";"5766"
"LOK1378_1mm";"SILVA (only NR);Bacteria;Gemmatimonadota;MD2902-B12;";"0.0";"0";"19";"19";"0";"19";"0";"430505";"5766"
"LOK1378_1mm";"SILVA (only NR);Bacteria;Gemmatimonadota;PAUC43f marine benthic group;";"0.0";"0";"98";"95";"0";"95";"3";"430429";"5766"
"LOK1378_1mm";"SILVA (only NR);Bacteria;Gemmatimonadota;S0134 terrestrial group;";"0.0";"0";"192";"189";"0";"189";"3";"430335";"5766"
"LOK1378_1mm";"SILVA (only NR);Bacteria;Halanaerobiaeota;";"0.0";"0";"244";"241";"0";"241";"3";"430283";"5766"
"LOK1378_1mm";"SILVA (only NR);Bacteria;Halanaerobiaeota;Halanaerobiia;";"0.0";"0";"244";"241";"0";"241";"3";"430283";"5766"
"LOK1378_1mm";"SILVA (only NR);Bacteria;Halanaerobiaeota;Halanaerobiia;Halanaerobiales;";"0.0";"0";"244";"241";"0";"241";"3";"430283";"5766"
"LOK1378_1mm";"SILVA (only NR);Bacteria;Halanaerobiaeota;Halanaerobiia;Halanaerobiales;Halanaerobiaceae;";"0.0";"0";"169";"167";"0";"167";"2";"430357";"5766"
"LOK1378_1mm";"SILVA (only NR);Bacteria;Halanaerobiaeota;Halanaerobiia;Halanaerobiales;Halanaerobiaceae;Halanaerobium;";"0.0";"0";"131";"129";"0";"129";"2";"430395";"5766"
"LOK1378_1mm";"SILVA (only NR);Bacteria;Halanaerobiaeota;Halanaerobiia;Halanaerobiales;Halanaerobiaceae;Halarsenatibacter;";"0.0";"0";"12";"12";"0";"12";"0";"430512";"5766"
"LOK1378_1mm";"SILVA (only NR);Bacteria;Halanaerobiaeota;Halanaerobiia;Halanaerobiales;Halanaerobiaceae;Halocella;";"0.0";"0";"23";"23";"0";"23";"0";"430501";"5766"
"LOK1378_1mm";"SILVA (only NR);Bacteria;Halanaerobiaeota;Halanaerobiia;Halanaerobiales;Halanaerobiaceae;Halothermothrix;";"0.0";"0";"3";"3";"0";"3";"0";"430521";"5766"
"LOK1378_1mm";"SILVA (only NR);Bacteria;Halanaerobiaeota;Halanaerobiia;Halanaerobiales;Halobacteroidaceae;";"0.0";"0";"75";"74";"0";"74";"1";"430450";"5766"
"LOK1378_1mm";"SILVA (only NR);Bacteria;Halanaerobiaeota;Halanaerobiia;Halanaerobiales;Halobacteroidaceae;Acetohalobium;";"0.0";"0";"3";"3";"0";"3";"0";"430521";"5766"
"LOK1378_1mm";"SILVA (only NR);Bacteria;Halanaerobiaeota;Halanaerobiia;Halanaerobiales;Halobacteroidaceae;Fuchsiella;";"0.0";"0";"3";"3";"0";"3";"0";"430521";"5766"
"LOK1378_1mm";"SILVA (only NR);Bacteria;Halanaerobiaeota;Halanaerobiia;Halanaerobiales;Halobacteroidaceae;Halanaerobacter;";"0.0";"0";"10";"10";"0";"10";"0";"430514";"5766"
"LOK1378_1mm";"SILVA (only NR);Bacteria;Halanaerobiaeota;Halanaerobiia;Halanaerobiales;Halobacteroidaceae;Halanaerobaculum;";"0.0";"0";"2";"2";"0";"2";"0";"430522";"5766"
"LOK1378_1mm";"SILVA (only NR);Bacteria;Halanaerobiaeota;Halanaerobiia;Halanaerobiales;Halobacteroidaceae;Halobacteroides;";"0.0";"0";"5";"5";"0";"5";"0";"430519";"5766"
"LOK1378_1mm";"SILVA (only NR);Bacteria;Halanaerobiaeota;Halanaerobiia;Halanaerobiales;Halobacteroidaceae;Halonatronum;";"0.0";"0";"3";"3";"0";"3";"0";"430521";"5766"
"LOK1378_1mm";"SILVA (only NR);Bacteria;Halanaerobiaeota;Halanaerobiia;Halanaerobiales;Halobacteroidaceae;Natroniella;";"0.0";"0";"4";"4";"0";"4";"0";"430520";"5766"
"LOK1378_1mm";"SILVA (only NR);Bacteria;Halanaerobiaeota;Halanaerobiia;Halanaerobiales;Halobacteroidaceae;Orenia;";"0.0";"0";"19";"18";"0";"18";"1";"430506";"5766"
"LOK1378_1mm";"SILVA (only NR);Bacteria;Halanaerobiaeota;Halanaerobiia;Halanaerobiales;Halobacteroidaceae;Selenihalanaerobacter;";"0.0";"0";"1";"1";"0";"1";"0";"430523";"5766"
"LOK1378_1mm";"SILVA (only NR);Bacteria;Halanaerobiaeota;Halanaerobiia;Halanaerobiales;Halobacteroidaceae;Sporohalobacter;";"0.0";"0";"4";"4";"0";"4";"0";"430520";"5766"
"LOK1378_1mm";"SILVA (only NR);Bacteria;Halanaerobiaeota;Halanaerobiia;Halanaerobiales;Halobacteroidaceae;uncultured;";"0.0";"0";"19";"19";"0";"19";"0";"430505";"5766"
"LOK1378_1mm";"SILVA (only NR);Bacteria;Hydrogenedentes;";"0.0";"0";"263";"257";"0";"257";"6";"430267";"5766"
"LOK1378_1mm";"SILVA (only NR);Bacteria;Hydrogenedentes;Hydrogenedentia;";"0.0";"0";"263";"257";"0";"257";"6";"430267";"5766"
"LOK1378_1mm";"SILVA (only NR);Bacteria;Hydrogenedentes;Hydrogenedentia;Hydrogenedentiales;";"0.0";"0";"263";"257";"0";"257";"6";"430267";"5766"
"LOK1378_1mm";"SILVA (only NR);Bacteria;Hydrogenedentes;Hydrogenedentia;Hydrogenedentiales;Hydrogenedensaceae;";"0.0";"0";"263";"257";"0";"257";"6";"430267";"5766"
"LOK1378_1mm";"SILVA (only NR);Bacteria;Hydrogenedentes;Hydrogenedentia;Hydrogenedentiales;Hydrogenedensaceae;Candidatus Hydrogenedens;";"0.0";"0";"3";"3";"0";"3";"0";"430521";"5766"
"LOK1378_1mm";"SILVA (only NR);Bacteria;Hydrogenedentes;Hydrogenedentia;Hydrogenedentiales;Hydrogenedensaceae;YC-ZSS-LKJ63;";"0.0";"0";"24";"22";"0";"22";"2";"430502";"5766"
"LOK1378_1mm";"SILVA (only NR);Bacteria;Hydrothermae;";"0.0";"0";"39";"34";"0";"34";"5";"430490";"5766"
"LOK1378_1mm";"SILVA (only NR);Bacteria;LCP-89;";"0.0";"0";"48";"48";"0";"48";"0";"430476";"5766"
"LOK1378_1mm";"SILVA (only NR);Bacteria;Latescibacterota;";"0.0";"0";"505";"480";"0";"480";"25";"430044";"5766"
"LOK1378_1mm";"SILVA (only NR);Bacteria;Latescibacterota;Latescibacteria;";"0.0";"0";"184";"178";"0";"178";"6";"430346";"5766"
"LOK1378_1mm";"SILVA (only NR);Bacteria;Latescibacterota;Latescibacteria;Latescibacterales;";"0.0";"0";"184";"178";"0";"178";"6";"430346";"5766"
"LOK1378_1mm";"SILVA (only NR);Bacteria;Latescibacterota;Latescibacteria;Latescibacterales;Latescibacteraceae;";"0.0";"0";"184";"178";"0";"178";"6";"430346";"5766"
"LOK1378_1mm";"SILVA (only NR);Bacteria;Latescibacterota;Latescibacteria;Latescibacterales;Latescibacteraceae;Candidatus Latescibacter;";"0.0";"0";"55";"50";"0";"50";"5";"430474";"5766"
"LOK1378_1mm";"SILVA (only NR);Bacteria;MAT-CR-M4-B07;";"0.0";"0";"28";"26";"0";"26";"2";"430498";"5766"
"LOK1378_1mm";"SILVA (only NR);Bacteria;MBNT15;";"0.0";"0";"160";"154";"0";"154";"6";"430370";"5766"
"LOK1378_1mm";"SILVA (only NR);Bacteria;Margulisbacteria;";"0.0";"0";"87";"84";"0";"84";"3";"430440";"5766"
"LOK1378_1mm";"SILVA (only NR);Bacteria;Marinimicrobia (SAR406 clade);";"0.0";"0";"664";"650";"0";"650";"14";"429874";"5766"
"LOK1378_1mm";"SILVA (only NR);Bacteria;Methylomirabilota;";"0.0";"0";"370";"357";"0";"357";"13";"430167";"5766"
"LOK1378_1mm";"SILVA (only NR);Bacteria;Methylomirabilota;Methylomirabilia;";"0.0";"0";"370";"357";"0";"357";"13";"430167";"5766"
"LOK1378_1mm";"SILVA (only NR);Bacteria;Methylomirabilota;Methylomirabilia;Methylomirabilales;";"0.0";"0";"108";"104";"0";"104";"4";"430420";"5766"
"LOK1378_1mm";"SILVA (only NR);Bacteria;Methylomirabilota;Methylomirabilia;Methylomirabilales;Methylomirabilaceae;";"0.0";"0";"108";"104";"0";"104";"4";"430420";"5766"
"LOK1378_1mm";"SILVA (only NR);Bacteria;Methylomirabilota;Methylomirabilia;Methylomirabilales;Methylomirabilaceae;Candidatus Methylomirabilis;";"0.0";"0";"25";"25";"0";"25";"0";"430499";"5766"
"LOK1378_1mm";"SILVA (only NR);Bacteria;Methylomirabilota;Methylomirabilia;Methylomirabilales;Methylomirabilaceae;MIZ14;";"0.0";"0";"2";"2";"0";"2";"0";"430522";"5766"
"LOK1378_1mm";"SILVA (only NR);Bacteria;Methylomirabilota;Methylomirabilia;Methylomirabilales;Methylomirabilaceae;MIZ17;";"0.0";"0";"7";"7";"0";"7";"0";"430517";"5766"
"LOK1378_1mm";"SILVA (only NR);Bacteria;Methylomirabilota;Methylomirabilia;Methylomirabilales;Methylomirabilaceae;Sh765B-TzT-35;";"0.0";"0";"32";"31";"0";"31";"1";"430493";"5766"
"LOK1378_1mm";"SILVA (only NR);Bacteria;Methylomirabilota;Methylomirabilia;Methylomirabilales;Methylomirabilaceae;Z114MB74;";"0.0";"0";"5";"4";"0";"4";"1";"430520";"5766"
"LOK1378_1mm";"SILVA (only NR);Bacteria;Methylomirabilota;Methylomirabilia;Methylomirabilales;Methylomirabilaceae;wb1-A12;";"0.0";"0";"37";"35";"0";"35";"2";"430489";"5766"
"LOK1378_1mm";"SILVA (only NR);Bacteria;Methylomirabilota;Methylomirabilia;Rokubacteriales;";"0.0";"0";"262";"253";"0";"253";"9";"430271";"5766"
"LOK1378_1mm";"SILVA (only NR);Bacteria;Methylomirabilota;Methylomirabilia;Rokubacteriales;WX65;";"0.0";"0";"21";"21";"0";"21";"0";"430503";"5766"
"LOK1378_1mm";"SILVA (only NR);Bacteria;Modulibacteria;";"0.0";"0";"248";"229";"0";"229";"19";"430295";"5766"
"LOK1378_1mm";"SILVA (only NR);Bacteria;Modulibacteria;Moduliflexia;";"0.0";"0";"248";"229";"0";"229";"19";"430295";"5766"
"LOK1378_1mm";"SILVA (only NR);Bacteria;Modulibacteria;Moduliflexia;Moduliflexales;";"0.0";"0";"248";"229";"0";"229";"19";"430295";"5766"
"LOK1378_1mm";"SILVA (only NR);Bacteria;Modulibacteria;Moduliflexia;Moduliflexales;Moduliflexaceae;";"0.0";"0";"248";"229";"0";"229";"19";"430295";"5766"
"LOK1378_1mm";"SILVA (only NR);Bacteria;Modulibacteria;Moduliflexia;Moduliflexales;Moduliflexaceae;Candidatus Moduliflexus;";"0.0";"0";"3";"3";"0";"3";"0";"430521";"5766"
"LOK1378_1mm";"SILVA (only NR);Bacteria;Myxococcota;";"0.0";"0";"3013";"2864";"0";"2864";"149";"427660";"5766"
"LOK1378_1mm";"SILVA (only NR);Bacteria;Myxococcota;Myxococcia;";"0.0";"0";"731";"680";"0";"680";"51";"429844";"5766"
"LOK1378_1mm";"SILVA (only NR);Bacteria;Myxococcota;Myxococcia;Myxococcales;";"0.0";"0";"731";"680";"0";"680";"51";"429844";"5766"
"LOK1378_1mm";"SILVA (only NR);Bacteria;Myxococcota;Myxococcia;Myxococcales;27F-1492R;";"0.0";"0";"11";"10";"0";"10";"1";"430514";"5766"
"LOK1378_1mm";"SILVA (only NR);Bacteria;Myxococcota;Myxococcia;Myxococcales;Anaeromyxobacteraceae;";"0.0";"0";"110";"104";"0";"104";"6";"430420";"5766"
"LOK1378_1mm";"SILVA (only NR);Bacteria;Myxococcota;Myxococcia;Myxococcales;Anaeromyxobacteraceae;Anaeromyxobacter;";"0.0";"0";"110";"104";"0";"104";"6";"430420";"5766"
"LOK1378_1mm";"SILVA (only NR);Bacteria;Myxococcota;Myxococcia;Myxococcales;Myxococcaceae;";"0.0";"0";"591";"547";"0";"547";"44";"429977";"5766"
"LOK1378_1mm";"SILVA (only NR);Bacteria;Myxococcota;Myxococcia;Myxococcales;Myxococcaceae;Aggregicoccus;";"0.0";"0";"2";"2";"0";"2";"0";"430522";"5766"
"LOK1378_1mm";"SILVA (only NR);Bacteria;Myxococcota;Myxococcia;Myxococcales;Myxococcaceae;Angiococcus;";"0.0";"0";"5";"5";"0";"5";"0";"430519";"5766"
"LOK1378_1mm";"SILVA (only NR);Bacteria;Myxococcota;Myxococcia;Myxococcales;Myxococcaceae;Archangium;";"0.0";"0";"18";"18";"0";"18";"0";"430506";"5766"
"LOK1378_1mm";"SILVA (only NR);Bacteria;Myxococcota;Myxococcia;Myxococcales;Myxococcaceae;Corallococcus;";"0.0";"0";"66";"56";"0";"56";"10";"430468";"5766"
"LOK1378_1mm";"SILVA (only NR);Bacteria;Myxococcota;Myxococcia;Myxococcales;Myxococcaceae;Cystobacter;";"0.0";"0";"18";"18";"0";"18";"0";"430506";"5766"
"LOK1378_1mm";"SILVA (only NR);Bacteria;Myxococcota;Myxococcia;Myxococcales;Myxococcaceae;Hyalangium;";"0.0";"0";"1";"1";"0";"1";"0";"430523";"5766"
"LOK1378_1mm";"SILVA (only NR);Bacteria;Myxococcota;Myxococcia;Myxococcales;Myxococcaceae;KD3-10;";"0.0";"0";"23";"19";"0";"19";"4";"430505";"5766"
"LOK1378_1mm";"SILVA (only NR);Bacteria;Myxococcota;Myxococcia;Myxococcales;Myxococcaceae;Melittangium;";"0.0";"0";"7";"7";"0";"7";"0";"430517";"5766"
"LOK1378_1mm";"SILVA (only NR);Bacteria;Myxococcota;Myxococcia;Myxococcales;Myxococcaceae;Myxococcus;";"0.0";"0";"101";"94";"0";"94";"7";"430430";"5766"
"LOK1378_1mm";"SILVA (only NR);Bacteria;Myxococcota;Myxococcia;Myxococcales;Myxococcaceae;P3OB-42;";"0.0";"0";"268";"250";"0";"250";"18";"430274";"5766"
"LOK1378_1mm";"SILVA (only NR);Bacteria;Myxococcota;Myxococcia;Myxococcales;Myxococcaceae;Pyxidicoccus;";"0.0";"0";"4";"4";"0";"4";"0";"430520";"5766"
"LOK1378_1mm";"SILVA (only NR);Bacteria;Myxococcota;Myxococcia;Myxococcales;Myxococcaceae;Stigmatella;";"0.0";"0";"13";"13";"0";"13";"0";"430511";"5766"
"LOK1378_1mm";"SILVA (only NR);Bacteria;Myxococcota;Myxococcia;Myxococcales;Myxococcaceae;Vitiosangium;";"0.0";"0";"2";"2";"0";"2";"0";"430522";"5766"
"LOK1378_1mm";"SILVA (only NR);Bacteria;Myxococcota;Myxococcia;Myxococcales;Myxococcaceae;uncultured;";"0.0";"0";"52";"47";"0";"47";"5";"430477";"5766"
"LOK1378_1mm";"SILVA (only NR);Bacteria;Myxococcota;Myxococcia;Myxococcales;Vulgatibacteraceae;";"0.0";"0";"19";"19";"0";"19";"0";"430505";"5766"
"LOK1378_1mm";"SILVA (only NR);Bacteria;Myxococcota;Myxococcia;Myxococcales;Vulgatibacteraceae;Vulgatibacter;";"0.0";"0";"19";"19";"0";"19";"0";"430505";"5766"
"LOK1378_1mm";"SILVA (only NR);Bacteria;Myxococcota;Polyangia;";"0.0";"0";"1911";"1832";"0";"1832";"79";"428692";"5766"
"LOK1378_1mm";"SILVA (only NR);Bacteria;Myxococcota;Polyangia;Blfdi19;";"0.0";"0";"63";"61";"0";"61";"2";"430463";"5766"
"LOK1378_1mm";"SILVA (only NR);Bacteria;Myxococcota;Polyangia;FFCH16767;";"0.0";"0";"3";"2";"0";"2";"1";"430522";"5766"
"LOK1378_1mm";"SILVA (only NR);Bacteria;Myxococcota;Polyangia;Haliangiales;";"0.0";"0";"560";"539";"0";"539";"21";"429985";"5766"
"LOK1378_1mm";"SILVA (only NR);Bacteria;Myxococcota;Polyangia;Haliangiales;Haliangiaceae;";"0.0";"0";"560";"539";"0";"539";"21";"429985";"5766"
"LOK1378_1mm";"SILVA (only NR);Bacteria;Myxococcota;Polyangia;Haliangiales;Haliangiaceae;Haliangium;";"0.0";"0";"560";"539";"0";"539";"21";"429985";"5766"
"LOK1378_1mm";"SILVA (only NR);Bacteria;Myxococcota;Polyangia;MSB-4B10;";"0.0";"0";"15";"14";"0";"14";"1";"430510";"5766"
"LOK1378_1mm";"SILVA (only NR);Bacteria;Myxococcota;Polyangia;MidBa8;";"0.0";"0";"63";"58";"0";"58";"5";"430466";"5766"
"LOK1378_1mm";"SILVA (only NR);Bacteria;Myxococcota;Polyangia;Nannocystales;";"0.0";"0";"123";"120";"0";"120";"3";"430404";"5766"
"LOK1378_1mm";"SILVA (only NR);Bacteria;Myxococcota;Polyangia;Nannocystales;Nannocystaceae;";"0.0";"0";"123";"120";"0";"120";"3";"430404";"5766"
"LOK1378_1mm";"SILVA (only NR);Bacteria;Myxococcota;Polyangia;Nannocystales;Nannocystaceae;Enhygromyxa;";"0.0";"0";"7";"7";"0";"7";"0";"430517";"5766"
"LOK1378_1mm";"SILVA (only NR);Bacteria;Myxococcota;Polyangia;Nannocystales;Nannocystaceae;Nannocystis;";"0.0";"0";"58";"56";"0";"56";"2";"430468";"5766"
"LOK1378_1mm";"SILVA (only NR);Bacteria;Myxococcota;Polyangia;Nannocystales;Nannocystaceae;Plesiocystis;";"0.0";"0";"5";"5";"0";"5";"0";"430519";"5766"
"LOK1378_1mm";"SILVA (only NR);Bacteria;Myxococcota;Polyangia;Nannocystales;Nannocystaceae;Pseudenhygromyxa;";"0.0";"0";"7";"7";"0";"7";"0";"430517";"5766"
"LOK1378_1mm";"SILVA (only NR);Bacteria;Myxococcota;Polyangia;Nannocystales;Nannocystaceae;uncultured;";"0.0";"0";"37";"36";"0";"36";"1";"430488";"5766"
"LOK1378_1mm";"SILVA (only NR);Bacteria;Myxococcota;Polyangia;PS-B29;";"0.0";"0";"25";"23";"0";"23";"2";"430501";"5766"
"LOK1378_1mm";"SILVA (only NR);Bacteria;Myxococcota;Polyangia;Polyangiales;";"0.0";"0";"907";"874";"0";"874";"33";"429650";"5766"
"LOK1378_1mm";"SILVA (only NR);Bacteria;Myxococcota;Polyangia;Polyangiales;Amb-16S-1034;";"0.0";"0";"3";"3";"0";"3";"0";"430521";"5766"
"LOK1378_1mm";"SILVA (only NR);Bacteria;Myxococcota;Polyangia;Polyangiales;BIrii41;";"0.0";"0";"171";"160";"0";"160";"11";"430364";"5766"
"LOK1378_1mm";"SILVA (only NR);Bacteria;Myxococcota;Polyangia;Polyangiales;Eel-36e1D6;";"0.0";"0";"17";"17";"0";"17";"0";"430507";"5766"
"LOK1378_1mm";"SILVA (only NR);Bacteria;Myxococcota;Polyangia;Polyangiales;Phaselicystidaceae;";"0.0";"0";"102";"102";"0";"102";"0";"430422";"5766"
"LOK1378_1mm";"SILVA (only NR);Bacteria;Myxococcota;Polyangia;Polyangiales;Phaselicystidaceae;Phaselicystis;";"0.0";"0";"102";"102";"0";"102";"0";"430422";"5766"
"LOK1378_1mm";"SILVA (only NR);Bacteria;Myxococcota;Polyangia;Polyangiales;Polyangiaceae;";"0.0";"0";"293";"279";"0";"279";"14";"430245";"5766"
"LOK1378_1mm";"SILVA (only NR);Bacteria;Myxococcota;Polyangia;Polyangiales;Polyangiaceae;Aetherobacter;";"0.0";"0";"8";"8";"0";"8";"0";"430516";"5766"
"LOK1378_1mm";"SILVA (only NR);Bacteria;Myxococcota;Polyangia;Polyangiales;Polyangiaceae;Byssovorax;";"0.0";"0";"2";"2";"0";"2";"0";"430522";"5766"
"LOK1378_1mm";"SILVA (only NR);Bacteria;Myxococcota;Polyangia;Polyangiales;Polyangiaceae;Chondromyces;";"0.0";"0";"7";"7";"0";"7";"0";"430517";"5766"
"LOK1378_1mm";"SILVA (only NR);Bacteria;Myxococcota;Polyangia;Polyangiales;Polyangiaceae;Jahnella;";"0.0";"0";"3";"3";"0";"3";"0";"430521";"5766"
"LOK1378_1mm";"SILVA (only NR);Bacteria;Myxococcota;Polyangia;Polyangiales;Polyangiaceae;Labilithrix;";"0.0";"0";"7";"7";"0";"7";"0";"430517";"5766"
"LOK1378_1mm";"SILVA (only NR);Bacteria;Myxococcota;Polyangia;Polyangiales;Polyangiaceae;Minicystis;";"0.0";"0";"10";"9";"0";"9";"1";"430515";"5766"
"LOK1378_1mm";"SILVA (only NR);Bacteria;Myxococcota;Polyangia;Polyangiales;Polyangiaceae;Pajaroellobacter;";"0.0";"0";"128";"120";"0";"120";"8";"430404";"5766"
"LOK1378_1mm";"SILVA (only NR);Bacteria;Myxococcota;Polyangia;Polyangiales;Polyangiaceae;Polyangium;";"0.0";"0";"24";"23";"0";"23";"1";"430501";"5766"
"LOK1378_1mm";"SILVA (only NR);Bacteria;Myxococcota;Polyangia;Polyangiales;Polyangiaceae;Sorangium;";"0.0";"0";"68";"66";"0";"66";"2";"430458";"5766"
"LOK1378_1mm";"SILVA (only NR);Bacteria;Myxococcota;Polyangia;Polyangiales;Polyangiaceae;uncultured;";"0.0";"0";"31";"29";"0";"29";"2";"430495";"5766"
"LOK1378_1mm";"SILVA (only NR);Bacteria;Myxococcota;Polyangia;Polyangiales;Sandaracinaceae;";"0.0";"0";"318";"310";"0";"310";"8";"430214";"5766"
"LOK1378_1mm";"SILVA (only NR);Bacteria;Myxococcota;Polyangia;Polyangiales;Sandaracinaceae;Sandaracinus;";"0.0";"0";"45";"45";"0";"45";"0";"430479";"5766"
"LOK1378_1mm";"SILVA (only NR);Bacteria;Myxococcota;Polyangia;Polyangiales;Sandaracinaceae;uncultured;";"0.0";"0";"273";"265";"0";"265";"8";"430259";"5766"
"LOK1378_1mm";"SILVA (only NR);Bacteria;Myxococcota;Polyangia;Polyangiales;uncultured;";"0.0";"0";"3";"3";"0";"3";"0";"430521";"5766"
"LOK1378_1mm";"SILVA (only NR);Bacteria;Myxococcota;Polyangia;UASB-TL25;";"0.0";"0";"49";"42";"0";"42";"7";"430482";"5766"
"LOK1378_1mm";"SILVA (only NR);Bacteria;Myxococcota;Polyangia;VHS-B3-70;";"0.0";"0";"29";"28";"0";"28";"1";"430496";"5766"
"LOK1378_1mm";"SILVA (only NR);Bacteria;Myxococcota;Polyangia;VHS-B4-70;";"0.0";"0";"12";"12";"0";"12";"0";"430512";"5766"
"LOK1378_1mm";"SILVA (only NR);Bacteria;Myxococcota;Polyangia;mle1-27;";"0.0";"0";"60";"57";"0";"57";"3";"430467";"5766"
"LOK1378_1mm";"SILVA (only NR);Bacteria;Myxococcota;bacteriap25;";"0.0";"0";"371";"352";"0";"352";"19";"430172";"5766"
"LOK1378_1mm";"SILVA (only NR);Bacteria;NB1-j;";"0.0";"0";"484";"473";"0";"473";"11";"430051";"5766"
"LOK1378_1mm";"SILVA (only NR);Bacteria;NKB15;";"0.0";"0";"51";"44";"0";"44";"7";"430480";"5766"
"LOK1378_1mm";"SILVA (only NR);Bacteria;Nitrospinota;";"0.0";"0";"311";"303";"0";"303";"8";"430221";"5766"
"LOK1378_1mm";"SILVA (only NR);Bacteria;Nitrospinota;MT5B39;";"0.0";"0";"7";"7";"0";"7";"0";"430517";"5766"
"LOK1378_1mm";"SILVA (only NR);Bacteria;Nitrospinota;Nitrospinia;";"0.0";"0";"235";"228";"0";"228";"7";"430296";"5766"
"LOK1378_1mm";"SILVA (only NR);Bacteria;Nitrospinota;Nitrospinia;Nitrospinales;";"0.0";"0";"235";"228";"0";"228";"7";"430296";"5766"
"LOK1378_1mm";"SILVA (only NR);Bacteria;Nitrospinota;Nitrospinia;Nitrospinales;Nitrospinaceae;";"0.0";"0";"235";"228";"0";"228";"7";"430296";"5766"
"LOK1378_1mm";"SILVA (only NR);Bacteria;Nitrospinota;Nitrospinia;Nitrospinales;Nitrospinaceae;LS-NOB;";"0.0";"0";"84";"83";"0";"83";"1";"430441";"5766"
"LOK1378_1mm";"SILVA (only NR);Bacteria;Nitrospinota;Nitrospinia;Nitrospinales;Nitrospinaceae;Nitrospina;";"0.0";"0";"139";"135";"0";"135";"4";"430389";"5766"
"LOK1378_1mm";"SILVA (only NR);Bacteria;Nitrospinota;Nitrospinia;Nitrospinales;Nitrospinaceae;uncultured;";"0.0";"0";"12";"10";"0";"10";"2";"430514";"5766"
"LOK1378_1mm";"SILVA (only NR);Bacteria;Nitrospinota;P9X2b3D02;";"0.0";"0";"68";"67";"0";"67";"1";"430457";"5766"
"LOK1378_1mm";"SILVA (only NR);Bacteria;Nitrospirota;";"0.0";"0";"1246";"1194";"0";"1194";"52";"429330";"5766"
"LOK1378_1mm";"SILVA (only NR);Bacteria;Nitrospirota;4-29-1;";"0.0";"0";"65";"62";"0";"62";"3";"430462";"5766"
"LOK1378_1mm";"SILVA (only NR);Bacteria;Nitrospirota;661256;";"0.0";"0";"2";"2";"0";"2";"0";"430522";"5766"
"LOK1378_1mm";"SILVA (only NR);Bacteria;Nitrospirota;BMS9AB35;";"0.0";"0";"26";"25";"0";"25";"1";"430499";"5766"
"LOK1378_1mm";"SILVA (only NR);Bacteria;Nitrospirota;HDB-SIOI1093;";"0.0";"0";"4";"4";"0";"4";"0";"430520";"5766"
"LOK1378_1mm";"SILVA (only NR);Bacteria;Nitrospirota;Leptospirillia;";"0.0";"0";"177";"160";"0";"160";"17";"430364";"5766"
"LOK1378_1mm";"SILVA (only NR);Bacteria;Nitrospirota;Leptospirillia;Leptospirillales;";"0.0";"0";"177";"160";"0";"160";"17";"430364";"5766"
"LOK1378_1mm";"SILVA (only NR);Bacteria;Nitrospirota;Leptospirillia;Leptospirillales;Leptospirillaceae;";"0.0";"0";"177";"160";"0";"160";"17";"430364";"5766"
"LOK1378_1mm";"SILVA (only NR);Bacteria;Nitrospirota;Leptospirillia;Leptospirillales;Leptospirillaceae;Leptospirillum;";"0.0";"0";"177";"160";"0";"160";"17";"430364";"5766"
"LOK1378_1mm";"SILVA (only NR);Bacteria;Nitrospirota;Nitrospiria;";"0.0";"0";"539";"523";"0";"523";"16";"430001";"5766"
"LOK1378_1mm";"SILVA (only NR);Bacteria;Nitrospirota;Nitrospiria;Nitrospirales;";"0.0";"0";"539";"523";"0";"523";"16";"430001";"5766"
"LOK1378_1mm";"SILVA (only NR);Bacteria;Nitrospirota;Nitrospiria;Nitrospirales;Nitrospiraceae;";"0.0";"0";"539";"523";"0";"523";"16";"430001";"5766"
"LOK1378_1mm";"SILVA (only NR);Bacteria;Nitrospirota;Nitrospiria;Nitrospirales;Nitrospiraceae;Nitrospira;";"0.0";"0";"539";"523";"0";"523";"16";"430001";"5766"
"LOK1378_1mm";"SILVA (only NR);Bacteria;Nitrospirota;Thermodesulfovibrionia;";"0.0";"0";"433";"418";"0";"418";"15";"430106";"5766"
"LOK1378_1mm";"SILVA (only NR);Bacteria;Nitrospirota;Thermodesulfovibrionia;Magnetobacteriales;";"0.0";"0";"11";"11";"0";"11";"0";"430513";"5766"
"LOK1378_1mm";"SILVA (only NR);Bacteria;Nitrospirota;Thermodesulfovibrionia;Magnetobacteriales;Magnetobacteriaceae;";"0.0";"0";"11";"11";"0";"11";"0";"430513";"5766"
"LOK1378_1mm";"SILVA (only NR);Bacteria;Nitrospirota;Thermodesulfovibrionia;Magnetobacteriales;Magnetobacteriaceae;Candidatus Magnetobacterium;";"0.0";"0";"6";"6";"0";"6";"0";"430518";"5766"
"LOK1378_1mm";"SILVA (only NR);Bacteria;Nitrospirota;Thermodesulfovibrionia;Magnetobacteriales;Magnetobacteriaceae;Candidatus Magnetoovum;";"0.0";"0";"5";"5";"0";"5";"0";"430519";"5766"
"LOK1378_1mm";"SILVA (only NR);Bacteria;Nitrospirota;Thermodesulfovibrionia;Thermodesulfovibrionales;";"0.0";"0";"59";"55";"0";"55";"4";"430469";"5766"
"LOK1378_1mm";"SILVA (only NR);Bacteria;Nitrospirota;Thermodesulfovibrionia;Thermodesulfovibrionales;Thermodesulfovibrionaceae;";"0.0";"0";"59";"55";"0";"55";"4";"430469";"5766"
"LOK1378_1mm";"SILVA (only NR);Bacteria;Nitrospirota;Thermodesulfovibrionia;Thermodesulfovibrionales;Thermodesulfovibrionaceae;Thermodesulfovibrio;";"0.0";"0";"59";"55";"0";"55";"4";"430469";"5766"
"LOK1378_1mm";"SILVA (only NR);Bacteria;Nitrospirota;Thermodesulfovibrionia;uncultured;";"0.0";"0";"363";"352";"0";"352";"11";"430172";"5766"
"LOK1378_1mm";"SILVA (only NR);Bacteria;PAUC34f;";"0.0";"0";"93";"93";"0";"93";"0";"430431";"5766"
"LOK1378_1mm";"SILVA (only NR);Bacteria;Patescibacteria;";"0.0";"0";"4543";"4374";"0";"4374";"169";"426150";"5766"
"LOK1378_1mm";"SILVA (only NR);Bacteria;Patescibacteria;ABY1;";"0.0";"0";"402";"387";"0";"387";"15";"430137";"5766"
"LOK1378_1mm";"SILVA (only NR);Bacteria;Patescibacteria;ABY1;Candidatus Buchananbacteria;";"0.0";"0";"15";"15";"0";"15";"0";"430509";"5766"
"LOK1378_1mm";"SILVA (only NR);Bacteria;Patescibacteria;ABY1;Candidatus Falkowbacteria;";"0.0";"0";"84";"80";"0";"80";"4";"430444";"5766"
"LOK1378_1mm";"SILVA (only NR);Bacteria;Patescibacteria;ABY1;Candidatus Jacksonbacteria;";"0.0";"0";"6";"6";"0";"6";"0";"430518";"5766"
"LOK1378_1mm";"SILVA (only NR);Bacteria;Patescibacteria;ABY1;Candidatus Kerfeldbacteria;";"0.0";"0";"71";"68";"0";"68";"3";"430456";"5766"
"LOK1378_1mm";"SILVA (only NR);Bacteria;Patescibacteria;ABY1;Candidatus Komeilibacteria;";"0.0";"0";"29";"27";"0";"27";"2";"430497";"5766"
"LOK1378_1mm";"SILVA (only NR);Bacteria;Patescibacteria;ABY1;Candidatus Kuenenbacteria;";"0.0";"0";"35";"34";"0";"34";"1";"430490";"5766"
"LOK1378_1mm";"SILVA (only NR);Bacteria;Patescibacteria;ABY1;Candidatus Magasanikbacteria;";"0.0";"0";"107";"103";"0";"103";"4";"430421";"5766"
"LOK1378_1mm";"SILVA (only NR);Bacteria;Patescibacteria;ABY1;Candidatus Uhrbacteria;";"0.0";"0";"55";"54";"0";"54";"1";"430470";"5766"
"LOK1378_1mm";"SILVA (only NR);Bacteria;Patescibacteria;Berkelbacteria;";"0.0";"0";"59";"58";"0";"58";"1";"430466";"5766"
"LOK1378_1mm";"SILVA (only NR);Bacteria;Patescibacteria;CPR2;";"0.0";"0";"19";"19";"0";"19";"0";"430505";"5766"
"LOK1378_1mm";"SILVA (only NR);Bacteria;Patescibacteria;Dojkabacteria;";"0.0";"0";"166";"160";"0";"160";"6";"430364";"5766"
"LOK1378_1mm";"SILVA (only NR);Bacteria;Patescibacteria;Gracilibacteria;";"0.0";"0";"876";"851";"0";"851";"25";"429673";"5766"
"LOK1378_1mm";"SILVA (only NR);Bacteria;Patescibacteria;Gracilibacteria;Absconditabacteriales (SR1);";"0.0";"0";"217";"209";"0";"209";"8";"430315";"5766"
"LOK1378_1mm";"SILVA (only NR);Bacteria;Patescibacteria;Gracilibacteria;Candidatus Abawacabacteria;";"0.0";"0";"15";"14";"0";"14";"1";"430510";"5766"
"LOK1378_1mm";"SILVA (only NR);Bacteria;Patescibacteria;Gracilibacteria;Candidatus Peregrinibacteria;";"0.0";"0";"132";"132";"0";"132";"0";"430392";"5766"
"LOK1378_1mm";"SILVA (only NR);Bacteria;Patescibacteria;Gracilibacteria;Candidatus Peribacteria;";"0.0";"0";"93";"89";"0";"89";"4";"430435";"5766"
"LOK1378_1mm";"SILVA (only NR);Bacteria;Patescibacteria;Gracilibacteria;JGI 0000069-P22;";"0.0";"0";"163";"157";"0";"157";"6";"430367";"5766"
"LOK1378_1mm";"SILVA (only NR);Bacteria;Patescibacteria;Kazania;";"0.0";"0";"16";"16";"0";"16";"0";"430508";"5766"
"LOK1378_1mm";"SILVA (only NR);Bacteria;Patescibacteria;MD2896-B216;";"0.0";"0";"4";"4";"0";"4";"0";"430520";"5766"
"LOK1378_1mm";"SILVA (only NR);Bacteria;Patescibacteria;Microgenomatia;";"0.0";"0";"832";"783";"0";"783";"49";"429741";"5766"
"LOK1378_1mm";"SILVA (only NR);Bacteria;Patescibacteria;Microgenomatia;Candidatus Amesbacteria;";"0.0";"0";"11";"11";"0";"11";"0";"430513";"5766"
"LOK1378_1mm";"SILVA (only NR);Bacteria;Patescibacteria;Microgenomatia;Candidatus Beckwithbacteria;";"0.0";"0";"20";"19";"0";"19";"1";"430505";"5766"
"LOK1378_1mm";"SILVA (only NR);Bacteria;Patescibacteria;Microgenomatia;Candidatus Chisholmbacteria;";"0.0";"0";"16";"16";"0";"16";"0";"430508";"5766"
"LOK1378_1mm";"SILVA (only NR);Bacteria;Patescibacteria;Microgenomatia;Candidatus Collierbacteria;";"0.0";"0";"50";"47";"0";"47";"3";"430477";"5766"
"LOK1378_1mm";"SILVA (only NR);Bacteria;Patescibacteria;Microgenomatia;Candidatus Curtissbacteria;";"0.0";"0";"20";"19";"0";"19";"1";"430505";"5766"
"LOK1378_1mm";"SILVA (only NR);Bacteria;Patescibacteria;Microgenomatia;Candidatus Daviesbacteria;";"0.0";"0";"46";"44";"0";"44";"2";"430480";"5766"
"LOK1378_1mm";"SILVA (only NR);Bacteria;Patescibacteria;Microgenomatia;Candidatus Gottesmanbacteria;";"0.0";"0";"46";"39";"0";"39";"7";"430485";"5766"
"LOK1378_1mm";"SILVA (only NR);Bacteria;Patescibacteria;Microgenomatia;Candidatus Levybacteria;";"0.0";"0";"72";"68";"0";"68";"4";"430456";"5766"
"LOK1378_1mm";"SILVA (only NR);Bacteria;Patescibacteria;Microgenomatia;Candidatus Pacebacteria;";"0.0";"0";"134";"129";"0";"129";"5";"430395";"5766"
"LOK1378_1mm";"SILVA (only NR);Bacteria;Patescibacteria;Microgenomatia;Candidatus Roizmanbacteria;";"0.0";"0";"161";"158";"0";"158";"3";"430366";"5766"
"LOK1378_1mm";"SILVA (only NR);Bacteria;Patescibacteria;Microgenomatia;Candidatus Shapirobacteria;";"0.0";"0";"65";"64";"0";"64";"1";"430460";"5766"
"LOK1378_1mm";"SILVA (only NR);Bacteria;Patescibacteria;Microgenomatia;Candidatus Woesebacteria;";"0.0";"0";"133";"115";"0";"115";"18";"430409";"5766"
"LOK1378_1mm";"SILVA (only NR);Bacteria;Patescibacteria;Microgenomatia;Candidatus Woykebacteria;";"0.0";"0";"27";"26";"0";"26";"1";"430498";"5766"
"LOK1378_1mm";"SILVA (only NR);Bacteria;Patescibacteria;Parcubacteria;";"0.0";"0";"853";"836";"0";"836";"17";"429688";"5766"
"LOK1378_1mm";"SILVA (only NR);Bacteria;Patescibacteria;Parcubacteria;32-520;";"0.0";"0";"23";"23";"0";"23";"0";"430501";"5766"
"LOK1378_1mm";"SILVA (only NR);Bacteria;Patescibacteria;Parcubacteria;CG1-02-40-25;";"0.0";"0";"4";"4";"0";"4";"0";"430520";"5766"
"LOK1378_1mm";"SILVA (only NR);Bacteria;Patescibacteria;Parcubacteria;CG1-02-42-13;";"0.0";"0";"12";"12";"0";"12";"0";"430512";"5766"
"LOK1378_1mm";"SILVA (only NR);Bacteria;Patescibacteria;Parcubacteria;Candidatus Adlerbacteria;";"0.0";"0";"35";"35";"0";"35";"0";"430489";"5766"
"LOK1378_1mm";"SILVA (only NR);Bacteria;Patescibacteria;Parcubacteria;Candidatus Azambacteria;";"0.0";"0";"26";"25";"0";"25";"1";"430499";"5766"
"LOK1378_1mm";"SILVA (only NR);Bacteria;Patescibacteria;Parcubacteria;Candidatus Brennerbacteria;";"0.0";"0";"4";"3";"0";"3";"1";"430521";"5766"
"LOK1378_1mm";"SILVA (only NR);Bacteria;Patescibacteria;Parcubacteria;Candidatus Campbellbacteria;";"0.0";"0";"30";"29";"0";"29";"1";"430495";"5766"
"LOK1378_1mm";"SILVA (only NR);Bacteria;Patescibacteria;Parcubacteria;Candidatus Colwellbacteria;";"0.0";"0";"6";"6";"0";"6";"0";"430518";"5766"
"LOK1378_1mm";"SILVA (only NR);Bacteria;Patescibacteria;Parcubacteria;Candidatus Doudnabacteria;";"0.0";"0";"2";"2";"0";"2";"0";"430522";"5766"
"LOK1378_1mm";"SILVA (only NR);Bacteria;Patescibacteria;Parcubacteria;Candidatus Giovannonibacteria;";"0.0";"0";"4";"4";"0";"4";"0";"430520";"5766"
"LOK1378_1mm";"SILVA (only NR);Bacteria;Patescibacteria;Parcubacteria;Candidatus Jorgensenbacteria;";"0.0";"0";"10";"10";"0";"10";"0";"430514";"5766"
"LOK1378_1mm";"SILVA (only NR);Bacteria;Patescibacteria;Parcubacteria;Candidatus Kaiserbacteria;";"0.0";"0";"192";"189";"0";"189";"3";"430335";"5766"
"LOK1378_1mm";"SILVA (only NR);Bacteria;Patescibacteria;Parcubacteria;Candidatus Liptonbacteria;";"0.0";"0";"3";"3";"0";"3";"0";"430521";"5766"
"LOK1378_1mm";"SILVA (only NR);Bacteria;Patescibacteria;Parcubacteria;Candidatus Lloydbacteria;";"0.0";"0";"8";"7";"0";"7";"1";"430517";"5766"
"LOK1378_1mm";"SILVA (only NR);Bacteria;Patescibacteria;Parcubacteria;Candidatus Moranbacteria;";"0.0";"0";"45";"44";"0";"44";"1";"430480";"5766"
"LOK1378_1mm";"SILVA (only NR);Bacteria;Patescibacteria;Parcubacteria;Candidatus Nealsonbacteria;";"0.0";"0";"6";"6";"0";"6";"0";"430518";"5766"
"LOK1378_1mm";"SILVA (only NR);Bacteria;Patescibacteria;Parcubacteria;Candidatus Nomurabacteria;";"0.0";"0";"55";"55";"0";"55";"0";"430469";"5766"
"LOK1378_1mm";"SILVA (only NR);Bacteria;Patescibacteria;Parcubacteria;Candidatus Portnoybacteria;";"0.0";"0";"16";"15";"0";"15";"1";"430509";"5766"
"LOK1378_1mm";"SILVA (only NR);Bacteria;Patescibacteria;Parcubacteria;Candidatus Ryanbacteria;";"0.0";"0";"3";"3";"0";"3";"0";"430521";"5766"
"LOK1378_1mm";"SILVA (only NR);Bacteria;Patescibacteria;Parcubacteria;Candidatus Spechtbacteria;";"0.0";"0";"5";"5";"0";"5";"0";"430519";"5766"
"LOK1378_1mm";"SILVA (only NR);Bacteria;Patescibacteria;Parcubacteria;Candidatus Staskawiczbacteria;";"0.0";"0";"11";"10";"0";"10";"1";"430514";"5766"
"LOK1378_1mm";"SILVA (only NR);Bacteria;Patescibacteria;Parcubacteria;Candidatus Terrybacteria;";"0.0";"0";"5";"5";"0";"5";"0";"430519";"5766"
"LOK1378_1mm";"SILVA (only NR);Bacteria;Patescibacteria;Parcubacteria;Candidatus Vogelbacteria;";"0.0";"0";"16";"15";"0";"15";"1";"430509";"5766"
"LOK1378_1mm";"SILVA (only NR);Bacteria;Patescibacteria;Parcubacteria;Candidatus Wolfebacteria;";"0.0";"0";"15";"14";"0";"14";"1";"430510";"5766"
"LOK1378_1mm";"SILVA (only NR);Bacteria;Patescibacteria;Parcubacteria;Candidatus Yanofskybacteria;";"0.0";"0";"42";"41";"0";"41";"1";"430483";"5766"
"LOK1378_1mm";"SILVA (only NR);Bacteria;Patescibacteria;Parcubacteria;Candidatus Yonathbacteria;";"0.0";"0";"4";"4";"0";"4";"0";"430520";"5766"
"LOK1378_1mm";"SILVA (only NR);Bacteria;Patescibacteria;Parcubacteria;Candidatus Zambryskibacteria;";"0.0";"0";"11";"11";"0";"11";"0";"430513";"5766"
"LOK1378_1mm";"SILVA (only NR);Bacteria;Patescibacteria;Parcubacteria;GW2011-GWA2-46-7;";"0.0";"0";"29";"29";"0";"29";"0";"430495";"5766"
"LOK1378_1mm";"SILVA (only NR);Bacteria;Patescibacteria;Parcubacteria;GWA2-38-13b;";"0.0";"0";"45";"45";"0";"45";"0";"430479";"5766"
"LOK1378_1mm";"SILVA (only NR);Bacteria;Patescibacteria;Parcubacteria;GWB1-42-6;";"0.0";"0";"8";"8";"0";"8";"0";"430516";"5766"
"LOK1378_1mm";"SILVA (only NR);Bacteria;Patescibacteria;Parcubacteria;Paceibacterales;";"0.0";"0";"11";"11";"0";"11";"0";"430513";"5766"
"LOK1378_1mm";"SILVA (only NR);Bacteria;Patescibacteria;Parcubacteria;Paceibacterales;Paceibacteraceae;";"0.0";"0";"11";"11";"0";"11";"0";"430513";"5766"
"LOK1378_1mm";"SILVA (only NR);Bacteria;Patescibacteria;Parcubacteria;Paceibacterales;Paceibacteraceae;Candidatus Paceibacter;";"0.0";"0";"11";"11";"0";"11";"0";"430513";"5766"
"LOK1378_1mm";"SILVA (only NR);Bacteria;Patescibacteria;Parcubacteria;UBA9983;";"0.0";"0";"8";"8";"0";"8";"0";"430516";"5766"
"LOK1378_1mm";"SILVA (only NR);Bacteria;Patescibacteria;Saccharimonadia;";"0.0";"0";"1217";"1168";"0";"1168";"49";"429356";"5766"
"LOK1378_1mm";"SILVA (only NR);Bacteria;Patescibacteria;Saccharimonadia;Saccharimonadales;";"0.0";"0";"1217";"1168";"0";"1168";"49";"429356";"5766"
"LOK1378_1mm";"SILVA (only NR);Bacteria;Patescibacteria;Saccharimonadia;Saccharimonadales;LWQ8;";"0.0";"0";"81";"77";"0";"77";"4";"430447";"5766"
"LOK1378_1mm";"SILVA (only NR);Bacteria;Patescibacteria;Saccharimonadia;Saccharimonadales;Saccharimonadaceae;";"0.0";"0";"310";"297";"0";"297";"13";"430227";"5766"
"LOK1378_1mm";"SILVA (only NR);Bacteria;Patescibacteria;Saccharimonadia;Saccharimonadales;Saccharimonadaceae;Candidatus Saccharimonas;";"0.0";"0";"110";"104";"0";"104";"6";"430420";"5766"
"LOK1378_1mm";"SILVA (only NR);Bacteria;Patescibacteria;Saccharimonadia;Saccharimonadales;Saccharimonadaceae;GTL1;";"0.0";"0";"1";"1";"0";"1";"0";"430523";"5766"
"LOK1378_1mm";"SILVA (only NR);Bacteria;Patescibacteria;Saccharimonadia;Saccharimonadales;Saccharimonadaceae;TM7a;";"0.0";"0";"79";"78";"0";"78";"1";"430446";"5766"
"LOK1378_1mm";"SILVA (only NR);Bacteria;Patescibacteria;Saccharimonadia;Saccharimonadales;Saccharimonadaceae;TM7x;";"0.0";"0";"62";"59";"0";"59";"3";"430465";"5766"
"LOK1378_1mm";"SILVA (only NR);Bacteria;Patescibacteria;Saccharimonadia;Saccharimonadales;WWH38;";"0.0";"0";"33";"32";"0";"32";"1";"430492";"5766"
"LOK1378_1mm";"SILVA (only NR);Bacteria;Patescibacteria;Saccharimonadia;Saccharimonadales;YM_S32_TM7_50_20;";"0.0";"0";"21";"18";"0";"18";"3";"430506";"5766"
"LOK1378_1mm";"SILVA (only NR);Bacteria;Patescibacteria;WWE3;";"0.0";"0";"87";"81";"0";"81";"6";"430443";"5766"
"LOK1378_1mm";"SILVA (only NR);Bacteria;Patescibacteria;uncultured;";"0.0";"0";"12";"11";"0";"11";"1";"430513";"5766"
"LOK1378_1mm";"SILVA (only NR);Bacteria;Planctomycetota;";"0.0";"0";"8657";"8297";"0";"8297";"360";"422227";"5766"
"LOK1378_1mm";"SILVA (only NR);Bacteria;Planctomycetota;028H05-P-BN-P5;";"0.0";"0";"9";"9";"0";"9";"0";"430515";"5766"
"LOK1378_1mm";"SILVA (only NR);Bacteria;Planctomycetota;BD7-11;";"0.0";"0";"79";"78";"0";"78";"1";"430446";"5766"
"LOK1378_1mm";"SILVA (only NR);Bacteria;Planctomycetota;Brocadiae;";"0.0";"0";"143";"137";"0";"137";"6";"430387";"5766"
"LOK1378_1mm";"SILVA (only NR);Bacteria;Planctomycetota;Brocadiae;Brocadiales;";"0.0";"0";"140";"134";"0";"134";"6";"430390";"5766"
"LOK1378_1mm";"SILVA (only NR);Bacteria;Planctomycetota;Brocadiae;Brocadiales;Brocadiaceae;";"0.0";"0";"74";"70";"0";"70";"4";"430454";"5766"
"LOK1378_1mm";"SILVA (only NR);Bacteria;Planctomycetota;Brocadiae;Brocadiales;Brocadiaceae;Candidatus Anammoxoglobus;";"0.0";"0";"3";"2";"0";"2";"1";"430522";"5766"
"LOK1378_1mm";"SILVA (only NR);Bacteria;Planctomycetota;Brocadiae;Brocadiales;Brocadiaceae;Candidatus Brocadia;";"0.0";"0";"32";"30";"0";"30";"2";"430494";"5766"
"LOK1378_1mm";"SILVA (only NR);Bacteria;Planctomycetota;Brocadiae;Brocadiales;Brocadiaceae;Candidatus Jettenia;";"0.0";"0";"16";"16";"0";"16";"0";"430508";"5766"
"LOK1378_1mm";"SILVA (only NR);Bacteria;Planctomycetota;Brocadiae;Brocadiales;Brocadiaceae;Candidatus Kuenenia;";"0.0";"0";"15";"14";"0";"14";"1";"430510";"5766"
"LOK1378_1mm";"SILVA (only NR);Bacteria;Planctomycetota;Brocadiae;Brocadiales;Brocadiaceae;uncultured;";"0.0";"0";"7";"7";"0";"7";"0";"430517";"5766"
"LOK1378_1mm";"SILVA (only NR);Bacteria;Planctomycetota;Brocadiae;Brocadiales;GWA2-50-13;";"0.0";"0";"11";"11";"0";"11";"0";"430513";"5766"
"LOK1378_1mm";"SILVA (only NR);Bacteria;Planctomycetota;Brocadiae;Brocadiales;Scalinduaceae;";"0.0";"0";"54";"52";"0";"52";"2";"430472";"5766"
"LOK1378_1mm";"SILVA (only NR);Bacteria;Planctomycetota;Brocadiae;Brocadiales;Scalinduaceae;Candidatus Scalindua;";"0.0";"0";"54";"52";"0";"52";"2";"430472";"5766"
"LOK1378_1mm";"SILVA (only NR);Bacteria;Planctomycetota;Brocadiae;SM23-32;";"0.0";"0";"3";"3";"0";"3";"0";"430521";"5766"
"LOK1378_1mm";"SILVA (only NR);Bacteria;Planctomycetota;ODP123;";"0.0";"0";"20";"20";"0";"20";"0";"430504";"5766"
"LOK1378_1mm";"SILVA (only NR);Bacteria;Planctomycetota;OM190;";"0.0";"0";"418";"410";"0";"410";"8";"430114";"5766"
"LOK1378_1mm";"SILVA (only NR);Bacteria;Planctomycetota;Phycisphaerae;";"0.0";"0";"2484";"2390";"0";"2390";"94";"428134";"5766"
"LOK1378_1mm";"SILVA (only NR);Bacteria;Planctomycetota;Phycisphaerae;Amsterdam-1B-07;";"0.0";"0";"5";"5";"0";"5";"0";"430519";"5766"
"LOK1378_1mm";"SILVA (only NR);Bacteria;Planctomycetota;Phycisphaerae;B103G10;";"0.0";"0";"2";"2";"0";"2";"0";"430522";"5766"
"LOK1378_1mm";"SILVA (only NR);Bacteria;Planctomycetota;Phycisphaerae;C86;";"0.0";"0";"15";"15";"0";"15";"0";"430509";"5766"
"LOK1378_1mm";"SILVA (only NR);Bacteria;Planctomycetota;Phycisphaerae;CCM11a;";"0.0";"0";"112";"111";"0";"111";"1";"430413";"5766"
"LOK1378_1mm";"SILVA (only NR);Bacteria;Planctomycetota;Phycisphaerae;DG-20;";"0.0";"0";"16";"15";"0";"15";"1";"430509";"5766"
"LOK1378_1mm";"SILVA (only NR);Bacteria;Planctomycetota;Phycisphaerae;MSBL9;";"0.0";"0";"823";"794";"0";"794";"29";"429730";"5766"
"LOK1378_1mm";"SILVA (only NR);Bacteria;Planctomycetota;Phycisphaerae;MSBL9;4572-13;";"0.0";"0";"18";"17";"0";"17";"1";"430507";"5766"
"LOK1378_1mm";"SILVA (only NR);Bacteria;Planctomycetota;Phycisphaerae;MSBL9;GWC2-45-44;";"0.0";"0";"9";"9";"0";"9";"0";"430515";"5766"
"LOK1378_1mm";"SILVA (only NR);Bacteria;Planctomycetota;Phycisphaerae;MSBL9;KCLunmb-38-53;";"0.0";"0";"18";"18";"0";"18";"0";"430506";"5766"
"LOK1378_1mm";"SILVA (only NR);Bacteria;Planctomycetota;Phycisphaerae;MSBL9;L21-RPul-D3;";"0.0";"0";"20";"19";"0";"19";"1";"430505";"5766"
"LOK1378_1mm";"SILVA (only NR);Bacteria;Planctomycetota;Phycisphaerae;MSBL9;SG8-4;";"0.0";"0";"668";"647";"0";"647";"21";"429877";"5766"
"LOK1378_1mm";"SILVA (only NR);Bacteria;Planctomycetota;Phycisphaerae;MSBL9;SM23-30;";"0.0";"0";"41";"40";"0";"40";"1";"430484";"5766"
"LOK1378_1mm";"SILVA (only NR);Bacteria;Planctomycetota;Phycisphaerae;MSBL9;ST-NAGAB-D1;";"0.0";"0";"45";"41";"0";"41";"4";"430483";"5766"
"LOK1378_1mm";"SILVA (only NR);Bacteria;Planctomycetota;Phycisphaerae;Phycisphaerales;";"0.0";"0";"971";"934";"0";"934";"37";"429590";"5766"
"LOK1378_1mm";"SILVA (only NR);Bacteria;Planctomycetota;Phycisphaerae;Phycisphaerales;AKAU3564 sediment group;";"0.0";"0";"274";"259";"0";"259";"15";"430265";"5766"
"LOK1378_1mm";"SILVA (only NR);Bacteria;Planctomycetota;Phycisphaerae;Phycisphaerales;Phycisphaeraceae;";"0.0";"0";"697";"675";"0";"675";"22";"429849";"5766"
"LOK1378_1mm";"SILVA (only NR);Bacteria;Planctomycetota;Phycisphaerae;Phycisphaerales;Phycisphaeraceae;AKYG587;";"0.0";"0";"42";"42";"0";"42";"0";"430482";"5766"
"LOK1378_1mm";"SILVA (only NR);Bacteria;Planctomycetota;Phycisphaerae;Phycisphaerales;Phycisphaeraceae;Algisphaera;";"0.0";"0";"8";"8";"0";"8";"0";"430516";"5766"
"LOK1378_1mm";"SILVA (only NR);Bacteria;Planctomycetota;Phycisphaerae;Phycisphaerales;Phycisphaeraceae;CL500-3;";"0.0";"0";"47";"46";"0";"46";"1";"430478";"5766"
"LOK1378_1mm";"SILVA (only NR);Bacteria;Planctomycetota;Phycisphaerae;Phycisphaerales;Phycisphaeraceae;FS140-16B-02 marine group;";"0.0";"0";"17";"17";"0";"17";"0";"430507";"5766"
"LOK1378_1mm";"SILVA (only NR);Bacteria;Planctomycetota;Phycisphaerae;Phycisphaerales;Phycisphaeraceae;I-8;";"0.0";"0";"12";"11";"0";"11";"1";"430513";"5766"
"LOK1378_1mm";"SILVA (only NR);Bacteria;Planctomycetota;Phycisphaerae;Phycisphaerales;Phycisphaeraceae;JL-ETNP-F27;";"0.0";"0";"28";"28";"0";"28";"0";"430496";"5766"
"LOK1378_1mm";"SILVA (only NR);Bacteria;Planctomycetota;Phycisphaerae;Phycisphaerales;Phycisphaeraceae;Phycisphaera;";"0.0";"0";"19";"19";"0";"19";"0";"430505";"5766"
"LOK1378_1mm";"SILVA (only NR);Bacteria;Planctomycetota;Phycisphaerae;Phycisphaerales;Phycisphaeraceae;SM1A02;";"0.0";"0";"283";"274";"0";"274";"9";"430250";"5766"
"LOK1378_1mm";"SILVA (only NR);Bacteria;Planctomycetota;Phycisphaerae;Phycisphaerales;Phycisphaeraceae;Urania-1B-19 marine sediment group;";"0.0";"0";"65";"64";"0";"64";"1";"430460";"5766"
"LOK1378_1mm";"SILVA (only NR);Bacteria;Planctomycetota;Phycisphaerae;Phycisphaerales;Phycisphaeraceae;Z195MB87;";"0.0";"0";"4";"4";"0";"4";"0";"430520";"5766"
"LOK1378_1mm";"SILVA (only NR);Bacteria;Planctomycetota;Phycisphaerae;Phycisphaerales;Phycisphaeraceae;uncultured;";"0.0";"0";"168";"159";"0";"159";"9";"430365";"5766"
"LOK1378_1mm";"SILVA (only NR);Bacteria;Planctomycetota;Phycisphaerae;Pla1 lineage;";"0.0";"0";"70";"64";"0";"64";"6";"430460";"5766"
"LOK1378_1mm";"SILVA (only NR);Bacteria;Planctomycetota;Phycisphaerae;S-70;";"0.0";"0";"30";"30";"0";"30";"0";"430494";"5766"
"LOK1378_1mm";"SILVA (only NR);Bacteria;Planctomycetota;Phycisphaerae;Tepidisphaerales;";"0.0";"0";"333";"319";"0";"319";"14";"430205";"5766"
"LOK1378_1mm";"SILVA (only NR);Bacteria;Planctomycetota;Phycisphaerae;Tepidisphaerales;CPla-3 termite group;";"0.0";"0";"16";"15";"0";"15";"1";"430509";"5766"
"LOK1378_1mm";"SILVA (only NR);Bacteria;Planctomycetota;Phycisphaerae;Tepidisphaerales;Tepidisphaeraceae;";"0.0";"0";"24";"23";"0";"23";"1";"430501";"5766"
"LOK1378_1mm";"SILVA (only NR);Bacteria;Planctomycetota;Phycisphaerae;Tepidisphaerales;Tepidisphaeraceae;Tepidisphaera;";"0.0";"0";"7";"7";"0";"7";"0";"430517";"5766"
"LOK1378_1mm";"SILVA (only NR);Bacteria;Planctomycetota;Phycisphaerae;Tepidisphaerales;WD2101 soil group;";"0.0";"0";"290";"278";"0";"278";"12";"430246";"5766"
"LOK1378_1mm";"SILVA (only NR);Bacteria;Planctomycetota;Phycisphaerae;mle1-8;";"0.0";"0";"107";"101";"0";"101";"6";"430423";"5766"
"LOK1378_1mm";"SILVA (only NR);Bacteria;Planctomycetota;Pla3 lineage;";"0.0";"0";"129";"120";"0";"120";"9";"430404";"5766"
"LOK1378_1mm";"SILVA (only NR);Bacteria;Planctomycetota;Pla4 lineage;";"0.0";"0";"158";"151";"0";"151";"7";"430373";"5766"
"LOK1378_1mm";"SILVA (only NR);Bacteria;Planctomycetota;Planctomycetes;";"0.0";"0";"4871";"4666";"0";"4666";"205";"425858";"5766"
"LOK1378_1mm";"SILVA (only NR);Bacteria;Planctomycetota;Planctomycetes;Gemmatales;";"0.0";"0";"931";"864";"0";"864";"67";"429660";"5766"
"LOK1378_1mm";"SILVA (only NR);Bacteria;Planctomycetota;Planctomycetes;Gemmatales;Gemmataceae;";"0.0";"0";"931";"864";"0";"864";"67";"429660";"5766"
"LOK1378_1mm";"SILVA (only NR);Bacteria;Planctomycetota;Planctomycetes;Gemmatales;Gemmataceae;Fimbriiglobus;";"0.0";"0";"76";"73";"0";"73";"3";"430451";"5766"
"LOK1378_1mm";"SILVA (only NR);Bacteria;Planctomycetota;Planctomycetes;Gemmatales;Gemmataceae;Gemmata;";"0.0";"0";"185";"171";"0";"171";"14";"430353";"5766"
"LOK1378_1mm";"SILVA (only NR);Bacteria;Planctomycetota;Planctomycetes;Gemmatales;Gemmataceae;Telmatocola;";"0.0";"0";"5";"5";"0";"5";"0";"430519";"5766"
"LOK1378_1mm";"SILVA (only NR);Bacteria;Planctomycetota;Planctomycetes;Gemmatales;Gemmataceae;Tuwongella;";"0.0";"0";"7";"7";"0";"7";"0";"430517";"5766"
"LOK1378_1mm";"SILVA (only NR);Bacteria;Planctomycetota;Planctomycetes;Gemmatales;Gemmataceae;Zavarzinella;";"0.0";"0";"8";"7";"0";"7";"1";"430517";"5766"
"LOK1378_1mm";"SILVA (only NR);Bacteria;Planctomycetota;Planctomycetes;Gemmatales;Gemmataceae;uncultured;";"0.0";"0";"642";"593";"0";"593";"49";"429931";"5766"
"LOK1378_1mm";"SILVA (only NR);Bacteria;Planctomycetota;Planctomycetes;Isosphaerales;";"0.0";"0";"431";"415";"0";"415";"16";"430109";"5766"
"LOK1378_1mm";"SILVA (only NR);Bacteria;Planctomycetota;Planctomycetes;Isosphaerales;Isosphaeraceae;";"0.0";"0";"431";"415";"0";"415";"16";"430109";"5766"
"LOK1378_1mm";"SILVA (only NR);Bacteria;Planctomycetota;Planctomycetes;Isosphaerales;Isosphaeraceae;Aquisphaera;";"0.0";"0";"51";"51";"0";"51";"0";"430473";"5766"
"LOK1378_1mm";"SILVA (only NR);Bacteria;Planctomycetota;Planctomycetes;Isosphaerales;Isosphaeraceae;Candidatus Nostocoida;";"0.0";"0";"13";"13";"0";"13";"0";"430511";"5766"
"LOK1378_1mm";"SILVA (only NR);Bacteria;Planctomycetota;Planctomycetes;Isosphaerales;Isosphaeraceae;Isosphaera;";"0.0";"0";"16";"16";"0";"16";"0";"430508";"5766"
"LOK1378_1mm";"SILVA (only NR);Bacteria;Planctomycetota;Planctomycetes;Isosphaerales;Isosphaeraceae;Paludisphaera;";"0.0";"0";"20";"18";"0";"18";"2";"430506";"5766"
"LOK1378_1mm";"SILVA (only NR);Bacteria;Planctomycetota;Planctomycetes;Isosphaerales;Isosphaeraceae;Singulisphaera;";"0.0";"0";"73";"72";"0";"72";"1";"430452";"5766"
"LOK1378_1mm";"SILVA (only NR);Bacteria;Planctomycetota;Planctomycetes;Isosphaerales;Isosphaeraceae;Tundrisphaera;";"0.0";"0";"65";"61";"0";"61";"4";"430463";"5766"
"LOK1378_1mm";"SILVA (only NR);Bacteria;Planctomycetota;Planctomycetes;Isosphaerales;Isosphaeraceae;uncultured;";"0.0";"0";"192";"183";"0";"183";"9";"430341";"5766"
"LOK1378_1mm";"SILVA (only NR);Bacteria;Planctomycetota;Planctomycetes;Pirellulales;";"0.0";"0";"2487";"2400";"0";"2400";"87";"428124";"5766"
"LOK1378_1mm";"SILVA (only NR);Bacteria;Planctomycetota;Planctomycetes;Pirellulales;Pirellulaceae;";"0.0";"0";"2487";"2400";"0";"2400";"87";"428124";"5766"
"LOK1378_1mm";"SILVA (only NR);Bacteria;Planctomycetota;Planctomycetes;Pirellulales;Pirellulaceae;Blastopirellula;";"0.0";"0";"324";"317";"0";"317";"7";"430207";"5766"
"LOK1378_1mm";"SILVA (only NR);Bacteria;Planctomycetota;Planctomycetes;Pirellulales;Pirellulaceae;Bythopirellula;";"0.0";"0";"24";"24";"0";"24";"0";"430500";"5766"
"LOK1378_1mm";"SILVA (only NR);Bacteria;Planctomycetota;Planctomycetes;Pirellulales;Pirellulaceae;CPla-4 termite group;";"0.0";"0";"10";"10";"0";"10";"0";"430514";"5766"
"LOK1378_1mm";"SILVA (only NR);Bacteria;Planctomycetota;Planctomycetes;Pirellulales;Pirellulaceae;Candidatus Anammoximicrobium;";"0.0";"0";"12";"11";"0";"11";"1";"430513";"5766"
"LOK1378_1mm";"SILVA (only NR);Bacteria;Planctomycetota;Planctomycetes;Pirellulales;Pirellulaceae;Pir1 lineage;";"0.0";"0";"7";"7";"0";"7";"0";"430517";"5766"
"LOK1378_1mm";"SILVA (only NR);Bacteria;Planctomycetota;Planctomycetes;Pirellulales;Pirellulaceae;Pir2 lineage;";"0.0";"0";"10";"9";"0";"9";"1";"430515";"5766"
"LOK1378_1mm";"SILVA (only NR);Bacteria;Planctomycetota;Planctomycetes;Pirellulales;Pirellulaceae;Pir3 lineage;";"0.0";"0";"7";"5";"0";"5";"2";"430519";"5766"
"LOK1378_1mm";"SILVA (only NR);Bacteria;Planctomycetota;Planctomycetes;Pirellulales;Pirellulaceae;Pir4 lineage;";"0.0";"0";"546";"520";"0";"520";"26";"430004";"5766"
"LOK1378_1mm";"SILVA (only NR);Bacteria;Planctomycetota;Planctomycetes;Pirellulales;Pirellulaceae;Pirellula;";"0.0";"0";"412";"399";"0";"399";"13";"430125";"5766"
"LOK1378_1mm";"SILVA (only NR);Bacteria;Planctomycetota;Planctomycetes;Pirellulales;Pirellulaceae;Rhodopirellula;";"0.0";"0";"292";"284";"0";"284";"8";"430240";"5766"
"LOK1378_1mm";"SILVA (only NR);Bacteria;Planctomycetota;Planctomycetes;Pirellulales;Pirellulaceae;Roseimaritima;";"0.0";"0";"9";"9";"0";"9";"0";"430515";"5766"
"LOK1378_1mm";"SILVA (only NR);Bacteria;Planctomycetota;Planctomycetes;Pirellulales;Pirellulaceae;Rubripirellula;";"0.0";"0";"54";"54";"0";"54";"0";"430470";"5766"
"LOK1378_1mm";"SILVA (only NR);Bacteria;Planctomycetota;Planctomycetes;Pirellulales;Pirellulaceae;Termite planctomycete cluster;";"0.0";"0";"63";"63";"0";"63";"0";"430461";"5766"
"LOK1378_1mm";"SILVA (only NR);Bacteria;Planctomycetota;Planctomycetes;Pirellulales;Pirellulaceae;Thermogutta;";"0.0";"0";"17";"17";"0";"17";"0";"430507";"5766"
"LOK1378_1mm";"SILVA (only NR);Bacteria;Planctomycetota;Planctomycetes;Pirellulales;Pirellulaceae;Thermostilla;";"0.0";"0";"1";"1";"0";"1";"0";"430523";"5766"
"LOK1378_1mm";"SILVA (only NR);Bacteria;Planctomycetota;Planctomycetes;Pirellulales;Pirellulaceae;p-1088-a5 gut group;";"0.0";"0";"41";"39";"0";"39";"2";"430485";"5766"
"LOK1378_1mm";"SILVA (only NR);Bacteria;Planctomycetota;Planctomycetes;Pirellulales;Pirellulaceae;uncultured;";"0.0";"0";"654";"627";"0";"627";"27";"429897";"5766"
"LOK1378_1mm";"SILVA (only NR);Bacteria;Planctomycetota;Planctomycetes;Planctomycetales;";"0.0";"0";"956";"925";"0";"925";"31";"429599";"5766"
"LOK1378_1mm";"SILVA (only NR);Bacteria;Planctomycetota;Planctomycetes;Planctomycetales;Gimesiaceae;";"0.0";"0";"121";"120";"0";"120";"1";"430404";"5766"
"LOK1378_1mm";"SILVA (only NR);Bacteria;Planctomycetota;Planctomycetes;Planctomycetales;Gimesiaceae;Gimesia;";"0.0";"0";"12";"12";"0";"12";"0";"430512";"5766"
"LOK1378_1mm";"SILVA (only NR);Bacteria;Planctomycetota;Planctomycetes;Planctomycetales;Gimesiaceae;uncultured;";"0.0";"0";"109";"108";"0";"108";"1";"430416";"5766"
"LOK1378_1mm";"SILVA (only NR);Bacteria;Planctomycetota;Planctomycetes;Planctomycetales;Rubinisphaeraceae;";"0.0";"0";"385";"373";"0";"373";"12";"430151";"5766"
"LOK1378_1mm";"SILVA (only NR);Bacteria;Planctomycetota;Planctomycetes;Planctomycetales;Rubinisphaeraceae;Fuerstia;";"0.0";"0";"18";"18";"0";"18";"0";"430506";"5766"
"LOK1378_1mm";"SILVA (only NR);Bacteria;Planctomycetota;Planctomycetes;Planctomycetales;Rubinisphaeraceae;Planctomicrobium;";"0.0";"0";"77";"75";"0";"75";"2";"430449";"5766"
"LOK1378_1mm";"SILVA (only NR);Bacteria;Planctomycetota;Planctomycetes;Planctomycetales;Rubinisphaeraceae;Rubinisphaera;";"0.0";"0";"26";"26";"0";"26";"0";"430498";"5766"
"LOK1378_1mm";"SILVA (only NR);Bacteria;Planctomycetota;Planctomycetes;Planctomycetales;Rubinisphaeraceae;SH-PL14;";"0.0";"0";"98";"92";"0";"92";"6";"430432";"5766"
"LOK1378_1mm";"SILVA (only NR);Bacteria;Planctomycetota;Planctomycetes;Planctomycetales;Rubinisphaeraceae;uncultured;";"0.0";"0";"165";"161";"0";"161";"4";"430363";"5766"
"LOK1378_1mm";"SILVA (only NR);Bacteria;Planctomycetota;Planctomycetes;Planctomycetales;Schlesneriaceae;";"0.0";"0";"116";"110";"0";"110";"6";"430414";"5766"
"LOK1378_1mm";"SILVA (only NR);Bacteria;Planctomycetota;Planctomycetes;Planctomycetales;Schlesneriaceae;Planctopirus;";"0.0";"0";"69";"65";"0";"65";"4";"430459";"5766"
"LOK1378_1mm";"SILVA (only NR);Bacteria;Planctomycetota;Planctomycetes;Planctomycetales;Schlesneriaceae;Schlesneria;";"0.0";"0";"46";"44";"0";"44";"2";"430480";"5766"
"LOK1378_1mm";"SILVA (only NR);Bacteria;Planctomycetota;Planctomycetes;Planctomycetales;uncultured;";"0.0";"0";"331";"319";"0";"319";"12";"430205";"5766"
"LOK1378_1mm";"SILVA (only NR);Bacteria;Planctomycetota;Planctomycetes;uncultured;";"0.0";"0";"66";"62";"0";"62";"4";"430462";"5766"
"LOK1378_1mm";"SILVA (only NR);Bacteria;Planctomycetota;SGST604;";"0.0";"0";"9";"7";"0";"7";"2";"430517";"5766"
"LOK1378_1mm";"SILVA (only NR);Bacteria;Planctomycetota;SPG12-343-353-B69;";"0.0";"0";"7";"7";"0";"7";"0";"430517";"5766"
"LOK1378_1mm";"SILVA (only NR);Bacteria;Planctomycetota;vadinHA49;";"0.0";"0";"330";"302";"0";"302";"28";"430222";"5766"
"LOK1378_1mm";"SILVA (only NR);Bacteria;Poribacteria;";"0.0";"0";"52";"52";"0";"52";"0";"430472";"5766"
"LOK1378_1mm";"SILVA (only NR);Bacteria;Proteobacteria;";"0.0";"0";"109146";"105142";"0";"105142";"4004";"325382";"5766"
"LOK1378_1mm";"SILVA (only NR);Bacteria;Proteobacteria;Alphaproteobacteria;";"0.0";"0";"33787";"32921";"0";"32921";"866";"397603";"5766"
"LOK1378_1mm";"SILVA (only NR);Bacteria;Proteobacteria;Alphaproteobacteria;AT-s3-44;";"0.0";"0";"82";"81";"0";"81";"1";"430443";"5766"
"LOK1378_1mm";"SILVA (only NR);Bacteria;Proteobacteria;Alphaproteobacteria;Acetobacterales;";"0.0";"0";"1558";"1515";"0";"1515";"43";"429009";"5766"
"LOK1378_1mm";"SILVA (only NR);Bacteria;Proteobacteria;Alphaproteobacteria;Acetobacterales;Acetobacteraceae;";"0.0";"0";"1548";"1507";"0";"1507";"41";"429017";"5766"
"LOK1378_1mm";"SILVA (only NR);Bacteria;Proteobacteria;Alphaproteobacteria;Acetobacterales;Acetobacteraceae;Acetobacter;";"0.0";"0";"246";"245";"0";"245";"1";"430279";"5766"
"LOK1378_1mm";"SILVA (only NR);Bacteria;Proteobacteria;Alphaproteobacteria;Acetobacterales;Acetobacteraceae;Acidicaldus;";"0.0";"0";"25";"24";"0";"24";"1";"430500";"5766"
"LOK1378_1mm";"SILVA (only NR);Bacteria;Proteobacteria;Alphaproteobacteria;Acetobacterales;Acetobacteraceae;Acidiphilium;";"0.0";"0";"151";"130";"0";"130";"21";"430394";"5766"
"LOK1378_1mm";"SILVA (only NR);Bacteria;Proteobacteria;Alphaproteobacteria;Acetobacterales;Acetobacteraceae;Acidisoma;";"0.0";"0";"15";"14";"0";"14";"1";"430510";"5766"
"LOK1378_1mm";"SILVA (only NR);Bacteria;Proteobacteria;Alphaproteobacteria;Acetobacterales;Acetobacteraceae;Acidisphaera;";"0.0";"0";"12";"12";"0";"12";"0";"430512";"5766"
"LOK1378_1mm";"SILVA (only NR);Bacteria;Proteobacteria;Alphaproteobacteria;Acetobacterales;Acetobacteraceae;Acidocella;";"0.0";"0";"32";"31";"0";"31";"1";"430493";"5766"
"LOK1378_1mm";"SILVA (only NR);Bacteria;Proteobacteria;Alphaproteobacteria;Acetobacterales;Acetobacteraceae;Acidomonas;";"0.0";"0";"8";"8";"0";"8";"0";"430516";"5766"
"LOK1378_1mm";"SILVA (only NR);Bacteria;Proteobacteria;Alphaproteobacteria;Acetobacterales;Acetobacteraceae;Ameyamaea;";"0.0";"0";"5";"5";"0";"5";"0";"430519";"5766"
"LOK1378_1mm";"SILVA (only NR);Bacteria;Proteobacteria;Alphaproteobacteria;Acetobacterales;Acetobacteraceae;Asaia;";"0.0";"0";"50";"50";"0";"50";"0";"430474";"5766"
"LOK1378_1mm";"SILVA (only NR);Bacteria;Proteobacteria;Alphaproteobacteria;Acetobacterales;Acetobacteraceae;Belnapia;";"0.0";"0";"12";"12";"0";"12";"0";"430512";"5766"
"LOK1378_1mm";"SILVA (only NR);Bacteria;Proteobacteria;Alphaproteobacteria;Acetobacterales;Acetobacteraceae;Bombella;";"0.0";"0";"11";"11";"0";"11";"0";"430513";"5766"
"LOK1378_1mm";"SILVA (only NR);Bacteria;Proteobacteria;Alphaproteobacteria;Acetobacterales;Acetobacteraceae;Commensalibacter;";"0.0";"0";"17";"17";"0";"17";"0";"430507";"5766"
"LOK1378_1mm";"SILVA (only NR);Bacteria;Proteobacteria;Alphaproteobacteria;Acetobacterales;Acetobacteraceae;Craurococcus-Caldovatus;";"0.0";"0";"35";"35";"0";"35";"0";"430489";"5766"
"LOK1378_1mm";"SILVA (only NR);Bacteria;Proteobacteria;Alphaproteobacteria;Acetobacterales;Acetobacteraceae;Crenalkalicoccus;";"0.0";"0";"1";"1";"0";"1";"0";"430523";"5766"
"LOK1378_1mm";"SILVA (only NR);Bacteria;Proteobacteria;Alphaproteobacteria;Acetobacterales;Acetobacteraceae;Endobacter;";"0.0";"0";"13";"13";"0";"13";"0";"430511";"5766"
"LOK1378_1mm";"SILVA (only NR);Bacteria;Proteobacteria;Alphaproteobacteria;Acetobacterales;Acetobacteraceae;Gluconacetobacter;";"0.0";"0";"64";"64";"0";"64";"0";"430460";"5766"
"LOK1378_1mm";"SILVA (only NR);Bacteria;Proteobacteria;Alphaproteobacteria;Acetobacterales;Acetobacteraceae;Gluconobacter;";"0.0";"0";"125";"121";"0";"121";"4";"430403";"5766"
"LOK1378_1mm";"SILVA (only NR);Bacteria;Proteobacteria;Alphaproteobacteria;Acetobacterales;Acetobacteraceae;Granulibacter;";"0.0";"0";"12";"11";"0";"11";"1";"430513";"5766"
"LOK1378_1mm";"SILVA (only NR);Bacteria;Proteobacteria;Alphaproteobacteria;Acetobacterales;Acetobacteraceae;Humitalea;";"0.0";"0";"1";"1";"0";"1";"0";"430523";"5766"
"LOK1378_1mm";"SILVA (only NR);Bacteria;Proteobacteria;Alphaproteobacteria;Acetobacterales;Acetobacteraceae;Komagataeibacter;";"0.0";"0";"152";"151";"0";"151";"1";"430373";"5766"
"LOK1378_1mm";"SILVA (only NR);Bacteria;Proteobacteria;Alphaproteobacteria;Acetobacterales;Acetobacteraceae;Kozakia;";"0.0";"0";"11";"11";"0";"11";"0";"430513";"5766"
"LOK1378_1mm";"SILVA (only NR);Bacteria;Proteobacteria;Alphaproteobacteria;Acetobacterales;Acetobacteraceae;Muricoccus;";"0.0";"0";"2";"2";"0";"2";"0";"430522";"5766"
"LOK1378_1mm";"SILVA (only NR);Bacteria;Proteobacteria;Alphaproteobacteria;Acetobacterales;Acetobacteraceae;Neoasaia;";"0.0";"0";"4";"4";"0";"4";"0";"430520";"5766"
"LOK1378_1mm";"SILVA (only NR);Bacteria;Proteobacteria;Alphaproteobacteria;Acetobacterales;Acetobacteraceae;Neokomagataea;";"0.0";"0";"3";"3";"0";"3";"0";"430521";"5766"
"LOK1378_1mm";"SILVA (only NR);Bacteria;Proteobacteria;Alphaproteobacteria;Acetobacterales;Acetobacteraceae;Nguyenibacter;";"0.0";"0";"2";"2";"0";"2";"0";"430522";"5766"
"LOK1378_1mm";"SILVA (only NR);Bacteria;Proteobacteria;Alphaproteobacteria;Acetobacterales;Acetobacteraceae;Paracraurococcus;";"0.0";"0";"2";"2";"0";"2";"0";"430522";"5766"
"LOK1378_1mm";"SILVA (only NR);Bacteria;Proteobacteria;Alphaproteobacteria;Acetobacterales;Acetobacteraceae;Rhodopila;";"0.0";"0";"9";"9";"0";"9";"0";"430515";"5766"
"LOK1378_1mm";"SILVA (only NR);Bacteria;Proteobacteria;Alphaproteobacteria;Acetobacterales;Acetobacteraceae;Rhodovarius;";"0.0";"0";"19";"18";"0";"18";"1";"430506";"5766"
"LOK1378_1mm";"SILVA (only NR);Bacteria;Proteobacteria;Alphaproteobacteria;Acetobacterales;Acetobacteraceae;Rhodovastum;";"0.0";"0";"21";"21";"0";"21";"0";"430503";"5766"
"LOK1378_1mm";"SILVA (only NR);Bacteria;Proteobacteria;Alphaproteobacteria;Acetobacterales;Acetobacteraceae;Roseococcus;";"0.0";"0";"21";"21";"0";"21";"0";"430503";"5766"
"LOK1378_1mm";"SILVA (only NR);Bacteria;Proteobacteria;Alphaproteobacteria;Acetobacterales;Acetobacteraceae;Roseomonas;";"0.0";"0";"193";"189";"0";"189";"4";"430335";"5766"
"LOK1378_1mm";"SILVA (only NR);Bacteria;Proteobacteria;Alphaproteobacteria;Acetobacterales;Acetobacteraceae;Rubritepida;";"0.0";"0";"13";"13";"0";"13";"0";"430511";"5766"
"LOK1378_1mm";"SILVA (only NR);Bacteria;Proteobacteria;Alphaproteobacteria;Acetobacterales;Acetobacteraceae;Saccharibacter;";"0.0";"0";"5";"5";"0";"5";"0";"430519";"5766"
"LOK1378_1mm";"SILVA (only NR);Bacteria;Proteobacteria;Alphaproteobacteria;Acetobacterales;Acetobacteraceae;Siccirubricoccus;";"0.0";"0";"1";"1";"0";"1";"0";"430523";"5766"
"LOK1378_1mm";"SILVA (only NR);Bacteria;Proteobacteria;Alphaproteobacteria;Acetobacterales;Acetobacteraceae;Swaminathania;";"0.0";"0";"4";"4";"0";"4";"0";"430520";"5766"
"LOK1378_1mm";"SILVA (only NR);Bacteria;Proteobacteria;Alphaproteobacteria;Acetobacterales;Acetobacteraceae;Tanticharoenia;";"0.0";"0";"5";"5";"0";"5";"0";"430519";"5766"
"LOK1378_1mm";"SILVA (only NR);Bacteria;Proteobacteria;Alphaproteobacteria;Acetobacterales;Acetobacteraceae;uncultured;";"0.0";"0";"234";"229";"0";"229";"5";"430295";"5766"
"LOK1378_1mm";"SILVA (only NR);Bacteria;Proteobacteria;Alphaproteobacteria;Acetobacterales;Elioraeaceae;";"0.0";"0";"6";"6";"0";"6";"0";"430518";"5766"
"LOK1378_1mm";"SILVA (only NR);Bacteria;Proteobacteria;Alphaproteobacteria;Acetobacterales;Elioraeaceae;Elioraea;";"0.0";"0";"6";"6";"0";"6";"0";"430518";"5766"
"LOK1378_1mm";"SILVA (only NR);Bacteria;Proteobacteria;Alphaproteobacteria;Alphaproteobacteria Incertae Sedis;";"0.0";"0";"52";"50";"0";"50";"2";"430474";"5766"
"LOK1378_1mm";"SILVA (only NR);Bacteria;Proteobacteria;Alphaproteobacteria;Alphaproteobacteria Incertae Sedis;Unknown Family;";"0.0";"0";"52";"50";"0";"50";"2";"430474";"5766"
"LOK1378_1mm";"SILVA (only NR);Bacteria;Proteobacteria;Alphaproteobacteria;Alphaproteobacteria Incertae Sedis;Unknown Family;Acuticoccus;";"0.0";"0";"15";"14";"0";"14";"1";"430510";"5766"
"LOK1378_1mm";"SILVA (only NR);Bacteria;Proteobacteria;Alphaproteobacteria;Alphaproteobacteria Incertae Sedis;Unknown Family;Neomegalonema;";"0.0";"0";"9";"8";"0";"8";"1";"430516";"5766"
"LOK1378_1mm";"SILVA (only NR);Bacteria;Proteobacteria;Alphaproteobacteria;Alphaproteobacteria Incertae Sedis;Unknown Family;uncultured;";"0.0";"0";"26";"26";"0";"26";"0";"430498";"5766"
"LOK1378_1mm";"SILVA (only NR);Bacteria;Proteobacteria;Alphaproteobacteria;Azospirillales;";"0.0";"0";"499";"477";"0";"477";"22";"430047";"5766"
"LOK1378_1mm";"SILVA (only NR);Bacteria;Proteobacteria;Alphaproteobacteria;Azospirillales;Azospirillaceae;";"0.0";"0";"430";"412";"0";"412";"18";"430112";"5766"
"LOK1378_1mm";"SILVA (only NR);Bacteria;Proteobacteria;Alphaproteobacteria;Azospirillales;Azospirillaceae;Azospirillum;";"0.0";"0";"286";"270";"0";"270";"16";"430254";"5766"
"LOK1378_1mm";"SILVA (only NR);Bacteria;Proteobacteria;Alphaproteobacteria;Azospirillales;Azospirillaceae;Desertibacter;";"0.0";"0";"3";"3";"0";"3";"0";"430521";"5766"
"LOK1378_1mm";"SILVA (only NR);Bacteria;Proteobacteria;Alphaproteobacteria;Azospirillales;Azospirillaceae;Nitrospirillum;";"0.0";"0";"17";"17";"0";"17";"0";"430507";"5766"
"LOK1378_1mm";"SILVA (only NR);Bacteria;Proteobacteria;Alphaproteobacteria;Azospirillales;Azospirillaceae;Niveispirillum;";"0.0";"0";"34";"33";"0";"33";"1";"430491";"5766"
"LOK1378_1mm";"SILVA (only NR);Bacteria;Proteobacteria;Alphaproteobacteria;Azospirillales;Azospirillaceae;Rhodocista;";"0.0";"0";"5";"5";"0";"5";"0";"430519";"5766"
"LOK1378_1mm";"SILVA (only NR);Bacteria;Proteobacteria;Alphaproteobacteria;Azospirillales;Azospirillaceae;Skermanella;";"0.0";"0";"66";"65";"0";"65";"1";"430459";"5766"
"LOK1378_1mm";"SILVA (only NR);Bacteria;Proteobacteria;Alphaproteobacteria;Azospirillales;Azospirillaceae;uncultured;";"0.0";"0";"16";"16";"0";"16";"0";"430508";"5766"
"LOK1378_1mm";"SILVA (only NR);Bacteria;Proteobacteria;Alphaproteobacteria;Azospirillales;Azospirillales Incertae Sedis;";"0.0";"0";"12";"12";"0";"12";"0";"430512";"5766"
"LOK1378_1mm";"SILVA (only NR);Bacteria;Proteobacteria;Alphaproteobacteria;Azospirillales;Azospirillales Incertae Sedis;Stella;";"0.0";"0";"12";"12";"0";"12";"0";"430512";"5766"
"LOK1378_1mm";"SILVA (only NR);Bacteria;Proteobacteria;Alphaproteobacteria;Azospirillales;Inquilinaceae;";"0.0";"0";"35";"32";"0";"32";"3";"430492";"5766"
"LOK1378_1mm";"SILVA (only NR);Bacteria;Proteobacteria;Alphaproteobacteria;Azospirillales;Inquilinaceae;Inquilinus;";"0.0";"0";"35";"32";"0";"32";"3";"430492";"5766"
"LOK1378_1mm";"SILVA (only NR);Bacteria;Proteobacteria;Alphaproteobacteria;Azospirillales;uncultured;";"0.0";"0";"22";"21";"0";"21";"1";"430503";"5766"
"LOK1378_1mm";"SILVA (only NR);Bacteria;Proteobacteria;Alphaproteobacteria;Caedibacterales;";"0.0";"0";"22";"22";"0";"22";"0";"430502";"5766"
"LOK1378_1mm";"SILVA (only NR);Bacteria;Proteobacteria;Alphaproteobacteria;Caedibacterales;Caedibacteraceae;";"0.0";"0";"22";"22";"0";"22";"0";"430502";"5766"
"LOK1378_1mm";"SILVA (only NR);Bacteria;Proteobacteria;Alphaproteobacteria;Caedibacterales;Caedibacteraceae;Caedibacter;";"0.0";"0";"12";"12";"0";"12";"0";"430512";"5766"
"LOK1378_1mm";"SILVA (only NR);Bacteria;Proteobacteria;Alphaproteobacteria;Caedibacterales;Caedibacteraceae;Candidatus Nucleicultrix;";"0.0";"0";"5";"5";"0";"5";"0";"430519";"5766"
"LOK1378_1mm";"SILVA (only NR);Bacteria;Proteobacteria;Alphaproteobacteria;Caedibacterales;Caedibacteraceae;uncultured;";"0.0";"0";"5";"5";"0";"5";"0";"430519";"5766"
"LOK1378_1mm";"SILVA (only NR);Bacteria;Proteobacteria;Alphaproteobacteria;Caulobacterales;";"0.0";"0";"1775";"1719";"0";"1719";"56";"428805";"5766"
"LOK1378_1mm";"SILVA (only NR);Bacteria;Proteobacteria;Alphaproteobacteria;Caulobacterales;Caulobacteraceae;";"0.0";"0";"1097";"1058";"0";"1058";"39";"429466";"5766"
"LOK1378_1mm";"SILVA (only NR);Bacteria;Proteobacteria;Alphaproteobacteria;Caulobacterales;Caulobacteraceae;Asticcacaulis;";"0.0";"0";"45";"44";"0";"44";"1";"430480";"5766"
"LOK1378_1mm";"SILVA (only NR);Bacteria;Proteobacteria;Alphaproteobacteria;Caulobacterales;Caulobacteraceae;Brevundimonas;";"0.0";"0";"541";"521";"0";"521";"20";"430003";"5766"
"LOK1378_1mm";"SILVA (only NR);Bacteria;Proteobacteria;Alphaproteobacteria;Caulobacterales;Caulobacteraceae;Caulobacter;";"0.0";"0";"177";"172";"0";"172";"5";"430352";"5766"
"LOK1378_1mm";"SILVA (only NR);Bacteria;Proteobacteria;Alphaproteobacteria;Caulobacterales;Caulobacteraceae;PMMR1;";"0.0";"0";"22";"22";"0";"22";"0";"430502";"5766"
"LOK1378_1mm";"SILVA (only NR);Bacteria;Proteobacteria;Alphaproteobacteria;Caulobacterales;Caulobacteraceae;Phenylobacterium;";"0.0";"0";"173";"167";"0";"167";"6";"430357";"5766"
"LOK1378_1mm";"SILVA (only NR);Bacteria;Proteobacteria;Alphaproteobacteria;Caulobacterales;Caulobacteraceae;uncultured;";"0.0";"0";"136";"129";"0";"129";"7";"430395";"5766"
"LOK1378_1mm";"SILVA (only NR);Bacteria;Proteobacteria;Alphaproteobacteria;Caulobacterales;Hyphomonadaceae;";"0.0";"0";"569";"552";"0";"552";"17";"429972";"5766"
"LOK1378_1mm";"SILVA (only NR);Bacteria;Proteobacteria;Alphaproteobacteria;Caulobacterales;Hyphomonadaceae;Algimonas;";"0.0";"0";"11";"11";"0";"11";"0";"430513";"5766"
"LOK1378_1mm";"SILVA (only NR);Bacteria;Proteobacteria;Alphaproteobacteria;Caulobacterales;Hyphomonadaceae;Euryhalocaulis;";"0.0";"0";"8";"8";"0";"8";"0";"430516";"5766"
"LOK1378_1mm";"SILVA (only NR);Bacteria;Proteobacteria;Alphaproteobacteria;Caulobacterales;Hyphomonadaceae;Fretibacter;";"0.0";"0";"2";"2";"0";"2";"0";"430522";"5766"
"LOK1378_1mm";"SILVA (only NR);Bacteria;Proteobacteria;Alphaproteobacteria;Caulobacterales;Hyphomonadaceae;Glycocaulis;";"0.0";"0";"3";"3";"0";"3";"0";"430521";"5766"
"LOK1378_1mm";"SILVA (only NR);Bacteria;Proteobacteria;Alphaproteobacteria;Caulobacterales;Hyphomonadaceae;Hellea;";"0.0";"0";"9";"9";"0";"9";"0";"430515";"5766"
"LOK1378_1mm";"SILVA (only NR);Bacteria;Proteobacteria;Alphaproteobacteria;Caulobacterales;Hyphomonadaceae;Henriciella;";"0.0";"0";"15";"15";"0";"15";"0";"430509";"5766"
"LOK1378_1mm";"SILVA (only NR);Bacteria;Proteobacteria;Alphaproteobacteria;Caulobacterales;Hyphomonadaceae;Hirschia;";"0.0";"0";"60";"60";"0";"60";"0";"430464";"5766"
"LOK1378_1mm";"SILVA (only NR);Bacteria;Proteobacteria;Alphaproteobacteria;Caulobacterales;Hyphomonadaceae;Hyphobacterium;";"0.0";"0";"10";"10";"0";"10";"0";"430514";"5766"
"LOK1378_1mm";"SILVA (only NR);Bacteria;Proteobacteria;Alphaproteobacteria;Caulobacterales;Hyphomonadaceae;Hyphomonas;";"0.0";"0";"106";"100";"0";"100";"6";"430424";"5766"
"LOK1378_1mm";"SILVA (only NR);Bacteria;Proteobacteria;Alphaproteobacteria;Caulobacterales;Hyphomonadaceae;Litorimonas;";"0.0";"0";"12";"12";"0";"12";"0";"430512";"5766"
"LOK1378_1mm";"SILVA (only NR);Bacteria;Proteobacteria;Alphaproteobacteria;Caulobacterales;Hyphomonadaceae;Maricaulis;";"0.0";"0";"30";"29";"0";"29";"1";"430495";"5766"
"LOK1378_1mm";"SILVA (only NR);Bacteria;Proteobacteria;Alphaproteobacteria;Caulobacterales;Hyphomonadaceae;Oceanicaulis;";"0.0";"0";"51";"49";"0";"49";"2";"430475";"5766"
"LOK1378_1mm";"SILVA (only NR);Bacteria;Proteobacteria;Alphaproteobacteria;Caulobacterales;Hyphomonadaceae;Ponticaulis;";"0.0";"0";"9";"9";"0";"9";"0";"430515";"5766"
"LOK1378_1mm";"SILVA (only NR);Bacteria;Proteobacteria;Alphaproteobacteria;Caulobacterales;Hyphomonadaceae;Robiginitomaculum;";"0.0";"0";"27";"27";"0";"27";"0";"430497";"5766"
"LOK1378_1mm";"SILVA (only NR);Bacteria;Proteobacteria;Alphaproteobacteria;Caulobacterales;Hyphomonadaceae;SWB02;";"0.0";"0";"99";"95";"0";"95";"4";"430429";"5766"
"LOK1378_1mm";"SILVA (only NR);Bacteria;Proteobacteria;Alphaproteobacteria;Caulobacterales;Hyphomonadaceae;UKL13-1;";"0.0";"0";"9";"9";"0";"9";"0";"430515";"5766"
"LOK1378_1mm";"SILVA (only NR);Bacteria;Proteobacteria;Alphaproteobacteria;Caulobacterales;Hyphomonadaceae;Woodsholea;";"0.0";"0";"2";"2";"0";"2";"0";"430522";"5766"
"LOK1378_1mm";"SILVA (only NR);Bacteria;Proteobacteria;Alphaproteobacteria;Caulobacterales;Hyphomonadaceae;uncultured;";"0.0";"0";"103";"99";"0";"99";"4";"430425";"5766"
"LOK1378_1mm";"SILVA (only NR);Bacteria;Proteobacteria;Alphaproteobacteria;Caulobacterales;Parvularculaceae;";"0.0";"0";"104";"104";"0";"104";"0";"430420";"5766"
"LOK1378_1mm";"SILVA (only NR);Bacteria;Proteobacteria;Alphaproteobacteria;Caulobacterales;Parvularculaceae;Amphiplicatus;";"0.0";"0";"39";"39";"0";"39";"0";"430485";"5766"
"LOK1378_1mm";"SILVA (only NR);Bacteria;Proteobacteria;Alphaproteobacteria;Caulobacterales;Parvularculaceae;Hyphococcus;";"0.0";"0";"10";"10";"0";"10";"0";"430514";"5766"
"LOK1378_1mm";"SILVA (only NR);Bacteria;Proteobacteria;Alphaproteobacteria;Caulobacterales;Parvularculaceae;Marinicaulis;";"0.0";"0";"20";"20";"0";"20";"0";"430504";"5766"
"LOK1378_1mm";"SILVA (only NR);Bacteria;Proteobacteria;Alphaproteobacteria;Caulobacterales;Parvularculaceae;Parvularcula;";"0.0";"0";"23";"23";"0";"23";"0";"430501";"5766"
"LOK1378_1mm";"SILVA (only NR);Bacteria;Proteobacteria;Alphaproteobacteria;Caulobacterales;Parvularculaceae;uncultured;";"0.0";"0";"12";"12";"0";"12";"0";"430512";"5766"
"LOK1378_1mm";"SILVA (only NR);Bacteria;Proteobacteria;Alphaproteobacteria;Caulobacterales;uncultured;";"0.0";"0";"5";"5";"0";"5";"0";"430519";"5766"
"LOK1378_1mm";"SILVA (only NR);Bacteria;Proteobacteria;Alphaproteobacteria;Defluviicoccales;";"0.0";"0";"334";"324";"0";"324";"10";"430200";"5766"
"LOK1378_1mm";"SILVA (only NR);Bacteria;Proteobacteria;Alphaproteobacteria;Defluviicoccales;Defluviicoccaceae;";"0.0";"0";"75";"71";"0";"71";"4";"430453";"5766"
"LOK1378_1mm";"SILVA (only NR);Bacteria;Proteobacteria;Alphaproteobacteria;Defluviicoccales;Defluviicoccaceae;Defluviicoccus;";"0.0";"0";"75";"71";"0";"71";"4";"430453";"5766"
"LOK1378_1mm";"SILVA (only NR);Bacteria;Proteobacteria;Alphaproteobacteria;Defluviicoccales;uncultured;";"0.0";"0";"259";"253";"0";"253";"6";"430271";"5766"
"LOK1378_1mm";"SILVA (only NR);Bacteria;Proteobacteria;Alphaproteobacteria;Dongiales;";"0.0";"0";"134";"131";"0";"131";"3";"430393";"5766"
"LOK1378_1mm";"SILVA (only NR);Bacteria;Proteobacteria;Alphaproteobacteria;Dongiales;Dongiaceae;";"0.0";"0";"134";"131";"0";"131";"3";"430393";"5766"
"LOK1378_1mm";"SILVA (only NR);Bacteria;Proteobacteria;Alphaproteobacteria;Dongiales;Dongiaceae;Dongia;";"0.0";"0";"134";"131";"0";"131";"3";"430393";"5766"
"LOK1378_1mm";"SILVA (only NR);Bacteria;Proteobacteria;Alphaproteobacteria;Dstr-E11;";"0.0";"0";"12";"12";"0";"12";"0";"430512";"5766"
"LOK1378_1mm";"SILVA (only NR);Bacteria;Proteobacteria;Alphaproteobacteria;Elsterales;";"0.0";"0";"300";"289";"0";"289";"11";"430235";"5766"
"LOK1378_1mm";"SILVA (only NR);Bacteria;Proteobacteria;Alphaproteobacteria;Elsterales;Elsteraceae;";"0.0";"0";"50";"48";"0";"48";"2";"430476";"5766"
"LOK1378_1mm";"SILVA (only NR);Bacteria;Proteobacteria;Alphaproteobacteria;Elsterales;Elsteraceae;Aliidongia;";"0.0";"0";"2";"2";"0";"2";"0";"430522";"5766"
"LOK1378_1mm";"SILVA (only NR);Bacteria;Proteobacteria;Alphaproteobacteria;Elsterales;Elsteraceae;Elstera;";"0.0";"0";"6";"6";"0";"6";"0";"430518";"5766"
"LOK1378_1mm";"SILVA (only NR);Bacteria;Proteobacteria;Alphaproteobacteria;Elsterales;Elsteraceae;Lacibacterium;";"0.0";"0";"1";"1";"0";"1";"0";"430523";"5766"
"LOK1378_1mm";"SILVA (only NR);Bacteria;Proteobacteria;Alphaproteobacteria;Elsterales;Elsteraceae;uncultured;";"0.0";"0";"40";"38";"0";"38";"2";"430486";"5766"
"LOK1378_1mm";"SILVA (only NR);Bacteria;Proteobacteria;Alphaproteobacteria;Elsterales;URHD0088;";"0.0";"0";"9";"9";"0";"9";"0";"430515";"5766"
"LOK1378_1mm";"SILVA (only NR);Bacteria;Proteobacteria;Alphaproteobacteria;Elsterales;uncultured;";"0.0";"0";"241";"232";"0";"232";"9";"430292";"5766"
"LOK1378_1mm";"SILVA (only NR);Bacteria;Proteobacteria;Alphaproteobacteria;Emcibacterales;";"0.0";"0";"3";"3";"0";"3";"0";"430521";"5766"
"LOK1378_1mm";"SILVA (only NR);Bacteria;Proteobacteria;Alphaproteobacteria;Emcibacterales;Emcibacteraceae;";"0.0";"0";"3";"3";"0";"3";"0";"430521";"5766"
"LOK1378_1mm";"SILVA (only NR);Bacteria;Proteobacteria;Alphaproteobacteria;Emcibacterales;Emcibacteraceae;Emcibacter;";"0.0";"0";"3";"3";"0";"3";"0";"430521";"5766"
"LOK1378_1mm";"SILVA (only NR);Bacteria;Proteobacteria;Alphaproteobacteria;Ferrovibrionales;";"0.0";"0";"30";"30";"0";"30";"0";"430494";"5766"
"LOK1378_1mm";"SILVA (only NR);Bacteria;Proteobacteria;Alphaproteobacteria;Ferrovibrionales;Ferrovibrionaceae;";"0.0";"0";"16";"16";"0";"16";"0";"430508";"5766"
"LOK1378_1mm";"SILVA (only NR);Bacteria;Proteobacteria;Alphaproteobacteria;Ferrovibrionales;Ferrovibrionaceae;Ferrovibrio;";"0.0";"0";"16";"16";"0";"16";"0";"430508";"5766"
"LOK1378_1mm";"SILVA (only NR);Bacteria;Proteobacteria;Alphaproteobacteria;Ferrovibrionales;Marinibaculum;";"0.0";"0";"1";"1";"0";"1";"0";"430523";"5766"
"LOK1378_1mm";"SILVA (only NR);Bacteria;Proteobacteria;Alphaproteobacteria;Ferrovibrionales;Taonella;";"0.0";"0";"6";"6";"0";"6";"0";"430518";"5766"
"LOK1378_1mm";"SILVA (only NR);Bacteria;Proteobacteria;Alphaproteobacteria;Ferrovibrionales;uncultured;";"0.0";"0";"7";"7";"0";"7";"0";"430517";"5766"
"LOK1378_1mm";"SILVA (only NR);Bacteria;Proteobacteria;Alphaproteobacteria;Holosporales;";"0.0";"0";"72";"71";"0";"71";"1";"430453";"5766"
"LOK1378_1mm";"SILVA (only NR);Bacteria;Proteobacteria;Alphaproteobacteria;Holosporales;Holosporaceae;";"0.0";"0";"72";"71";"0";"71";"1";"430453";"5766"
"LOK1378_1mm";"SILVA (only NR);Bacteria;Proteobacteria;Alphaproteobacteria;Holosporales;Holosporaceae;Candidatus Bealeia;";"0.0";"0";"8";"8";"0";"8";"0";"430516";"5766"
"LOK1378_1mm";"SILVA (only NR);Bacteria;Proteobacteria;Alphaproteobacteria;Holosporales;Holosporaceae;Candidatus Gortzia;";"0.0";"0";"4";"4";"0";"4";"0";"430520";"5766"
"LOK1378_1mm";"SILVA (only NR);Bacteria;Proteobacteria;Alphaproteobacteria;Holosporales;Holosporaceae;Candidatus Paraholospora;";"0.0";"0";"2";"2";"0";"2";"0";"430522";"5766"
"LOK1378_1mm";"SILVA (only NR);Bacteria;Proteobacteria;Alphaproteobacteria;Holosporales;Holosporaceae;Holospora;";"0.0";"0";"9";"8";"0";"8";"1";"430516";"5766"
"LOK1378_1mm";"SILVA (only NR);Bacteria;Proteobacteria;Alphaproteobacteria;Holosporales;Holosporaceae;uncultured;";"0.0";"0";"46";"46";"0";"46";"0";"430478";"5766"
"LOK1378_1mm";"SILVA (only NR);Bacteria;Proteobacteria;Alphaproteobacteria;Kiloniellales;";"0.0";"0";"361";"357";"0";"357";"4";"430167";"5766"
"LOK1378_1mm";"SILVA (only NR);Bacteria;Proteobacteria;Alphaproteobacteria;Kiloniellales;Fodinicurvataceae;";"0.0";"0";"75";"74";"0";"74";"1";"430450";"5766"
"LOK1378_1mm";"SILVA (only NR);Bacteria;Proteobacteria;Alphaproteobacteria;Kiloniellales;Fodinicurvataceae;Fodinicurvata;";"0.0";"0";"9";"9";"0";"9";"0";"430515";"5766"
"LOK1378_1mm";"SILVA (only NR);Bacteria;Proteobacteria;Alphaproteobacteria;Kiloniellales;Fodinicurvataceae;Limimonas;";"0.0";"0";"11";"11";"0";"11";"0";"430513";"5766"
"LOK1378_1mm";"SILVA (only NR);Bacteria;Proteobacteria;Alphaproteobacteria;Kiloniellales;Fodinicurvataceae;Rhodovibrio;";"0.0";"0";"30";"30";"0";"30";"0";"430494";"5766"
"LOK1378_1mm";"SILVA (only NR);Bacteria;Proteobacteria;Alphaproteobacteria;Kiloniellales;Fodinicurvataceae;uncultured;";"0.0";"0";"25";"24";"0";"24";"1";"430500";"5766"
"LOK1378_1mm";"SILVA (only NR);Bacteria;Proteobacteria;Alphaproteobacteria;Kiloniellales;Kiloniellaceae;";"0.0";"0";"286";"283";"0";"283";"3";"430241";"5766"
"LOK1378_1mm";"SILVA (only NR);Bacteria;Proteobacteria;Alphaproteobacteria;Kiloniellales;Kiloniellaceae;Kiloniella;";"0.0";"0";"7";"7";"0";"7";"0";"430517";"5766"
"LOK1378_1mm";"SILVA (only NR);Bacteria;Proteobacteria;Alphaproteobacteria;Kiloniellales;Kiloniellaceae;Limibacillus;";"0.0";"0";"11";"11";"0";"11";"0";"430513";"5766"
"LOK1378_1mm";"SILVA (only NR);Bacteria;Proteobacteria;Alphaproteobacteria;Kiloniellales;Kiloniellaceae;Pelagibius;";"0.0";"0";"44";"43";"0";"43";"1";"430481";"5766"
"LOK1378_1mm";"SILVA (only NR);Bacteria;Proteobacteria;Alphaproteobacteria;Kiloniellales;Kiloniellaceae;Tagaea;";"0.0";"0";"5";"5";"0";"5";"0";"430519";"5766"
"LOK1378_1mm";"SILVA (only NR);Bacteria;Proteobacteria;Alphaproteobacteria;Kiloniellales;Kiloniellaceae;Tistlia;";"0.0";"0";"30";"29";"0";"29";"1";"430495";"5766"
"LOK1378_1mm";"SILVA (only NR);Bacteria;Proteobacteria;Alphaproteobacteria;Kiloniellales;Kiloniellaceae;uncultured;";"0.0";"0";"189";"188";"0";"188";"1";"430336";"5766"
"LOK1378_1mm";"SILVA (only NR);Bacteria;Proteobacteria;Alphaproteobacteria;Kordiimonadales;";"0.0";"0";"127";"117";"0";"117";"10";"430407";"5766"
"LOK1378_1mm";"SILVA (only NR);Bacteria;Proteobacteria;Alphaproteobacteria;Kordiimonadales;Iodidimonadaceae;";"0.0";"0";"10";"10";"0";"10";"0";"430514";"5766"
"LOK1378_1mm";"SILVA (only NR);Bacteria;Proteobacteria;Alphaproteobacteria;Kordiimonadales;Iodidimonadaceae;Iodidimonas;";"0.0";"0";"10";"10";"0";"10";"0";"430514";"5766"
"LOK1378_1mm";"SILVA (only NR);Bacteria;Proteobacteria;Alphaproteobacteria;Kordiimonadales;Kordiimonadaceae;";"0.0";"0";"78";"68";"0";"68";"10";"430456";"5766"
"LOK1378_1mm";"SILVA (only NR);Bacteria;Proteobacteria;Alphaproteobacteria;Kordiimonadales;Kordiimonadaceae;Kordiimonas;";"0.0";"0";"78";"68";"0";"68";"10";"430456";"5766"
"LOK1378_1mm";"SILVA (only NR);Bacteria;Proteobacteria;Alphaproteobacteria;Kordiimonadales;Kordiimonadales Incertae Sedis;";"0.0";"0";"2";"2";"0";"2";"0";"430522";"5766"
"LOK1378_1mm";"SILVA (only NR);Bacteria;Proteobacteria;Alphaproteobacteria;Kordiimonadales;Kordiimonadales Incertae Sedis;Eilatimonas;";"0.0";"0";"2";"2";"0";"2";"0";"430522";"5766"
"LOK1378_1mm";"SILVA (only NR);Bacteria;Proteobacteria;Alphaproteobacteria;Kordiimonadales;Temperatibacteraceae;";"0.0";"0";"2";"2";"0";"2";"0";"430522";"5766"
"LOK1378_1mm";"SILVA (only NR);Bacteria;Proteobacteria;Alphaproteobacteria;Kordiimonadales;Temperatibacteraceae;Temperatibacter;";"0.0";"0";"2";"2";"0";"2";"0";"430522";"5766"
"LOK1378_1mm";"SILVA (only NR);Bacteria;Proteobacteria;Alphaproteobacteria;Kordiimonadales;uncultured;";"0.0";"0";"35";"35";"0";"35";"0";"430489";"5766"
"LOK1378_1mm";"SILVA (only NR);Bacteria;Proteobacteria;Alphaproteobacteria;Micavibrionales;";"0.0";"0";"303";"295";"0";"295";"8";"430229";"5766"
"LOK1378_1mm";"SILVA (only NR);Bacteria;Proteobacteria;Alphaproteobacteria;Micavibrionales;Micavibrionaceae;";"0.0";"0";"153";"150";"0";"150";"3";"430374";"5766"
"LOK1378_1mm";"SILVA (only NR);Bacteria;Proteobacteria;Alphaproteobacteria;Micavibrionales;Micavibrionaceae;Micavibrio;";"0.0";"0";"3";"3";"0";"3";"0";"430521";"5766"
"LOK1378_1mm";"SILVA (only NR);Bacteria;Proteobacteria;Alphaproteobacteria;Micavibrionales;Micavibrionaceae;uncultured;";"0.0";"0";"150";"147";"0";"147";"3";"430377";"5766"
"LOK1378_1mm";"SILVA (only NR);Bacteria;Proteobacteria;Alphaproteobacteria;Micavibrionales;uncultured;";"0.0";"0";"148";"143";"0";"143";"5";"430381";"5766"
"LOK1378_1mm";"SILVA (only NR);Bacteria;Proteobacteria;Alphaproteobacteria;Micropepsales;";"0.0";"0";"146";"141";"0";"141";"5";"430383";"5766"
"LOK1378_1mm";"SILVA (only NR);Bacteria;Proteobacteria;Alphaproteobacteria;Micropepsales;Micropepsaceae;";"0.0";"0";"146";"141";"0";"141";"5";"430383";"5766"
"LOK1378_1mm";"SILVA (only NR);Bacteria;Proteobacteria;Alphaproteobacteria;Micropepsales;Micropepsaceae;Micropepsis;";"0.0";"0";"7";"7";"0";"7";"0";"430517";"5766"
"LOK1378_1mm";"SILVA (only NR);Bacteria;Proteobacteria;Alphaproteobacteria;Micropepsales;Micropepsaceae;Rhizomicrobium;";"0.0";"0";"6";"6";"0";"6";"0";"430518";"5766"
"LOK1378_1mm";"SILVA (only NR);Bacteria;Proteobacteria;Alphaproteobacteria;Micropepsales;Micropepsaceae;uncultured;";"0.0";"0";"128";"123";"0";"123";"5";"430401";"5766"
"LOK1378_1mm";"SILVA (only NR);Bacteria;Proteobacteria;Alphaproteobacteria;NRL2;";"0.0";"0";"25";"24";"0";"24";"1";"430500";"5766"
"LOK1378_1mm";"SILVA (only NR);Bacteria;Proteobacteria;Alphaproteobacteria;Paracaedibacterales;";"0.0";"0";"146";"142";"0";"142";"4";"430382";"5766"
"LOK1378_1mm";"SILVA (only NR);Bacteria;Proteobacteria;Alphaproteobacteria;Paracaedibacterales;Paracaedibacteraceae;";"0.0";"0";"146";"142";"0";"142";"4";"430382";"5766"
"LOK1378_1mm";"SILVA (only NR);Bacteria;Proteobacteria;Alphaproteobacteria;Paracaedibacterales;Paracaedibacteraceae;Candidatus Captivus;";"0.0";"0";"20";"19";"0";"19";"1";"430505";"5766"
"LOK1378_1mm";"SILVA (only NR);Bacteria;Proteobacteria;Alphaproteobacteria;Paracaedibacterales;Paracaedibacteraceae;Candidatus Finniella;";"0.0";"0";"11";"10";"0";"10";"1";"430514";"5766"
"LOK1378_1mm";"SILVA (only NR);Bacteria;Proteobacteria;Alphaproteobacteria;Paracaedibacterales;Paracaedibacteraceae;Candidatus Odyssella;";"0.0";"0";"2";"2";"0";"2";"0";"430522";"5766"
"LOK1378_1mm";"SILVA (only NR);Bacteria;Proteobacteria;Alphaproteobacteria;Paracaedibacterales;Paracaedibacteraceae;Candidatus Paracaedibacter;";"0.0";"0";"34";"33";"0";"33";"1";"430491";"5766"
"LOK1378_1mm";"SILVA (only NR);Bacteria;Proteobacteria;Alphaproteobacteria;Paracaedibacterales;Paracaedibacteraceae;uncultured;";"0.0";"0";"76";"75";"0";"75";"1";"430449";"5766"
"LOK1378_1mm";"SILVA (only NR);Bacteria;Proteobacteria;Alphaproteobacteria;Parvibaculales;";"0.0";"0";"215";"209";"0";"209";"6";"430315";"5766"
"LOK1378_1mm";"SILVA (only NR);Bacteria;Proteobacteria;Alphaproteobacteria;Parvibaculales;OCS116 clade;";"0.0";"0";"46";"46";"0";"46";"0";"430478";"5766"
"LOK1378_1mm";"SILVA (only NR);Bacteria;Proteobacteria;Alphaproteobacteria;Parvibaculales;PS1 clade;";"0.0";"0";"73";"73";"0";"73";"0";"430451";"5766"
"LOK1378_1mm";"SILVA (only NR);Bacteria;Proteobacteria;Alphaproteobacteria;Parvibaculales;Parvibaculaceae;";"0.0";"0";"91";"85";"0";"85";"6";"430439";"5766"
"LOK1378_1mm";"SILVA (only NR);Bacteria;Proteobacteria;Alphaproteobacteria;Parvibaculales;Parvibaculaceae;Candidatus Phaeomarinobacter;";"0.0";"0";"1";"1";"0";"1";"0";"430523";"5766"
"LOK1378_1mm";"SILVA (only NR);Bacteria;Proteobacteria;Alphaproteobacteria;Parvibaculales;Parvibaculaceae;Mf105b01;";"0.0";"0";"14";"8";"0";"8";"6";"430516";"5766"
"LOK1378_1mm";"SILVA (only NR);Bacteria;Proteobacteria;Alphaproteobacteria;Parvibaculales;Parvibaculaceae;Parvibaculum;";"0.0";"0";"49";"49";"0";"49";"0";"430475";"5766"
"LOK1378_1mm";"SILVA (only NR);Bacteria;Proteobacteria;Alphaproteobacteria;Parvibaculales;Parvibaculaceae;Pyruvatibacter;";"0.0";"0";"1";"1";"0";"1";"0";"430523";"5766"
"LOK1378_1mm";"SILVA (only NR);Bacteria;Proteobacteria;Alphaproteobacteria;Parvibaculales;Parvibaculaceae;Rhodoligotrophos;";"0.0";"0";"5";"5";"0";"5";"0";"430519";"5766"
"LOK1378_1mm";"SILVA (only NR);Bacteria;Proteobacteria;Alphaproteobacteria;Parvibaculales;Parvibaculaceae;Tepidicaulis;";"0.0";"0";"4";"4";"0";"4";"0";"430520";"5766"
"LOK1378_1mm";"SILVA (only NR);Bacteria;Proteobacteria;Alphaproteobacteria;Parvibaculales;Parvibaculaceae;uncultured;";"0.0";"0";"12";"12";"0";"12";"0";"430512";"5766"
"LOK1378_1mm";"SILVA (only NR);Bacteria;Proteobacteria;Alphaproteobacteria;Parvibaculales;uncultured;";"0.0";"0";"4";"4";"0";"4";"0";"430520";"5766"
"LOK1378_1mm";"SILVA (only NR);Bacteria;Proteobacteria;Alphaproteobacteria;Puniceispirillales;";"0.0";"0";"307";"304";"0";"304";"3";"430220";"5766"
"LOK1378_1mm";"SILVA (only NR);Bacteria;Proteobacteria;Alphaproteobacteria;Puniceispirillales;EF100-94H03;";"0.0";"0";"25";"25";"0";"25";"0";"430499";"5766"
"LOK1378_1mm";"SILVA (only NR);Bacteria;Proteobacteria;Alphaproteobacteria;Puniceispirillales;Puniceispirillales Incertae Sedis;";"0.0";"0";"22";"21";"0";"21";"1";"430503";"5766"
"LOK1378_1mm";"SILVA (only NR);Bacteria;Proteobacteria;Alphaproteobacteria;Puniceispirillales;Puniceispirillales Incertae Sedis;Constrictibacter;";"0.0";"0";"22";"21";"0";"21";"1";"430503";"5766"
"LOK1378_1mm";"SILVA (only NR);Bacteria;Proteobacteria;Alphaproteobacteria;Puniceispirillales;SAR116 clade;";"0.0";"0";"226";"224";"0";"224";"2";"430300";"5766"
"LOK1378_1mm";"SILVA (only NR);Bacteria;Proteobacteria;Alphaproteobacteria;Puniceispirillales;SAR116 clade;Candidatus Puniceispirillum;";"0.0";"0";"16";"16";"0";"16";"0";"430508";"5766"
"LOK1378_1mm";"SILVA (only NR);Bacteria;Proteobacteria;Alphaproteobacteria;Puniceispirillales;uncultured;";"0.0";"0";"32";"32";"0";"32";"0";"430492";"5766"
"LOK1378_1mm";"SILVA (only NR);Bacteria;Proteobacteria;Alphaproteobacteria;Reyranellales;";"0.0";"0";"179";"173";"0";"173";"6";"430351";"5766"
"LOK1378_1mm";"SILVA (only NR);Bacteria;Proteobacteria;Alphaproteobacteria;Reyranellales;Reyranellaceae;";"0.0";"0";"179";"173";"0";"173";"6";"430351";"5766"
"LOK1378_1mm";"SILVA (only NR);Bacteria;Proteobacteria;Alphaproteobacteria;Reyranellales;Reyranellaceae;Reyranella;";"0.0";"0";"124";"119";"0";"119";"5";"430405";"5766"
"LOK1378_1mm";"SILVA (only NR);Bacteria;Proteobacteria;Alphaproteobacteria;Reyranellales;Reyranellaceae;uncultured;";"0.0";"0";"55";"54";"0";"54";"1";"430470";"5766"
"LOK1378_1mm";"SILVA (only NR);Bacteria;Proteobacteria;Alphaproteobacteria;Rhizobiales;";"0.0";"0";"10862";"10564";"0";"10564";"298";"419960";"5766"
"LOK1378_1mm";"SILVA (only NR);Bacteria;Proteobacteria;Alphaproteobacteria;Rhizobiales;A0839;";"0.0";"0";"112";"110";"0";"110";"2";"430414";"5766"
"LOK1378_1mm";"SILVA (only NR);Bacteria;Proteobacteria;Alphaproteobacteria;Rhizobiales;Amb-16S-1323;";"0.0";"0";"18";"18";"0";"18";"0";"430506";"5766"
"LOK1378_1mm";"SILVA (only NR);Bacteria;Proteobacteria;Alphaproteobacteria;Rhizobiales;Ancalomicrobiaceae;";"0.0";"0";"4";"4";"0";"4";"0";"430520";"5766"
"LOK1378_1mm";"SILVA (only NR);Bacteria;Proteobacteria;Alphaproteobacteria;Rhizobiales;Ancalomicrobiaceae;Ancalomicrobium;";"0.0";"0";"4";"4";"0";"4";"0";"430520";"5766"
"LOK1378_1mm";"SILVA (only NR);Bacteria;Proteobacteria;Alphaproteobacteria;Rhizobiales;Beijerinckiaceae;";"0.0";"0";"1477";"1417";"0";"1417";"60";"429107";"5766"
"LOK1378_1mm";"SILVA (only NR);Bacteria;Proteobacteria;Alphaproteobacteria;Rhizobiales;Beijerinckiaceae;1174-901-12;";"0.0";"0";"62";"61";"0";"61";"1";"430463";"5766"
"LOK1378_1mm";"SILVA (only NR);Bacteria;Proteobacteria;Alphaproteobacteria;Rhizobiales;Beijerinckiaceae;28-YEA-48;";"0.0";"0";"2";"2";"0";"2";"0";"430522";"5766"
"LOK1378_1mm";"SILVA (only NR);Bacteria;Proteobacteria;Alphaproteobacteria;Rhizobiales;Beijerinckiaceae;Beijerinckia;";"0.0";"0";"23";"23";"0";"23";"0";"430501";"5766"
"LOK1378_1mm";"SILVA (only NR);Bacteria;Proteobacteria;Alphaproteobacteria;Rhizobiales;Beijerinckiaceae;Bosea;";"0.0";"0";"124";"122";"0";"122";"2";"430402";"5766"
"LOK1378_1mm";"SILVA (only NR);Bacteria;Proteobacteria;Alphaproteobacteria;Rhizobiales;Beijerinckiaceae;Camelimonas;";"0.0";"0";"9";"9";"0";"9";"0";"430515";"5766"
"LOK1378_1mm";"SILVA (only NR);Bacteria;Proteobacteria;Alphaproteobacteria;Rhizobiales;Beijerinckiaceae;Chelatococcus;";"0.0";"0";"21";"21";"0";"21";"0";"430503";"5766"
"LOK1378_1mm";"SILVA (only NR);Bacteria;Proteobacteria;Alphaproteobacteria;Rhizobiales;Beijerinckiaceae;FFCH5858;";"0.0";"0";"6";"6";"0";"6";"0";"430518";"5766"
"LOK1378_1mm";"SILVA (only NR);Bacteria;Proteobacteria;Alphaproteobacteria;Rhizobiales;Beijerinckiaceae;FukuN57;";"0.0";"0";"15";"15";"0";"15";"0";"430509";"5766"
"LOK1378_1mm";"SILVA (only NR);Bacteria;Proteobacteria;Alphaproteobacteria;Rhizobiales;Beijerinckiaceae;Methylobacterium-Methylorubrum;";"0.0";"0";"551";"520";"0";"520";"31";"430004";"5766"
"LOK1378_1mm";"SILVA (only NR);Bacteria;Proteobacteria;Alphaproteobacteria;Rhizobiales;Beijerinckiaceae;Methylocapsa;";"0.0";"0";"10";"6";"0";"6";"4";"430518";"5766"
"LOK1378_1mm";"SILVA (only NR);Bacteria;Proteobacteria;Alphaproteobacteria;Rhizobiales;Beijerinckiaceae;Methylocella;";"0.0";"0";"20";"20";"0";"20";"0";"430504";"5766"
"LOK1378_1mm";"SILVA (only NR);Bacteria;Proteobacteria;Alphaproteobacteria;Rhizobiales;Beijerinckiaceae;Methylocystis;";"0.0";"0";"56";"56";"0";"56";"0";"430468";"5766"
"LOK1378_1mm";"SILVA (only NR);Bacteria;Proteobacteria;Alphaproteobacteria;Rhizobiales;Beijerinckiaceae;Methyloferula;";"0.0";"0";"5";"3";"0";"3";"2";"430521";"5766"
"LOK1378_1mm";"SILVA (only NR);Bacteria;Proteobacteria;Alphaproteobacteria;Rhizobiales;Beijerinckiaceae;Methylorosula;";"0.0";"0";"24";"24";"0";"24";"0";"430500";"5766"
"LOK1378_1mm";"SILVA (only NR);Bacteria;Proteobacteria;Alphaproteobacteria;Rhizobiales;Beijerinckiaceae;Methylosinus;";"0.0";"0";"18";"17";"0";"17";"1";"430507";"5766"
"LOK1378_1mm";"SILVA (only NR);Bacteria;Proteobacteria;Alphaproteobacteria;Rhizobiales;Beijerinckiaceae;Methylovirgula;";"0.0";"0";"15";"15";"0";"15";"0";"430509";"5766"
"LOK1378_1mm";"SILVA (only NR);Bacteria;Proteobacteria;Alphaproteobacteria;Rhizobiales;Beijerinckiaceae;Microvirga;";"0.0";"0";"170";"162";"0";"162";"8";"430362";"5766"
"LOK1378_1mm";"SILVA (only NR);Bacteria;Proteobacteria;Alphaproteobacteria;Rhizobiales;Beijerinckiaceae;Neo-b11;";"0.0";"0";"3";"3";"0";"3";"0";"430521";"5766"
"LOK1378_1mm";"SILVA (only NR);Bacteria;Proteobacteria;Alphaproteobacteria;Rhizobiales;Beijerinckiaceae;Pseudochelatococcus;";"0.0";"0";"14";"14";"0";"14";"0";"430510";"5766"
"LOK1378_1mm";"SILVA (only NR);Bacteria;Proteobacteria;Alphaproteobacteria;Rhizobiales;Beijerinckiaceae;Psychroglaciecola;";"0.0";"0";"16";"16";"0";"16";"0";"430508";"5766"
"LOK1378_1mm";"SILVA (only NR);Bacteria;Proteobacteria;Alphaproteobacteria;Rhizobiales;Beijerinckiaceae;Qingshengfania;";"0.0";"0";"2";"2";"0";"2";"0";"430522";"5766"
"LOK1378_1mm";"SILVA (only NR);Bacteria;Proteobacteria;Alphaproteobacteria;Rhizobiales;Beijerinckiaceae;Rhodoblastus;";"0.0";"0";"15";"13";"0";"13";"2";"430511";"5766"
"LOK1378_1mm";"SILVA (only NR);Bacteria;Proteobacteria;Alphaproteobacteria;Rhizobiales;Beijerinckiaceae;Roseiarcus;";"0.0";"0";"48";"45";"0";"45";"3";"430479";"5766"
"LOK1378_1mm";"SILVA (only NR);Bacteria;Proteobacteria;Alphaproteobacteria;Rhizobiales;Beijerinckiaceae;Salinarimonas;";"0.0";"0";"14";"13";"0";"13";"1";"430511";"5766"
"LOK1378_1mm";"SILVA (only NR);Bacteria;Proteobacteria;Alphaproteobacteria;Rhizobiales;Beijerinckiaceae;alphaI cluster;";"0.0";"0";"50";"48";"0";"48";"2";"430476";"5766"
"LOK1378_1mm";"SILVA (only NR);Bacteria;Proteobacteria;Alphaproteobacteria;Rhizobiales;Beijerinckiaceae;uncultured;";"0.0";"0";"172";"169";"0";"169";"3";"430355";"5766"
"LOK1378_1mm";"SILVA (only NR);Bacteria;Proteobacteria;Alphaproteobacteria;Rhizobiales;C2U;";"0.0";"0";"20";"19";"0";"19";"1";"430505";"5766"
"LOK1378_1mm";"SILVA (only NR);Bacteria;Proteobacteria;Alphaproteobacteria;Rhizobiales;D05-2;";"0.0";"0";"41";"41";"0";"41";"0";"430483";"5766"
"LOK1378_1mm";"SILVA (only NR);Bacteria;Proteobacteria;Alphaproteobacteria;Rhizobiales;Devosiaceae;";"0.0";"0";"536";"530";"0";"530";"6";"429994";"5766"
"LOK1378_1mm";"SILVA (only NR);Bacteria;Proteobacteria;Alphaproteobacteria;Rhizobiales;Devosiaceae;Arsenicitalea;";"0.0";"0";"17";"16";"0";"16";"1";"430508";"5766"
"LOK1378_1mm";"SILVA (only NR);Bacteria;Proteobacteria;Alphaproteobacteria;Rhizobiales;Devosiaceae;Cucumibacter;";"0.0";"0";"4";"4";"0";"4";"0";"430520";"5766"
"LOK1378_1mm";"SILVA (only NR);Bacteria;Proteobacteria;Alphaproteobacteria;Rhizobiales;Devosiaceae;Devosia;";"0.0";"0";"384";"379";"0";"379";"5";"430145";"5766"
"LOK1378_1mm";"SILVA (only NR);Bacteria;Proteobacteria;Alphaproteobacteria;Rhizobiales;Devosiaceae;Maritalea;";"0.0";"0";"13";"13";"0";"13";"0";"430511";"5766"
"LOK1378_1mm";"SILVA (only NR);Bacteria;Proteobacteria;Alphaproteobacteria;Rhizobiales;Devosiaceae;Methyloterrigena;";"0.0";"0";"2";"2";"0";"2";"0";"430522";"5766"
"LOK1378_1mm";"SILVA (only NR);Bacteria;Proteobacteria;Alphaproteobacteria;Rhizobiales;Devosiaceae;Paradevosia;";"0.0";"0";"2";"2";"0";"2";"0";"430522";"5766"
"LOK1378_1mm";"SILVA (only NR);Bacteria;Proteobacteria;Alphaproteobacteria;Rhizobiales;Devosiaceae;Pelagibacterium;";"0.0";"0";"43";"43";"0";"43";"0";"430481";"5766"
"LOK1378_1mm";"SILVA (only NR);Bacteria;Proteobacteria;Alphaproteobacteria;Rhizobiales;Devosiaceae;Youhaiella;";"0.0";"0";"2";"2";"0";"2";"0";"430522";"5766"
"LOK1378_1mm";"SILVA (only NR);Bacteria;Proteobacteria;Alphaproteobacteria;Rhizobiales;Devosiaceae;uncultured;";"0.0";"0";"65";"65";"0";"65";"0";"430459";"5766"
"LOK1378_1mm";"SILVA (only NR);Bacteria;Proteobacteria;Alphaproteobacteria;Rhizobiales;Hyphomicrobiaceae;";"0.0";"0";"583";"564";"0";"564";"19";"429960";"5766"
"LOK1378_1mm";"SILVA (only NR);Bacteria;Proteobacteria;Alphaproteobacteria;Rhizobiales;Hyphomicrobiaceae;Filomicrobium;";"0.0";"0";"71";"71";"0";"71";"0";"430453";"5766"
"LOK1378_1mm";"SILVA (only NR);Bacteria;Proteobacteria;Alphaproteobacteria;Rhizobiales;Hyphomicrobiaceae;Hyphomicrobium;";"0.0";"0";"300";"291";"0";"291";"9";"430233";"5766"
"LOK1378_1mm";"SILVA (only NR);Bacteria;Proteobacteria;Alphaproteobacteria;Rhizobiales;Hyphomicrobiaceae;Pedomicrobium;";"0.0";"0";"163";"156";"0";"156";"7";"430368";"5766"
"LOK1378_1mm";"SILVA (only NR);Bacteria;Proteobacteria;Alphaproteobacteria;Rhizobiales;Hyphomicrobiaceae;uncultured;";"0.0";"0";"48";"45";"0";"45";"3";"430479";"5766"
"LOK1378_1mm";"SILVA (only NR);Bacteria;Proteobacteria;Alphaproteobacteria;Rhizobiales;KF-JG30-B3;";"0.0";"0";"64";"60";"0";"60";"4";"430464";"5766"
"LOK1378_1mm";"SILVA (only NR);Bacteria;Proteobacteria;Alphaproteobacteria;Rhizobiales;Kaistiaceae;";"0.0";"0";"25";"25";"0";"25";"0";"430499";"5766"
"LOK1378_1mm";"SILVA (only NR);Bacteria;Proteobacteria;Alphaproteobacteria;Rhizobiales;Kaistiaceae;Kaistia;";"0.0";"0";"25";"25";"0";"25";"0";"430499";"5766"
"LOK1378_1mm";"SILVA (only NR);Bacteria;Proteobacteria;Alphaproteobacteria;Rhizobiales;Labraceae;";"0.0";"0";"53";"52";"0";"52";"1";"430472";"5766"
"LOK1378_1mm";"SILVA (only NR);Bacteria;Proteobacteria;Alphaproteobacteria;Rhizobiales;Labraceae;Labrys;";"0.0";"0";"53";"52";"0";"52";"1";"430472";"5766"
"LOK1378_1mm";"SILVA (only NR);Bacteria;Proteobacteria;Alphaproteobacteria;Rhizobiales;Lutibaculaceae;";"0.0";"0";"3";"3";"0";"3";"0";"430521";"5766"
"LOK1378_1mm";"SILVA (only NR);Bacteria;Proteobacteria;Alphaproteobacteria;Rhizobiales;Lutibaculaceae;Lutibaculum;";"0.0";"0";"3";"3";"0";"3";"0";"430521";"5766"
"LOK1378_1mm";"SILVA (only NR);Bacteria;Proteobacteria;Alphaproteobacteria;Rhizobiales;Methyloligellaceae;";"0.0";"0";"226";"220";"0";"220";"6";"430304";"5766"
"LOK1378_1mm";"SILVA (only NR);Bacteria;Proteobacteria;Alphaproteobacteria;Rhizobiales;Methyloligellaceae;Methyloceanibacter;";"0.0";"0";"33";"32";"0";"32";"1";"430492";"5766"
"LOK1378_1mm";"SILVA (only NR);Bacteria;Proteobacteria;Alphaproteobacteria;Rhizobiales;Methyloligellaceae;Methyloligella;";"0.0";"0";"2";"2";"0";"2";"0";"430522";"5766"
"LOK1378_1mm";"SILVA (only NR);Bacteria;Proteobacteria;Alphaproteobacteria;Rhizobiales;Methyloligellaceae;Rhodobium;";"0.0";"0";"4";"4";"0";"4";"0";"430520";"5766"
"LOK1378_1mm";"SILVA (only NR);Bacteria;Proteobacteria;Alphaproteobacteria;Rhizobiales;Methyloligellaceae;uncultured;";"0.0";"0";"180";"175";"0";"175";"5";"430349";"5766"
"LOK1378_1mm";"SILVA (only NR);Bacteria;Proteobacteria;Alphaproteobacteria;Rhizobiales;Methylopilaceae;";"0.0";"0";"27";"27";"0";"27";"0";"430497";"5766"
"LOK1378_1mm";"SILVA (only NR);Bacteria;Proteobacteria;Alphaproteobacteria;Rhizobiales;Methylopilaceae;Albibacter;";"0.0";"0";"4";"4";"0";"4";"0";"430520";"5766"
"LOK1378_1mm";"SILVA (only NR);Bacteria;Proteobacteria;Alphaproteobacteria;Rhizobiales;Methylopilaceae;Hansschlegelia;";"0.0";"0";"10";"10";"0";"10";"0";"430514";"5766"
"LOK1378_1mm";"SILVA (only NR);Bacteria;Proteobacteria;Alphaproteobacteria;Rhizobiales;Methylopilaceae;Methylopila;";"0.0";"0";"9";"9";"0";"9";"0";"430515";"5766"
"LOK1378_1mm";"SILVA (only NR);Bacteria;Proteobacteria;Alphaproteobacteria;Rhizobiales;Methylopilaceae;uncultured;";"0.0";"0";"2";"2";"0";"2";"0";"430522";"5766"
"LOK1378_1mm";"SILVA (only NR);Bacteria;Proteobacteria;Alphaproteobacteria;Rhizobiales;Pleomorphomonadaceae;";"0.0";"0";"60";"58";"0";"58";"2";"430466";"5766"
"LOK1378_1mm";"SILVA (only NR);Bacteria;Proteobacteria;Alphaproteobacteria;Rhizobiales;Pleomorphomonadaceae;Chthonobacter;";"0.0";"0";"16";"16";"0";"16";"0";"430508";"5766"
"LOK1378_1mm";"SILVA (only NR);Bacteria;Proteobacteria;Alphaproteobacteria;Rhizobiales;Pleomorphomonadaceae;Hartmannibacter;";"0.0";"0";"2";"2";"0";"2";"0";"430522";"5766"
"LOK1378_1mm";"SILVA (only NR);Bacteria;Proteobacteria;Alphaproteobacteria;Rhizobiales;Pleomorphomonadaceae;Methylobrevis;";"0.0";"0";"1";"1";"0";"1";"0";"430523";"5766"
"LOK1378_1mm";"SILVA (only NR);Bacteria;Proteobacteria;Alphaproteobacteria;Rhizobiales;Pleomorphomonadaceae;Pleomorphomonas;";"0.0";"0";"15";"14";"0";"14";"1";"430510";"5766"
"LOK1378_1mm";"SILVA (only NR);Bacteria;Proteobacteria;Alphaproteobacteria;Rhizobiales;Pleomorphomonadaceae;Prosthecomicrobium;";"0.0";"0";"10";"10";"0";"10";"0";"430514";"5766"
"LOK1378_1mm";"SILVA (only NR);Bacteria;Proteobacteria;Alphaproteobacteria;Rhizobiales;Pleomorphomonadaceae;uncultured;";"0.0";"0";"16";"15";"0";"15";"1";"430509";"5766"
"LOK1378_1mm";"SILVA (only NR);Bacteria;Proteobacteria;Alphaproteobacteria;Rhizobiales;Rhizobiaceae;";"0.0";"0";"4735";"4628";"0";"4628";"107";"425896";"5766"
"LOK1378_1mm";"SILVA (only NR);Bacteria;Proteobacteria;Alphaproteobacteria;Rhizobiales;Rhizobiaceae;Ahrensia;";"0.0";"0";"10";"9";"0";"9";"1";"430515";"5766"
"LOK1378_1mm";"SILVA (only NR);Bacteria;Proteobacteria;Alphaproteobacteria;Rhizobiales;Rhizobiaceae;Aliihoeflea;";"0.0";"0";"10";"10";"0";"10";"0";"430514";"5766"
"LOK1378_1mm";"SILVA (only NR);Bacteria;Proteobacteria;Alphaproteobacteria;Rhizobiales;Rhizobiaceae;Allorhizobium-Neorhizobium-Pararhizobium-Rhizobium;";"0.0";"0";"1660";"1604";"0";"1604";"56";"428920";"5766"
"LOK1378_1mm";"SILVA (only NR);Bacteria;Proteobacteria;Alphaproteobacteria;Rhizobiales;Rhizobiaceae;Aminobacter;";"0.0";"0";"89";"88";"0";"88";"1";"430436";"5766"
"LOK1378_1mm";"SILVA (only NR);Bacteria;Proteobacteria;Alphaproteobacteria;Rhizobiales;Rhizobiaceae;Aquamicrobium;";"0.0";"0";"44";"44";"0";"44";"0";"430480";"5766"
"LOK1378_1mm";"SILVA (only NR);Bacteria;Proteobacteria;Alphaproteobacteria;Rhizobiales;Rhizobiaceae;Aurantimonas;";"0.0";"0";"13";"13";"0";"13";"0";"430511";"5766"
"LOK1378_1mm";"SILVA (only NR);Bacteria;Proteobacteria;Alphaproteobacteria;Rhizobiales;Rhizobiaceae;Aureimonas;";"0.0";"0";"62";"62";"0";"62";"0";"430462";"5766"
"LOK1378_1mm";"SILVA (only NR);Bacteria;Proteobacteria;Alphaproteobacteria;Rhizobiales;Rhizobiaceae;Bartonella;";"0.0";"0";"135";"135";"0";"135";"0";"430389";"5766"
"LOK1378_1mm";"SILVA (only NR);Bacteria;Proteobacteria;Alphaproteobacteria;Rhizobiales;Rhizobiaceae;Brucella;";"0.0";"0";"383";"383";"0";"383";"0";"430141";"5766"
"LOK1378_1mm";"SILVA (only NR);Bacteria;Proteobacteria;Alphaproteobacteria;Rhizobiales;Rhizobiaceae;Candidatus Hodgkinia;";"0.0";"0";"173";"173";"0";"173";"0";"430351";"5766"
"LOK1378_1mm";"SILVA (only NR);Bacteria;Proteobacteria;Alphaproteobacteria;Rhizobiales;Rhizobiaceae;Candidatus Liberibacter;";"0.0";"0";"21";"21";"0";"21";"0";"430503";"5766"
"LOK1378_1mm";"SILVA (only NR);Bacteria;Proteobacteria;Alphaproteobacteria;Rhizobiales;Rhizobiaceae;Candidatus Tokpelaia;";"0.0";"0";"1";"1";"0";"1";"0";"430523";"5766"
"LOK1378_1mm";"SILVA (only NR);Bacteria;Proteobacteria;Alphaproteobacteria;Rhizobiales;Rhizobiaceae;Chelativorans;";"0.0";"0";"20";"20";"0";"20";"0";"430504";"5766"
"LOK1378_1mm";"SILVA (only NR);Bacteria;Proteobacteria;Alphaproteobacteria;Rhizobiales;Rhizobiaceae;Ciceribacter;";"0.0";"0";"14";"12";"0";"12";"2";"430512";"5766"
"LOK1378_1mm";"SILVA (only NR);Bacteria;Proteobacteria;Alphaproteobacteria;Rhizobiales;Rhizobiaceae;Cohaesibacter;";"0.0";"0";"49";"49";"0";"49";"0";"430475";"5766"
"LOK1378_1mm";"SILVA (only NR);Bacteria;Proteobacteria;Alphaproteobacteria;Rhizobiales;Rhizobiaceae;Corticibacterium;";"0.0";"0";"3";"3";"0";"3";"0";"430521";"5766"
"LOK1378_1mm";"SILVA (only NR);Bacteria;Proteobacteria;Alphaproteobacteria;Rhizobiales;Rhizobiaceae;Daeguia;";"0.0";"0";"1";"1";"0";"1";"0";"430523";"5766"
"LOK1378_1mm";"SILVA (only NR);Bacteria;Proteobacteria;Alphaproteobacteria;Rhizobiales;Rhizobiaceae;Ensifer;";"0.0";"0";"409";"398";"0";"398";"11";"430126";"5766"
"LOK1378_1mm";"SILVA (only NR);Bacteria;Proteobacteria;Alphaproteobacteria;Rhizobiales;Rhizobiaceae;Falsochrobactrum;";"0.0";"0";"23";"22";"0";"22";"1";"430502";"5766"
"LOK1378_1mm";"SILVA (only NR);Bacteria;Proteobacteria;Alphaproteobacteria;Rhizobiales;Rhizobiaceae;Fulvimarina;";"0.0";"0";"8";"8";"0";"8";"0";"430516";"5766"
"LOK1378_1mm";"SILVA (only NR);Bacteria;Proteobacteria;Alphaproteobacteria;Rhizobiales;Rhizobiaceae;Hoeflea;";"0.0";"0";"27";"27";"0";"27";"0";"430497";"5766"
"LOK1378_1mm";"SILVA (only NR);Bacteria;Proteobacteria;Alphaproteobacteria;Rhizobiales;Rhizobiaceae;Jiella;";"0.0";"0";"4";"4";"0";"4";"0";"430520";"5766"
"LOK1378_1mm";"SILVA (only NR);Bacteria;Proteobacteria;Alphaproteobacteria;Rhizobiales;Rhizobiaceae;Lentilitoribacter;";"0.0";"0";"8";"8";"0";"8";"0";"430516";"5766"
"LOK1378_1mm";"SILVA (only NR);Bacteria;Proteobacteria;Alphaproteobacteria;Rhizobiales;Rhizobiaceae;Martelella;";"0.0";"0";"29";"29";"0";"29";"0";"430495";"5766"
"LOK1378_1mm";"SILVA (only NR);Bacteria;Proteobacteria;Alphaproteobacteria;Rhizobiales;Rhizobiaceae;Mesorhizobium;";"0.0";"0";"548";"541";"0";"541";"7";"429983";"5766"
"LOK1378_1mm";"SILVA (only NR);Bacteria;Proteobacteria;Alphaproteobacteria;Rhizobiales;Rhizobiaceae;Mycoplana;";"0.0";"0";"8";"8";"0";"8";"0";"430516";"5766"
"LOK1378_1mm";"SILVA (only NR);Bacteria;Proteobacteria;Alphaproteobacteria;Rhizobiales;Rhizobiaceae;Neorhizobium;";"0.0";"0";"19";"18";"0";"18";"1";"430506";"5766"
"LOK1378_1mm";"SILVA (only NR);Bacteria;Proteobacteria;Alphaproteobacteria;Rhizobiales;Rhizobiaceae;Nitratireductor;";"0.0";"0";"104";"102";"0";"102";"2";"430422";"5766"
"LOK1378_1mm";"SILVA (only NR);Bacteria;Proteobacteria;Alphaproteobacteria;Rhizobiales;Rhizobiaceae;Ochrobactrum;";"0.0";"0";"308";"296";"0";"296";"12";"430228";"5766"
"LOK1378_1mm";"SILVA (only NR);Bacteria;Proteobacteria;Alphaproteobacteria;Rhizobiales;Rhizobiaceae;Oricola;";"0.0";"0";"4";"4";"0";"4";"0";"430520";"5766"
"LOK1378_1mm";"SILVA (only NR);Bacteria;Proteobacteria;Alphaproteobacteria;Rhizobiales;Rhizobiaceae;Paenochrobactrum;";"0.0";"0";"14";"14";"0";"14";"0";"430510";"5766"
"LOK1378_1mm";"SILVA (only NR);Bacteria;Proteobacteria;Alphaproteobacteria;Rhizobiales;Rhizobiaceae;Paramesorhizobium;";"0.0";"0";"5";"5";"0";"5";"0";"430519";"5766"
"LOK1378_1mm";"SILVA (only NR);Bacteria;Proteobacteria;Alphaproteobacteria;Rhizobiales;Rhizobiaceae;Phyllobacterium;";"0.0";"0";"106";"103";"0";"103";"3";"430421";"5766"
"LOK1378_1mm";"SILVA (only NR);Bacteria;Proteobacteria;Alphaproteobacteria;Rhizobiales;Rhizobiaceae;Pseudahrensia;";"0.0";"0";"50";"48";"0";"48";"2";"430476";"5766"
"LOK1378_1mm";"SILVA (only NR);Bacteria;Proteobacteria;Alphaproteobacteria;Rhizobiales;Rhizobiaceae;Pseudaminobacter;";"0.0";"0";"51";"51";"0";"51";"0";"430473";"5766"
"LOK1378_1mm";"SILVA (only NR);Bacteria;Proteobacteria;Alphaproteobacteria;Rhizobiales;Rhizobiaceae;Pseudochrobactrum;";"0.0";"0";"40";"39";"0";"39";"1";"430485";"5766"
"LOK1378_1mm";"SILVA (only NR);Bacteria;Proteobacteria;Alphaproteobacteria;Rhizobiales;Rhizobiaceae;Pseudohoeflea;";"0.0";"0";"3";"3";"0";"3";"0";"430521";"5766"
"LOK1378_1mm";"SILVA (only NR);Bacteria;Proteobacteria;Alphaproteobacteria;Rhizobiales;Rhizobiaceae;Pseudorhizobium;";"0.0";"0";"5";"4";"0";"4";"1";"430520";"5766"
"LOK1378_1mm";"SILVA (only NR);Bacteria;Proteobacteria;Alphaproteobacteria;Rhizobiales;Rhizobiaceae;Roseitalea;";"0.0";"0";"10";"10";"0";"10";"0";"430514";"5766"
"LOK1378_1mm";"SILVA (only NR);Bacteria;Proteobacteria;Alphaproteobacteria;Rhizobiales;Rhizobiaceae;Shinella;";"0.0";"0";"63";"62";"0";"62";"1";"430462";"5766"
"LOK1378_1mm";"SILVA (only NR);Bacteria;Proteobacteria;Alphaproteobacteria;Rhizobiales;Rhizobiaceae;Tianweitania;";"0.0";"0";"6";"6";"0";"6";"0";"430518";"5766"
"LOK1378_1mm";"SILVA (only NR);Bacteria;Proteobacteria;Alphaproteobacteria;Rhizobiales;Rhizobiaceae;[Rhizobium] sphaerophysae group;";"0.0";"0";"5";"5";"0";"5";"0";"430519";"5766"
"LOK1378_1mm";"SILVA (only NR);Bacteria;Proteobacteria;Alphaproteobacteria;Rhizobiales;Rhizobiaceae;uncultured;";"0.0";"0";"152";"149";"0";"149";"3";"430375";"5766"
"LOK1378_1mm";"SILVA (only NR);Bacteria;Proteobacteria;Alphaproteobacteria;Rhizobiales;Rhizobiales Incertae Sedis;";"0.0";"0";"433";"417";"0";"417";"16";"430107";"5766"
"LOK1378_1mm";"SILVA (only NR);Bacteria;Proteobacteria;Alphaproteobacteria;Rhizobiales;Rhizobiales Incertae Sedis;Alsobacter;";"0.0";"0";"5";"4";"0";"4";"1";"430520";"5766"
"LOK1378_1mm";"SILVA (only NR);Bacteria;Proteobacteria;Alphaproteobacteria;Rhizobiales;Rhizobiales Incertae Sedis;Anderseniella;";"0.0";"0";"22";"22";"0";"22";"0";"430502";"5766"
"LOK1378_1mm";"SILVA (only NR);Bacteria;Proteobacteria;Alphaproteobacteria;Rhizobiales;Rhizobiales Incertae Sedis;Bauldia;";"0.0";"0";"103";"99";"0";"99";"4";"430425";"5766"
"LOK1378_1mm";"SILVA (only NR);Bacteria;Proteobacteria;Alphaproteobacteria;Rhizobiales;Rhizobiales Incertae Sedis;Dichotomicrobium;";"0.0";"0";"57";"55";"0";"55";"2";"430469";"5766"
"LOK1378_1mm";"SILVA (only NR);Bacteria;Proteobacteria;Alphaproteobacteria;Rhizobiales;Rhizobiales Incertae Sedis;Nordella;";"0.0";"0";"56";"53";"0";"53";"3";"430471";"5766"
"LOK1378_1mm";"SILVA (only NR);Bacteria;Proteobacteria;Alphaproteobacteria;Rhizobiales;Rhizobiales Incertae Sedis;Phreatobacter;";"0.0";"0";"49";"48";"0";"48";"1";"430476";"5766"
"LOK1378_1mm";"SILVA (only NR);Bacteria;Proteobacteria;Alphaproteobacteria;Rhizobiales;Rhizobiales Incertae Sedis;uncultured;";"0.0";"0";"140";"135";"0";"135";"5";"430389";"5766"
"LOK1378_1mm";"SILVA (only NR);Bacteria;Proteobacteria;Alphaproteobacteria;Rhizobiales;Rhodobiaceae;";"0.0";"0";"33";"33";"0";"33";"0";"430491";"5766"
"LOK1378_1mm";"SILVA (only NR);Bacteria;Proteobacteria;Alphaproteobacteria;Rhizobiales;Rhodobiaceae;Afifella;";"0.0";"0";"16";"16";"0";"16";"0";"430508";"5766"
"LOK1378_1mm";"SILVA (only NR);Bacteria;Proteobacteria;Alphaproteobacteria;Rhizobiales;Rhodobiaceae;Amorphus;";"0.0";"0";"6";"6";"0";"6";"0";"430518";"5766"
"LOK1378_1mm";"SILVA (only NR);Bacteria;Proteobacteria;Alphaproteobacteria;Rhizobiales;Rhodobiaceae;Tepidamorphus;";"0.0";"0";"11";"11";"0";"11";"0";"430513";"5766"
"LOK1378_1mm";"SILVA (only NR);Bacteria;Proteobacteria;Alphaproteobacteria;Rhizobiales;Rhodomicrobiaceae;";"0.0";"0";"64";"63";"0";"63";"1";"430461";"5766"
"LOK1378_1mm";"SILVA (only NR);Bacteria;Proteobacteria;Alphaproteobacteria;Rhizobiales;Rhodomicrobiaceae;Rhodomicrobium;";"0.0";"0";"64";"63";"0";"63";"1";"430461";"5766"
"LOK1378_1mm";"SILVA (only NR);Bacteria;Proteobacteria;Alphaproteobacteria;Rhizobiales;Stappiaceae;";"0.0";"0";"219";"208";"0";"208";"11";"430316";"5766"
"LOK1378_1mm";"SILVA (only NR);Bacteria;Proteobacteria;Alphaproteobacteria;Rhizobiales;Stappiaceae;Agaricicola;";"0.0";"0";"3";"3";"0";"3";"0";"430521";"5766"
"LOK1378_1mm";"SILVA (only NR);Bacteria;Proteobacteria;Alphaproteobacteria;Rhizobiales;Stappiaceae;Breoghania;";"0.0";"0";"6";"6";"0";"6";"0";"430518";"5766"
"LOK1378_1mm";"SILVA (only NR);Bacteria;Proteobacteria;Alphaproteobacteria;Rhizobiales;Stappiaceae;Labrenzia;";"0.0";"0";"81";"78";"0";"78";"3";"430446";"5766"
"LOK1378_1mm";"SILVA (only NR);Bacteria;Proteobacteria;Alphaproteobacteria;Rhizobiales;Stappiaceae;Nesiotobacter;";"0.0";"0";"2";"2";"0";"2";"0";"430522";"5766"
"LOK1378_1mm";"SILVA (only NR);Bacteria;Proteobacteria;Alphaproteobacteria;Rhizobiales;Stappiaceae;Pannonibacter;";"0.0";"0";"31";"30";"0";"30";"1";"430494";"5766"
"LOK1378_1mm";"SILVA (only NR);Bacteria;Proteobacteria;Alphaproteobacteria;Rhizobiales;Stappiaceae;Polymorphum;";"0.0";"0";"1";"1";"0";"1";"0";"430523";"5766"
"LOK1378_1mm";"SILVA (only NR);Bacteria;Proteobacteria;Alphaproteobacteria;Rhizobiales;Stappiaceae;Pseudovibrio;";"0.0";"0";"62";"55";"0";"55";"7";"430469";"5766"
"LOK1378_1mm";"SILVA (only NR);Bacteria;Proteobacteria;Alphaproteobacteria;Rhizobiales;Stappiaceae;Rhodothalassium;";"0.0";"0";"6";"6";"0";"6";"0";"430518";"5766"
"LOK1378_1mm";"SILVA (only NR);Bacteria;Proteobacteria;Alphaproteobacteria;Rhizobiales;Stappiaceae;Roseibium;";"0.0";"0";"6";"6";"0";"6";"0";"430518";"5766"
"LOK1378_1mm";"SILVA (only NR);Bacteria;Proteobacteria;Alphaproteobacteria;Rhizobiales;Stappiaceae;Stappia;";"0.0";"0";"17";"17";"0";"17";"0";"430507";"5766"
"LOK1378_1mm";"SILVA (only NR);Bacteria;Proteobacteria;Alphaproteobacteria;Rhizobiales;Thermopetrobacteraceae;";"0.0";"0";"10";"9";"0";"9";"1";"430515";"5766"
"LOK1378_1mm";"SILVA (only NR);Bacteria;Proteobacteria;Alphaproteobacteria;Rhizobiales;Thermopetrobacteraceae;Thermopetrobacter;";"0.0";"0";"10";"9";"0";"9";"1";"430515";"5766"
"LOK1378_1mm";"SILVA (only NR);Bacteria;Proteobacteria;Alphaproteobacteria;Rhizobiales;WC3-116;";"0.0";"0";"2";"2";"0";"2";"0";"430522";"5766"
"LOK1378_1mm";"SILVA (only NR);Bacteria;Proteobacteria;Alphaproteobacteria;Rhizobiales;Xanthobacteraceae;";"0.0";"0";"2003";"1943";"0";"1943";"60";"428581";"5766"
"LOK1378_1mm";"SILVA (only NR);Bacteria;Proteobacteria;Alphaproteobacteria;Rhizobiales;Xanthobacteraceae;Afipia;";"0.0";"0";"82";"78";"0";"78";"4";"430446";"5766"
"LOK1378_1mm";"SILVA (only NR);Bacteria;Proteobacteria;Alphaproteobacteria;Rhizobiales;Xanthobacteraceae;Ancylobacter;";"0.0";"0";"31";"30";"0";"30";"1";"430494";"5766"
"LOK1378_1mm";"SILVA (only NR);Bacteria;Proteobacteria;Alphaproteobacteria;Rhizobiales;Xanthobacteraceae;Angulomicrobium;";"0.0";"0";"2";"2";"0";"2";"0";"430522";"5766"
"LOK1378_1mm";"SILVA (only NR);Bacteria;Proteobacteria;Alphaproteobacteria;Rhizobiales;Xanthobacteraceae;Aquabacter;";"0.0";"0";"1";"1";"0";"1";"0";"430523";"5766"
"LOK1378_1mm";"SILVA (only NR);Bacteria;Proteobacteria;Alphaproteobacteria;Rhizobiales;Xanthobacteraceae;Azorhizobium;";"0.0";"0";"20";"20";"0";"20";"0";"430504";"5766"
"LOK1378_1mm";"SILVA (only NR);Bacteria;Proteobacteria;Alphaproteobacteria;Rhizobiales;Xanthobacteraceae;Blastochloris;";"0.0";"0";"17";"17";"0";"17";"0";"430507";"5766"
"LOK1378_1mm";"SILVA (only NR);Bacteria;Proteobacteria;Alphaproteobacteria;Rhizobiales;Xanthobacteraceae;Bradyrhizobium;";"0.0";"0";"804";"781";"0";"781";"23";"429743";"5766"
"LOK1378_1mm";"SILVA (only NR);Bacteria;Proteobacteria;Alphaproteobacteria;Rhizobiales;Xanthobacteraceae;Methylorhabdus;";"0.0";"0";"2";"2";"0";"2";"0";"430522";"5766"
"LOK1378_1mm";"SILVA (only NR);Bacteria;Proteobacteria;Alphaproteobacteria;Rhizobiales;Xanthobacteraceae;Nitrobacter;";"0.0";"0";"22";"22";"0";"22";"0";"430502";"5766"
"LOK1378_1mm";"SILVA (only NR);Bacteria;Proteobacteria;Alphaproteobacteria;Rhizobiales;Xanthobacteraceae;Oligotropha;";"0.0";"0";"6";"6";"0";"6";"0";"430518";"5766"
"LOK1378_1mm";"SILVA (only NR);Bacteria;Proteobacteria;Alphaproteobacteria;Rhizobiales;Xanthobacteraceae;Pseudolabrys;";"0.0";"0";"150";"147";"0";"147";"3";"430377";"5766"
"LOK1378_1mm";"SILVA (only NR);Bacteria;Proteobacteria;Alphaproteobacteria;Rhizobiales;Xanthobacteraceae;Pseudorhodoplanes;";"0.0";"0";"36";"33";"0";"33";"3";"430491";"5766"
"LOK1378_1mm";"SILVA (only NR);Bacteria;Proteobacteria;Alphaproteobacteria;Rhizobiales;Xanthobacteraceae;Pseudoxanthobacter;";"0.0";"0";"6";"6";"0";"6";"0";"430518";"5766"
"LOK1378_1mm";"SILVA (only NR);Bacteria;Proteobacteria;Alphaproteobacteria;Rhizobiales;Xanthobacteraceae;Rhodoplanes;";"0.0";"0";"105";"103";"0";"103";"2";"430421";"5766"
"LOK1378_1mm";"SILVA (only NR);Bacteria;Proteobacteria;Alphaproteobacteria;Rhizobiales;Xanthobacteraceae;Rhodopseudomonas;";"0.0";"0";"114";"109";"0";"109";"5";"430415";"5766"
"LOK1378_1mm";"SILVA (only NR);Bacteria;Proteobacteria;Alphaproteobacteria;Rhizobiales;Xanthobacteraceae;Starkeya;";"0.0";"0";"13";"13";"0";"13";"0";"430511";"5766"
"LOK1378_1mm";"SILVA (only NR);Bacteria;Proteobacteria;Alphaproteobacteria;Rhizobiales;Xanthobacteraceae;Tardiphaga;";"0.0";"0";"17";"17";"0";"17";"0";"430507";"5766"
"LOK1378_1mm";"SILVA (only NR);Bacteria;Proteobacteria;Alphaproteobacteria;Rhizobiales;Xanthobacteraceae;Variibacter;";"0.0";"0";"4";"4";"0";"4";"0";"430520";"5766"
"LOK1378_1mm";"SILVA (only NR);Bacteria;Proteobacteria;Alphaproteobacteria;Rhizobiales;Xanthobacteraceae;Xanthobacter;";"0.0";"0";"43";"41";"0";"41";"2";"430483";"5766"
"LOK1378_1mm";"SILVA (only NR);Bacteria;Proteobacteria;Alphaproteobacteria;Rhizobiales;Xanthobacteraceae;uncultured;";"0.0";"0";"503";"486";"0";"486";"17";"430038";"5766"
"LOK1378_1mm";"SILVA (only NR);Bacteria;Proteobacteria;Alphaproteobacteria;Rhizobiales;uncultured;";"0.0";"0";"110";"109";"0";"109";"1";"430415";"5766"
"LOK1378_1mm";"SILVA (only NR);Bacteria;Proteobacteria;Alphaproteobacteria;Rhodobacterales;";"0.0";"0";"5419";"5306";"0";"5306";"113";"425218";"5766"
"LOK1378_1mm";"SILVA (only NR);Bacteria;Proteobacteria;Alphaproteobacteria;Rhodobacterales;Rhodobacteraceae;";"0.0";"0";"5419";"5306";"0";"5306";"113";"425218";"5766"
"LOK1378_1mm";"SILVA (only NR);Bacteria;Proteobacteria;Alphaproteobacteria;Rhodobacterales;Rhodobacteraceae;Actibacterium;";"0.0";"0";"25";"24";"0";"24";"1";"430500";"5766"
"LOK1378_1mm";"SILVA (only NR);Bacteria;Proteobacteria;Alphaproteobacteria;Rhodobacterales;Rhodobacteraceae;Aestuariibius;";"0.0";"0";"2";"2";"0";"2";"0";"430522";"5766"
"LOK1378_1mm";"SILVA (only NR);Bacteria;Proteobacteria;Alphaproteobacteria;Rhodobacterales;Rhodobacteraceae;Aestuariicoccus;";"0.0";"0";"21";"20";"0";"20";"1";"430504";"5766"
"LOK1378_1mm";"SILVA (only NR);Bacteria;Proteobacteria;Alphaproteobacteria;Rhodobacterales;Rhodobacteraceae;Aestuariihabitans;";"0.0";"0";"2";"2";"0";"2";"0";"430522";"5766"
"LOK1378_1mm";"SILVA (only NR);Bacteria;Proteobacteria;Alphaproteobacteria;Rhodobacterales;Rhodobacteraceae;Aestuariivita;";"0.0";"0";"1";"1";"0";"1";"0";"430523";"5766"
"LOK1378_1mm";"SILVA (only NR);Bacteria;Proteobacteria;Alphaproteobacteria;Rhodobacterales;Rhodobacteraceae;Albidovulum;";"0.0";"0";"21";"20";"0";"20";"1";"430504";"5766"
"LOK1378_1mm";"SILVA (only NR);Bacteria;Proteobacteria;Alphaproteobacteria;Rhodobacterales;Rhodobacteraceae;Albimonas;";"0.0";"0";"12";"12";"0";"12";"0";"430512";"5766"
"LOK1378_1mm";"SILVA (only NR);Bacteria;Proteobacteria;Alphaproteobacteria;Rhodobacterales;Rhodobacteraceae;Albirhodobacter;";"0.0";"0";"12";"12";"0";"12";"0";"430512";"5766"
"LOK1378_1mm";"SILVA (only NR);Bacteria;Proteobacteria;Alphaproteobacteria;Rhodobacterales;Rhodobacteraceae;Aliiroseovarius;";"0.0";"0";"34";"32";"0";"32";"2";"430492";"5766"
"LOK1378_1mm";"SILVA (only NR);Bacteria;Proteobacteria;Alphaproteobacteria;Rhodobacterales;Rhodobacteraceae;Amaricoccus;";"0.0";"0";"47";"45";"0";"45";"2";"430479";"5766"
"LOK1378_1mm";"SILVA (only NR);Bacteria;Proteobacteria;Alphaproteobacteria;Rhodobacterales;Rhodobacteraceae;Amylibacter;";"0.0";"0";"62";"61";"0";"61";"1";"430463";"5766"
"LOK1378_1mm";"SILVA (only NR);Bacteria;Proteobacteria;Alphaproteobacteria;Rhodobacterales;Rhodobacteraceae;Antarctobacter;";"0.0";"0";"8";"8";"0";"8";"0";"430516";"5766"
"LOK1378_1mm";"SILVA (only NR);Bacteria;Proteobacteria;Alphaproteobacteria;Rhodobacterales;Rhodobacteraceae;Aquimixticola;";"0.0";"0";"4";"4";"0";"4";"0";"430520";"5766"
"LOK1378_1mm";"SILVA (only NR);Bacteria;Proteobacteria;Alphaproteobacteria;Rhodobacterales;Rhodobacteraceae;Ascidiaceihabitans;";"0.0";"0";"48";"48";"0";"48";"0";"430476";"5766"
"LOK1378_1mm";"SILVA (only NR);Bacteria;Proteobacteria;Alphaproteobacteria;Rhodobacterales;Rhodobacteraceae;Boseongicola;";"0.0";"0";"7";"7";"0";"7";"0";"430517";"5766"
"LOK1378_1mm";"SILVA (only NR);Bacteria;Proteobacteria;Alphaproteobacteria;Rhodobacterales;Rhodobacteraceae;Brevirhabdus;";"0.0";"0";"4";"4";"0";"4";"0";"430520";"5766"
"LOK1378_1mm";"SILVA (only NR);Bacteria;Proteobacteria;Alphaproteobacteria;Rhodobacterales;Rhodobacteraceae;Celeribacter;";"0.0";"0";"35";"34";"0";"34";"1";"430490";"5766"
"LOK1378_1mm";"SILVA (only NR);Bacteria;Proteobacteria;Alphaproteobacteria;Rhodobacterales;Rhodobacteraceae;Cereibacter;";"0.0";"0";"11";"11";"0";"11";"0";"430513";"5766"
"LOK1378_1mm";"SILVA (only NR);Bacteria;Proteobacteria;Alphaproteobacteria;Rhodobacterales;Rhodobacteraceae;Citreicella;";"0.0";"0";"12";"12";"0";"12";"0";"430512";"5766"
"LOK1378_1mm";"SILVA (only NR);Bacteria;Proteobacteria;Alphaproteobacteria;Rhodobacterales;Rhodobacteraceae;Citreimonas;";"0.0";"0";"3";"3";"0";"3";"0";"430521";"5766"
"LOK1378_1mm";"SILVA (only NR);Bacteria;Proteobacteria;Alphaproteobacteria;Rhodobacterales;Rhodobacteraceae;Cognatishimia;";"0.0";"0";"26";"26";"0";"26";"0";"430498";"5766"
"LOK1378_1mm";"SILVA (only NR);Bacteria;Proteobacteria;Alphaproteobacteria;Rhodobacterales;Rhodobacteraceae;Cognatiyoonia;";"0.0";"0";"8";"8";"0";"8";"0";"430516";"5766"
"LOK1378_1mm";"SILVA (only NR);Bacteria;Proteobacteria;Alphaproteobacteria;Rhodobacterales;Rhodobacteraceae;Confluentimicrobium;";"0.0";"0";"5";"5";"0";"5";"0";"430519";"5766"
"LOK1378_1mm";"SILVA (only NR);Bacteria;Proteobacteria;Alphaproteobacteria;Rhodobacterales;Rhodobacteraceae;Cribrihabitans;";"0.0";"0";"9";"9";"0";"9";"0";"430515";"5766"
"LOK1378_1mm";"SILVA (only NR);Bacteria;Proteobacteria;Alphaproteobacteria;Rhodobacterales;Rhodobacteraceae;Defluviimonas;";"0.0";"0";"54";"53";"0";"53";"1";"430471";"5766"
"LOK1378_1mm";"SILVA (only NR);Bacteria;Proteobacteria;Alphaproteobacteria;Rhodobacterales;Rhodobacteraceae;Dinoroseobacter;";"0.0";"0";"18";"17";"0";"17";"1";"430507";"5766"
"LOK1378_1mm";"SILVA (only NR);Bacteria;Proteobacteria;Alphaproteobacteria;Rhodobacterales;Rhodobacteraceae;Donghicola;";"0.0";"0";"20";"20";"0";"20";"0";"430504";"5766"
"LOK1378_1mm";"SILVA (only NR);Bacteria;Proteobacteria;Alphaproteobacteria;Rhodobacterales;Rhodobacteraceae;Epibacterium;";"0.0";"0";"46";"45";"0";"45";"1";"430479";"5766"
"LOK1378_1mm";"SILVA (only NR);Bacteria;Proteobacteria;Alphaproteobacteria;Rhodobacterales;Rhodobacteraceae;Falsirhodobacter;";"0.0";"0";"28";"26";"0";"26";"2";"430498";"5766"
"LOK1378_1mm";"SILVA (only NR);Bacteria;Proteobacteria;Alphaproteobacteria;Rhodobacterales;Rhodobacteraceae;Flavimaricola;";"0.0";"0";"13";"13";"0";"13";"0";"430511";"5766"
"LOK1378_1mm";"SILVA (only NR);Bacteria;Proteobacteria;Alphaproteobacteria;Rhodobacterales;Rhodobacteraceae;Frigidibacter;";"0.0";"0";"3";"3";"0";"3";"0";"430521";"5766"
"LOK1378_1mm";"SILVA (only NR);Bacteria;Proteobacteria;Alphaproteobacteria;Rhodobacterales;Rhodobacteraceae;Gemmobacter;";"0.0";"0";"58";"57";"0";"57";"1";"430467";"5766"
"LOK1378_1mm";"SILVA (only NR);Bacteria;Proteobacteria;Alphaproteobacteria;Rhodobacterales;Rhodobacteraceae;HIMB11;";"0.0";"0";"42";"38";"0";"38";"4";"430486";"5766"
"LOK1378_1mm";"SILVA (only NR);Bacteria;Proteobacteria;Alphaproteobacteria;Rhodobacterales;Rhodobacteraceae;Haematobacter;";"0.0";"0";"16";"15";"0";"15";"1";"430509";"5766"
"LOK1378_1mm";"SILVA (only NR);Bacteria;Proteobacteria;Alphaproteobacteria;Rhodobacterales;Rhodobacteraceae;Halocynthiibacter;";"0.0";"0";"12";"12";"0";"12";"0";"430512";"5766"
"LOK1378_1mm";"SILVA (only NR);Bacteria;Proteobacteria;Alphaproteobacteria;Rhodobacterales;Rhodobacteraceae;Halodurantibacterium;";"0.0";"0";"23";"23";"0";"23";"0";"430501";"5766"
"LOK1378_1mm";"SILVA (only NR);Bacteria;Proteobacteria;Alphaproteobacteria;Rhodobacterales;Rhodobacteraceae;Halovulum;";"0.0";"0";"12";"12";"0";"12";"0";"430512";"5766"
"LOK1378_1mm";"SILVA (only NR);Bacteria;Proteobacteria;Alphaproteobacteria;Rhodobacterales;Rhodobacteraceae;Hasllibacter;";"0.0";"0";"2";"2";"0";"2";"0";"430522";"5766"
"LOK1378_1mm";"SILVA (only NR);Bacteria;Proteobacteria;Alphaproteobacteria;Rhodobacterales;Rhodobacteraceae;Hwanghaeicola;";"0.0";"0";"2";"2";"0";"2";"0";"430522";"5766"
"LOK1378_1mm";"SILVA (only NR);Bacteria;Proteobacteria;Alphaproteobacteria;Rhodobacterales;Rhodobacteraceae;Jannaschia;";"0.0";"0";"49";"47";"0";"47";"2";"430477";"5766"
"LOK1378_1mm";"SILVA (only NR);Bacteria;Proteobacteria;Alphaproteobacteria;Rhodobacterales;Rhodobacteraceae;Jhaorihella;";"0.0";"0";"12";"11";"0";"11";"1";"430513";"5766"
"LOK1378_1mm";"SILVA (only NR);Bacteria;Proteobacteria;Alphaproteobacteria;Rhodobacterales;Rhodobacteraceae;Ketogulonicigenium;";"0.0";"0";"14";"14";"0";"14";"0";"430510";"5766"
"LOK1378_1mm";"SILVA (only NR);Bacteria;Proteobacteria;Alphaproteobacteria;Rhodobacterales;Rhodobacteraceae;Lacimonas;";"0.0";"0";"8";"8";"0";"8";"0";"430516";"5766"
"LOK1378_1mm";"SILVA (only NR);Bacteria;Proteobacteria;Alphaproteobacteria;Rhodobacterales;Rhodobacteraceae;Leisingera;";"0.0";"0";"25";"25";"0";"25";"0";"430499";"5766"
"LOK1378_1mm";"SILVA (only NR);Bacteria;Proteobacteria;Alphaproteobacteria;Rhodobacterales;Rhodobacteraceae;Lentibacter;";"0.0";"0";"25";"24";"0";"24";"1";"430500";"5766"
"LOK1378_1mm";"SILVA (only NR);Bacteria;Proteobacteria;Alphaproteobacteria;Rhodobacterales;Rhodobacteraceae;Limibaculum;";"0.0";"0";"94";"92";"0";"92";"2";"430432";"5766"
"LOK1378_1mm";"SILVA (only NR);Bacteria;Proteobacteria;Alphaproteobacteria;Rhodobacterales;Rhodobacteraceae;Limimaricola;";"0.0";"0";"21";"21";"0";"21";"0";"430503";"5766"
"LOK1378_1mm";"SILVA (only NR);Bacteria;Proteobacteria;Alphaproteobacteria;Rhodobacterales;Rhodobacteraceae;Litoreibacter;";"0.0";"0";"15";"15";"0";"15";"0";"430509";"5766"
"LOK1378_1mm";"SILVA (only NR);Bacteria;Proteobacteria;Alphaproteobacteria;Rhodobacterales;Rhodobacteraceae;Litorimicrobium;";"0.0";"0";"14";"13";"0";"13";"1";"430511";"5766"
"LOK1378_1mm";"SILVA (only NR);Bacteria;Proteobacteria;Alphaproteobacteria;Rhodobacterales;Rhodobacteraceae;Litorisediminicola;";"0.0";"0";"1";"1";"0";"1";"0";"430523";"5766"
"LOK1378_1mm";"SILVA (only NR);Bacteria;Proteobacteria;Alphaproteobacteria;Rhodobacterales;Rhodobacteraceae;Litorisediminivivens;";"0.0";"0";"2";"2";"0";"2";"0";"430522";"5766"
"LOK1378_1mm";"SILVA (only NR);Bacteria;Proteobacteria;Alphaproteobacteria;Rhodobacterales;Rhodobacteraceae;Loktanella;";"0.0";"0";"7";"7";"0";"7";"0";"430517";"5766"
"LOK1378_1mm";"SILVA (only NR);Bacteria;Proteobacteria;Alphaproteobacteria;Rhodobacterales;Rhodobacteraceae;Lutimaribacter;";"0.0";"0";"13";"12";"0";"12";"1";"430512";"5766"
"LOK1378_1mm";"SILVA (only NR);Bacteria;Proteobacteria;Alphaproteobacteria;Rhodobacterales;Rhodobacteraceae;Maliponia;";"0.0";"0";"1";"1";"0";"1";"0";"430523";"5766"
"LOK1378_1mm";"SILVA (only NR);Bacteria;Proteobacteria;Alphaproteobacteria;Rhodobacterales;Rhodobacteraceae;Mameliella;";"0.0";"0";"17";"16";"0";"16";"1";"430508";"5766"
"LOK1378_1mm";"SILVA (only NR);Bacteria;Proteobacteria;Alphaproteobacteria;Rhodobacterales;Rhodobacteraceae;Maribius;";"0.0";"0";"8";"8";"0";"8";"0";"430516";"5766"
"LOK1378_1mm";"SILVA (only NR);Bacteria;Proteobacteria;Alphaproteobacteria;Rhodobacterales;Rhodobacteraceae;Marinibacterium;";"0.0";"0";"18";"18";"0";"18";"0";"430506";"5766"
"LOK1378_1mm";"SILVA (only NR);Bacteria;Proteobacteria;Alphaproteobacteria;Rhodobacterales;Rhodobacteraceae;Marinosulfonomonas;";"0.0";"0";"1";"1";"0";"1";"0";"430523";"5766"
"LOK1378_1mm";"SILVA (only NR);Bacteria;Proteobacteria;Alphaproteobacteria;Rhodobacterales;Rhodobacteraceae;Marinovum;";"0.0";"0";"24";"24";"0";"24";"0";"430500";"5766"
"LOK1378_1mm";"SILVA (only NR);Bacteria;Proteobacteria;Alphaproteobacteria;Rhodobacterales;Rhodobacteraceae;Maritimibacter;";"0.0";"0";"19";"19";"0";"19";"0";"430505";"5766"
"LOK1378_1mm";"SILVA (only NR);Bacteria;Proteobacteria;Alphaproteobacteria;Rhodobacterales;Rhodobacteraceae;Marivita;";"0.0";"0";"39";"37";"0";"37";"2";"430487";"5766"
"LOK1378_1mm";"SILVA (only NR);Bacteria;Proteobacteria;Alphaproteobacteria;Rhodobacterales;Rhodobacteraceae;Marivivens;";"0.0";"0";"13";"13";"0";"13";"0";"430511";"5766"
"LOK1378_1mm";"SILVA (only NR);Bacteria;Proteobacteria;Alphaproteobacteria;Rhodobacterales;Rhodobacteraceae;Methylarcula;";"0.0";"0";"2";"2";"0";"2";"0";"430522";"5766"
"LOK1378_1mm";"SILVA (only NR);Bacteria;Proteobacteria;Alphaproteobacteria;Rhodobacterales;Rhodobacteraceae;Natronohydrobacter;";"0.0";"0";"2";"2";"0";"2";"0";"430522";"5766"
"LOK1378_1mm";"SILVA (only NR);Bacteria;Proteobacteria;Alphaproteobacteria;Rhodobacterales;Rhodobacteraceae;Nautella;";"0.0";"0";"28";"27";"0";"27";"1";"430497";"5766"
"LOK1378_1mm";"SILVA (only NR);Bacteria;Proteobacteria;Alphaproteobacteria;Rhodobacterales;Rhodobacteraceae;Nereida;";"0.0";"0";"8";"8";"0";"8";"0";"430516";"5766"
"LOK1378_1mm";"SILVA (only NR);Bacteria;Proteobacteria;Alphaproteobacteria;Rhodobacterales;Rhodobacteraceae;Nioella;";"0.0";"0";"21";"20";"0";"20";"1";"430504";"5766"
"LOK1378_1mm";"SILVA (only NR);Bacteria;Proteobacteria;Alphaproteobacteria;Rhodobacterales;Rhodobacteraceae;Oceanibulbus;";"0.0";"0";"5";"5";"0";"5";"0";"430519";"5766"
"LOK1378_1mm";"SILVA (only NR);Bacteria;Proteobacteria;Alphaproteobacteria;Rhodobacterales;Rhodobacteraceae;Oceanicella;";"0.0";"0";"11";"11";"0";"11";"0";"430513";"5766"
"LOK1378_1mm";"SILVA (only NR);Bacteria;Proteobacteria;Alphaproteobacteria;Rhodobacterales;Rhodobacteraceae;Oceanicola;";"0.0";"0";"10";"10";"0";"10";"0";"430514";"5766"
"LOK1378_1mm";"SILVA (only NR);Bacteria;Proteobacteria;Alphaproteobacteria;Rhodobacterales;Rhodobacteraceae;Oceaniovalibus;";"0.0";"0";"4";"4";"0";"4";"0";"430520";"5766"
"LOK1378_1mm";"SILVA (only NR);Bacteria;Proteobacteria;Alphaproteobacteria;Rhodobacterales;Rhodobacteraceae;Oceanobacterium;";"0.0";"0";"5";"5";"0";"5";"0";"430519";"5766"
"LOK1378_1mm";"SILVA (only NR);Bacteria;Proteobacteria;Alphaproteobacteria;Rhodobacterales;Rhodobacteraceae;Octadecabacter;";"0.0";"0";"42";"40";"0";"40";"2";"430484";"5766"
"LOK1378_1mm";"SILVA (only NR);Bacteria;Proteobacteria;Alphaproteobacteria;Rhodobacterales;Rhodobacteraceae;Pacificibacter;";"0.0";"0";"4";"4";"0";"4";"0";"430520";"5766"
"LOK1378_1mm";"SILVA (only NR);Bacteria;Proteobacteria;Alphaproteobacteria;Rhodobacterales;Rhodobacteraceae;Paenirhodobacter;";"0.0";"0";"9";"9";"0";"9";"0";"430515";"5766"
"LOK1378_1mm";"SILVA (only NR);Bacteria;Proteobacteria;Alphaproteobacteria;Rhodobacterales;Rhodobacteraceae;Palleronia-Pseudomaribius;";"0.0";"0";"11";"11";"0";"11";"0";"430513";"5766"
"LOK1378_1mm";"SILVA (only NR);Bacteria;Proteobacteria;Alphaproteobacteria;Rhodobacterales;Rhodobacteraceae;Paracoccus;";"0.0";"0";"542";"532";"0";"532";"10";"429992";"5766"
"LOK1378_1mm";"SILVA (only NR);Bacteria;Proteobacteria;Alphaproteobacteria;Rhodobacterales;Rhodobacteraceae;Pelagibaca;";"0.0";"0";"9";"9";"0";"9";"0";"430515";"5766"
"LOK1378_1mm";"SILVA (only NR);Bacteria;Proteobacteria;Alphaproteobacteria;Rhodobacterales;Rhodobacteraceae;Pelagicola;";"0.0";"0";"7";"7";"0";"7";"0";"430517";"5766"
"LOK1378_1mm";"SILVA (only NR);Bacteria;Proteobacteria;Alphaproteobacteria;Rhodobacterales;Rhodobacteraceae;Pelagimonas;";"0.0";"0";"6";"6";"0";"6";"0";"430518";"5766"
"LOK1378_1mm";"SILVA (only NR);Bacteria;Proteobacteria;Alphaproteobacteria;Rhodobacterales;Rhodobacteraceae;Phaeobacter;";"0.0";"0";"45";"45";"0";"45";"0";"430479";"5766"
"LOK1378_1mm";"SILVA (only NR);Bacteria;Proteobacteria;Alphaproteobacteria;Rhodobacterales;Rhodobacteraceae;Planktomarina;";"0.0";"0";"110";"110";"0";"110";"0";"430414";"5766"
"LOK1378_1mm";"SILVA (only NR);Bacteria;Proteobacteria;Alphaproteobacteria;Rhodobacterales;Rhodobacteraceae;Planktotalea;";"0.0";"0";"25";"24";"0";"24";"1";"430500";"5766"
"LOK1378_1mm";"SILVA (only NR);Bacteria;Proteobacteria;Alphaproteobacteria;Rhodobacterales;Rhodobacteraceae;Plastorhodobacter;";"0.0";"0";"4";"4";"0";"4";"0";"430520";"5766"
"LOK1378_1mm";"SILVA (only NR);Bacteria;Proteobacteria;Alphaproteobacteria;Rhodobacterales;Rhodobacteraceae;Pontibaca;";"0.0";"0";"4";"4";"0";"4";"0";"430520";"5766"
"LOK1378_1mm";"SILVA (only NR);Bacteria;Proteobacteria;Alphaproteobacteria;Rhodobacterales;Rhodobacteraceae;Ponticoccus;";"0.0";"0";"23";"22";"0";"22";"1";"430502";"5766"
"LOK1378_1mm";"SILVA (only NR);Bacteria;Proteobacteria;Alphaproteobacteria;Rhodobacterales;Rhodobacteraceae;Pontivivens;";"0.0";"0";"13";"12";"0";"12";"1";"430512";"5766"
"LOK1378_1mm";"SILVA (only NR);Bacteria;Proteobacteria;Alphaproteobacteria;Rhodobacterales;Rhodobacteraceae;Poseidonocella;";"0.0";"0";"2";"2";"0";"2";"0";"430522";"5766"
"LOK1378_1mm";"SILVA (only NR);Bacteria;Proteobacteria;Alphaproteobacteria;Rhodobacterales;Rhodobacteraceae;Primorskyibacter;";"0.0";"0";"5";"5";"0";"5";"0";"430519";"5766"
"LOK1378_1mm";"SILVA (only NR);Bacteria;Proteobacteria;Alphaproteobacteria;Rhodobacterales;Rhodobacteraceae;Profundibacterium;";"0.0";"0";"3";"3";"0";"3";"0";"430521";"5766"
"LOK1378_1mm";"SILVA (only NR);Bacteria;Proteobacteria;Alphaproteobacteria;Rhodobacterales;Rhodobacteraceae;Pseudaestuariivita;";"0.0";"0";"2";"2";"0";"2";"0";"430522";"5766"
"LOK1378_1mm";"SILVA (only NR);Bacteria;Proteobacteria;Alphaproteobacteria;Rhodobacterales;Rhodobacteraceae;Pseudodonghicola;";"0.0";"0";"2";"2";"0";"2";"0";"430522";"5766"
"LOK1378_1mm";"SILVA (only NR);Bacteria;Proteobacteria;Alphaproteobacteria;Rhodobacterales;Rhodobacteraceae;Pseudohalocynthiibacter;";"0.0";"0";"1";"1";"0";"1";"0";"430523";"5766"
"LOK1378_1mm";"SILVA (only NR);Bacteria;Proteobacteria;Alphaproteobacteria;Rhodobacterales;Rhodobacteraceae;Pseudooceanicola;";"0.0";"0";"38";"37";"0";"37";"1";"430487";"5766"
"LOK1378_1mm";"SILVA (only NR);Bacteria;Proteobacteria;Alphaproteobacteria;Rhodobacterales;Rhodobacteraceae;Pseudooctadecabacter;";"0.0";"0";"2";"2";"0";"2";"0";"430522";"5766"
"LOK1378_1mm";"SILVA (only NR);Bacteria;Proteobacteria;Alphaproteobacteria;Rhodobacterales;Rhodobacteraceae;Pseudopelagicola;";"0.0";"0";"1";"1";"0";"1";"0";"430523";"5766"
"LOK1378_1mm";"SILVA (only NR);Bacteria;Proteobacteria;Alphaproteobacteria;Rhodobacterales;Rhodobacteraceae;Pseudophaeobacter;";"0.0";"0";"34";"33";"0";"33";"1";"430491";"5766"
"LOK1378_1mm";"SILVA (only NR);Bacteria;Proteobacteria;Alphaproteobacteria;Rhodobacterales;Rhodobacteraceae;Pseudorhodobacter;";"0.0";"0";"74";"74";"0";"74";"0";"430450";"5766"
"LOK1378_1mm";"SILVA (only NR);Bacteria;Proteobacteria;Alphaproteobacteria;Rhodobacterales;Rhodobacteraceae;Pseudoroseicyclus;";"0.0";"0";"2";"2";"0";"2";"0";"430522";"5766"
"LOK1378_1mm";"SILVA (only NR);Bacteria;Proteobacteria;Alphaproteobacteria;Rhodobacterales;Rhodobacteraceae;Pseudoruegeria;";"0.0";"0";"24";"24";"0";"24";"0";"430500";"5766"
"LOK1378_1mm";"SILVA (only NR);Bacteria;Proteobacteria;Alphaproteobacteria;Rhodobacterales;Rhodobacteraceae;Puniceibacterium;";"0.0";"0";"6";"6";"0";"6";"0";"430518";"5766"
"LOK1378_1mm";"SILVA (only NR);Bacteria;Proteobacteria;Alphaproteobacteria;Rhodobacterales;Rhodobacteraceae;Rhodobaca;";"0.0";"0";"5";"5";"0";"5";"0";"430519";"5766"
"LOK1378_1mm";"SILVA (only NR);Bacteria;Proteobacteria;Alphaproteobacteria;Rhodobacterales;Rhodobacteraceae;Rhodobacter;";"0.0";"0";"256";"253";"0";"253";"3";"430271";"5766"
"LOK1378_1mm";"SILVA (only NR);Bacteria;Proteobacteria;Alphaproteobacteria;Rhodobacterales;Rhodobacteraceae;Rhodobaculum;";"0.0";"0";"40";"40";"0";"40";"0";"430484";"5766"
"LOK1378_1mm";"SILVA (only NR);Bacteria;Proteobacteria;Alphaproteobacteria;Rhodobacterales;Rhodobacteraceae;Rhodovulum;";"0.0";"0";"60";"59";"0";"59";"1";"430465";"5766"
"LOK1378_1mm";"SILVA (only NR);Bacteria;Proteobacteria;Alphaproteobacteria;Rhodobacterales;Rhodobacteraceae;Roseibaca;";"0.0";"0";"13";"13";"0";"13";"0";"430511";"5766"
"LOK1378_1mm";"SILVA (only NR);Bacteria;Proteobacteria;Alphaproteobacteria;Rhodobacterales;Rhodobacteraceae;Roseibacterium;";"0.0";"0";"34";"33";"0";"33";"1";"430491";"5766"
"LOK1378_1mm";"SILVA (only NR);Bacteria;Proteobacteria;Alphaproteobacteria;Rhodobacterales;Rhodobacteraceae;Roseicitreum;";"0.0";"0";"1";"1";"0";"1";"0";"430523";"5766"
"LOK1378_1mm";"SILVA (only NR);Bacteria;Proteobacteria;Alphaproteobacteria;Rhodobacterales;Rhodobacteraceae;Roseicyclus;";"0.0";"0";"12";"12";"0";"12";"0";"430512";"5766"
"LOK1378_1mm";"SILVA (only NR);Bacteria;Proteobacteria;Alphaproteobacteria;Rhodobacterales;Rhodobacteraceae;Roseinatronobacter;";"0.0";"0";"10";"10";"0";"10";"0";"430514";"5766"
"LOK1378_1mm";"SILVA (only NR);Bacteria;Proteobacteria;Alphaproteobacteria;Rhodobacterales;Rhodobacteraceae;Roseisalinus;";"0.0";"0";"3";"3";"0";"3";"0";"430521";"5766"
"LOK1378_1mm";"SILVA (only NR);Bacteria;Proteobacteria;Alphaproteobacteria;Rhodobacterales;Rhodobacteraceae;Roseivivax;";"0.0";"0";"114";"106";"0";"106";"8";"430418";"5766"
"LOK1378_1mm";"SILVA (only NR);Bacteria;Proteobacteria;Alphaproteobacteria;Rhodobacterales;Rhodobacteraceae;Roseobacter clade CHAB-I-5 lineage;";"0.0";"0";"27";"27";"0";"27";"0";"430497";"5766"
"LOK1378_1mm";"SILVA (only NR);Bacteria;Proteobacteria;Alphaproteobacteria;Rhodobacterales;Rhodobacteraceae;Roseobacter clade Marinomonas lineage;";"0.0";"0";"3";"3";"0";"3";"0";"430521";"5766"
"LOK1378_1mm";"SILVA (only NR);Bacteria;Proteobacteria;Alphaproteobacteria;Rhodobacterales;Rhodobacteraceae;Roseobacter clade NAC11-7 lineage;";"0.0";"0";"91";"90";"0";"90";"1";"430434";"5766"
"LOK1378_1mm";"SILVA (only NR);Bacteria;Proteobacteria;Alphaproteobacteria;Rhodobacterales;Rhodobacteraceae;Roseobacter;";"0.0";"0";"44";"40";"0";"40";"4";"430484";"5766"
"LOK1378_1mm";"SILVA (only NR);Bacteria;Proteobacteria;Alphaproteobacteria;Rhodobacterales;Rhodobacteraceae;Roseovarius;";"0.0";"0";"221";"219";"0";"219";"2";"430305";"5766"
"LOK1378_1mm";"SILVA (only NR);Bacteria;Proteobacteria;Alphaproteobacteria;Rhodobacterales;Rhodobacteraceae;Rubellimicrobium;";"0.0";"0";"94";"93";"0";"93";"1";"430431";"5766"
"LOK1378_1mm";"SILVA (only NR);Bacteria;Proteobacteria;Alphaproteobacteria;Rhodobacterales;Rhodobacteraceae;Rubribacterium;";"0.0";"0";"19";"18";"0";"18";"1";"430506";"5766"
"LOK1378_1mm";"SILVA (only NR);Bacteria;Proteobacteria;Alphaproteobacteria;Rhodobacterales;Rhodobacteraceae;Rubrimonas;";"0.0";"0";"10";"10";"0";"10";"0";"430514";"5766"
"LOK1378_1mm";"SILVA (only NR);Bacteria;Proteobacteria;Alphaproteobacteria;Rhodobacterales;Rhodobacteraceae;Ruegeria;";"0.0";"0";"145";"139";"0";"139";"6";"430385";"5766"
"LOK1378_1mm";"SILVA (only NR);Bacteria;Proteobacteria;Alphaproteobacteria;Rhodobacterales;Rhodobacteraceae;Sagittula;";"0.0";"0";"18";"17";"0";"17";"1";"430507";"5766"
"LOK1378_1mm";"SILVA (only NR);Bacteria;Proteobacteria;Alphaproteobacteria;Rhodobacterales;Rhodobacteraceae;Salinihabitans;";"0.0";"0";"3";"3";"0";"3";"0";"430521";"5766"
"LOK1378_1mm";"SILVA (only NR);Bacteria;Proteobacteria;Alphaproteobacteria;Rhodobacterales;Rhodobacteraceae;Salipiger;";"0.0";"0";"3";"3";"0";"3";"0";"430521";"5766"
"LOK1378_1mm";"SILVA (only NR);Bacteria;Proteobacteria;Alphaproteobacteria;Rhodobacterales;Rhodobacteraceae;Sedimentitalea;";"0.0";"0";"45";"45";"0";"45";"0";"430479";"5766"
"LOK1378_1mm";"SILVA (only NR);Bacteria;Proteobacteria;Alphaproteobacteria;Rhodobacterales;Rhodobacteraceae;Sediminimonas;";"0.0";"0";"20";"20";"0";"20";"0";"430504";"5766"
"LOK1378_1mm";"SILVA (only NR);Bacteria;Proteobacteria;Alphaproteobacteria;Rhodobacterales;Rhodobacteraceae;Seohaeicola;";"0.0";"0";"6";"6";"0";"6";"0";"430518";"5766"
"LOK1378_1mm";"SILVA (only NR);Bacteria;Proteobacteria;Alphaproteobacteria;Rhodobacterales;Rhodobacteraceae;Shimia;";"0.0";"0";"22";"22";"0";"22";"0";"430502";"5766"
"LOK1378_1mm";"SILVA (only NR);Bacteria;Proteobacteria;Alphaproteobacteria;Rhodobacterales;Rhodobacteraceae;Silicimonas;";"0.0";"0";"27";"27";"0";"27";"0";"430497";"5766"
"LOK1378_1mm";"SILVA (only NR);Bacteria;Proteobacteria;Alphaproteobacteria;Rhodobacterales;Rhodobacteraceae;Sulfitobacter;";"0.0";"0";"273";"268";"0";"268";"5";"430256";"5766"
"LOK1378_1mm";"SILVA (only NR);Bacteria;Proteobacteria;Alphaproteobacteria;Rhodobacterales;Rhodobacteraceae;Tabrizicola;";"0.0";"0";"53";"53";"0";"53";"0";"430471";"5766"
"LOK1378_1mm";"SILVA (only NR);Bacteria;Proteobacteria;Alphaproteobacteria;Rhodobacterales;Rhodobacteraceae;Tateyamaria;";"0.0";"0";"39";"39";"0";"39";"0";"430485";"5766"
"LOK1378_1mm";"SILVA (only NR);Bacteria;Proteobacteria;Alphaproteobacteria;Rhodobacterales;Rhodobacteraceae;Thalassobius;";"0.0";"0";"36";"36";"0";"36";"0";"430488";"5766"
"LOK1378_1mm";"SILVA (only NR);Bacteria;Proteobacteria;Alphaproteobacteria;Rhodobacterales;Rhodobacteraceae;Thalassococcus;";"0.0";"0";"8";"8";"0";"8";"0";"430516";"5766"
"LOK1378_1mm";"SILVA (only NR);Bacteria;Proteobacteria;Alphaproteobacteria;Rhodobacterales;Rhodobacteraceae;Thiobacimonas;";"0.0";"0";"3";"3";"0";"3";"0";"430521";"5766"
"LOK1378_1mm";"SILVA (only NR);Bacteria;Proteobacteria;Alphaproteobacteria;Rhodobacterales;Rhodobacteraceae;Thioclava;";"0.0";"0";"20";"20";"0";"20";"0";"430504";"5766"
"LOK1378_1mm";"SILVA (only NR);Bacteria;Proteobacteria;Alphaproteobacteria;Rhodobacterales;Rhodobacteraceae;Tranquillimonas;";"0.0";"0";"2";"2";"0";"2";"0";"430522";"5766"
"LOK1378_1mm";"SILVA (only NR);Bacteria;Proteobacteria;Alphaproteobacteria;Rhodobacterales;Rhodobacteraceae;Tropicibacter;";"0.0";"0";"34";"33";"0";"33";"1";"430491";"5766"
"LOK1378_1mm";"SILVA (only NR);Bacteria;Proteobacteria;Alphaproteobacteria;Rhodobacterales;Rhodobacteraceae;Tropicimonas;";"0.0";"0";"54";"53";"0";"53";"1";"430471";"5766"
"LOK1378_1mm";"SILVA (only NR);Bacteria;Proteobacteria;Alphaproteobacteria;Rhodobacterales;Rhodobacteraceae;Vadicella;";"0.0";"0";"3";"3";"0";"3";"0";"430521";"5766"
"LOK1378_1mm";"SILVA (only NR);Bacteria;Proteobacteria;Alphaproteobacteria;Rhodobacterales;Rhodobacteraceae;WDS1C4;";"0.0";"0";"11";"11";"0";"11";"0";"430513";"5766"
"LOK1378_1mm";"SILVA (only NR);Bacteria;Proteobacteria;Alphaproteobacteria;Rhodobacterales;Rhodobacteraceae;Wenxinia;";"0.0";"0";"7";"7";"0";"7";"0";"430517";"5766"
"LOK1378_1mm";"SILVA (only NR);Bacteria;Proteobacteria;Alphaproteobacteria;Rhodobacterales;Rhodobacteraceae;Yangia;";"0.0";"0";"16";"16";"0";"16";"0";"430508";"5766"
"LOK1378_1mm";"SILVA (only NR);Bacteria;Proteobacteria;Alphaproteobacteria;Rhodobacterales;Rhodobacteraceae;Yoonia-Loktanella;";"0.0";"0";"120";"116";"0";"116";"4";"430408";"5766"
"LOK1378_1mm";"SILVA (only NR);Bacteria;Proteobacteria;Alphaproteobacteria;Rhodobacterales;Rhodobacteraceae;Youngimonas;";"0.0";"0";"4";"4";"0";"4";"0";"430520";"5766"
"LOK1378_1mm";"SILVA (only NR);Bacteria;Proteobacteria;Alphaproteobacteria;Rhodobacterales;Rhodobacteraceae;uncultured;";"0.0";"0";"899";"881";"0";"881";"18";"429643";"5766"
"LOK1378_1mm";"SILVA (only NR);Bacteria;Proteobacteria;Alphaproteobacteria;Rhodospirillales;";"0.0";"0";"1257";"1228";"0";"1228";"29";"429296";"5766"
"LOK1378_1mm";"SILVA (only NR);Bacteria;Proteobacteria;Alphaproteobacteria;Rhodospirillales;AEGEAN-169 marine group;";"0.0";"0";"108";"107";"0";"107";"1";"430417";"5766"
"LOK1378_1mm";"SILVA (only NR);Bacteria;Proteobacteria;Alphaproteobacteria;Rhodospirillales;Magnetospiraceae;";"0.0";"0";"339";"334";"0";"334";"5";"430190";"5766"
"LOK1378_1mm";"SILVA (only NR);Bacteria;Proteobacteria;Alphaproteobacteria;Rhodospirillales;Magnetospiraceae;Magnetospira;";"0.0";"0";"57";"56";"0";"56";"1";"430468";"5766"
"LOK1378_1mm";"SILVA (only NR);Bacteria;Proteobacteria;Alphaproteobacteria;Rhodospirillales;Magnetospiraceae;Magnetovibrio;";"0.0";"0";"46";"45";"0";"45";"1";"430479";"5766"
"LOK1378_1mm";"SILVA (only NR);Bacteria;Proteobacteria;Alphaproteobacteria;Rhodospirillales;Magnetospiraceae;Varunaivibrio;";"0.0";"0";"3";"3";"0";"3";"0";"430521";"5766"
"LOK1378_1mm";"SILVA (only NR);Bacteria;Proteobacteria;Alphaproteobacteria;Rhodospirillales;Magnetospiraceae;uncultured;";"0.0";"0";"230";"227";"0";"227";"3";"430297";"5766"
"LOK1378_1mm";"SILVA (only NR);Bacteria;Proteobacteria;Alphaproteobacteria;Rhodospirillales;Magnetospirillaceae;";"0.0";"0";"110";"106";"0";"106";"4";"430418";"5766"
"LOK1378_1mm";"SILVA (only NR);Bacteria;Proteobacteria;Alphaproteobacteria;Rhodospirillales;Magnetospirillaceae;Magnetospirillum;";"0.0";"0";"48";"47";"0";"47";"1";"430477";"5766"
"LOK1378_1mm";"SILVA (only NR);Bacteria;Proteobacteria;Alphaproteobacteria;Rhodospirillales;Magnetospirillaceae;Phaeospirillum;";"0.0";"0";"11";"11";"0";"11";"0";"430513";"5766"
"LOK1378_1mm";"SILVA (only NR);Bacteria;Proteobacteria;Alphaproteobacteria;Rhodospirillales;Magnetospirillaceae;Telmatospirillum;";"0.0";"0";"19";"18";"0";"18";"1";"430506";"5766"
"LOK1378_1mm";"SILVA (only NR);Bacteria;Proteobacteria;Alphaproteobacteria;Rhodospirillales;Magnetospirillaceae;[Aquaspirillum] polymorphum group;";"0.0";"0";"2";"2";"0";"2";"0";"430522";"5766"
"LOK1378_1mm";"SILVA (only NR);Bacteria;Proteobacteria;Alphaproteobacteria;Rhodospirillales;Magnetospirillaceae;uncultured;";"0.0";"0";"18";"16";"0";"16";"2";"430508";"5766"
"LOK1378_1mm";"SILVA (only NR);Bacteria;Proteobacteria;Alphaproteobacteria;Rhodospirillales;Rhodospirillaceae;";"0.0";"0";"194";"188";"0";"188";"6";"430336";"5766"
"LOK1378_1mm";"SILVA (only NR);Bacteria;Proteobacteria;Alphaproteobacteria;Rhodospirillales;Rhodospirillaceae;BRH-c57;";"0.0";"0";"3";"3";"0";"3";"0";"430521";"5766"
"LOK1378_1mm";"SILVA (only NR);Bacteria;Proteobacteria;Alphaproteobacteria;Rhodospirillales;Rhodospirillaceae;Caenispirillum;";"0.0";"0";"9";"9";"0";"9";"0";"430515";"5766"
"LOK1378_1mm";"SILVA (only NR);Bacteria;Proteobacteria;Alphaproteobacteria;Rhodospirillales;Rhodospirillaceae;Candidatus Riegeria;";"0.0";"0";"26";"26";"0";"26";"0";"430498";"5766"
"LOK1378_1mm";"SILVA (only NR);Bacteria;Proteobacteria;Alphaproteobacteria;Rhodospirillales;Rhodospirillaceae;Haematospirillum;";"0.0";"0";"5";"5";"0";"5";"0";"430519";"5766"
"LOK1378_1mm";"SILVA (only NR);Bacteria;Proteobacteria;Alphaproteobacteria;Rhodospirillales;Rhodospirillaceae;Insolitispirillum;";"0.0";"0";"8";"8";"0";"8";"0";"430516";"5766"
"LOK1378_1mm";"SILVA (only NR);Bacteria;Proteobacteria;Alphaproteobacteria;Rhodospirillales;Rhodospirillaceae;Marispirillum;";"0.0";"0";"6";"6";"0";"6";"0";"430518";"5766"
"LOK1378_1mm";"SILVA (only NR);Bacteria;Proteobacteria;Alphaproteobacteria;Rhodospirillales;Rhodospirillaceae;Novispirillum;";"0.0";"0";"7";"7";"0";"7";"0";"430517";"5766"
"LOK1378_1mm";"SILVA (only NR);Bacteria;Proteobacteria;Alphaproteobacteria;Rhodospirillales;Rhodospirillaceae;Pararhodospirillum;";"0.0";"0";"5";"5";"0";"5";"0";"430519";"5766"
"LOK1378_1mm";"SILVA (only NR);Bacteria;Proteobacteria;Alphaproteobacteria;Rhodospirillales;Rhodospirillaceae;Phaeovibrio;";"0.0";"0";"1";"1";"0";"1";"0";"430523";"5766"
"LOK1378_1mm";"SILVA (only NR);Bacteria;Proteobacteria;Alphaproteobacteria;Rhodospirillales;Rhodospirillaceae;Rhodospirillum;";"0.0";"0";"4";"4";"0";"4";"0";"430520";"5766"
"LOK1378_1mm";"SILVA (only NR);Bacteria;Proteobacteria;Alphaproteobacteria;Rhodospirillales;Rhodospirillaceae;Roseospira;";"0.0";"0";"14";"13";"0";"13";"1";"430511";"5766"
"LOK1378_1mm";"SILVA (only NR);Bacteria;Proteobacteria;Alphaproteobacteria;Rhodospirillales;Rhodospirillaceae;Roseospirillum;";"0.0";"0";"6";"5";"0";"5";"1";"430519";"5766"
"LOK1378_1mm";"SILVA (only NR);Bacteria;Proteobacteria;Alphaproteobacteria;Rhodospirillales;Rhodospirillaceae;uncultured;";"0.0";"0";"97";"93";"0";"93";"4";"430431";"5766"
"LOK1378_1mm";"SILVA (only NR);Bacteria;Proteobacteria;Alphaproteobacteria;Rhodospirillales;Terasakiellaceae;";"0.0";"0";"113";"111";"0";"111";"2";"430413";"5766"
"LOK1378_1mm";"SILVA (only NR);Bacteria;Proteobacteria;Alphaproteobacteria;Rhodospirillales;Terasakiellaceae;Aestuariispira;";"0.0";"0";"5";"5";"0";"5";"0";"430519";"5766"
"LOK1378_1mm";"SILVA (only NR);Bacteria;Proteobacteria;Alphaproteobacteria;Rhodospirillales;Terasakiellaceae;Terasakiella;";"0.0";"0";"15";"15";"0";"15";"0";"430509";"5766"
"LOK1378_1mm";"SILVA (only NR);Bacteria;Proteobacteria;Alphaproteobacteria;Rhodospirillales;Terasakiellaceae;uncultured;";"0.0";"0";"92";"90";"0";"90";"2";"430434";"5766"
"LOK1378_1mm";"SILVA (only NR);Bacteria;Proteobacteria;Alphaproteobacteria;Rhodospirillales;Thalassospiraceae;";"0.0";"0";"96";"93";"0";"93";"3";"430431";"5766"
"LOK1378_1mm";"SILVA (only NR);Bacteria;Proteobacteria;Alphaproteobacteria;Rhodospirillales;Thalassospiraceae;Thalassospira;";"0.0";"0";"96";"93";"0";"93";"3";"430431";"5766"
"LOK1378_1mm";"SILVA (only NR);Bacteria;Proteobacteria;Alphaproteobacteria;Rhodospirillales;uncultured;";"0.0";"0";"296";"288";"0";"288";"8";"430236";"5766"
"LOK1378_1mm";"SILVA (only NR);Bacteria;Proteobacteria;Alphaproteobacteria;Rickettsiales;";"0.0";"0";"2242";"2138";"0";"2138";"104";"428386";"5766"
"LOK1378_1mm";"SILVA (only NR);Bacteria;Proteobacteria;Alphaproteobacteria;Rickettsiales;AB1;";"0.0";"0";"47";"47";"0";"47";"0";"430477";"5766"
"LOK1378_1mm";"SILVA (only NR);Bacteria;Proteobacteria;Alphaproteobacteria;Rickettsiales;Anaplasmataceae;";"0.0";"0";"247";"244";"0";"244";"3";"430280";"5766"
"LOK1378_1mm";"SILVA (only NR);Bacteria;Proteobacteria;Alphaproteobacteria;Rickettsiales;Anaplasmataceae;Anaplasma;";"0.0";"0";"57";"56";"0";"56";"1";"430468";"5766"
"LOK1378_1mm";"SILVA (only NR);Bacteria;Proteobacteria;Alphaproteobacteria;Rickettsiales;Anaplasmataceae;Candidatus Cryptoplasma;";"0.0";"0";"2";"2";"0";"2";"0";"430522";"5766"
"LOK1378_1mm";"SILVA (only NR);Bacteria;Proteobacteria;Alphaproteobacteria;Rickettsiales;Anaplasmataceae;Candidatus Neoehrlichia;";"0.0";"0";"4";"4";"0";"4";"0";"430520";"5766"
"LOK1378_1mm";"SILVA (only NR);Bacteria;Proteobacteria;Alphaproteobacteria;Rickettsiales;Anaplasmataceae;Candidatus Xenohaliotis;";"0.0";"0";"5";"5";"0";"5";"0";"430519";"5766"
"LOK1378_1mm";"SILVA (only NR);Bacteria;Proteobacteria;Alphaproteobacteria;Rickettsiales;Anaplasmataceae;Candidatus Xenolissoclinum;";"0.0";"0";"1";"1";"0";"1";"0";"430523";"5766"
"LOK1378_1mm";"SILVA (only NR);Bacteria;Proteobacteria;Alphaproteobacteria;Rickettsiales;Anaplasmataceae;Ehrlichia;";"0.0";"0";"35";"35";"0";"35";"0";"430489";"5766"
"LOK1378_1mm";"SILVA (only NR);Bacteria;Proteobacteria;Alphaproteobacteria;Rickettsiales;Anaplasmataceae;Neorickettsia;";"0.0";"0";"25";"24";"0";"24";"1";"430500";"5766"
"LOK1378_1mm";"SILVA (only NR);Bacteria;Proteobacteria;Alphaproteobacteria;Rickettsiales;Anaplasmataceae;Wolbachia;";"0.0";"0";"110";"109";"0";"109";"1";"430415";"5766"
"LOK1378_1mm";"SILVA (only NR);Bacteria;Proteobacteria;Alphaproteobacteria;Rickettsiales;Anaplasmataceae;uncultured;";"0.0";"0";"5";"5";"0";"5";"0";"430519";"5766"
"LOK1378_1mm";"SILVA (only NR);Bacteria;Proteobacteria;Alphaproteobacteria;Rickettsiales;Candidatus Hepatincola;";"0.0";"0";"8";"8";"0";"8";"0";"430516";"5766"
"LOK1378_1mm";"SILVA (only NR);Bacteria;Proteobacteria;Alphaproteobacteria;Rickettsiales;Candidatus Jidaibacter;";"0.0";"0";"12";"11";"0";"11";"1";"430513";"5766"
"LOK1378_1mm";"SILVA (only NR);Bacteria;Proteobacteria;Alphaproteobacteria;Rickettsiales;Fokiniaceae;";"0.0";"0";"44";"43";"0";"43";"1";"430481";"5766"
"LOK1378_1mm";"SILVA (only NR);Bacteria;Proteobacteria;Alphaproteobacteria;Rickettsiales;Fokiniaceae;Candidatus Anadelfobacter;";"0.0";"0";"2";"2";"0";"2";"0";"430522";"5766"
"LOK1378_1mm";"SILVA (only NR);Bacteria;Proteobacteria;Alphaproteobacteria;Rickettsiales;Fokiniaceae;Candidatus Cyrtobacter;";"0.0";"0";"2";"2";"0";"2";"0";"430522";"5766"
"LOK1378_1mm";"SILVA (only NR);Bacteria;Proteobacteria;Alphaproteobacteria;Rickettsiales;Fokiniaceae;Candidatus Defluviella;";"0.0";"0";"1";"1";"0";"1";"0";"430523";"5766"
"LOK1378_1mm";"SILVA (only NR);Bacteria;Proteobacteria;Alphaproteobacteria;Rickettsiales;Fokiniaceae;Candidatus Fokinia;";"0.0";"0";"3";"3";"0";"3";"0";"430521";"5766"
"LOK1378_1mm";"SILVA (only NR);Bacteria;Proteobacteria;Alphaproteobacteria;Rickettsiales;Fokiniaceae;Candidatus Lariskella;";"0.0";"0";"6";"6";"0";"6";"0";"430518";"5766"
"LOK1378_1mm";"SILVA (only NR);Bacteria;Proteobacteria;Alphaproteobacteria;Rickettsiales;Fokiniaceae;Lyticum;";"0.0";"0";"1";"1";"0";"1";"0";"430523";"5766"
"LOK1378_1mm";"SILVA (only NR);Bacteria;Proteobacteria;Alphaproteobacteria;Rickettsiales;Fokiniaceae;MD3-55;";"0.0";"0";"20";"20";"0";"20";"0";"430504";"5766"
"LOK1378_1mm";"SILVA (only NR);Bacteria;Proteobacteria;Alphaproteobacteria;Rickettsiales;Fokiniaceae;uncultured;";"0.0";"0";"7";"6";"0";"6";"1";"430518";"5766"
"LOK1378_1mm";"SILVA (only NR);Bacteria;Proteobacteria;Alphaproteobacteria;Rickettsiales;Midichloriaceae;";"0.0";"0";"7";"7";"0";"7";"0";"430517";"5766"
"LOK1378_1mm";"SILVA (only NR);Bacteria;Proteobacteria;Alphaproteobacteria;Rickettsiales;Midichloriaceae;Candidatus Midichloria;";"0.0";"0";"7";"7";"0";"7";"0";"430517";"5766"
"LOK1378_1mm";"SILVA (only NR);Bacteria;Proteobacteria;Alphaproteobacteria;Rickettsiales;Mitochondria;";"0.0";"0";"1227";"1140";"0";"1140";"87";"429384";"5766"
"LOK1378_1mm";"SILVA (only NR);Bacteria;Proteobacteria;Alphaproteobacteria;Rickettsiales;Rickettsiaceae;";"0.0";"0";"285";"280";"0";"280";"5";"430244";"5766"
"LOK1378_1mm";"SILVA (only NR);Bacteria;Proteobacteria;Alphaproteobacteria;Rickettsiales;Rickettsiaceae;Ac37b;";"0.0";"0";"2";"2";"0";"2";"0";"430522";"5766"
"LOK1378_1mm";"SILVA (only NR);Bacteria;Proteobacteria;Alphaproteobacteria;Rickettsiales;Rickettsiaceae;Candidatus Arcanobacter;";"0.0";"0";"1";"1";"0";"1";"0";"430523";"5766"
"LOK1378_1mm";"SILVA (only NR);Bacteria;Proteobacteria;Alphaproteobacteria;Rickettsiales;Rickettsiaceae;Candidatus Cryptoprodotis;";"0.0";"0";"5";"5";"0";"5";"0";"430519";"5766"
"LOK1378_1mm";"SILVA (only NR);Bacteria;Proteobacteria;Alphaproteobacteria;Rickettsiales;Rickettsiaceae;Candidatus Gigarickettsia;";"0.0";"0";"3";"3";"0";"3";"0";"430521";"5766"
"LOK1378_1mm";"SILVA (only NR);Bacteria;Proteobacteria;Alphaproteobacteria;Rickettsiales;Rickettsiaceae;Candidatus Hemipteriphilus;";"0.0";"0";"2";"2";"0";"2";"0";"430522";"5766"
"LOK1378_1mm";"SILVA (only NR);Bacteria;Proteobacteria;Alphaproteobacteria;Rickettsiales;Rickettsiaceae;Candidatus Megaira;";"0.0";"0";"26";"23";"0";"23";"3";"430501";"5766"
"LOK1378_1mm";"SILVA (only NR);Bacteria;Proteobacteria;Alphaproteobacteria;Rickettsiales;Rickettsiaceae;Candidatus Trichorickettsia;";"0.0";"0";"3";"3";"0";"3";"0";"430521";"5766"
"LOK1378_1mm";"SILVA (only NR);Bacteria;Proteobacteria;Alphaproteobacteria;Rickettsiales;Rickettsiaceae;Orientia;";"0.0";"0";"16";"16";"0";"16";"0";"430508";"5766"
"LOK1378_1mm";"SILVA (only NR);Bacteria;Proteobacteria;Alphaproteobacteria;Rickettsiales;Rickettsiaceae;Rickettsia;";"0.0";"0";"163";"163";"0";"163";"0";"430361";"5766"
"LOK1378_1mm";"SILVA (only NR);Bacteria;Proteobacteria;Alphaproteobacteria;Rickettsiales;Rickettsiaceae;uncultured;";"0.0";"0";"59";"57";"0";"57";"2";"430467";"5766"
"LOK1378_1mm";"SILVA (only NR);Bacteria;Proteobacteria;Alphaproteobacteria;Rickettsiales;S25-593;";"0.0";"0";"90";"89";"0";"89";"1";"430435";"5766"
"LOK1378_1mm";"SILVA (only NR);Bacteria;Proteobacteria;Alphaproteobacteria;Rickettsiales;SM1B06;";"0.0";"0";"4";"3";"0";"3";"1";"430521";"5766"
"LOK1378_1mm";"SILVA (only NR);Bacteria;Proteobacteria;Alphaproteobacteria;Rickettsiales;SM2D12;";"0.0";"0";"220";"215";"0";"215";"5";"430309";"5766"
"LOK1378_1mm";"SILVA (only NR);Bacteria;Proteobacteria;Alphaproteobacteria;Rickettsiales;bac2nit3;";"0.0";"0";"4";"4";"0";"4";"0";"430520";"5766"
"LOK1378_1mm";"SILVA (only NR);Bacteria;Proteobacteria;Alphaproteobacteria;Rickettsiales;uncultured;";"0.0";"0";"44";"44";"0";"44";"0";"430480";"5766"
"LOK1378_1mm";"SILVA (only NR);Bacteria;Proteobacteria;Alphaproteobacteria;SAR11 clade;";"0.0";"0";"2004";"1997";"0";"1997";"7";"428527";"5766"
"LOK1378_1mm";"SILVA (only NR);Bacteria;Proteobacteria;Alphaproteobacteria;SAR11 clade;Clade I;";"0.0";"0";"1091";"1088";"0";"1088";"3";"429436";"5766"
"LOK1378_1mm";"SILVA (only NR);Bacteria;Proteobacteria;Alphaproteobacteria;SAR11 clade;Clade I;Clade Ia;";"0.0";"0";"465";"463";"0";"463";"2";"430061";"5766"
"LOK1378_1mm";"SILVA (only NR);Bacteria;Proteobacteria;Alphaproteobacteria;SAR11 clade;Clade I;Clade Ib;";"0.0";"0";"238";"238";"0";"238";"0";"430286";"5766"
"LOK1378_1mm";"SILVA (only NR);Bacteria;Proteobacteria;Alphaproteobacteria;SAR11 clade;Clade I;uncultured;";"0.0";"0";"382";"381";"0";"381";"1";"430143";"5766"
"LOK1378_1mm";"SILVA (only NR);Bacteria;Proteobacteria;Alphaproteobacteria;SAR11 clade;Clade II;";"0.0";"0";"756";"753";"0";"753";"3";"429771";"5766"
"LOK1378_1mm";"SILVA (only NR);Bacteria;Proteobacteria;Alphaproteobacteria;SAR11 clade;Clade III;";"0.0";"0";"80";"80";"0";"80";"0";"430444";"5766"
"LOK1378_1mm";"SILVA (only NR);Bacteria;Proteobacteria;Alphaproteobacteria;SAR11 clade;Clade IV;";"0.0";"0";"31";"31";"0";"31";"0";"430493";"5766"
"LOK1378_1mm";"SILVA (only NR);Bacteria;Proteobacteria;Alphaproteobacteria;SAR11 clade;uncultured;";"0.0";"0";"42";"41";"0";"41";"1";"430483";"5766"
"LOK1378_1mm";"SILVA (only NR);Bacteria;Proteobacteria;Alphaproteobacteria;Sneathiellales;";"0.0";"0";"41";"40";"0";"40";"1";"430484";"5766"
"LOK1378_1mm";"SILVA (only NR);Bacteria;Proteobacteria;Alphaproteobacteria;Sneathiellales;Sneathiellaceae;";"0.0";"0";"41";"40";"0";"40";"1";"430484";"5766"
"LOK1378_1mm";"SILVA (only NR);Bacteria;Proteobacteria;Alphaproteobacteria;Sneathiellales;Sneathiellaceae;Oceanibacterium;";"0.0";"0";"1";"1";"0";"1";"0";"430523";"5766"
"LOK1378_1mm";"SILVA (only NR);Bacteria;Proteobacteria;Alphaproteobacteria;Sneathiellales;Sneathiellaceae;Sneathiella;";"0.0";"0";"31";"30";"0";"30";"1";"430494";"5766"
"LOK1378_1mm";"SILVA (only NR);Bacteria;Proteobacteria;Alphaproteobacteria;Sneathiellales;Sneathiellaceae;uncultured;";"0.0";"0";"9";"9";"0";"9";"0";"430515";"5766"
"LOK1378_1mm";"SILVA (only NR);Bacteria;Proteobacteria;Alphaproteobacteria;Sphingomonadales;";"0.0";"0";"4495";"4399";"0";"4399";"96";"426125";"5766"
"LOK1378_1mm";"SILVA (only NR);Bacteria;Proteobacteria;Alphaproteobacteria;Sphingomonadales;Sphingomonadaceae;";"0.0";"0";"4495";"4399";"0";"4399";"96";"426125";"5766"
"LOK1378_1mm";"SILVA (only NR);Bacteria;Proteobacteria;Alphaproteobacteria;Sphingomonadales;Sphingomonadaceae;Altererythrobacter;";"0.0";"0";"309";"301";"0";"301";"8";"430223";"5766"
"LOK1378_1mm";"SILVA (only NR);Bacteria;Proteobacteria;Alphaproteobacteria;Sphingomonadales;Sphingomonadaceae;Blastomonas;";"0.0";"0";"27";"26";"0";"26";"1";"430498";"5766"
"LOK1378_1mm";"SILVA (only NR);Bacteria;Proteobacteria;Alphaproteobacteria;Sphingomonadales;Sphingomonadaceae;Croceicoccus;";"0.0";"0";"11";"11";"0";"11";"0";"430513";"5766"
"LOK1378_1mm";"SILVA (only NR);Bacteria;Proteobacteria;Alphaproteobacteria;Sphingomonadales;Sphingomonadaceae;DSSF69;";"0.0";"0";"14";"14";"0";"14";"0";"430510";"5766"
"LOK1378_1mm";"SILVA (only NR);Bacteria;Proteobacteria;Alphaproteobacteria;Sphingomonadales;Sphingomonadaceae;Ellin6055;";"0.0";"0";"92";"91";"0";"91";"1";"430433";"5766"
"LOK1378_1mm";"SILVA (only NR);Bacteria;Proteobacteria;Alphaproteobacteria;Sphingomonadales;Sphingomonadaceae;Erythrobacter;";"0.0";"0";"259";"259";"0";"259";"0";"430265";"5766"
"LOK1378_1mm";"SILVA (only NR);Bacteria;Proteobacteria;Alphaproteobacteria;Sphingomonadales;Sphingomonadaceae;Hephaestia;";"0.0";"0";"7";"7";"0";"7";"0";"430517";"5766"
"LOK1378_1mm";"SILVA (only NR);Bacteria;Proteobacteria;Alphaproteobacteria;Sphingomonadales;Sphingomonadaceae;MN 122.2a;";"0.0";"0";"7";"7";"0";"7";"0";"430517";"5766"
"LOK1378_1mm";"SILVA (only NR);Bacteria;Proteobacteria;Alphaproteobacteria;Sphingomonadales;Sphingomonadaceae;Novosphingobium;";"0.0";"0";"552";"535";"0";"535";"17";"429989";"5766"
"LOK1378_1mm";"SILVA (only NR);Bacteria;Proteobacteria;Alphaproteobacteria;Sphingomonadales;Sphingomonadaceae;Parablastomonas;";"0.0";"0";"5";"5";"0";"5";"0";"430519";"5766"
"LOK1378_1mm";"SILVA (only NR);Bacteria;Proteobacteria;Alphaproteobacteria;Sphingomonadales;Sphingomonadaceae;Parasphingopyxis;";"0.0";"0";"8";"8";"0";"8";"0";"430516";"5766"
"LOK1378_1mm";"SILVA (only NR);Bacteria;Proteobacteria;Alphaproteobacteria;Sphingomonadales;Sphingomonadaceae;Plot4-2H12;";"0.0";"0";"3";"3";"0";"3";"0";"430521";"5766"
"LOK1378_1mm";"SILVA (only NR);Bacteria;Proteobacteria;Alphaproteobacteria;Sphingomonadales;Sphingomonadaceae;Polymorphobacter;";"0.0";"0";"30";"29";"0";"29";"1";"430495";"5766"
"LOK1378_1mm";"SILVA (only NR);Bacteria;Proteobacteria;Alphaproteobacteria;Sphingomonadales;Sphingomonadaceae;Porphyrobacter;";"0.0";"0";"96";"95";"0";"95";"1";"430429";"5766"
"LOK1378_1mm";"SILVA (only NR);Bacteria;Proteobacteria;Alphaproteobacteria;Sphingomonadales;Sphingomonadaceae;Qipengyuania;";"0.0";"0";"22";"20";"0";"20";"2";"430504";"5766"
"LOK1378_1mm";"SILVA (only NR);Bacteria;Proteobacteria;Alphaproteobacteria;Sphingomonadales;Sphingomonadaceae;Rhizorhapis;";"0.0";"0";"54";"54";"0";"54";"0";"430470";"5766"
"LOK1378_1mm";"SILVA (only NR);Bacteria;Proteobacteria;Alphaproteobacteria;Sphingomonadales;Sphingomonadaceae;SD04E11;";"0.0";"0";"12";"12";"0";"12";"0";"430512";"5766"
"LOK1378_1mm";"SILVA (only NR);Bacteria;Proteobacteria;Alphaproteobacteria;Sphingomonadales;Sphingomonadaceae;Sandaracinobacter;";"0.0";"0";"19";"19";"0";"19";"0";"430505";"5766"
"LOK1378_1mm";"SILVA (only NR);Bacteria;Proteobacteria;Alphaproteobacteria;Sphingomonadales;Sphingomonadaceae;Sandarakinorhabdus;";"0.0";"0";"9";"9";"0";"9";"0";"430515";"5766"
"LOK1378_1mm";"SILVA (only NR);Bacteria;Proteobacteria;Alphaproteobacteria;Sphingomonadales;Sphingomonadaceae;Sphingoaurantiacus;";"0.0";"0";"25";"25";"0";"25";"0";"430499";"5766"
"LOK1378_1mm";"SILVA (only NR);Bacteria;Proteobacteria;Alphaproteobacteria;Sphingomonadales;Sphingomonadaceae;Sphingobium;";"0.0";"0";"484";"471";"0";"471";"13";"430053";"5766"
"LOK1378_1mm";"SILVA (only NR);Bacteria;Proteobacteria;Alphaproteobacteria;Sphingomonadales;Sphingomonadaceae;Sphingomicrobium;";"0.0";"0";"9";"9";"0";"9";"0";"430515";"5766"
"LOK1378_1mm";"SILVA (only NR);Bacteria;Proteobacteria;Alphaproteobacteria;Sphingomonadales;Sphingomonadaceae;Sphingomonas;";"0.0";"0";"1787";"1758";"0";"1758";"29";"428766";"5766"
"LOK1378_1mm";"SILVA (only NR);Bacteria;Proteobacteria;Alphaproteobacteria;Sphingomonadales;Sphingomonadaceae;Sphingopyxis;";"0.0";"0";"214";"204";"0";"204";"10";"430320";"5766"
"LOK1378_1mm";"SILVA (only NR);Bacteria;Proteobacteria;Alphaproteobacteria;Sphingomonadales;Sphingomonadaceae;Sphingorhabdus;";"0.0";"0";"120";"113";"0";"113";"7";"430411";"5766"
"LOK1378_1mm";"SILVA (only NR);Bacteria;Proteobacteria;Alphaproteobacteria;Sphingomonadales;Sphingomonadaceae;Sphingosinicella;";"0.0";"0";"13";"12";"0";"12";"1";"430512";"5766"
"LOK1378_1mm";"SILVA (only NR);Bacteria;Proteobacteria;Alphaproteobacteria;Sphingomonadales;Sphingomonadaceae;Stakelama;";"0.0";"0";"6";"6";"0";"6";"0";"430518";"5766"
"LOK1378_1mm";"SILVA (only NR);Bacteria;Proteobacteria;Alphaproteobacteria;Sphingomonadales;Sphingomonadaceae;Zymomonas;";"0.0";"0";"33";"33";"0";"33";"0";"430491";"5766"
"LOK1378_1mm";"SILVA (only NR);Bacteria;Proteobacteria;Alphaproteobacteria;Sphingomonadales;Sphingomonadaceae;uncultured;";"0.0";"0";"256";"251";"0";"251";"5";"430273";"5766"
"LOK1378_1mm";"SILVA (only NR);Bacteria;Proteobacteria;Alphaproteobacteria;Thalassobaculales;";"0.0";"0";"152";"148";"0";"148";"4";"430376";"5766"
"LOK1378_1mm";"SILVA (only NR);Bacteria;Proteobacteria;Alphaproteobacteria;Thalassobaculales;Nisaeaceae;";"0.0";"0";"44";"42";"0";"42";"2";"430482";"5766"
"LOK1378_1mm";"SILVA (only NR);Bacteria;Proteobacteria;Alphaproteobacteria;Thalassobaculales;Nisaeaceae;Nisaea;";"0.0";"0";"12";"10";"0";"10";"2";"430514";"5766"
"LOK1378_1mm";"SILVA (only NR);Bacteria;Proteobacteria;Alphaproteobacteria;Thalassobaculales;Nisaeaceae;OM75 clade;";"0.0";"0";"32";"32";"0";"32";"0";"430492";"5766"
"LOK1378_1mm";"SILVA (only NR);Bacteria;Proteobacteria;Alphaproteobacteria;Thalassobaculales;Oceanibaculaceae;";"0.0";"0";"7";"7";"0";"7";"0";"430517";"5766"
"LOK1378_1mm";"SILVA (only NR);Bacteria;Proteobacteria;Alphaproteobacteria;Thalassobaculales;Oceanibaculaceae;Oceanibaculum;";"0.0";"0";"7";"7";"0";"7";"0";"430517";"5766"
"LOK1378_1mm";"SILVA (only NR);Bacteria;Proteobacteria;Alphaproteobacteria;Thalassobaculales;Thalassobaculaceae;";"0.0";"0";"15";"15";"0";"15";"0";"430509";"5766"
"LOK1378_1mm";"SILVA (only NR);Bacteria;Proteobacteria;Alphaproteobacteria;Thalassobaculales;Thalassobaculaceae;Candidatus Endolissoclinum;";"0.0";"0";"2";"2";"0";"2";"0";"430522";"5766"
"LOK1378_1mm";"SILVA (only NR);Bacteria;Proteobacteria;Alphaproteobacteria;Thalassobaculales;Thalassobaculaceae;Thalassobaculum;";"0.0";"0";"13";"13";"0";"13";"0";"430511";"5766"
"LOK1378_1mm";"SILVA (only NR);Bacteria;Proteobacteria;Alphaproteobacteria;Thalassobaculales;uncultured;";"0.0";"0";"86";"84";"0";"84";"2";"430440";"5766"
"LOK1378_1mm";"SILVA (only NR);Bacteria;Proteobacteria;Alphaproteobacteria;Tistrellales;";"0.0";"0";"126";"123";"0";"123";"3";"430401";"5766"
"LOK1378_1mm";"SILVA (only NR);Bacteria;Proteobacteria;Alphaproteobacteria;Tistrellales;Geminicoccaceae;";"0.0";"0";"103";"100";"0";"100";"3";"430424";"5766"
"LOK1378_1mm";"SILVA (only NR);Bacteria;Proteobacteria;Alphaproteobacteria;Tistrellales;Geminicoccaceae;Arboricoccus;";"0.0";"0";"4";"2";"0";"2";"2";"430522";"5766"
"LOK1378_1mm";"SILVA (only NR);Bacteria;Proteobacteria;Alphaproteobacteria;Tistrellales;Geminicoccaceae;Candidatus Alysiosphaera;";"0.0";"0";"54";"53";"0";"53";"1";"430471";"5766"
"LOK1378_1mm";"SILVA (only NR);Bacteria;Proteobacteria;Alphaproteobacteria;Tistrellales;Geminicoccaceae;Geminicoccus;";"0.0";"0";"9";"9";"0";"9";"0";"430515";"5766"
"LOK1378_1mm";"SILVA (only NR);Bacteria;Proteobacteria;Alphaproteobacteria;Tistrellales;Geminicoccaceae;uncultured;";"0.0";"0";"36";"36";"0";"36";"0";"430488";"5766"
"LOK1378_1mm";"SILVA (only NR);Bacteria;Proteobacteria;Alphaproteobacteria;Tistrellales;Tistrellaceae;";"0.0";"0";"23";"23";"0";"23";"0";"430501";"5766"
"LOK1378_1mm";"SILVA (only NR);Bacteria;Proteobacteria;Alphaproteobacteria;Tistrellales;Tistrellaceae;Tistrella;";"0.0";"0";"23";"23";"0";"23";"0";"430501";"5766"
"LOK1378_1mm";"SILVA (only NR);Bacteria;Proteobacteria;Alphaproteobacteria;Zavarziniales;";"0.0";"0";"24";"24";"0";"24";"0";"430500";"5766"
"LOK1378_1mm";"SILVA (only NR);Bacteria;Proteobacteria;Alphaproteobacteria;Zavarziniales;Zavarziniaceae;";"0.0";"0";"5";"5";"0";"5";"0";"430519";"5766"
"LOK1378_1mm";"SILVA (only NR);Bacteria;Proteobacteria;Alphaproteobacteria;Zavarziniales;Zavarziniaceae;Oleomonas;";"0.0";"0";"1";"1";"0";"1";"0";"430523";"5766"
"LOK1378_1mm";"SILVA (only NR);Bacteria;Proteobacteria;Alphaproteobacteria;Zavarziniales;Zavarziniaceae;Zavarzinia;";"0.0";"0";"2";"2";"0";"2";"0";"430522";"5766"
"LOK1378_1mm";"SILVA (only NR);Bacteria;Proteobacteria;Alphaproteobacteria;Zavarziniales;uncultured;";"0.0";"0";"19";"19";"0";"19";"0";"430505";"5766"
"LOK1378_1mm";"SILVA (only NR);Bacteria;Proteobacteria;Alphaproteobacteria;uncultured;";"0.0";"0";"481";"466";"0";"466";"15";"430058";"5766"
"LOK1378_1mm";"SILVA (only NR);Bacteria;Proteobacteria;Gammaproteobacteria;";"0.0";"0";"75026";"71890";"0";"71890";"3136";"358634";"5766"
"LOK1378_1mm";"SILVA (only NR);Bacteria;Proteobacteria;Gammaproteobacteria;1013-28-CG33;";"0.0";"0";"19";"19";"0";"19";"0";"430505";"5766"
"LOK1378_1mm";"SILVA (only NR);Bacteria;Proteobacteria;Gammaproteobacteria;AT-s16;";"0.0";"0";"6";"6";"0";"6";"0";"430518";"5766"
"LOK1378_1mm";"SILVA (only NR);Bacteria;Proteobacteria;Gammaproteobacteria;AT-s2-59;";"0.0";"0";"54";"52";"0";"52";"2";"430472";"5766"
"LOK1378_1mm";"SILVA (only NR);Bacteria;Proteobacteria;Gammaproteobacteria;Acidiferrobacterales;";"0.0";"0";"113";"108";"0";"108";"5";"430416";"5766"
"LOK1378_1mm";"SILVA (only NR);Bacteria;Proteobacteria;Gammaproteobacteria;Acidiferrobacterales;Acidiferrobacteraceae;";"0.0";"0";"113";"108";"0";"108";"5";"430416";"5766"
"LOK1378_1mm";"SILVA (only NR);Bacteria;Proteobacteria;Gammaproteobacteria;Acidiferrobacterales;Acidiferrobacteraceae;Acidiferrobacter;";"0.0";"0";"5";"4";"0";"4";"1";"430520";"5766"
"LOK1378_1mm";"SILVA (only NR);Bacteria;Proteobacteria;Gammaproteobacteria;Acidiferrobacterales;Acidiferrobacteraceae;Sulfurifustis;";"0.0";"0";"87";"85";"0";"85";"2";"430439";"5766"
"LOK1378_1mm";"SILVA (only NR);Bacteria;Proteobacteria;Gammaproteobacteria;Acidiferrobacterales;Acidiferrobacteraceae;uncultured;";"0.0";"0";"17";"15";"0";"15";"2";"430509";"5766"
"LOK1378_1mm";"SILVA (only NR);Bacteria;Proteobacteria;Gammaproteobacteria;Acidithiobacillales;";"0.0";"0";"344";"318";"0";"318";"26";"430206";"5766"
"LOK1378_1mm";"SILVA (only NR);Bacteria;Proteobacteria;Gammaproteobacteria;Acidithiobacillales;Acidithiobacillaceae;";"0.0";"0";"344";"318";"0";"318";"26";"430206";"5766"
"LOK1378_1mm";"SILVA (only NR);Bacteria;Proteobacteria;Gammaproteobacteria;Acidithiobacillales;Acidithiobacillaceae;9M32;";"0.0";"0";"25";"25";"0";"25";"0";"430499";"5766"
"LOK1378_1mm";"SILVA (only NR);Bacteria;Proteobacteria;Gammaproteobacteria;Acidithiobacillales;Acidithiobacillaceae;Acidithiobacillus;";"0.0";"0";"236";"215";"0";"215";"21";"430309";"5766"
"LOK1378_1mm";"SILVA (only NR);Bacteria;Proteobacteria;Gammaproteobacteria;Acidithiobacillales;Acidithiobacillaceae;KCM-B-112;";"0.0";"0";"57";"52";"0";"52";"5";"430472";"5766"
"LOK1378_1mm";"SILVA (only NR);Bacteria;Proteobacteria;Gammaproteobacteria;Acidithiobacillales;Acidithiobacillaceae;RCP1-48;";"0.0";"0";"14";"14";"0";"14";"0";"430510";"5766"
"LOK1378_1mm";"SILVA (only NR);Bacteria;Proteobacteria;Gammaproteobacteria;Acidithiobacillales;Acidithiobacillaceae;TX1A-55;";"0.0";"0";"5";"5";"0";"5";"0";"430519";"5766"
"LOK1378_1mm";"SILVA (only NR);Bacteria;Proteobacteria;Gammaproteobacteria;Acidithiobacillales;Acidithiobacillaceae;Thermithiobacillus;";"0.0";"0";"7";"7";"0";"7";"0";"430517";"5766"
"LOK1378_1mm";"SILVA (only NR);Bacteria;Proteobacteria;Gammaproteobacteria;Arenicellales;";"0.0";"0";"216";"208";"0";"208";"8";"430316";"5766"
"LOK1378_1mm";"SILVA (only NR);Bacteria;Proteobacteria;Gammaproteobacteria;Arenicellales;Arenicellaceae;";"0.0";"0";"216";"208";"0";"208";"8";"430316";"5766"
"LOK1378_1mm";"SILVA (only NR);Bacteria;Proteobacteria;Gammaproteobacteria;Arenicellales;Arenicellaceae;Arenicella;";"0.0";"0";"22";"22";"0";"22";"0";"430502";"5766"
"LOK1378_1mm";"SILVA (only NR);Bacteria;Proteobacteria;Gammaproteobacteria;Arenicellales;Arenicellaceae;Candidatus Thiosymbion;";"0.0";"0";"38";"37";"0";"37";"1";"430487";"5766"
"LOK1378_1mm";"SILVA (only NR);Bacteria;Proteobacteria;Gammaproteobacteria;Arenicellales;Arenicellaceae;HTCC5015;";"0.0";"0";"16";"15";"0";"15";"1";"430509";"5766"
"LOK1378_1mm";"SILVA (only NR);Bacteria;Proteobacteria;Gammaproteobacteria;Arenicellales;Arenicellaceae;Perspicuibacter;";"0.0";"0";"4";"4";"0";"4";"0";"430520";"5766"
"LOK1378_1mm";"SILVA (only NR);Bacteria;Proteobacteria;Gammaproteobacteria;Arenicellales;Arenicellaceae;Thiolapillus;";"0.0";"0";"8";"8";"0";"8";"0";"430516";"5766"
"LOK1378_1mm";"SILVA (only NR);Bacteria;Proteobacteria;Gammaproteobacteria;Arenicellales;Arenicellaceae;uncultured;";"0.0";"0";"125";"120";"0";"120";"5";"430404";"5766"
"LOK1378_1mm";"SILVA (only NR);Bacteria;Proteobacteria;Gammaproteobacteria;B108;";"0.0";"0";"2";"2";"0";"2";"0";"430522";"5766"
"LOK1378_1mm";"SILVA (only NR);Bacteria;Proteobacteria;Gammaproteobacteria;B2M28;";"0.0";"0";"165";"164";"0";"164";"1";"430360";"5766"
"LOK1378_1mm";"SILVA (only NR);Bacteria;Proteobacteria;Gammaproteobacteria;BD7-8;";"0.0";"0";"21";"21";"0";"21";"0";"430503";"5766"
"LOK1378_1mm";"SILVA (only NR);Bacteria;Proteobacteria;Gammaproteobacteria;BD72BR169;";"0.0";"0";"14";"14";"0";"14";"0";"430510";"5766"
"LOK1378_1mm";"SILVA (only NR);Bacteria;Proteobacteria;Gammaproteobacteria;Beggiatoales;";"0.0";"0";"137";"133";"0";"133";"4";"430391";"5766"
"LOK1378_1mm";"SILVA (only NR);Bacteria;Proteobacteria;Gammaproteobacteria;Beggiatoales;Beggiatoaceae;";"0.0";"0";"137";"133";"0";"133";"4";"430391";"5766"
"LOK1378_1mm";"SILVA (only NR);Bacteria;Proteobacteria;Gammaproteobacteria;Beggiatoales;Beggiatoaceae;Beggiatoa;";"0.0";"0";"28";"26";"0";"26";"2";"430498";"5766"
"LOK1378_1mm";"SILVA (only NR);Bacteria;Proteobacteria;Gammaproteobacteria;Beggiatoales;Beggiatoaceae;Candidatus Allobeggiatoa;";"0.0";"0";"1";"1";"0";"1";"0";"430523";"5766"
"LOK1378_1mm";"SILVA (only NR);Bacteria;Proteobacteria;Gammaproteobacteria;Beggiatoales;Beggiatoaceae;Candidatus Isobeggiatoa;";"0.0";"0";"7";"7";"0";"7";"0";"430517";"5766"
"LOK1378_1mm";"SILVA (only NR);Bacteria;Proteobacteria;Gammaproteobacteria;Beggiatoales;Beggiatoaceae;Candidatus Maribeggiatoa;";"0.0";"0";"2";"2";"0";"2";"0";"430522";"5766"
"LOK1378_1mm";"SILVA (only NR);Bacteria;Proteobacteria;Gammaproteobacteria;Beggiatoales;Beggiatoaceae;Candidatus Marithioploca;";"0.0";"0";"4";"4";"0";"4";"0";"430520";"5766"
"LOK1378_1mm";"SILVA (only NR);Bacteria;Proteobacteria;Gammaproteobacteria;Beggiatoales;Beggiatoaceae;Candidatus Marithrix;";"0.0";"0";"5";"5";"0";"5";"0";"430519";"5766"
"LOK1378_1mm";"SILVA (only NR);Bacteria;Proteobacteria;Gammaproteobacteria;Beggiatoales;Beggiatoaceae;Candidatus Parabeggiatoa;";"0.0";"0";"4";"4";"0";"4";"0";"430520";"5766"
"LOK1378_1mm";"SILVA (only NR);Bacteria;Proteobacteria;Gammaproteobacteria;Beggiatoales;Beggiatoaceae;Candidatus Thiophysa;";"0.0";"0";"1";"1";"0";"1";"0";"430523";"5766"
"LOK1378_1mm";"SILVA (only NR);Bacteria;Proteobacteria;Gammaproteobacteria;Beggiatoales;Beggiatoaceae;Candidatus Thiopilula;";"0.0";"0";"5";"5";"0";"5";"0";"430519";"5766"
"LOK1378_1mm";"SILVA (only NR);Bacteria;Proteobacteria;Gammaproteobacteria;Beggiatoales;Beggiatoaceae;Thioflexothrix;";"0.0";"0";"10";"10";"0";"10";"0";"430514";"5766"
"LOK1378_1mm";"SILVA (only NR);Bacteria;Proteobacteria;Gammaproteobacteria;Beggiatoales;Beggiatoaceae;Thiomargarita;";"0.0";"0";"10";"10";"0";"10";"0";"430514";"5766"
"LOK1378_1mm";"SILVA (only NR);Bacteria;Proteobacteria;Gammaproteobacteria;Beggiatoales;Beggiatoaceae;Thioploca;";"0.0";"0";"4";"4";"0";"4";"0";"430520";"5766"
"LOK1378_1mm";"SILVA (only NR);Bacteria;Proteobacteria;Gammaproteobacteria;Beggiatoales;Beggiatoaceae;uncultured;";"0.0";"0";"54";"52";"0";"52";"2";"430472";"5766"
"LOK1378_1mm";"SILVA (only NR);Bacteria;Proteobacteria;Gammaproteobacteria;Burkholderiales;";"0.0";"0";"20421";"19712";"0";"19712";"709";"410812";"5766"
"LOK1378_1mm";"SILVA (only NR);Bacteria;Proteobacteria;Gammaproteobacteria;Burkholderiales;A21b;";"0.0";"0";"76";"75";"0";"75";"1";"430449";"5766"
"LOK1378_1mm";"SILVA (only NR);Bacteria;Proteobacteria;Gammaproteobacteria;Burkholderiales;Alcaligenaceae;";"0.0";"0";"1746";"1690";"0";"1690";"56";"428834";"5766"
"LOK1378_1mm";"SILVA (only NR);Bacteria;Proteobacteria;Gammaproteobacteria;Burkholderiales;Alcaligenaceae;Achromobacter;";"0.0";"0";"348";"324";"0";"324";"24";"430200";"5766"
"LOK1378_1mm";"SILVA (only NR);Bacteria;Proteobacteria;Gammaproteobacteria;Burkholderiales;Alcaligenaceae;Advenella;";"0.0";"0";"41";"41";"0";"41";"0";"430483";"5766"
"LOK1378_1mm";"SILVA (only NR);Bacteria;Proteobacteria;Gammaproteobacteria;Burkholderiales;Alcaligenaceae;Alcaligenes;";"0.0";"0";"269";"254";"0";"254";"15";"430270";"5766"
"LOK1378_1mm";"SILVA (only NR);Bacteria;Proteobacteria;Gammaproteobacteria;Burkholderiales;Alcaligenaceae;Ampullimonas;";"0.0";"0";"2";"2";"0";"2";"0";"430522";"5766"
"LOK1378_1mm";"SILVA (only NR);Bacteria;Proteobacteria;Gammaproteobacteria;Burkholderiales;Alcaligenaceae;Basilea;";"0.0";"0";"3";"3";"0";"3";"0";"430521";"5766"
"LOK1378_1mm";"SILVA (only NR);Bacteria;Proteobacteria;Gammaproteobacteria;Burkholderiales;Alcaligenaceae;Bordetella;";"0.0";"0";"532";"530";"0";"530";"2";"429994";"5766"
"LOK1378_1mm";"SILVA (only NR);Bacteria;Proteobacteria;Gammaproteobacteria;Burkholderiales;Alcaligenaceae;Brackiella;";"0.0";"0";"1";"1";"0";"1";"0";"430523";"5766"
"LOK1378_1mm";"SILVA (only NR);Bacteria;Proteobacteria;Gammaproteobacteria;Burkholderiales;Alcaligenaceae;Candidatus Kinetoplastibacterium;";"0.0";"0";"9";"9";"0";"9";"0";"430515";"5766"
"LOK1378_1mm";"SILVA (only NR);Bacteria;Proteobacteria;Gammaproteobacteria;Burkholderiales;Alcaligenaceae;Candidimonas;";"0.0";"0";"22";"22";"0";"22";"0";"430502";"5766"
"LOK1378_1mm";"SILVA (only NR);Bacteria;Proteobacteria;Gammaproteobacteria;Burkholderiales;Alcaligenaceae;Castellaniella;";"0.0";"0";"83";"82";"0";"82";"1";"430442";"5766"
"LOK1378_1mm";"SILVA (only NR);Bacteria;Proteobacteria;Gammaproteobacteria;Burkholderiales;Alcaligenaceae;Derxia;";"0.0";"0";"6";"6";"0";"6";"0";"430518";"5766"
"LOK1378_1mm";"SILVA (only NR);Bacteria;Proteobacteria;Gammaproteobacteria;Burkholderiales;Alcaligenaceae;Eoetvoesia;";"0.0";"0";"10";"10";"0";"10";"0";"430514";"5766"
"LOK1378_1mm";"SILVA (only NR);Bacteria;Proteobacteria;Gammaproteobacteria;Burkholderiales;Alcaligenaceae;GKS98 freshwater group;";"0.0";"0";"57";"56";"0";"56";"1";"430468";"5766"
"LOK1378_1mm";"SILVA (only NR);Bacteria;Proteobacteria;Gammaproteobacteria;Burkholderiales;Alcaligenaceae;Kerstersia;";"0.0";"0";"27";"27";"0";"27";"0";"430497";"5766"
"LOK1378_1mm";"SILVA (only NR);Bacteria;Proteobacteria;Gammaproteobacteria;Burkholderiales;Alcaligenaceae;Oligella;";"0.0";"0";"15";"15";"0";"15";"0";"430509";"5766"
"LOK1378_1mm";"SILVA (only NR);Bacteria;Proteobacteria;Gammaproteobacteria;Burkholderiales;Alcaligenaceae;Orrella;";"0.0";"0";"3";"3";"0";"3";"0";"430521";"5766"
"LOK1378_1mm";"SILVA (only NR);Bacteria;Proteobacteria;Gammaproteobacteria;Burkholderiales;Alcaligenaceae;Paenalcaligenes;";"0.0";"0";"20";"16";"0";"16";"4";"430508";"5766"
"LOK1378_1mm";"SILVA (only NR);Bacteria;Proteobacteria;Gammaproteobacteria;Burkholderiales;Alcaligenaceae;Paralcaligenes;";"0.0";"0";"4";"4";"0";"4";"0";"430520";"5766"
"LOK1378_1mm";"SILVA (only NR);Bacteria;Proteobacteria;Gammaproteobacteria;Burkholderiales;Alcaligenaceae;Parapusillimonas;";"0.0";"0";"54";"50";"0";"50";"4";"430474";"5766"
"LOK1378_1mm";"SILVA (only NR);Bacteria;Proteobacteria;Gammaproteobacteria;Burkholderiales;Alcaligenaceae;Parvibium;";"0.0";"0";"7";"6";"0";"6";"1";"430518";"5766"
"LOK1378_1mm";"SILVA (only NR);Bacteria;Proteobacteria;Gammaproteobacteria;Burkholderiales;Alcaligenaceae;Pelistega;";"0.0";"0";"10";"10";"0";"10";"0";"430514";"5766"
"LOK1378_1mm";"SILVA (only NR);Bacteria;Proteobacteria;Gammaproteobacteria;Burkholderiales;Alcaligenaceae;Pigmentiphaga;";"0.0";"0";"21";"21";"0";"21";"0";"430503";"5766"
"LOK1378_1mm";"SILVA (only NR);Bacteria;Proteobacteria;Gammaproteobacteria;Burkholderiales;Alcaligenaceae;Pusillimonas;";"0.0";"0";"63";"62";"0";"62";"1";"430462";"5766"
"LOK1378_1mm";"SILVA (only NR);Bacteria;Proteobacteria;Gammaproteobacteria;Burkholderiales;Alcaligenaceae;Taylorella;";"0.0";"0";"17";"17";"0";"17";"0";"430507";"5766"
"LOK1378_1mm";"SILVA (only NR);Bacteria;Proteobacteria;Gammaproteobacteria;Burkholderiales;Alcaligenaceae;Verticiella;";"0.0";"0";"39";"38";"0";"38";"1";"430486";"5766"
"LOK1378_1mm";"SILVA (only NR);Bacteria;Proteobacteria;Gammaproteobacteria;Burkholderiales;Alcaligenaceae;uncultured;";"0.0";"0";"54";"52";"0";"52";"2";"430472";"5766"
"LOK1378_1mm";"SILVA (only NR);Bacteria;Proteobacteria;Gammaproteobacteria;Burkholderiales;Aquaspirillaceae;";"0.0";"0";"48";"48";"0";"48";"0";"430476";"5766"
"LOK1378_1mm";"SILVA (only NR);Bacteria;Proteobacteria;Gammaproteobacteria;Burkholderiales;Aquaspirillaceae;Aquaspirillum;";"0.0";"0";"13";"13";"0";"13";"0";"430511";"5766"
"LOK1378_1mm";"SILVA (only NR);Bacteria;Proteobacteria;Gammaproteobacteria;Burkholderiales;Aquaspirillaceae;Laribacter;";"0.0";"0";"17";"17";"0";"17";"0";"430507";"5766"
"LOK1378_1mm";"SILVA (only NR);Bacteria;Proteobacteria;Gammaproteobacteria;Burkholderiales;Aquaspirillaceae;Microvirgula;";"0.0";"0";"11";"11";"0";"11";"0";"430513";"5766"
"LOK1378_1mm";"SILVA (only NR);Bacteria;Proteobacteria;Gammaproteobacteria;Burkholderiales;Aquaspirillaceae;Rivicola;";"0.0";"0";"6";"6";"0";"6";"0";"430518";"5766"
"LOK1378_1mm";"SILVA (only NR);Bacteria;Proteobacteria;Gammaproteobacteria;Burkholderiales;B1-7BS;";"0.0";"0";"81";"79";"0";"79";"2";"430445";"5766"
"LOK1378_1mm";"SILVA (only NR);Bacteria;Proteobacteria;Gammaproteobacteria;Burkholderiales;Burkholderiaceae;";"0.0";"0";"3609";"3463";"0";"3463";"146";"427061";"5766"
"LOK1378_1mm";"SILVA (only NR);Bacteria;Proteobacteria;Gammaproteobacteria;Burkholderiales;Burkholderiaceae;Burkholderia-Caballeronia-Paraburkholderia;";"0.0";"0";"2182";"2109";"0";"2109";"73";"428415";"5766"
"LOK1378_1mm";"SILVA (only NR);Bacteria;Proteobacteria;Gammaproteobacteria;Burkholderiales;Burkholderiaceae;Candidatus Glomeribacter;";"0.0";"0";"9";"9";"0";"9";"0";"430515";"5766"
"LOK1378_1mm";"SILVA (only NR);Bacteria;Proteobacteria;Gammaproteobacteria;Burkholderiales;Burkholderiaceae;Candidatus Tremblaya;";"0.0";"0";"37";"36";"0";"36";"1";"430488";"5766"
"LOK1378_1mm";"SILVA (only NR);Bacteria;Proteobacteria;Gammaproteobacteria;Burkholderiales;Burkholderiaceae;Cupriavidus;";"0.0";"0";"310";"302";"0";"302";"8";"430222";"5766"
"LOK1378_1mm";"SILVA (only NR);Bacteria;Proteobacteria;Gammaproteobacteria;Burkholderiales;Burkholderiaceae;Lautropia;";"0.0";"0";"194";"185";"0";"185";"9";"430339";"5766"
"LOK1378_1mm";"SILVA (only NR);Bacteria;Proteobacteria;Gammaproteobacteria;Burkholderiales;Burkholderiaceae;Limnobacter;";"0.0";"0";"202";"201";"0";"201";"1";"430323";"5766"
"LOK1378_1mm";"SILVA (only NR);Bacteria;Proteobacteria;Gammaproteobacteria;Burkholderiales;Burkholderiaceae;Mycoavidus;";"0.0";"0";"4";"4";"0";"4";"0";"430520";"5766"
"LOK1378_1mm";"SILVA (only NR);Bacteria;Proteobacteria;Gammaproteobacteria;Burkholderiales;Burkholderiaceae;Pandoraea;";"0.0";"0";"80";"78";"0";"78";"2";"430446";"5766"
"LOK1378_1mm";"SILVA (only NR);Bacteria;Proteobacteria;Gammaproteobacteria;Burkholderiales;Burkholderiaceae;Polynucleobacter;";"0.0";"0";"169";"160";"0";"160";"9";"430364";"5766"
"LOK1378_1mm";"SILVA (only NR);Bacteria;Proteobacteria;Gammaproteobacteria;Burkholderiales;Burkholderiaceae;Ralstonia;";"0.0";"0";"377";"336";"0";"336";"41";"430188";"5766"
"LOK1378_1mm";"SILVA (only NR);Bacteria;Proteobacteria;Gammaproteobacteria;Burkholderiales;Burkholderiaceae;Robbsia;";"0.0";"0";"15";"14";"0";"14";"1";"430510";"5766"
"LOK1378_1mm";"SILVA (only NR);Bacteria;Proteobacteria;Gammaproteobacteria;Burkholderiales;Burkholderiaceae;uncultured;";"0.0";"0";"29";"28";"0";"28";"1";"430496";"5766"
"LOK1378_1mm";"SILVA (only NR);Bacteria;Proteobacteria;Gammaproteobacteria;Burkholderiales;Burkholderiales Incertae Sedis;";"0.0";"0";"5";"5";"0";"5";"0";"430519";"5766"
"LOK1378_1mm";"SILVA (only NR);Bacteria;Proteobacteria;Gammaproteobacteria;Burkholderiales;Burkholderiales Incertae Sedis;2013Ark19i;";"0.0";"0";"3";"3";"0";"3";"0";"430521";"5766"
"LOK1378_1mm";"SILVA (only NR);Bacteria;Proteobacteria;Gammaproteobacteria;Burkholderiales;Burkholderiales Incertae Sedis;Candidatus Branchiomonas;";"0.0";"0";"2";"2";"0";"2";"0";"430522";"5766"
"LOK1378_1mm";"SILVA (only NR);Bacteria;Proteobacteria;Gammaproteobacteria;Burkholderiales;Candidatus Protistobacter;";"0.0";"0";"2";"2";"0";"2";"0";"430522";"5766"
"LOK1378_1mm";"SILVA (only NR);Bacteria;Proteobacteria;Gammaproteobacteria;Burkholderiales;Chitinibacteraceae;";"0.0";"0";"64";"61";"0";"61";"3";"430463";"5766"
"LOK1378_1mm";"SILVA (only NR);Bacteria;Proteobacteria;Gammaproteobacteria;Burkholderiales;Chitinibacteraceae;Amantichitinum;";"0.0";"0";"3";"3";"0";"3";"0";"430521";"5766"
"LOK1378_1mm";"SILVA (only NR);Bacteria;Proteobacteria;Gammaproteobacteria;Burkholderiales;Chitinibacteraceae;Andreprevotia;";"0.0";"0";"2";"2";"0";"2";"0";"430522";"5766"
"LOK1378_1mm";"SILVA (only NR);Bacteria;Proteobacteria;Gammaproteobacteria;Burkholderiales;Chitinibacteraceae;Chitinibacter;";"0.0";"0";"7";"7";"0";"7";"0";"430517";"5766"
"LOK1378_1mm";"SILVA (only NR);Bacteria;Proteobacteria;Gammaproteobacteria;Burkholderiales;Chitinibacteraceae;Chitinilyticum;";"0.0";"0";"2";"2";"0";"2";"0";"430522";"5766"
"LOK1378_1mm";"SILVA (only NR);Bacteria;Proteobacteria;Gammaproteobacteria;Burkholderiales;Chitinibacteraceae;Chitiniphilus;";"0.0";"0";"8";"7";"0";"7";"1";"430517";"5766"
"LOK1378_1mm";"SILVA (only NR);Bacteria;Proteobacteria;Gammaproteobacteria;Burkholderiales;Chitinibacteraceae;Deefgea;";"0.0";"0";"14";"13";"0";"13";"1";"430511";"5766"
"LOK1378_1mm";"SILVA (only NR);Bacteria;Proteobacteria;Gammaproteobacteria;Burkholderiales;Chitinibacteraceae;Formivibrio;";"0.0";"0";"4";"4";"0";"4";"0";"430520";"5766"
"LOK1378_1mm";"SILVA (only NR);Bacteria;Proteobacteria;Gammaproteobacteria;Burkholderiales;Chitinibacteraceae;Iodobacter;";"0.0";"0";"12";"12";"0";"12";"0";"430512";"5766"
"LOK1378_1mm";"SILVA (only NR);Bacteria;Proteobacteria;Gammaproteobacteria;Burkholderiales;Chitinibacteraceae;Jeongeupia;";"0.0";"0";"4";"4";"0";"4";"0";"430520";"5766"
"LOK1378_1mm";"SILVA (only NR);Bacteria;Proteobacteria;Gammaproteobacteria;Burkholderiales;Chitinibacteraceae;Silvimonas;";"0.0";"0";"6";"6";"0";"6";"0";"430518";"5766"
"LOK1378_1mm";"SILVA (only NR);Bacteria;Proteobacteria;Gammaproteobacteria;Burkholderiales;Chitinimonadaceae;";"0.0";"0";"34";"32";"0";"32";"2";"430492";"5766"
"LOK1378_1mm";"SILVA (only NR);Bacteria;Proteobacteria;Gammaproteobacteria;Burkholderiales;Chitinimonadaceae;Chitinimonas;";"0.0";"0";"25";"23";"0";"23";"2";"430501";"5766"
"LOK1378_1mm";"SILVA (only NR);Bacteria;Proteobacteria;Gammaproteobacteria;Burkholderiales;Chitinimonadaceae;Chitinivorax;";"0.0";"0";"9";"9";"0";"9";"0";"430515";"5766"
"LOK1378_1mm";"SILVA (only NR);Bacteria;Proteobacteria;Gammaproteobacteria;Burkholderiales;Chromobacteriaceae;";"0.0";"0";"185";"177";"0";"177";"8";"430347";"5766"
"LOK1378_1mm";"SILVA (only NR);Bacteria;Proteobacteria;Gammaproteobacteria;Burkholderiales;Chromobacteriaceae;Aquitalea;";"0.0";"0";"21";"20";"0";"20";"1";"430504";"5766"
"LOK1378_1mm";"SILVA (only NR);Bacteria;Proteobacteria;Gammaproteobacteria;Burkholderiales;Chromobacteriaceae;Chromobacterium;";"0.0";"0";"67";"64";"0";"64";"3";"430460";"5766"
"LOK1378_1mm";"SILVA (only NR);Bacteria;Proteobacteria;Gammaproteobacteria;Burkholderiales;Chromobacteriaceae;Crenobacter;";"0.0";"0";"11";"11";"0";"11";"0";"430513";"5766"
"LOK1378_1mm";"SILVA (only NR);Bacteria;Proteobacteria;Gammaproteobacteria;Burkholderiales;Chromobacteriaceae;Gulbenkiania;";"0.0";"0";"2";"2";"0";"2";"0";"430522";"5766"
"LOK1378_1mm";"SILVA (only NR);Bacteria;Proteobacteria;Gammaproteobacteria;Burkholderiales;Chromobacteriaceae;Paludibacterium;";"0.0";"0";"23";"22";"0";"22";"1";"430502";"5766"
"LOK1378_1mm";"SILVA (only NR);Bacteria;Proteobacteria;Gammaproteobacteria;Burkholderiales;Chromobacteriaceae;Pseudogulbenkiania;";"0.0";"0";"14";"14";"0";"14";"0";"430510";"5766"
"LOK1378_1mm";"SILVA (only NR);Bacteria;Proteobacteria;Gammaproteobacteria;Burkholderiales;Chromobacteriaceae;Vogesella;";"0.0";"0";"47";"44";"0";"44";"3";"430480";"5766"
"LOK1378_1mm";"SILVA (only NR);Bacteria;Proteobacteria;Gammaproteobacteria;Burkholderiales;Comamonadaceae;";"0.0";"0";"5187";"4995";"0";"4995";"192";"425529";"5766"
"LOK1378_1mm";"SILVA (only NR);Bacteria;Proteobacteria;Gammaproteobacteria;Burkholderiales;Comamonadaceae;Acidovorax;";"0.0";"0";"531";"502";"0";"502";"29";"430022";"5766"
"LOK1378_1mm";"SILVA (only NR);Bacteria;Proteobacteria;Gammaproteobacteria;Burkholderiales;Comamonadaceae;Alicycliphilus;";"0.0";"0";"43";"43";"0";"43";"0";"430481";"5766"
"LOK1378_1mm";"SILVA (only NR);Bacteria;Proteobacteria;Gammaproteobacteria;Burkholderiales;Comamonadaceae;Aquabacterium;";"0.0";"0";"287";"281";"0";"281";"6";"430243";"5766"
"LOK1378_1mm";"SILVA (only NR);Bacteria;Proteobacteria;Gammaproteobacteria;Burkholderiales;Comamonadaceae;Aquincola;";"0.0";"0";"1";"1";"0";"1";"0";"430523";"5766"
"LOK1378_1mm";"SILVA (only NR);Bacteria;Proteobacteria;Gammaproteobacteria;Burkholderiales;Comamonadaceae;Azohydromonas;";"0.0";"0";"20";"19";"0";"19";"1";"430505";"5766"
"LOK1378_1mm";"SILVA (only NR);Bacteria;Proteobacteria;Gammaproteobacteria;Burkholderiales;Comamonadaceae;Brachymonas;";"0.0";"0";"88";"88";"0";"88";"0";"430436";"5766"
"LOK1378_1mm";"SILVA (only NR);Bacteria;Proteobacteria;Gammaproteobacteria;Burkholderiales;Comamonadaceae;Caenimonas;";"0.0";"0";"63";"62";"0";"62";"1";"430462";"5766"
"LOK1378_1mm";"SILVA (only NR);Bacteria;Proteobacteria;Gammaproteobacteria;Burkholderiales;Comamonadaceae;Caldimonas;";"0.0";"0";"6";"5";"0";"5";"1";"430519";"5766"
"LOK1378_1mm";"SILVA (only NR);Bacteria;Proteobacteria;Gammaproteobacteria;Burkholderiales;Comamonadaceae;Candidatus Symbiobacter;";"0.0";"0";"47";"46";"0";"46";"1";"430478";"5766"
"LOK1378_1mm";"SILVA (only NR);Bacteria;Proteobacteria;Gammaproteobacteria;Burkholderiales;Comamonadaceae;Comamonas;";"0.0";"0";"483";"454";"0";"454";"29";"430070";"5766"
"LOK1378_1mm";"SILVA (only NR);Bacteria;Proteobacteria;Gammaproteobacteria;Burkholderiales;Comamonadaceae;Corticibacter;";"0.0";"0";"6";"6";"0";"6";"0";"430518";"5766"
"LOK1378_1mm";"SILVA (only NR);Bacteria;Proteobacteria;Gammaproteobacteria;Burkholderiales;Comamonadaceae;Curvibacter;";"0.0";"0";"88";"85";"0";"85";"3";"430439";"5766"
"LOK1378_1mm";"SILVA (only NR);Bacteria;Proteobacteria;Gammaproteobacteria;Burkholderiales;Comamonadaceae;Delftia;";"0.0";"0";"261";"249";"0";"249";"12";"430275";"5766"
"LOK1378_1mm";"SILVA (only NR);Bacteria;Proteobacteria;Gammaproteobacteria;Burkholderiales;Comamonadaceae;Diaphorobacter;";"0.0";"0";"186";"179";"0";"179";"7";"430345";"5766"
"LOK1378_1mm";"SILVA (only NR);Bacteria;Proteobacteria;Gammaproteobacteria;Burkholderiales;Comamonadaceae;Extensimonas;";"0.0";"0";"11";"11";"0";"11";"0";"430513";"5766"
"LOK1378_1mm";"SILVA (only NR);Bacteria;Proteobacteria;Gammaproteobacteria;Burkholderiales;Comamonadaceae;Giesbergeria;";"0.0";"0";"17";"16";"0";"16";"1";"430508";"5766"
"LOK1378_1mm";"SILVA (only NR);Bacteria;Proteobacteria;Gammaproteobacteria;Burkholderiales;Comamonadaceae;Hydrogenophaga;";"0.0";"0";"256";"251";"0";"251";"5";"430273";"5766"
"LOK1378_1mm";"SILVA (only NR);Bacteria;Proteobacteria;Gammaproteobacteria;Burkholderiales;Comamonadaceae;Hylemonella;";"0.0";"0";"12";"12";"0";"12";"0";"430512";"5766"
"LOK1378_1mm";"SILVA (only NR);Bacteria;Proteobacteria;Gammaproteobacteria;Burkholderiales;Comamonadaceae;Ideonella;";"0.0";"0";"56";"55";"0";"55";"1";"430469";"5766"
"LOK1378_1mm";"SILVA (only NR);Bacteria;Proteobacteria;Gammaproteobacteria;Burkholderiales;Comamonadaceae;Inhella;";"0.0";"0";"21";"20";"0";"20";"1";"430504";"5766"
"LOK1378_1mm";"SILVA (only NR);Bacteria;Proteobacteria;Gammaproteobacteria;Burkholderiales;Comamonadaceae;Kinneretia;";"0.0";"0";"6";"5";"0";"5";"1";"430519";"5766"
"LOK1378_1mm";"SILVA (only NR);Bacteria;Proteobacteria;Gammaproteobacteria;Burkholderiales;Comamonadaceae;Lampropedia;";"0.0";"0";"11";"11";"0";"11";"0";"430513";"5766"
"LOK1378_1mm";"SILVA (only NR);Bacteria;Proteobacteria;Gammaproteobacteria;Burkholderiales;Comamonadaceae;Leptothrix;";"0.0";"0";"90";"89";"0";"89";"1";"430435";"5766"
"LOK1378_1mm";"SILVA (only NR);Bacteria;Proteobacteria;Gammaproteobacteria;Burkholderiales;Comamonadaceae;Limnohabitans;";"0.0";"0";"234";"229";"0";"229";"5";"430295";"5766"
"LOK1378_1mm";"SILVA (only NR);Bacteria;Proteobacteria;Gammaproteobacteria;Burkholderiales;Comamonadaceae;Macromonas;";"0.0";"0";"4";"4";"0";"4";"0";"430520";"5766"
"LOK1378_1mm";"SILVA (only NR);Bacteria;Proteobacteria;Gammaproteobacteria;Burkholderiales;Comamonadaceae;Malikia;";"0.0";"0";"16";"16";"0";"16";"0";"430508";"5766"
"LOK1378_1mm";"SILVA (only NR);Bacteria;Proteobacteria;Gammaproteobacteria;Burkholderiales;Comamonadaceae;Methylibium;";"0.0";"0";"26";"25";"0";"25";"1";"430499";"5766"
"LOK1378_1mm";"SILVA (only NR);Bacteria;Proteobacteria;Gammaproteobacteria;Burkholderiales;Comamonadaceae;Mitsuaria;";"0.0";"0";"19";"18";"0";"18";"1";"430506";"5766"
"LOK1378_1mm";"SILVA (only NR);Bacteria;Proteobacteria;Gammaproteobacteria;Burkholderiales;Comamonadaceae;Ottowia;";"0.0";"0";"91";"90";"0";"90";"1";"430434";"5766"
"LOK1378_1mm";"SILVA (only NR);Bacteria;Proteobacteria;Gammaproteobacteria;Burkholderiales;Comamonadaceae;Paucibacter;";"0.0";"0";"49";"49";"0";"49";"0";"430475";"5766"
"LOK1378_1mm";"SILVA (only NR);Bacteria;Proteobacteria;Gammaproteobacteria;Burkholderiales;Comamonadaceae;Pelomonas;";"0.0";"0";"89";"84";"0";"84";"5";"430440";"5766"
"LOK1378_1mm";"SILVA (only NR);Bacteria;Proteobacteria;Gammaproteobacteria;Burkholderiales;Comamonadaceae;Piscinibacter;";"0.0";"0";"22";"22";"0";"22";"0";"430502";"5766"
"LOK1378_1mm";"SILVA (only NR);Bacteria;Proteobacteria;Gammaproteobacteria;Burkholderiales;Comamonadaceae;Polaromonas;";"0.0";"0";"191";"185";"0";"185";"6";"430339";"5766"
"LOK1378_1mm";"SILVA (only NR);Bacteria;Proteobacteria;Gammaproteobacteria;Burkholderiales;Comamonadaceae;Pseudacidovorax;";"0.0";"0";"3";"3";"0";"3";"0";"430521";"5766"
"LOK1378_1mm";"SILVA (only NR);Bacteria;Proteobacteria;Gammaproteobacteria;Burkholderiales;Comamonadaceae;Pseudorhodoferax;";"0.0";"0";"24";"23";"0";"23";"1";"430501";"5766"
"LOK1378_1mm";"SILVA (only NR);Bacteria;Proteobacteria;Gammaproteobacteria;Burkholderiales;Comamonadaceae;RS62 marine group;";"0.0";"0";"48";"48";"0";"48";"0";"430476";"5766"
"LOK1378_1mm";"SILVA (only NR);Bacteria;Proteobacteria;Gammaproteobacteria;Burkholderiales;Comamonadaceae;Ramlibacter;";"0.0";"0";"183";"179";"0";"179";"4";"430345";"5766"
"LOK1378_1mm";"SILVA (only NR);Bacteria;Proteobacteria;Gammaproteobacteria;Burkholderiales;Comamonadaceae;Rhizobacter;";"0.0";"0";"170";"161";"0";"161";"9";"430363";"5766"
"LOK1378_1mm";"SILVA (only NR);Bacteria;Proteobacteria;Gammaproteobacteria;Burkholderiales;Comamonadaceae;Rhodoferax;";"0.0";"0";"346";"329";"0";"329";"17";"430195";"5766"
"LOK1378_1mm";"SILVA (only NR);Bacteria;Proteobacteria;Gammaproteobacteria;Burkholderiales;Comamonadaceae;Rivibacter;";"0.0";"0";"13";"13";"0";"13";"0";"430511";"5766"
"LOK1378_1mm";"SILVA (only NR);Bacteria;Proteobacteria;Gammaproteobacteria;Burkholderiales;Comamonadaceae;Roseateles;";"0.0";"0";"23";"22";"0";"22";"1";"430502";"5766"
"LOK1378_1mm";"SILVA (only NR);Bacteria;Proteobacteria;Gammaproteobacteria;Burkholderiales;Comamonadaceae;Rubrivivax;";"0.0";"0";"27";"25";"0";"25";"2";"430499";"5766"
"LOK1378_1mm";"SILVA (only NR);Bacteria;Proteobacteria;Gammaproteobacteria;Burkholderiales;Comamonadaceae;Schlegelella;";"0.0";"0";"9";"9";"0";"9";"0";"430515";"5766"
"LOK1378_1mm";"SILVA (only NR);Bacteria;Proteobacteria;Gammaproteobacteria;Burkholderiales;Comamonadaceae;Simplicispira;";"0.0";"0";"60";"60";"0";"60";"0";"430464";"5766"
"LOK1378_1mm";"SILVA (only NR);Bacteria;Proteobacteria;Gammaproteobacteria;Burkholderiales;Comamonadaceae;Sphaerotilus;";"0.0";"0";"61";"58";"0";"58";"3";"430466";"5766"
"LOK1378_1mm";"SILVA (only NR);Bacteria;Proteobacteria;Gammaproteobacteria;Burkholderiales;Comamonadaceae;Tepidicella;";"0.0";"0";"3";"2";"0";"2";"1";"430522";"5766"
"LOK1378_1mm";"SILVA (only NR);Bacteria;Proteobacteria;Gammaproteobacteria;Burkholderiales;Comamonadaceae;Tepidimonas;";"0.0";"0";"29";"26";"0";"26";"3";"430498";"5766"
"LOK1378_1mm";"SILVA (only NR);Bacteria;Proteobacteria;Gammaproteobacteria;Burkholderiales;Comamonadaceae;Thiomonas;";"0.0";"0";"55";"54";"0";"54";"1";"430470";"5766"
"LOK1378_1mm";"SILVA (only NR);Bacteria;Proteobacteria;Gammaproteobacteria;Burkholderiales;Comamonadaceae;Tibeticola;";"0.0";"0";"5";"5";"0";"5";"0";"430519";"5766"
"LOK1378_1mm";"SILVA (only NR);Bacteria;Proteobacteria;Gammaproteobacteria;Burkholderiales;Comamonadaceae;Variovorax;";"0.0";"0";"222";"203";"0";"203";"19";"430321";"5766"
"LOK1378_1mm";"SILVA (only NR);Bacteria;Proteobacteria;Gammaproteobacteria;Burkholderiales;Comamonadaceae;Verminephrobacter;";"0.0";"0";"30";"30";"0";"30";"0";"430494";"5766"
"LOK1378_1mm";"SILVA (only NR);Bacteria;Proteobacteria;Gammaproteobacteria;Burkholderiales;Comamonadaceae;Xenophilus;";"0.0";"0";"9";"8";"0";"8";"1";"430516";"5766"
"LOK1378_1mm";"SILVA (only NR);Bacteria;Proteobacteria;Gammaproteobacteria;Burkholderiales;Comamonadaceae;Xylophilus;";"0.0";"0";"24";"23";"0";"23";"1";"430501";"5766"
"LOK1378_1mm";"SILVA (only NR);Bacteria;Proteobacteria;Gammaproteobacteria;Burkholderiales;Comamonadaceae;Zhizhongheella;";"0.0";"0";"4";"4";"0";"4";"0";"430520";"5766"
"LOK1378_1mm";"SILVA (only NR);Bacteria;Proteobacteria;Gammaproteobacteria;Burkholderiales;Comamonadaceae;[Polyangium] brachysporum group;";"0.0";"0";"9";"9";"0";"9";"0";"430515";"5766"
"LOK1378_1mm";"SILVA (only NR);Bacteria;Proteobacteria;Gammaproteobacteria;Burkholderiales;Comamonadaceae;uncultured;";"0.0";"0";"466";"458";"0";"458";"8";"430066";"5766"
"LOK1378_1mm";"SILVA (only NR);Bacteria;Proteobacteria;Gammaproteobacteria;Burkholderiales;EC94;";"0.0";"0";"20";"19";"0";"19";"1";"430505";"5766"
"LOK1378_1mm";"SILVA (only NR);Bacteria;Proteobacteria;Gammaproteobacteria;Burkholderiales;Ferrovaceae;";"0.0";"0";"31";"27";"0";"27";"4";"430497";"5766"
"LOK1378_1mm";"SILVA (only NR);Bacteria;Proteobacteria;Gammaproteobacteria;Burkholderiales;Ferrovaceae;Ferrovum;";"0.0";"0";"31";"27";"0";"27";"4";"430497";"5766"
"LOK1378_1mm";"SILVA (only NR);Bacteria;Proteobacteria;Gammaproteobacteria;Burkholderiales;Gallionellaceae;";"0.0";"0";"403";"398";"0";"398";"5";"430126";"5766"
"LOK1378_1mm";"SILVA (only NR);Bacteria;Proteobacteria;Gammaproteobacteria;Burkholderiales;Gallionellaceae;Candidatus Nitrotoga;";"0.0";"0";"47";"47";"0";"47";"0";"430477";"5766"
"LOK1378_1mm";"SILVA (only NR);Bacteria;Proteobacteria;Gammaproteobacteria;Burkholderiales;Gallionellaceae;Ferriphaselus;";"0.0";"0";"10";"10";"0";"10";"0";"430514";"5766"
"LOK1378_1mm";"SILVA (only NR);Bacteria;Proteobacteria;Gammaproteobacteria;Burkholderiales;Gallionellaceae;Gallionella;";"0.0";"0";"138";"134";"0";"134";"4";"430390";"5766"
"LOK1378_1mm";"SILVA (only NR);Bacteria;Proteobacteria;Gammaproteobacteria;Burkholderiales;Gallionellaceae;Sideroxydans;";"0.0";"0";"161";"160";"0";"160";"1";"430364";"5766"
"LOK1378_1mm";"SILVA (only NR);Bacteria;Proteobacteria;Gammaproteobacteria;Burkholderiales;Gallionellaceae;uncultured;";"0.0";"0";"44";"44";"0";"44";"0";"430480";"5766"
"LOK1378_1mm";"SILVA (only NR);Bacteria;Proteobacteria;Gammaproteobacteria;Burkholderiales;Hydrogenophilaceae;";"0.0";"0";"556";"534";"0";"534";"22";"429990";"5766"
"LOK1378_1mm";"SILVA (only NR);Bacteria;Proteobacteria;Gammaproteobacteria;Burkholderiales;Hydrogenophilaceae;Annwodia;";"0.0";"0";"4";"4";"0";"4";"0";"430520";"5766"
"LOK1378_1mm";"SILVA (only NR);Bacteria;Proteobacteria;Gammaproteobacteria;Burkholderiales;Hydrogenophilaceae;Hydrogenophilus;";"0.0";"0";"28";"26";"0";"26";"2";"430498";"5766"
"LOK1378_1mm";"SILVA (only NR);Bacteria;Proteobacteria;Gammaproteobacteria;Burkholderiales;Hydrogenophilaceae;Spirillum;";"0.0";"0";"4";"4";"0";"4";"0";"430520";"5766"
"LOK1378_1mm";"SILVA (only NR);Bacteria;Proteobacteria;Gammaproteobacteria;Burkholderiales;Hydrogenophilaceae;Sulfuritortus;";"0.0";"0";"5";"5";"0";"5";"0";"430519";"5766"
"LOK1378_1mm";"SILVA (only NR);Bacteria;Proteobacteria;Gammaproteobacteria;Burkholderiales;Hydrogenophilaceae;Tepidiphilus;";"0.0";"0";"23";"23";"0";"23";"0";"430501";"5766"
"LOK1378_1mm";"SILVA (only NR);Bacteria;Proteobacteria;Gammaproteobacteria;Burkholderiales;Hydrogenophilaceae;Thiobacillus;";"0.0";"0";"276";"271";"0";"271";"5";"430253";"5766"
"LOK1378_1mm";"SILVA (only NR);Bacteria;Proteobacteria;Gammaproteobacteria;Burkholderiales;Hydrogenophilaceae;Thiobacter;";"0.0";"0";"5";"5";"0";"5";"0";"430519";"5766"
"LOK1378_1mm";"SILVA (only NR);Bacteria;Proteobacteria;Gammaproteobacteria;Burkholderiales;Hydrogenophilaceae;uncultured;";"0.0";"0";"209";"194";"0";"194";"15";"430330";"5766"
"LOK1378_1mm";"SILVA (only NR);Bacteria;Proteobacteria;Gammaproteobacteria;Burkholderiales;Leeiaceae;";"0.0";"0";"15";"15";"0";"15";"0";"430509";"5766"
"LOK1378_1mm";"SILVA (only NR);Bacteria;Proteobacteria;Gammaproteobacteria;Burkholderiales;Leeiaceae;Leeia;";"0.0";"0";"15";"15";"0";"15";"0";"430509";"5766"
"LOK1378_1mm";"SILVA (only NR);Bacteria;Proteobacteria;Gammaproteobacteria;Burkholderiales;MWH-UniP1 aquatic group;";"0.0";"0";"70";"69";"0";"69";"1";"430455";"5766"
"LOK1378_1mm";"SILVA (only NR);Bacteria;Proteobacteria;Gammaproteobacteria;Burkholderiales;Methylophilaceae;";"0.0";"0";"553";"527";"0";"527";"26";"429997";"5766"
"LOK1378_1mm";"SILVA (only NR);Bacteria;Proteobacteria;Gammaproteobacteria;Burkholderiales;Methylophilaceae;Candidatus Methylopumilus;";"0.0";"0";"33";"33";"0";"33";"0";"430491";"5766"
"LOK1378_1mm";"SILVA (only NR);Bacteria;Proteobacteria;Gammaproteobacteria;Burkholderiales;Methylophilaceae;MM1;";"0.0";"0";"9";"9";"0";"9";"0";"430515";"5766"
"LOK1378_1mm";"SILVA (only NR);Bacteria;Proteobacteria;Gammaproteobacteria;Burkholderiales;Methylophilaceae;MM2;";"0.0";"0";"19";"19";"0";"19";"0";"430505";"5766"
"LOK1378_1mm";"SILVA (only NR);Bacteria;Proteobacteria;Gammaproteobacteria;Burkholderiales;Methylophilaceae;Methylobacillus;";"0.0";"0";"31";"29";"0";"29";"2";"430495";"5766"
"LOK1378_1mm";"SILVA (only NR);Bacteria;Proteobacteria;Gammaproteobacteria;Burkholderiales;Methylophilaceae;Methylophilus;";"0.0";"0";"112";"93";"0";"93";"19";"430431";"5766"
"LOK1378_1mm";"SILVA (only NR);Bacteria;Proteobacteria;Gammaproteobacteria;Burkholderiales;Methylophilaceae;Methylotenera;";"0.0";"0";"145";"141";"0";"141";"4";"430383";"5766"
"LOK1378_1mm";"SILVA (only NR);Bacteria;Proteobacteria;Gammaproteobacteria;Burkholderiales;Methylophilaceae;Methylovorus;";"0.0";"0";"7";"7";"0";"7";"0";"430517";"5766"
"LOK1378_1mm";"SILVA (only NR);Bacteria;Proteobacteria;Gammaproteobacteria;Burkholderiales;Methylophilaceae;OM43 clade;";"0.0";"0";"131";"130";"0";"130";"1";"430394";"5766"
"LOK1378_1mm";"SILVA (only NR);Bacteria;Proteobacteria;Gammaproteobacteria;Burkholderiales;Methylophilaceae;UBA6140;";"0.0";"0";"17";"17";"0";"17";"0";"430507";"5766"
"LOK1378_1mm";"SILVA (only NR);Bacteria;Proteobacteria;Gammaproteobacteria;Burkholderiales;Methylophilaceae;uncultured;";"0.0";"0";"47";"47";"0";"47";"0";"430477";"5766"
"LOK1378_1mm";"SILVA (only NR);Bacteria;Proteobacteria;Gammaproteobacteria;Burkholderiales;Neisseriaceae;";"0.0";"0";"1355";"1300";"0";"1300";"55";"429224";"5766"
"LOK1378_1mm";"SILVA (only NR);Bacteria;Proteobacteria;Gammaproteobacteria;Burkholderiales;Neisseriaceae;Alysiella;";"0.0";"0";"24";"24";"0";"24";"0";"430500";"5766"
"LOK1378_1mm";"SILVA (only NR);Bacteria;Proteobacteria;Gammaproteobacteria;Burkholderiales;Neisseriaceae;Bergeriella;";"0.0";"0";"4";"4";"0";"4";"0";"430520";"5766"
"LOK1378_1mm";"SILVA (only NR);Bacteria;Proteobacteria;Gammaproteobacteria;Burkholderiales;Neisseriaceae;Conchiformibius;";"0.0";"0";"42";"42";"0";"42";"0";"430482";"5766"
"LOK1378_1mm";"SILVA (only NR);Bacteria;Proteobacteria;Gammaproteobacteria;Burkholderiales;Neisseriaceae;Eikenella;";"0.0";"0";"20";"19";"0";"19";"1";"430505";"5766"
"LOK1378_1mm";"SILVA (only NR);Bacteria;Proteobacteria;Gammaproteobacteria;Burkholderiales;Neisseriaceae;Kingella;";"0.0";"0";"116";"112";"0";"112";"4";"430412";"5766"
"LOK1378_1mm";"SILVA (only NR);Bacteria;Proteobacteria;Gammaproteobacteria;Burkholderiales;Neisseriaceae;Neisseria;";"0.0";"0";"980";"935";"0";"935";"45";"429589";"5766"
"LOK1378_1mm";"SILVA (only NR);Bacteria;Proteobacteria;Gammaproteobacteria;Burkholderiales;Neisseriaceae;Simonsiella;";"0.0";"0";"12";"12";"0";"12";"0";"430512";"5766"
"LOK1378_1mm";"SILVA (only NR);Bacteria;Proteobacteria;Gammaproteobacteria;Burkholderiales;Neisseriaceae;Snodgrassella;";"0.0";"0";"22";"19";"0";"19";"3";"430505";"5766"
"LOK1378_1mm";"SILVA (only NR);Bacteria;Proteobacteria;Gammaproteobacteria;Burkholderiales;Neisseriaceae;Stenoxybacter;";"0.0";"0";"3";"3";"0";"3";"0";"430521";"5766"
"LOK1378_1mm";"SILVA (only NR);Bacteria;Proteobacteria;Gammaproteobacteria;Burkholderiales;Neisseriaceae;Uruburuella;";"0.0";"0";"4";"4";"0";"4";"0";"430520";"5766"
"LOK1378_1mm";"SILVA (only NR);Bacteria;Proteobacteria;Gammaproteobacteria;Burkholderiales;Neisseriaceae;Vitreoscilla;";"0.0";"0";"13";"13";"0";"13";"0";"430511";"5766"
"LOK1378_1mm";"SILVA (only NR);Bacteria;Proteobacteria;Gammaproteobacteria;Burkholderiales;Neisseriaceae;uncultured;";"0.0";"0";"113";"111";"0";"111";"2";"430413";"5766"
"LOK1378_1mm";"SILVA (only NR);Bacteria;Proteobacteria;Gammaproteobacteria;Burkholderiales;Nitrosomonadaceae;";"0.0";"0";"1071";"1023";"0";"1023";"48";"429501";"5766"
"LOK1378_1mm";"SILVA (only NR);Bacteria;Proteobacteria;Gammaproteobacteria;Burkholderiales;Nitrosomonadaceae;966-1;";"0.0";"0";"18";"18";"0";"18";"0";"430506";"5766"
"LOK1378_1mm";"SILVA (only NR);Bacteria;Proteobacteria;Gammaproteobacteria;Burkholderiales;Nitrosomonadaceae;DSSD61;";"0.0";"0";"9";"9";"0";"9";"0";"430515";"5766"
"LOK1378_1mm";"SILVA (only NR);Bacteria;Proteobacteria;Gammaproteobacteria;Burkholderiales;Nitrosomonadaceae;Ellin6067;";"0.0";"0";"250";"244";"0";"244";"6";"430280";"5766"
"LOK1378_1mm";"SILVA (only NR);Bacteria;Proteobacteria;Gammaproteobacteria;Burkholderiales;Nitrosomonadaceae;GOUTA6;";"0.0";"0";"40";"37";"0";"37";"3";"430487";"5766"
"LOK1378_1mm";"SILVA (only NR);Bacteria;Proteobacteria;Gammaproteobacteria;Burkholderiales;Nitrosomonadaceae;IS-44;";"0.0";"0";"77";"73";"0";"73";"4";"430451";"5766"
"LOK1378_1mm";"SILVA (only NR);Bacteria;Proteobacteria;Gammaproteobacteria;Burkholderiales;Nitrosomonadaceae;MND1;";"0.0";"0";"290";"277";"0";"277";"13";"430247";"5766"
"LOK1378_1mm";"SILVA (only NR);Bacteria;Proteobacteria;Gammaproteobacteria;Burkholderiales;Nitrosomonadaceae;Nitrosomonas;";"0.0";"0";"210";"196";"0";"196";"14";"430328";"5766"
"LOK1378_1mm";"SILVA (only NR);Bacteria;Proteobacteria;Gammaproteobacteria;Burkholderiales;Nitrosomonadaceae;Nitrosospira;";"0.0";"0";"49";"43";"0";"43";"6";"430481";"5766"
"LOK1378_1mm";"SILVA (only NR);Bacteria;Proteobacteria;Gammaproteobacteria;Burkholderiales;Nitrosomonadaceae;P3OB-51;";"0.0";"0";"3";"3";"0";"3";"0";"430521";"5766"
"LOK1378_1mm";"SILVA (only NR);Bacteria;Proteobacteria;Gammaproteobacteria;Burkholderiales;Nitrosomonadaceae;cr616;";"0.0";"0";"5";"5";"0";"5";"0";"430519";"5766"
"LOK1378_1mm";"SILVA (only NR);Bacteria;Proteobacteria;Gammaproteobacteria;Burkholderiales;Nitrosomonadaceae;mle1-7;";"0.0";"0";"69";"67";"0";"67";"2";"430457";"5766"
"LOK1378_1mm";"SILVA (only NR);Bacteria;Proteobacteria;Gammaproteobacteria;Burkholderiales;Nitrosomonadaceae;oc32;";"0.0";"0";"27";"27";"0";"27";"0";"430497";"5766"
"LOK1378_1mm";"SILVA (only NR);Bacteria;Proteobacteria;Gammaproteobacteria;Burkholderiales;Nitrosomonadaceae;uncultured;";"0.0";"0";"24";"24";"0";"24";"0";"430500";"5766"
"LOK1378_1mm";"SILVA (only NR);Bacteria;Proteobacteria;Gammaproteobacteria;Burkholderiales;Oxalobacteraceae;";"0.0";"0";"2275";"2223";"0";"2223";"52";"428301";"5766"
"LOK1378_1mm";"SILVA (only NR);Bacteria;Proteobacteria;Gammaproteobacteria;Burkholderiales;Oxalobacteraceae;Actimicrobium;";"0.0";"0";"12";"12";"0";"12";"0";"430512";"5766"
"LOK1378_1mm";"SILVA (only NR);Bacteria;Proteobacteria;Gammaproteobacteria;Burkholderiales;Oxalobacteraceae;CM1G08;";"0.0";"0";"7";"7";"0";"7";"0";"430517";"5766"
"LOK1378_1mm";"SILVA (only NR);Bacteria;Proteobacteria;Gammaproteobacteria;Burkholderiales;Oxalobacteraceae;Candidatus Nasuia;";"0.0";"0";"12";"12";"0";"12";"0";"430512";"5766"
"LOK1378_1mm";"SILVA (only NR);Bacteria;Proteobacteria;Gammaproteobacteria;Burkholderiales;Oxalobacteraceae;Candidatus Profftella;";"0.0";"0";"4";"4";"0";"4";"0";"430520";"5766"
"LOK1378_1mm";"SILVA (only NR);Bacteria;Proteobacteria;Gammaproteobacteria;Burkholderiales;Oxalobacteraceae;Candidatus Vidania;";"0.0";"0";"13";"12";"0";"12";"1";"430512";"5766"
"LOK1378_1mm";"SILVA (only NR);Bacteria;Proteobacteria;Gammaproteobacteria;Burkholderiales;Oxalobacteraceae;Candidatus Zinderia;";"0.0";"0";"21";"21";"0";"21";"0";"430503";"5766"
"LOK1378_1mm";"SILVA (only NR);Bacteria;Proteobacteria;Gammaproteobacteria;Burkholderiales;Oxalobacteraceae;Collimonas;";"0.0";"0";"31";"31";"0";"31";"0";"430493";"5766"
"LOK1378_1mm";"SILVA (only NR);Bacteria;Proteobacteria;Gammaproteobacteria;Burkholderiales;Oxalobacteraceae;Duganella;";"0.0";"0";"101";"100";"0";"100";"1";"430424";"5766"
"LOK1378_1mm";"SILVA (only NR);Bacteria;Proteobacteria;Gammaproteobacteria;Burkholderiales;Oxalobacteraceae;Glaciimonas;";"0.0";"0";"9";"9";"0";"9";"0";"430515";"5766"
"LOK1378_1mm";"SILVA (only NR);Bacteria;Proteobacteria;Gammaproteobacteria;Burkholderiales;Oxalobacteraceae;Herbaspirillum;";"0.0";"0";"144";"143";"0";"143";"1";"430381";"5766"
"LOK1378_1mm";"SILVA (only NR);Bacteria;Proteobacteria;Gammaproteobacteria;Burkholderiales;Oxalobacteraceae;Herminiimonas;";"0.0";"0";"93";"89";"0";"89";"4";"430435";"5766"
"LOK1378_1mm";"SILVA (only NR);Bacteria;Proteobacteria;Gammaproteobacteria;Burkholderiales;Oxalobacteraceae;Janthinobacterium;";"0.0";"0";"209";"202";"0";"202";"7";"430322";"5766"
"LOK1378_1mm";"SILVA (only NR);Bacteria;Proteobacteria;Gammaproteobacteria;Burkholderiales;Oxalobacteraceae;Massilia;";"0.0";"0";"1037";"1010";"0";"1010";"27";"429514";"5766"
"LOK1378_1mm";"SILVA (only NR);Bacteria;Proteobacteria;Gammaproteobacteria;Burkholderiales;Oxalobacteraceae;Noviherbaspirillum;";"0.0";"0";"243";"241";"0";"241";"2";"430283";"5766"
"LOK1378_1mm";"SILVA (only NR);Bacteria;Proteobacteria;Gammaproteobacteria;Burkholderiales;Oxalobacteraceae;Oxalicibacterium;";"0.0";"0";"20";"20";"0";"20";"0";"430504";"5766"
"LOK1378_1mm";"SILVA (only NR);Bacteria;Proteobacteria;Gammaproteobacteria;Burkholderiales;Oxalobacteraceae;Oxalobacter;";"0.0";"0";"27";"27";"0";"27";"0";"430497";"5766"
"LOK1378_1mm";"SILVA (only NR);Bacteria;Proteobacteria;Gammaproteobacteria;Burkholderiales;Oxalobacteraceae;Paraherbaspirillum;";"0.0";"0";"2";"2";"0";"2";"0";"430522";"5766"
"LOK1378_1mm";"SILVA (only NR);Bacteria;Proteobacteria;Gammaproteobacteria;Burkholderiales;Oxalobacteraceae;Paucimonas;";"0.0";"0";"6";"6";"0";"6";"0";"430518";"5766"
"LOK1378_1mm";"SILVA (only NR);Bacteria;Proteobacteria;Gammaproteobacteria;Burkholderiales;Oxalobacteraceae;Pseudoduganella;";"0.0";"0";"8";"8";"0";"8";"0";"430516";"5766"
"LOK1378_1mm";"SILVA (only NR);Bacteria;Proteobacteria;Gammaproteobacteria;Burkholderiales;Oxalobacteraceae;Rugamonas;";"0.0";"0";"6";"6";"0";"6";"0";"430518";"5766"
"LOK1378_1mm";"SILVA (only NR);Bacteria;Proteobacteria;Gammaproteobacteria;Burkholderiales;Oxalobacteraceae;Telluria;";"0.0";"0";"2";"2";"0";"2";"0";"430522";"5766"
"LOK1378_1mm";"SILVA (only NR);Bacteria;Proteobacteria;Gammaproteobacteria;Burkholderiales;Oxalobacteraceae;Undibacterium;";"0.0";"0";"118";"112";"0";"112";"6";"430412";"5766"
"LOK1378_1mm";"SILVA (only NR);Bacteria;Proteobacteria;Gammaproteobacteria;Burkholderiales;Oxalobacteraceae;[Aquaspirillum] arcticum group;";"0.0";"0";"23";"22";"0";"22";"1";"430502";"5766"
"LOK1378_1mm";"SILVA (only NR);Bacteria;Proteobacteria;Gammaproteobacteria;Burkholderiales;Oxalobacteraceae;s3t2d-1089;";"0.0";"0";"4";"4";"0";"4";"0";"430520";"5766"
"LOK1378_1mm";"SILVA (only NR);Bacteria;Proteobacteria;Gammaproteobacteria;Burkholderiales;Oxalobacteraceae;uncultured;";"0.0";"0";"113";"111";"0";"111";"2";"430413";"5766"
"LOK1378_1mm";"SILVA (only NR);Bacteria;Proteobacteria;Gammaproteobacteria;Burkholderiales;Procabacteriaceae;";"0.0";"0";"10";"10";"0";"10";"0";"430514";"5766"
"LOK1378_1mm";"SILVA (only NR);Bacteria;Proteobacteria;Gammaproteobacteria;Burkholderiales;Procabacteriaceae;Procabacter;";"0.0";"0";"10";"10";"0";"10";"0";"430514";"5766"
"LOK1378_1mm";"SILVA (only NR);Bacteria;Proteobacteria;Gammaproteobacteria;Burkholderiales;Rhodocyclaceae;";"0.0";"0";"1708";"1656";"0";"1656";"52";"428868";"5766"
"LOK1378_1mm";"SILVA (only NR);Bacteria;Proteobacteria;Gammaproteobacteria;Burkholderiales;Rhodocyclaceae;Azoarcus;";"0.0";"0";"121";"118";"0";"118";"3";"430406";"5766"
"LOK1378_1mm";"SILVA (only NR);Bacteria;Proteobacteria;Gammaproteobacteria;Burkholderiales;Rhodocyclaceae;Azonexus;";"0.0";"0";"28";"26";"0";"26";"2";"430498";"5766"
"LOK1378_1mm";"SILVA (only NR);Bacteria;Proteobacteria;Gammaproteobacteria;Burkholderiales;Rhodocyclaceae;Azospira;";"0.0";"0";"52";"51";"0";"51";"1";"430473";"5766"
"LOK1378_1mm";"SILVA (only NR);Bacteria;Proteobacteria;Gammaproteobacteria;Burkholderiales;Rhodocyclaceae;Azovibrio;";"0.0";"0";"18";"17";"0";"17";"1";"430507";"5766"
"LOK1378_1mm";"SILVA (only NR);Bacteria;Proteobacteria;Gammaproteobacteria;Burkholderiales;Rhodocyclaceae;C39;";"0.0";"0";"31";"31";"0";"31";"0";"430493";"5766"
"LOK1378_1mm";"SILVA (only NR);Bacteria;Proteobacteria;Gammaproteobacteria;Burkholderiales;Rhodocyclaceae;Candidatus Accumulibacter;";"0.0";"0";"123";"123";"0";"123";"0";"430401";"5766"
"LOK1378_1mm";"SILVA (only NR);Bacteria;Proteobacteria;Gammaproteobacteria;Burkholderiales;Rhodocyclaceae;Dechlorobacter;";"0.0";"0";"27";"26";"0";"26";"1";"430498";"5766"
"LOK1378_1mm";"SILVA (only NR);Bacteria;Proteobacteria;Gammaproteobacteria;Burkholderiales;Rhodocyclaceae;Dechloromonas;";"0.0";"0";"181";"175";"0";"175";"6";"430349";"5766"
"LOK1378_1mm";"SILVA (only NR);Bacteria;Proteobacteria;Gammaproteobacteria;Burkholderiales;Rhodocyclaceae;Dechlorosoma;";"0.0";"0";"23";"22";"0";"22";"1";"430502";"5766"
"LOK1378_1mm";"SILVA (only NR);Bacteria;Proteobacteria;Gammaproteobacteria;Burkholderiales;Rhodocyclaceae;Denitratisoma;";"0.0";"0";"65";"64";"0";"64";"1";"430460";"5766"
"LOK1378_1mm";"SILVA (only NR);Bacteria;Proteobacteria;Gammaproteobacteria;Burkholderiales;Rhodocyclaceae;Denitromonas;";"0.0";"0";"16";"16";"0";"16";"0";"430508";"5766"
"LOK1378_1mm";"SILVA (only NR);Bacteria;Proteobacteria;Gammaproteobacteria;Burkholderiales;Rhodocyclaceae;Ferribacterium;";"0.0";"0";"33";"32";"0";"32";"1";"430492";"5766"
"LOK1378_1mm";"SILVA (only NR);Bacteria;Proteobacteria;Gammaproteobacteria;Burkholderiales;Rhodocyclaceae;Georgfuchsia;";"0.0";"0";"8";"8";"0";"8";"0";"430516";"5766"
"LOK1378_1mm";"SILVA (only NR);Bacteria;Proteobacteria;Gammaproteobacteria;Burkholderiales;Rhodocyclaceae;Methyloversatilis;";"0.0";"0";"42";"39";"0";"39";"3";"430485";"5766"
"LOK1378_1mm";"SILVA (only NR);Bacteria;Proteobacteria;Gammaproteobacteria;Burkholderiales;Rhodocyclaceae;Niveibacterium;";"0.0";"0";"4";"3";"0";"3";"1";"430521";"5766"
"LOK1378_1mm";"SILVA (only NR);Bacteria;Proteobacteria;Gammaproteobacteria;Burkholderiales;Rhodocyclaceae;Propionivibrio;";"0.0";"0";"76";"73";"0";"73";"3";"430451";"5766"
"LOK1378_1mm";"SILVA (only NR);Bacteria;Proteobacteria;Gammaproteobacteria;Burkholderiales;Rhodocyclaceae;Quatrionicoccus;";"0.0";"0";"3";"3";"0";"3";"0";"430521";"5766"
"LOK1378_1mm";"SILVA (only NR);Bacteria;Proteobacteria;Gammaproteobacteria;Burkholderiales;Rhodocyclaceae;Rhodocyclus;";"0.0";"0";"4";"4";"0";"4";"0";"430520";"5766"
"LOK1378_1mm";"SILVA (only NR);Bacteria;Proteobacteria;Gammaproteobacteria;Burkholderiales;Rhodocyclaceae;Sterolibacterium;";"0.0";"0";"28";"27";"0";"27";"1";"430497";"5766"
"LOK1378_1mm";"SILVA (only NR);Bacteria;Proteobacteria;Gammaproteobacteria;Burkholderiales;Rhodocyclaceae;Sulfurisoma;";"0.0";"0";"6";"6";"0";"6";"0";"430518";"5766"
"LOK1378_1mm";"SILVA (only NR);Bacteria;Proteobacteria;Gammaproteobacteria;Burkholderiales;Rhodocyclaceae;Sulfuritalea;";"0.0";"0";"159";"159";"0";"159";"0";"430365";"5766"
"LOK1378_1mm";"SILVA (only NR);Bacteria;Proteobacteria;Gammaproteobacteria;Burkholderiales;Rhodocyclaceae;Thauera;";"0.0";"0";"209";"193";"0";"193";"16";"430331";"5766"
"LOK1378_1mm";"SILVA (only NR);Bacteria;Proteobacteria;Gammaproteobacteria;Burkholderiales;Rhodocyclaceae;Uliginosibacterium;";"0.0";"0";"35";"33";"0";"33";"2";"430491";"5766"
"LOK1378_1mm";"SILVA (only NR);Bacteria;Proteobacteria;Gammaproteobacteria;Burkholderiales;Rhodocyclaceae;Z-35;";"0.0";"0";"20";"17";"0";"17";"3";"430507";"5766"
"LOK1378_1mm";"SILVA (only NR);Bacteria;Proteobacteria;Gammaproteobacteria;Burkholderiales;Rhodocyclaceae;Zoogloea;";"0.0";"0";"136";"135";"0";"135";"1";"430389";"5766"
"LOK1378_1mm";"SILVA (only NR);Bacteria;Proteobacteria;Gammaproteobacteria;Burkholderiales;Rhodocyclaceae;uncultured;";"0.0";"0";"245";"241";"0";"241";"4";"430283";"5766"
"LOK1378_1mm";"SILVA (only NR);Bacteria;Proteobacteria;Gammaproteobacteria;Burkholderiales;SC-I-84;";"0.0";"0";"367";"356";"0";"356";"11";"430168";"5766"
"LOK1378_1mm";"SILVA (only NR);Bacteria;Proteobacteria;Gammaproteobacteria;Burkholderiales;Sulfuricellaceae;";"0.0";"0";"157";"154";"0";"154";"3";"430370";"5766"
"LOK1378_1mm";"SILVA (only NR);Bacteria;Proteobacteria;Gammaproteobacteria;Burkholderiales;Sulfuricellaceae;Ferritrophicum;";"0.0";"0";"68";"68";"0";"68";"0";"430456";"5766"
"LOK1378_1mm";"SILVA (only NR);Bacteria;Proteobacteria;Gammaproteobacteria;Burkholderiales;Sulfuricellaceae;Sulfuricella;";"0.0";"0";"19";"18";"0";"18";"1";"430506";"5766"
"LOK1378_1mm";"SILVA (only NR);Bacteria;Proteobacteria;Gammaproteobacteria;Burkholderiales;Sulfuricellaceae;Sulfuriferula;";"0.0";"0";"52";"50";"0";"50";"2";"430474";"5766"
"LOK1378_1mm";"SILVA (only NR);Bacteria;Proteobacteria;Gammaproteobacteria;Burkholderiales;Sulfuricellaceae;Sulfurirhabdus;";"0.0";"0";"17";"17";"0";"17";"0";"430507";"5766"
"LOK1378_1mm";"SILVA (only NR);Bacteria;Proteobacteria;Gammaproteobacteria;Burkholderiales;Sutterellaceae;";"0.0";"0";"388";"379";"0";"379";"9";"430145";"5766"
"LOK1378_1mm";"SILVA (only NR);Bacteria;Proteobacteria;Gammaproteobacteria;Burkholderiales;Sutterellaceae;AAP99;";"0.0";"0";"32";"32";"0";"32";"0";"430492";"5766"
"LOK1378_1mm";"SILVA (only NR);Bacteria;Proteobacteria;Gammaproteobacteria;Burkholderiales;Sutterellaceae;Parasutterella;";"0.0";"0";"129";"124";"0";"124";"5";"430400";"5766"
"LOK1378_1mm";"SILVA (only NR);Bacteria;Proteobacteria;Gammaproteobacteria;Burkholderiales;Sutterellaceae;Sutterella;";"0.0";"0";"110";"109";"0";"109";"1";"430415";"5766"
"LOK1378_1mm";"SILVA (only NR);Bacteria;Proteobacteria;Gammaproteobacteria;Burkholderiales;Sutterellaceae;uncultured;";"0.0";"0";"116";"113";"0";"113";"3";"430411";"5766"
"LOK1378_1mm";"SILVA (only NR);Bacteria;Proteobacteria;Gammaproteobacteria;Burkholderiales;T34;";"0.0";"0";"23";"23";"0";"23";"0";"430501";"5766"
"LOK1378_1mm";"SILVA (only NR);Bacteria;Proteobacteria;Gammaproteobacteria;Burkholderiales;TRA3-20;";"0.0";"0";"355";"348";"0";"348";"7";"430176";"5766"
"LOK1378_1mm";"SILVA (only NR);Bacteria;Proteobacteria;Gammaproteobacteria;Burkholderiales;uncultured;";"0.0";"0";"22";"19";"0";"19";"3";"430505";"5766"
"LOK1378_1mm";"SILVA (only NR);Bacteria;Proteobacteria;Gammaproteobacteria;CCD24;";"0.0";"0";"69";"68";"0";"68";"1";"430456";"5766"
"LOK1378_1mm";"SILVA (only NR);Bacteria;Proteobacteria;Gammaproteobacteria;CCM19a;";"0.0";"0";"19";"19";"0";"19";"0";"430505";"5766"
"LOK1378_1mm";"SILVA (only NR);Bacteria;Proteobacteria;Gammaproteobacteria;CH2b56;";"0.0";"0";"7";"7";"0";"7";"0";"430517";"5766"
"LOK1378_1mm";"SILVA (only NR);Bacteria;Proteobacteria;Gammaproteobacteria;CHAB-XI-27;";"0.0";"0";"10";"9";"0";"9";"1";"430515";"5766"
"LOK1378_1mm";"SILVA (only NR);Bacteria;Proteobacteria;Gammaproteobacteria;Cardiobacteriales;";"0.0";"0";"438";"430";"0";"430";"8";"430094";"5766"
"LOK1378_1mm";"SILVA (only NR);Bacteria;Proteobacteria;Gammaproteobacteria;Cardiobacteriales;Cardiobacteriaceae;";"0.0";"0";"415";"409";"0";"409";"6";"430115";"5766"
"LOK1378_1mm";"SILVA (only NR);Bacteria;Proteobacteria;Gammaproteobacteria;Cardiobacteriales;Cardiobacteriaceae;Cardiobacterium;";"0.0";"0";"113";"107";"0";"107";"6";"430417";"5766"
"LOK1378_1mm";"SILVA (only NR);Bacteria;Proteobacteria;Gammaproteobacteria;Cardiobacteriales;Cardiobacteriaceae;Dichelobacter;";"0.0";"0";"4";"4";"0";"4";"0";"430520";"5766"
"LOK1378_1mm";"SILVA (only NR);Bacteria;Proteobacteria;Gammaproteobacteria;Cardiobacteriales;Cardiobacteriaceae;Suttonella;";"0.0";"0";"10";"10";"0";"10";"0";"430514";"5766"
"LOK1378_1mm";"SILVA (only NR);Bacteria;Proteobacteria;Gammaproteobacteria;Cardiobacteriales;Cardiobacteriaceae;uncultured;";"0.0";"0";"287";"287";"0";"287";"0";"430237";"5766"
"LOK1378_1mm";"SILVA (only NR);Bacteria;Proteobacteria;Gammaproteobacteria;Cardiobacteriales;Wohlfahrtiimonadaceae;";"0.0";"0";"22";"20";"0";"20";"2";"430504";"5766"
"LOK1378_1mm";"SILVA (only NR);Bacteria;Proteobacteria;Gammaproteobacteria;Cardiobacteriales;Wohlfahrtiimonadaceae;Ignatzschineria;";"0.0";"0";"13";"11";"0";"11";"2";"430513";"5766"
"LOK1378_1mm";"SILVA (only NR);Bacteria;Proteobacteria;Gammaproteobacteria;Cardiobacteriales;Wohlfahrtiimonadaceae;Koukoulia;";"0.0";"0";"2";"2";"0";"2";"0";"430522";"5766"
"LOK1378_1mm";"SILVA (only NR);Bacteria;Proteobacteria;Gammaproteobacteria;Cardiobacteriales;Wohlfahrtiimonadaceae;Wohlfahrtiimonas;";"0.0";"0";"6";"6";"0";"6";"0";"430518";"5766"
"LOK1378_1mm";"SILVA (only NR);Bacteria;Proteobacteria;Gammaproteobacteria;Chromatiales;";"0.0";"0";"494";"467";"0";"467";"27";"430057";"5766"
"LOK1378_1mm";"SILVA (only NR);Bacteria;Proteobacteria;Gammaproteobacteria;Chromatiales;Chromatiaceae;";"0.0";"0";"356";"333";"0";"333";"23";"430191";"5766"
"LOK1378_1mm";"SILVA (only NR);Bacteria;Proteobacteria;Gammaproteobacteria;Chromatiales;Chromatiaceae;Achromatium;";"0.0";"0";"16";"16";"0";"16";"0";"430508";"5766"
"LOK1378_1mm";"SILVA (only NR);Bacteria;Proteobacteria;Gammaproteobacteria;Chromatiales;Chromatiaceae;Allochromatium;";"0.0";"0";"21";"17";"0";"17";"4";"430507";"5766"
"LOK1378_1mm";"SILVA (only NR);Bacteria;Proteobacteria;Gammaproteobacteria;Chromatiales;Chromatiaceae;Candidatus Thiobios;";"0.0";"0";"33";"33";"0";"33";"0";"430491";"5766"
"LOK1378_1mm";"SILVA (only NR);Bacteria;Proteobacteria;Gammaproteobacteria;Chromatiales;Chromatiaceae;Chromatium;";"0.0";"0";"12";"12";"0";"12";"0";"430512";"5766"
"LOK1378_1mm";"SILVA (only NR);Bacteria;Proteobacteria;Gammaproteobacteria;Chromatiales;Chromatiaceae;Halochromatium;";"0.0";"0";"69";"62";"0";"62";"7";"430462";"5766"
"LOK1378_1mm";"SILVA (only NR);Bacteria;Proteobacteria;Gammaproteobacteria;Chromatiales;Chromatiaceae;Isochromatium;";"0.0";"0";"1";"1";"0";"1";"0";"430523";"5766"
"LOK1378_1mm";"SILVA (only NR);Bacteria;Proteobacteria;Gammaproteobacteria;Chromatiales;Chromatiaceae;Lamprocystis;";"0.0";"0";"13";"12";"0";"12";"1";"430512";"5766"
"LOK1378_1mm";"SILVA (only NR);Bacteria;Proteobacteria;Gammaproteobacteria;Chromatiales;Chromatiaceae;Marichromatium;";"0.0";"0";"16";"14";"0";"14";"2";"430510";"5766"
"LOK1378_1mm";"SILVA (only NR);Bacteria;Proteobacteria;Gammaproteobacteria;Chromatiales;Chromatiaceae;Phaeochromatium;";"0.0";"0";"2";"2";"0";"2";"0";"430522";"5766"
"LOK1378_1mm";"SILVA (only NR);Bacteria;Proteobacteria;Gammaproteobacteria;Chromatiales;Chromatiaceae;Rhabdochromatium;";"0.0";"0";"2";"2";"0";"2";"0";"430522";"5766"
"LOK1378_1mm";"SILVA (only NR);Bacteria;Proteobacteria;Gammaproteobacteria;Chromatiales;Chromatiaceae;Thioalkalicoccus;";"0.0";"0";"3";"3";"0";"3";"0";"430521";"5766"
"LOK1378_1mm";"SILVA (only NR);Bacteria;Proteobacteria;Gammaproteobacteria;Chromatiales;Chromatiaceae;Thiobaca;";"0.0";"0";"3";"3";"0";"3";"0";"430521";"5766"
"LOK1378_1mm";"SILVA (only NR);Bacteria;Proteobacteria;Gammaproteobacteria;Chromatiales;Chromatiaceae;Thiocapsa;";"0.0";"0";"24";"24";"0";"24";"0";"430500";"5766"
"LOK1378_1mm";"SILVA (only NR);Bacteria;Proteobacteria;Gammaproteobacteria;Chromatiales;Chromatiaceae;Thiococcus;";"0.0";"0";"3";"3";"0";"3";"0";"430521";"5766"
"LOK1378_1mm";"SILVA (only NR);Bacteria;Proteobacteria;Gammaproteobacteria;Chromatiales;Chromatiaceae;Thiocystis;";"0.0";"0";"17";"17";"0";"17";"0";"430507";"5766"
"LOK1378_1mm";"SILVA (only NR);Bacteria;Proteobacteria;Gammaproteobacteria;Chromatiales;Chromatiaceae;Thiodictyon;";"0.0";"0";"4";"4";"0";"4";"0";"430520";"5766"
"LOK1378_1mm";"SILVA (only NR);Bacteria;Proteobacteria;Gammaproteobacteria;Chromatiales;Chromatiaceae;Thioflavicoccus;";"0.0";"0";"4";"4";"0";"4";"0";"430520";"5766"
"LOK1378_1mm";"SILVA (only NR);Bacteria;Proteobacteria;Gammaproteobacteria;Chromatiales;Chromatiaceae;Thiohalobacter;";"0.0";"0";"3";"3";"0";"3";"0";"430521";"5766"
"LOK1378_1mm";"SILVA (only NR);Bacteria;Proteobacteria;Gammaproteobacteria;Chromatiales;Chromatiaceae;Thiohalocapsa;";"0.0";"0";"58";"52";"0";"52";"6";"430472";"5766"
"LOK1378_1mm";"SILVA (only NR);Bacteria;Proteobacteria;Gammaproteobacteria;Chromatiales;Chromatiaceae;Thiolamprovum;";"0.0";"0";"3";"3";"0";"3";"0";"430521";"5766"
"LOK1378_1mm";"SILVA (only NR);Bacteria;Proteobacteria;Gammaproteobacteria;Chromatiales;Chromatiaceae;Thiophaeococcus;";"0.0";"0";"6";"6";"0";"6";"0";"430518";"5766"
"LOK1378_1mm";"SILVA (only NR);Bacteria;Proteobacteria;Gammaproteobacteria;Chromatiales;Chromatiaceae;Thiorhodococcus;";"0.0";"0";"11";"11";"0";"11";"0";"430513";"5766"
"LOK1378_1mm";"SILVA (only NR);Bacteria;Proteobacteria;Gammaproteobacteria;Chromatiales;Chromatiaceae;Thiorhodovibrio;";"0.0";"0";"5";"4";"0";"4";"1";"430520";"5766"
"LOK1378_1mm";"SILVA (only NR);Bacteria;Proteobacteria;Gammaproteobacteria;Chromatiales;Chromatiaceae;uncultured;";"0.0";"0";"26";"25";"0";"25";"1";"430499";"5766"
"LOK1378_1mm";"SILVA (only NR);Bacteria;Proteobacteria;Gammaproteobacteria;Chromatiales;Sedimenticolaceae;";"0.0";"0";"138";"134";"0";"134";"4";"430390";"5766"
"LOK1378_1mm";"SILVA (only NR);Bacteria;Proteobacteria;Gammaproteobacteria;Chromatiales;Sedimenticolaceae;Candidatus Thiodiazotropha;";"0.0";"0";"18";"17";"0";"17";"1";"430507";"5766"
"LOK1378_1mm";"SILVA (only NR);Bacteria;Proteobacteria;Gammaproteobacteria;Chromatiales;Sedimenticolaceae;Sedimenticola;";"0.0";"0";"70";"68";"0";"68";"2";"430456";"5766"
"LOK1378_1mm";"SILVA (only NR);Bacteria;Proteobacteria;Gammaproteobacteria;Chromatiales;Sedimenticolaceae;uncultured;";"0.0";"0";"50";"49";"0";"49";"1";"430475";"5766"
"LOK1378_1mm";"SILVA (only NR);Bacteria;Proteobacteria;Gammaproteobacteria;Competibacterales;";"0.0";"0";"125";"103";"0";"103";"22";"430421";"5766"
"LOK1378_1mm";"SILVA (only NR);Bacteria;Proteobacteria;Gammaproteobacteria;Competibacterales;Competibacteraceae;";"0.0";"0";"125";"103";"0";"103";"22";"430421";"5766"
"LOK1378_1mm";"SILVA (only NR);Bacteria;Proteobacteria;Gammaproteobacteria;Competibacterales;Competibacteraceae;Candidatus Competibacter;";"0.0";"0";"95";"88";"0";"88";"7";"430436";"5766"
"LOK1378_1mm";"SILVA (only NR);Bacteria;Proteobacteria;Gammaproteobacteria;Competibacterales;Competibacteraceae;Candidatus Contendobacter;";"0.0";"0";"23";"9";"0";"9";"14";"430515";"5766"
"LOK1378_1mm";"SILVA (only NR);Bacteria;Proteobacteria;Gammaproteobacteria;Competibacterales;Competibacteraceae;Plasticicumulans;";"0.0";"0";"7";"6";"0";"6";"1";"430518";"5766"
"LOK1378_1mm";"SILVA (only NR);Bacteria;Proteobacteria;Gammaproteobacteria;Coxiellales;";"0.0";"0";"387";"380";"0";"380";"7";"430144";"5766"
"LOK1378_1mm";"SILVA (only NR);Bacteria;Proteobacteria;Gammaproteobacteria;Coxiellales;Coxiellaceae;";"0.0";"0";"387";"380";"0";"380";"7";"430144";"5766"
"LOK1378_1mm";"SILVA (only NR);Bacteria;Proteobacteria;Gammaproteobacteria;Coxiellales;Coxiellaceae;Coxiella;";"0.0";"0";"387";"380";"0";"380";"7";"430144";"5766"
"LOK1378_1mm";"SILVA (only NR);Bacteria;Proteobacteria;Gammaproteobacteria;D90;";"0.0";"0";"10";"10";"0";"10";"0";"430514";"5766"
"LOK1378_1mm";"SILVA (only NR);Bacteria;Proteobacteria;Gammaproteobacteria;Diplorickettsiales;";"0.0";"0";"446";"416";"0";"416";"30";"430108";"5766"
"LOK1378_1mm";"SILVA (only NR);Bacteria;Proteobacteria;Gammaproteobacteria;Diplorickettsiales;Diplorickettsiaceae;";"0.0";"0";"446";"416";"0";"416";"30";"430108";"5766"
"LOK1378_1mm";"SILVA (only NR);Bacteria;Proteobacteria;Gammaproteobacteria;Diplorickettsiales;Diplorickettsiaceae;Aquicella;";"0.0";"0";"167";"156";"0";"156";"11";"430368";"5766"
"LOK1378_1mm";"SILVA (only NR);Bacteria;Proteobacteria;Gammaproteobacteria;Diplorickettsiales;Diplorickettsiaceae;Diplorickettsia;";"0.0";"0";"7";"5";"0";"5";"2";"430519";"5766"
"LOK1378_1mm";"SILVA (only NR);Bacteria;Proteobacteria;Gammaproteobacteria;Diplorickettsiales;Diplorickettsiaceae;Rickettsiella;";"0.0";"0";"34";"32";"0";"32";"2";"430492";"5766"
"LOK1378_1mm";"SILVA (only NR);Bacteria;Proteobacteria;Gammaproteobacteria;Diplorickettsiales;Diplorickettsiaceae;uncultured;";"0.0";"0";"233";"218";"0";"218";"15";"430306";"5766"
"LOK1378_1mm";"SILVA (only NR);Bacteria;Proteobacteria;Gammaproteobacteria;EC3;";"0.0";"0";"55";"54";"0";"54";"1";"430470";"5766"
"LOK1378_1mm";"SILVA (only NR);Bacteria;Proteobacteria;Gammaproteobacteria;EPR3968-O8a-Bc78;";"0.0";"0";"56";"56";"0";"56";"0";"430468";"5766"
"LOK1378_1mm";"SILVA (only NR);Bacteria;Proteobacteria;Gammaproteobacteria;EV818SWSAP88;";"0.0";"0";"23";"23";"0";"23";"0";"430501";"5766"
"LOK1378_1mm";"SILVA (only NR);Bacteria;Proteobacteria;Gammaproteobacteria;Ectothiorhodospirales;";"0.0";"0";"473";"465";"0";"465";"8";"430059";"5766"
"LOK1378_1mm";"SILVA (only NR);Bacteria;Proteobacteria;Gammaproteobacteria;Ectothiorhodospirales;Acidihalobacteraceae;";"0.0";"0";"12";"12";"0";"12";"0";"430512";"5766"
"LOK1378_1mm";"SILVA (only NR);Bacteria;Proteobacteria;Gammaproteobacteria;Ectothiorhodospirales;Acidihalobacteraceae;Acidihalobacter;";"0.0";"0";"12";"12";"0";"12";"0";"430512";"5766"
"LOK1378_1mm";"SILVA (only NR);Bacteria;Proteobacteria;Gammaproteobacteria;Ectothiorhodospirales;Ectothiorhodospiraceae;";"0.0";"0";"311";"305";"0";"305";"6";"430219";"5766"
"LOK1378_1mm";"SILVA (only NR);Bacteria;Proteobacteria;Gammaproteobacteria;Ectothiorhodospirales;Ectothiorhodospiraceae;Ectothiorhodosinus;";"0.0";"0";"1";"1";"0";"1";"0";"430523";"5766"
"LOK1378_1mm";"SILVA (only NR);Bacteria;Proteobacteria;Gammaproteobacteria;Ectothiorhodospirales;Ectothiorhodospiraceae;Ectothiorhodospira;";"0.0";"0";"20";"20";"0";"20";"0";"430504";"5766"
"LOK1378_1mm";"SILVA (only NR);Bacteria;Proteobacteria;Gammaproteobacteria;Ectothiorhodospirales;Ectothiorhodospiraceae;Halofilum;";"0.0";"0";"22";"22";"0";"22";"0";"430502";"5766"
"LOK1378_1mm";"SILVA (only NR);Bacteria;Proteobacteria;Gammaproteobacteria;Ectothiorhodospirales;Ectothiorhodospiraceae;Thioalbus;";"0.0";"0";"5";"5";"0";"5";"0";"430519";"5766"
"LOK1378_1mm";"SILVA (only NR);Bacteria;Proteobacteria;Gammaproteobacteria;Ectothiorhodospirales;Ectothiorhodospiraceae;Thioalkalivibrio;";"0.0";"0";"41";"37";"0";"37";"4";"430487";"5766"
"LOK1378_1mm";"SILVA (only NR);Bacteria;Proteobacteria;Gammaproteobacteria;Ectothiorhodospirales;Ectothiorhodospiraceae;Thiogranum;";"0.0";"0";"66";"65";"0";"65";"1";"430459";"5766"
"LOK1378_1mm";"SILVA (only NR);Bacteria;Proteobacteria;Gammaproteobacteria;Ectothiorhodospirales;Ectothiorhodospiraceae;Thiohalomonas;";"0.0";"0";"10";"10";"0";"10";"0";"430514";"5766"
"LOK1378_1mm";"SILVA (only NR);Bacteria;Proteobacteria;Gammaproteobacteria;Ectothiorhodospirales;Ectothiorhodospiraceae;Thiohalospira;";"0.0";"0";"6";"5";"0";"5";"1";"430519";"5766"
"LOK1378_1mm";"SILVA (only NR);Bacteria;Proteobacteria;Gammaproteobacteria;Ectothiorhodospirales;Ectothiorhodospiraceae;Thiorhodospira;";"0.0";"0";"3";"3";"0";"3";"0";"430521";"5766"
"LOK1378_1mm";"SILVA (only NR);Bacteria;Proteobacteria;Gammaproteobacteria;Ectothiorhodospirales;Ectothiorhodospiraceae;uncultured;";"0.0";"0";"136";"136";"0";"136";"0";"430388";"5766"
"LOK1378_1mm";"SILVA (only NR);Bacteria;Proteobacteria;Gammaproteobacteria;Ectothiorhodospirales;Thioalkalispiraceae;";"0.0";"0";"150";"148";"0";"148";"2";"430376";"5766"
"LOK1378_1mm";"SILVA (only NR);Bacteria;Proteobacteria;Gammaproteobacteria;Ectothiorhodospirales;Thioalkalispiraceae;Thioalkalispira-Sulfurivermis;";"0.0";"0";"60";"60";"0";"60";"0";"430464";"5766"
"LOK1378_1mm";"SILVA (only NR);Bacteria;Proteobacteria;Gammaproteobacteria;Ectothiorhodospirales;Thioalkalispiraceae;Thiohalophilus;";"0.0";"0";"74";"72";"0";"72";"2";"430452";"5766"
"LOK1378_1mm";"SILVA (only NR);Bacteria;Proteobacteria;Gammaproteobacteria;Ectothiorhodospirales;Thioalkalispiraceae;uncultured;";"0.0";"0";"16";"16";"0";"16";"0";"430508";"5766"
"LOK1378_1mm";"SILVA (only NR);Bacteria;Proteobacteria;Gammaproteobacteria;Enterobacterales;";"0.0";"0";"23028";"22042";"0";"22042";"986";"408482";"5766"
"LOK1378_1mm";"SILVA (only NR);Bacteria;Proteobacteria;Gammaproteobacteria;Enterobacterales;Aeromonadaceae;";"0.0";"0";"1135";"1079";"0";"1079";"56";"429445";"5766"
"LOK1378_1mm";"SILVA (only NR);Bacteria;Proteobacteria;Gammaproteobacteria;Enterobacterales;Aeromonadaceae;Aeromonas;";"0.0";"0";"1030";"975";"0";"975";"55";"429549";"5766"
"LOK1378_1mm";"SILVA (only NR);Bacteria;Proteobacteria;Gammaproteobacteria;Enterobacterales;Aeromonadaceae;Oceanimonas;";"0.0";"0";"22";"22";"0";"22";"0";"430502";"5766"
"LOK1378_1mm";"SILVA (only NR);Bacteria;Proteobacteria;Gammaproteobacteria;Enterobacterales;Aeromonadaceae;Oceanisphaera;";"0.0";"0";"41";"41";"0";"41";"0";"430483";"5766"
"LOK1378_1mm";"SILVA (only NR);Bacteria;Proteobacteria;Gammaproteobacteria;Enterobacterales;Aeromonadaceae;Tolumonas;";"0.0";"0";"19";"18";"0";"18";"1";"430506";"5766"
"LOK1378_1mm";"SILVA (only NR);Bacteria;Proteobacteria;Gammaproteobacteria;Enterobacterales;Aeromonadaceae;Zobellella;";"0.0";"0";"16";"16";"0";"16";"0";"430508";"5766"
"LOK1378_1mm";"SILVA (only NR);Bacteria;Proteobacteria;Gammaproteobacteria;Enterobacterales;Alteromonadaceae;";"0.0";"0";"1053";"986";"0";"986";"67";"429538";"5766"
"LOK1378_1mm";"SILVA (only NR);Bacteria;Proteobacteria;Gammaproteobacteria;Enterobacterales;Alteromonadaceae;Aestuariibacter;";"0.0";"0";"55";"49";"0";"49";"6";"430475";"5766"
"LOK1378_1mm";"SILVA (only NR);Bacteria;Proteobacteria;Gammaproteobacteria;Enterobacterales;Alteromonadaceae;Agaribacter;";"0.0";"0";"22";"21";"0";"21";"1";"430503";"5766"
"LOK1378_1mm";"SILVA (only NR);Bacteria;Proteobacteria;Gammaproteobacteria;Enterobacterales;Alteromonadaceae;Aliiglaciecola;";"0.0";"0";"14";"14";"0";"14";"0";"430510";"5766"
"LOK1378_1mm";"SILVA (only NR);Bacteria;Proteobacteria;Gammaproteobacteria;Enterobacterales;Alteromonadaceae;Alishewanella;";"0.0";"0";"37";"37";"0";"37";"0";"430487";"5766"
"LOK1378_1mm";"SILVA (only NR);Bacteria;Proteobacteria;Gammaproteobacteria;Enterobacterales;Alteromonadaceae;Alteromonas;";"0.0";"0";"456";"417";"0";"417";"39";"430107";"5766"
"LOK1378_1mm";"SILVA (only NR);Bacteria;Proteobacteria;Gammaproteobacteria;Enterobacterales;Alteromonadaceae;Bowmanella;";"0.0";"0";"4";"4";"0";"4";"0";"430520";"5766"
"LOK1378_1mm";"SILVA (only NR);Bacteria;Proteobacteria;Gammaproteobacteria;Enterobacterales;Alteromonadaceae;Catenovulum;";"0.0";"0";"12";"12";"0";"12";"0";"430512";"5766"
"LOK1378_1mm";"SILVA (only NR);Bacteria;Proteobacteria;Gammaproteobacteria;Enterobacterales;Alteromonadaceae;Gayadomonas;";"0.0";"0";"2";"2";"0";"2";"0";"430522";"5766"
"LOK1378_1mm";"SILVA (only NR);Bacteria;Proteobacteria;Gammaproteobacteria;Enterobacterales;Alteromonadaceae;Glaciecola;";"0.0";"0";"54";"52";"0";"52";"2";"430472";"5766"
"LOK1378_1mm";"SILVA (only NR);Bacteria;Proteobacteria;Gammaproteobacteria;Enterobacterales;Alteromonadaceae;Lacimicrobium;";"0.0";"0";"6";"6";"0";"6";"0";"430518";"5766"
"LOK1378_1mm";"SILVA (only NR);Bacteria;Proteobacteria;Gammaproteobacteria;Enterobacterales;Alteromonadaceae;Neiella;";"0.0";"0";"4";"4";"0";"4";"0";"430520";"5766"
"LOK1378_1mm";"SILVA (only NR);Bacteria;Proteobacteria;Gammaproteobacteria;Enterobacterales;Alteromonadaceae;Paraglaciecola;";"0.0";"0";"66";"62";"0";"62";"4";"430462";"5766"
"LOK1378_1mm";"SILVA (only NR);Bacteria;Proteobacteria;Gammaproteobacteria;Enterobacterales;Alteromonadaceae;Pseudobowmanella;";"0.0";"0";"3";"3";"0";"3";"0";"430521";"5766"
"LOK1378_1mm";"SILVA (only NR);Bacteria;Proteobacteria;Gammaproteobacteria;Enterobacterales;Alteromonadaceae;Rheinheimera;";"0.0";"0";"225";"216";"0";"216";"9";"430308";"5766"
"LOK1378_1mm";"SILVA (only NR);Bacteria;Proteobacteria;Gammaproteobacteria;Enterobacterales;Alteromonadaceae;Salinimonas;";"0.0";"0";"19";"17";"0";"17";"2";"430507";"5766"
"LOK1378_1mm";"SILVA (only NR);Bacteria;Proteobacteria;Gammaproteobacteria;Enterobacterales;Alteromonadaceae;XY-R5;";"0.0";"0";"2";"2";"0";"2";"0";"430522";"5766"
"LOK1378_1mm";"SILVA (only NR);Bacteria;Proteobacteria;Gammaproteobacteria;Enterobacterales;Alteromonadaceae;uncultured;";"0.0";"0";"61";"57";"0";"57";"4";"430467";"5766"
"LOK1378_1mm";"SILVA (only NR);Bacteria;Proteobacteria;Gammaproteobacteria;Enterobacterales;Budviciaceae;";"0.0";"0";"22";"22";"0";"22";"0";"430502";"5766"
"LOK1378_1mm";"SILVA (only NR);Bacteria;Proteobacteria;Gammaproteobacteria;Enterobacterales;Budviciaceae;Budvicia;";"0.0";"0";"6";"6";"0";"6";"0";"430518";"5766"
"LOK1378_1mm";"SILVA (only NR);Bacteria;Proteobacteria;Gammaproteobacteria;Enterobacterales;Budviciaceae;Leminorella;";"0.0";"0";"5";"5";"0";"5";"0";"430519";"5766"
"LOK1378_1mm";"SILVA (only NR);Bacteria;Proteobacteria;Gammaproteobacteria;Enterobacterales;Budviciaceae;Pragia;";"0.0";"0";"11";"11";"0";"11";"0";"430513";"5766"
"LOK1378_1mm";"SILVA (only NR);Bacteria;Proteobacteria;Gammaproteobacteria;Enterobacterales;Celerinatantimonadaceae;";"0.0";"0";"3";"3";"0";"3";"0";"430521";"5766"
"LOK1378_1mm";"SILVA (only NR);Bacteria;Proteobacteria;Gammaproteobacteria;Enterobacterales;Celerinatantimonadaceae;Celerinatantimonas;";"0.0";"0";"3";"3";"0";"3";"0";"430521";"5766"
"LOK1378_1mm";"SILVA (only NR);Bacteria;Proteobacteria;Gammaproteobacteria;Enterobacterales;Colwelliaceae;";"0.0";"0";"511";"499";"0";"499";"12";"430025";"5766"
"LOK1378_1mm";"SILVA (only NR);Bacteria;Proteobacteria;Gammaproteobacteria;Enterobacterales;Colwelliaceae;Colwellia;";"0.0";"0";"377";"370";"0";"370";"7";"430154";"5766"
"LOK1378_1mm";"SILVA (only NR);Bacteria;Proteobacteria;Gammaproteobacteria;Enterobacterales;Colwelliaceae;Litorilituus;";"0.0";"0";"1";"1";"0";"1";"0";"430523";"5766"
"LOK1378_1mm";"SILVA (only NR);Bacteria;Proteobacteria;Gammaproteobacteria;Enterobacterales;Colwelliaceae;Thalassomonas;";"0.0";"0";"6";"6";"0";"6";"0";"430518";"5766"
"LOK1378_1mm";"SILVA (only NR);Bacteria;Proteobacteria;Gammaproteobacteria;Enterobacterales;Colwelliaceae;Thalassotalea;";"0.0";"0";"101";"96";"0";"96";"5";"430428";"5766"
"LOK1378_1mm";"SILVA (only NR);Bacteria;Proteobacteria;Gammaproteobacteria;Enterobacterales;Colwelliaceae;uncultured;";"0.0";"0";"24";"24";"0";"24";"0";"430500";"5766"
"LOK1378_1mm";"SILVA (only NR);Bacteria;Proteobacteria;Gammaproteobacteria;Enterobacterales;Enterobacterales Incertae Sedis;";"0.0";"0";"14";"14";"0";"14";"0";"430510";"5766"
"LOK1378_1mm";"SILVA (only NR);Bacteria;Proteobacteria;Gammaproteobacteria;Enterobacterales;Enterobacterales Incertae Sedis;Alkalimonas;";"0.0";"0";"14";"14";"0";"14";"0";"430510";"5766"
"LOK1378_1mm";"SILVA (only NR);Bacteria;Proteobacteria;Gammaproteobacteria;Enterobacterales;Enterobacteriaceae;";"0.0";"0";"7969";"7665";"0";"7665";"304";"422859";"5766"
"LOK1378_1mm";"SILVA (only NR);Bacteria;Proteobacteria;Gammaproteobacteria;Enterobacterales;Enterobacteriaceae;Aquamonas;";"0.0";"0";"1";"1";"0";"1";"0";"430523";"5766"
"LOK1378_1mm";"SILVA (only NR);Bacteria;Proteobacteria;Gammaproteobacteria;Enterobacterales;Enterobacteriaceae;Atlantibacter;";"0.0";"0";"4";"4";"0";"4";"0";"430520";"5766"
"LOK1378_1mm";"SILVA (only NR);Bacteria;Proteobacteria;Gammaproteobacteria;Enterobacterales;Enterobacteriaceae;Buttiauxella;";"0.0";"0";"57";"54";"0";"54";"3";"430470";"5766"
"LOK1378_1mm";"SILVA (only NR);Bacteria;Proteobacteria;Gammaproteobacteria;Enterobacterales;Enterobacteriaceae;Cedecea;";"0.0";"0";"14";"14";"0";"14";"0";"430510";"5766"
"LOK1378_1mm";"SILVA (only NR);Bacteria;Proteobacteria;Gammaproteobacteria;Enterobacterales;Enterobacteriaceae;Citrobacter;";"0.0";"0";"516";"500";"0";"500";"16";"430024";"5766"
"LOK1378_1mm";"SILVA (only NR);Bacteria;Proteobacteria;Gammaproteobacteria;Enterobacterales;Enterobacteriaceae;Cronobacter;";"0.0";"0";"153";"151";"0";"151";"2";"430373";"5766"
"LOK1378_1mm";"SILVA (only NR);Bacteria;Proteobacteria;Gammaproteobacteria;Enterobacterales;Enterobacteriaceae;Enterobacillus;";"0.0";"0";"15";"14";"0";"14";"1";"430510";"5766"
"LOK1378_1mm";"SILVA (only NR);Bacteria;Proteobacteria;Gammaproteobacteria;Enterobacterales;Enterobacteriaceae;Enterobacter;";"0.0";"0";"1670";"1575";"0";"1575";"95";"428949";"5766"
"LOK1378_1mm";"SILVA (only NR);Bacteria;Proteobacteria;Gammaproteobacteria;Enterobacterales;Enterobacteriaceae;Escherichia-Shigella;";"0.0";"0";"2807";"2723";"0";"2723";"84";"427801";"5766"
"LOK1378_1mm";"SILVA (only NR);Bacteria;Proteobacteria;Gammaproteobacteria;Enterobacterales;Enterobacteriaceae;Franconibacter;";"0.0";"0";"12";"6";"0";"6";"6";"430518";"5766"
"LOK1378_1mm";"SILVA (only NR);Bacteria;Proteobacteria;Gammaproteobacteria;Enterobacterales;Enterobacteriaceae;Klebsiella;";"0.0";"0";"1177";"1119";"0";"1119";"58";"429405";"5766"
"LOK1378_1mm";"SILVA (only NR);Bacteria;Proteobacteria;Gammaproteobacteria;Enterobacterales;Enterobacteriaceae;Kluyvera;";"0.0";"0";"88";"82";"0";"82";"6";"430442";"5766"
"LOK1378_1mm";"SILVA (only NR);Bacteria;Proteobacteria;Gammaproteobacteria;Enterobacterales;Enterobacteriaceae;Kosakonia;";"0.0";"0";"157";"153";"0";"153";"4";"430371";"5766"
"LOK1378_1mm";"SILVA (only NR);Bacteria;Proteobacteria;Gammaproteobacteria;Enterobacterales;Enterobacteriaceae;Lelliottia;";"0.0";"0";"31";"30";"0";"30";"1";"430494";"5766"
"LOK1378_1mm";"SILVA (only NR);Bacteria;Proteobacteria;Gammaproteobacteria;Enterobacterales;Enterobacteriaceae;Mangrovibacter;";"0.0";"0";"11";"10";"0";"10";"1";"430514";"5766"
"LOK1378_1mm";"SILVA (only NR);Bacteria;Proteobacteria;Gammaproteobacteria;Enterobacterales;Enterobacteriaceae;Plesiomonas;";"0.0";"0";"107";"104";"0";"104";"3";"430420";"5766"
"LOK1378_1mm";"SILVA (only NR);Bacteria;Proteobacteria;Gammaproteobacteria;Enterobacterales;Enterobacteriaceae;Pluralibacter;";"0.0";"0";"8";"8";"0";"8";"0";"430516";"5766"
"LOK1378_1mm";"SILVA (only NR);Bacteria;Proteobacteria;Gammaproteobacteria;Enterobacterales;Enterobacteriaceae;Pseudocitrobacter;";"0.0";"0";"20";"17";"0";"17";"3";"430507";"5766"
"LOK1378_1mm";"SILVA (only NR);Bacteria;Proteobacteria;Gammaproteobacteria;Enterobacterales;Enterobacteriaceae;Raoultella;";"0.0";"0";"96";"95";"0";"95";"1";"430429";"5766"
"LOK1378_1mm";"SILVA (only NR);Bacteria;Proteobacteria;Gammaproteobacteria;Enterobacterales;Enterobacteriaceae;Salmonella;";"0.0";"0";"952";"933";"0";"933";"19";"429591";"5766"
"LOK1378_1mm";"SILVA (only NR);Bacteria;Proteobacteria;Gammaproteobacteria;Enterobacterales;Enterobacteriaceae;Shimwellia;";"0.0";"0";"25";"25";"0";"25";"0";"430499";"5766"
"LOK1378_1mm";"SILVA (only NR);Bacteria;Proteobacteria;Gammaproteobacteria;Enterobacterales;Enterobacteriaceae;Trabulsiella;";"0.0";"0";"23";"22";"0";"22";"1";"430502";"5766"
"LOK1378_1mm";"SILVA (only NR);Bacteria;Proteobacteria;Gammaproteobacteria;Enterobacterales;Enterobacteriaceae;Yokenella;";"0.0";"0";"11";"11";"0";"11";"0";"430513";"5766"
"LOK1378_1mm";"SILVA (only NR);Bacteria;Proteobacteria;Gammaproteobacteria;Enterobacterales;Erwiniaceae;";"0.0";"0";"1233";"1178";"0";"1178";"55";"429346";"5766"
"LOK1378_1mm";"SILVA (only NR);Bacteria;Proteobacteria;Gammaproteobacteria;Enterobacterales;Erwiniaceae;Candidatus Stammerula;";"0.0";"0";"8";"8";"0";"8";"0";"430516";"5766"
"LOK1378_1mm";"SILVA (only NR);Bacteria;Proteobacteria;Gammaproteobacteria;Enterobacterales;Erwiniaceae;Erwinia;";"0.0";"0";"200";"191";"0";"191";"9";"430333";"5766"
"LOK1378_1mm";"SILVA (only NR);Bacteria;Proteobacteria;Gammaproteobacteria;Enterobacterales;Erwiniaceae;Incertae Sedis;";"0.0";"0";"8";"8";"0";"8";"0";"430516";"5766"
"LOK1378_1mm";"SILVA (only NR);Bacteria;Proteobacteria;Gammaproteobacteria;Enterobacterales;Erwiniaceae;Izhakiella;";"0.0";"0";"25";"25";"0";"25";"0";"430499";"5766"
"LOK1378_1mm";"SILVA (only NR);Bacteria;Proteobacteria;Gammaproteobacteria;Enterobacterales;Erwiniaceae;Pantoea;";"0.0";"0";"861";"823";"0";"823";"38";"429701";"5766"
"LOK1378_1mm";"SILVA (only NR);Bacteria;Proteobacteria;Gammaproteobacteria;Enterobacterales;Erwiniaceae;Phaseolibacter;";"0.0";"0";"3";"3";"0";"3";"0";"430521";"5766"
"LOK1378_1mm";"SILVA (only NR);Bacteria;Proteobacteria;Gammaproteobacteria;Enterobacterales;Erwiniaceae;Rosenbergiella;";"0.0";"0";"38";"36";"0";"36";"2";"430488";"5766"
"LOK1378_1mm";"SILVA (only NR);Bacteria;Proteobacteria;Gammaproteobacteria;Enterobacterales;Erwiniaceae;Siccibacter;";"0.0";"0";"16";"14";"0";"14";"2";"430510";"5766"
"LOK1378_1mm";"SILVA (only NR);Bacteria;Proteobacteria;Gammaproteobacteria;Enterobacterales;Erwiniaceae;Tatumella;";"0.0";"0";"37";"34";"0";"34";"3";"430490";"5766"
"LOK1378_1mm";"SILVA (only NR);Bacteria;Proteobacteria;Gammaproteobacteria;Enterobacterales;Erwiniaceae;uncultured;";"0.0";"0";"23";"23";"0";"23";"0";"430501";"5766"
"LOK1378_1mm";"SILVA (only NR);Bacteria;Proteobacteria;Gammaproteobacteria;Enterobacterales;Gallaecimonadaceae;";"0.0";"0";"10";"7";"0";"7";"3";"430517";"5766"
"LOK1378_1mm";"SILVA (only NR);Bacteria;Proteobacteria;Gammaproteobacteria;Enterobacterales;Gallaecimonadaceae;Gallaecimonas;";"0.0";"0";"10";"7";"0";"7";"3";"430517";"5766"
"LOK1378_1mm";"SILVA (only NR);Bacteria;Proteobacteria;Gammaproteobacteria;Enterobacterales;Hafniaceae;";"0.0";"0";"142";"141";"0";"141";"1";"430383";"5766"
"LOK1378_1mm";"SILVA (only NR);Bacteria;Proteobacteria;Gammaproteobacteria;Enterobacterales;Hafniaceae;Edwardsiella;";"0.0";"0";"62";"61";"0";"61";"1";"430463";"5766"
"LOK1378_1mm";"SILVA (only NR);Bacteria;Proteobacteria;Gammaproteobacteria;Enterobacterales;Hafniaceae;Hafnia-Obesumbacterium;";"0.0";"0";"80";"80";"0";"80";"0";"430444";"5766"
"LOK1378_1mm";"SILVA (only NR);Bacteria;Proteobacteria;Gammaproteobacteria;Enterobacterales;Idiomarinaceae;";"0.0";"0";"240";"228";"0";"228";"12";"430296";"5766"
"LOK1378_1mm";"SILVA (only NR);Bacteria;Proteobacteria;Gammaproteobacteria;Enterobacterales;Idiomarinaceae;Aliidiomarina;";"0.0";"0";"53";"52";"0";"52";"1";"430472";"5766"
"LOK1378_1mm";"SILVA (only NR);Bacteria;Proteobacteria;Gammaproteobacteria;Enterobacterales;Idiomarinaceae;Idiomarina;";"0.0";"0";"186";"175";"0";"175";"11";"430349";"5766"
"LOK1378_1mm";"SILVA (only NR);Bacteria;Proteobacteria;Gammaproteobacteria;Enterobacterales;JI49D030;";"0.0";"0";"2";"2";"0";"2";"0";"430522";"5766"
"LOK1378_1mm";"SILVA (only NR);Bacteria;Proteobacteria;Gammaproteobacteria;Enterobacterales;Kangiellaceae;";"0.0";"0";"68";"64";"0";"64";"4";"430460";"5766"
"LOK1378_1mm";"SILVA (only NR);Bacteria;Proteobacteria;Gammaproteobacteria;Enterobacterales;Kangiellaceae;Aliikangiella;";"0.0";"0";"17";"17";"0";"17";"0";"430507";"5766"
"LOK1378_1mm";"SILVA (only NR);Bacteria;Proteobacteria;Gammaproteobacteria;Enterobacterales;Kangiellaceae;Kangiella;";"0.0";"0";"31";"27";"0";"27";"4";"430497";"5766"
"LOK1378_1mm";"SILVA (only NR);Bacteria;Proteobacteria;Gammaproteobacteria;Enterobacterales;Kangiellaceae;Pleionea;";"0.0";"0";"4";"4";"0";"4";"0";"430520";"5766"
"LOK1378_1mm";"SILVA (only NR);Bacteria;Proteobacteria;Gammaproteobacteria;Enterobacterales;Kangiellaceae;uncultured;";"0.0";"0";"16";"16";"0";"16";"0";"430508";"5766"
"LOK1378_1mm";"SILVA (only NR);Bacteria;Proteobacteria;Gammaproteobacteria;Enterobacterales;MB19;";"0.0";"0";"11";"10";"0";"10";"1";"430514";"5766"
"LOK1378_1mm";"SILVA (only NR);Bacteria;Proteobacteria;Gammaproteobacteria;Enterobacterales;Morganellaceae;";"0.0";"0";"1368";"1297";"0";"1297";"71";"429227";"5766"
"LOK1378_1mm";"SILVA (only NR);Bacteria;Proteobacteria;Gammaproteobacteria;Enterobacterales;Morganellaceae;Arsenophonus;";"0.0";"0";"98";"93";"0";"93";"5";"430431";"5766"
"LOK1378_1mm";"SILVA (only NR);Bacteria;Proteobacteria;Gammaproteobacteria;Enterobacterales;Morganellaceae;Buchnera;";"0.0";"0";"219";"210";"0";"210";"9";"430314";"5766"
"LOK1378_1mm";"SILVA (only NR);Bacteria;Proteobacteria;Gammaproteobacteria;Enterobacterales;Morganellaceae;Candidatus Annandia;";"0.0";"0";"2";"2";"0";"2";"0";"430522";"5766"
"LOK1378_1mm";"SILVA (only NR);Bacteria;Proteobacteria;Gammaproteobacteria;Enterobacterales;Morganellaceae;Candidatus Baumannia;";"0.0";"0";"21";"21";"0";"21";"0";"430503";"5766"
"LOK1378_1mm";"SILVA (only NR);Bacteria;Proteobacteria;Gammaproteobacteria;Enterobacterales;Morganellaceae;Candidatus Benitsuchiphilus;";"0.0";"0";"10";"10";"0";"10";"0";"430514";"5766"
"LOK1378_1mm";"SILVA (only NR);Bacteria;Proteobacteria;Gammaproteobacteria;Enterobacterales;Morganellaceae;Candidatus Blochmannia;";"0.0";"0";"36";"34";"0";"34";"2";"430490";"5766"
"LOK1378_1mm";"SILVA (only NR);Bacteria;Proteobacteria;Gammaproteobacteria;Enterobacterales;Morganellaceae;Candidatus Curculioniphilus;";"0.0";"0";"31";"31";"0";"31";"0";"430493";"5766"
"LOK1378_1mm";"SILVA (only NR);Bacteria;Proteobacteria;Gammaproteobacteria;Enterobacterales;Morganellaceae;Candidatus Ecksteinia;";"0.0";"0";"6";"6";"0";"6";"0";"430518";"5766"
"LOK1378_1mm";"SILVA (only NR);Bacteria;Proteobacteria;Gammaproteobacteria;Enterobacterales;Morganellaceae;Candidatus Hamiltonella;";"0.0";"0";"18";"12";"0";"12";"6";"430512";"5766"
"LOK1378_1mm";"SILVA (only NR);Bacteria;Proteobacteria;Gammaproteobacteria;Enterobacterales;Morganellaceae;Candidatus Hartigia;";"0.0";"0";"3";"3";"0";"3";"0";"430521";"5766"
"LOK1378_1mm";"SILVA (only NR);Bacteria;Proteobacteria;Gammaproteobacteria;Enterobacterales;Morganellaceae;Candidatus Ishikawaella;";"0.0";"0";"5";"1";"0";"1";"4";"430523";"5766"
"LOK1378_1mm";"SILVA (only NR);Bacteria;Proteobacteria;Gammaproteobacteria;Enterobacterales;Morganellaceae;Candidatus Kleidoceria;";"0.0";"0";"1";"1";"0";"1";"0";"430523";"5766"
"LOK1378_1mm";"SILVA (only NR);Bacteria;Proteobacteria;Gammaproteobacteria;Enterobacterales;Morganellaceae;Candidatus Moranella;";"0.0";"0";"4";"4";"0";"4";"0";"430520";"5766"
"LOK1378_1mm";"SILVA (only NR);Bacteria;Proteobacteria;Gammaproteobacteria;Enterobacterales;Morganellaceae;Candidatus Puchtella;";"0.0";"0";"4";"4";"0";"4";"0";"430520";"5766"
"LOK1378_1mm";"SILVA (only NR);Bacteria;Proteobacteria;Gammaproteobacteria;Enterobacterales;Morganellaceae;Candidatus Purcelliella;";"0.0";"0";"9";"9";"0";"9";"0";"430515";"5766"
"LOK1378_1mm";"SILVA (only NR);Bacteria;Proteobacteria;Gammaproteobacteria;Enterobacterales;Morganellaceae;Candidatus Regiella;";"0.0";"0";"11";"11";"0";"11";"0";"430513";"5766"
"LOK1378_1mm";"SILVA (only NR);Bacteria;Proteobacteria;Gammaproteobacteria;Enterobacterales;Morganellaceae;Candidatus Riesia;";"0.0";"0";"6";"6";"0";"6";"0";"430518";"5766"
"LOK1378_1mm";"SILVA (only NR);Bacteria;Proteobacteria;Gammaproteobacteria;Enterobacterales;Morganellaceae;Candidatus Rosenkranzia;";"0.0";"0";"8";"2";"0";"2";"6";"430522";"5766"
"LOK1378_1mm";"SILVA (only NR);Bacteria;Proteobacteria;Gammaproteobacteria;Enterobacterales;Morganellaceae;Candidatus Schneideria;";"0.0";"0";"5";"5";"0";"5";"0";"430519";"5766"
"LOK1378_1mm";"SILVA (only NR);Bacteria;Proteobacteria;Gammaproteobacteria;Enterobacterales;Morganellaceae;Candidatus Westeberhardia;";"0.0";"0";"1";"1";"0";"1";"0";"430523";"5766"
"LOK1378_1mm";"SILVA (only NR);Bacteria;Proteobacteria;Gammaproteobacteria;Enterobacterales;Morganellaceae;Cosenzaea;";"0.0";"0";"3";"3";"0";"3";"0";"430521";"5766"
"LOK1378_1mm";"SILVA (only NR);Bacteria;Proteobacteria;Gammaproteobacteria;Enterobacterales;Morganellaceae;Incertae Sedis;";"0.0";"0";"28";"28";"0";"28";"0";"430496";"5766"
"LOK1378_1mm";"SILVA (only NR);Bacteria;Proteobacteria;Gammaproteobacteria;Enterobacterales;Morganellaceae;Moellerella;";"0.0";"0";"3";"3";"0";"3";"0";"430521";"5766"
"LOK1378_1mm";"SILVA (only NR);Bacteria;Proteobacteria;Gammaproteobacteria;Enterobacterales;Morganellaceae;Morganella;";"0.0";"0";"123";"116";"0";"116";"7";"430408";"5766"
"LOK1378_1mm";"SILVA (only NR);Bacteria;Proteobacteria;Gammaproteobacteria;Enterobacterales;Morganellaceae;Photorhabdus;";"0.0";"0";"72";"70";"0";"70";"2";"430454";"5766"
"LOK1378_1mm";"SILVA (only NR);Bacteria;Proteobacteria;Gammaproteobacteria;Enterobacterales;Morganellaceae;Proteus;";"0.0";"0";"230";"215";"0";"215";"15";"430309";"5766"
"LOK1378_1mm";"SILVA (only NR);Bacteria;Proteobacteria;Gammaproteobacteria;Enterobacterales;Morganellaceae;Providencia;";"0.0";"0";"189";"180";"0";"180";"9";"430344";"5766"
"LOK1378_1mm";"SILVA (only NR);Bacteria;Proteobacteria;Gammaproteobacteria;Enterobacterales;Morganellaceae;Wigglesworthia;";"0.0";"0";"4";"4";"0";"4";"0";"430520";"5766"
"LOK1378_1mm";"SILVA (only NR);Bacteria;Proteobacteria;Gammaproteobacteria;Enterobacterales;Morganellaceae;Xenorhabdus;";"0.0";"0";"95";"95";"0";"95";"0";"430429";"5766"
"LOK1378_1mm";"SILVA (only NR);Bacteria;Proteobacteria;Gammaproteobacteria;Enterobacterales;Morganellaceae;endosymbionts;";"0.0";"0";"91";"87";"0";"87";"4";"430437";"5766"
"LOK1378_1mm";"SILVA (only NR);Bacteria;Proteobacteria;Gammaproteobacteria;Enterobacterales;Morganellaceae;uncultured;";"0.0";"0";"13";"13";"0";"13";"0";"430511";"5766"
"LOK1378_1mm";"SILVA (only NR);Bacteria;Proteobacteria;Gammaproteobacteria;Enterobacterales;Moritellaceae;";"0.0";"0";"58";"58";"0";"58";"0";"430466";"5766"
"LOK1378_1mm";"SILVA (only NR);Bacteria;Proteobacteria;Gammaproteobacteria;Enterobacterales;Moritellaceae;Moritella;";"0.0";"0";"44";"44";"0";"44";"0";"430480";"5766"
"LOK1378_1mm";"SILVA (only NR);Bacteria;Proteobacteria;Gammaproteobacteria;Enterobacterales;Moritellaceae;Paramoritella;";"0.0";"0";"7";"7";"0";"7";"0";"430517";"5766"
"LOK1378_1mm";"SILVA (only NR);Bacteria;Proteobacteria;Gammaproteobacteria;Enterobacterales;Moritellaceae;uncultured;";"0.0";"0";"7";"7";"0";"7";"0";"430517";"5766"
"LOK1378_1mm";"SILVA (only NR);Bacteria;Proteobacteria;Gammaproteobacteria;Enterobacterales;Orbaceae;";"0.0";"0";"91";"58";"0";"58";"33";"430466";"5766"
"LOK1378_1mm";"SILVA (only NR);Bacteria;Proteobacteria;Gammaproteobacteria;Enterobacterales;Orbaceae;Candidatus Schmidhempelia;";"0.0";"0";"4";"4";"0";"4";"0";"430520";"5766"
"LOK1378_1mm";"SILVA (only NR);Bacteria;Proteobacteria;Gammaproteobacteria;Enterobacterales;Orbaceae;Frischella;";"0.0";"0";"7";"5";"0";"5";"2";"430519";"5766"
"LOK1378_1mm";"SILVA (only NR);Bacteria;Proteobacteria;Gammaproteobacteria;Enterobacterales;Orbaceae;Gilliamella;";"0.0";"0";"66";"38";"0";"38";"28";"430486";"5766"
"LOK1378_1mm";"SILVA (only NR);Bacteria;Proteobacteria;Gammaproteobacteria;Enterobacterales;Orbaceae;Orbus;";"0.0";"0";"5";"4";"0";"4";"1";"430520";"5766"
"LOK1378_1mm";"SILVA (only NR);Bacteria;Proteobacteria;Gammaproteobacteria;Enterobacterales;Orbaceae;uncultured;";"0.0";"0";"5";"5";"0";"5";"0";"430519";"5766"
"LOK1378_1mm";"SILVA (only NR);Bacteria;Proteobacteria;Gammaproteobacteria;Enterobacterales;Pasteurellaceae;";"0.0";"0";"2549";"2467";"0";"2467";"82";"428057";"5766"
"LOK1378_1mm";"SILVA (only NR);Bacteria;Proteobacteria;Gammaproteobacteria;Enterobacterales;Pasteurellaceae;Actinobacillus;";"0.0";"0";"398";"392";"0";"392";"6";"430132";"5766"
"LOK1378_1mm";"SILVA (only NR);Bacteria;Proteobacteria;Gammaproteobacteria;Enterobacterales;Pasteurellaceae;Aggregatibacter;";"0.0";"0";"207";"199";"0";"199";"8";"430325";"5766"
"LOK1378_1mm";"SILVA (only NR);Bacteria;Proteobacteria;Gammaproteobacteria;Enterobacterales;Pasteurellaceae;Avibacterium;";"0.0";"0";"25";"24";"0";"24";"1";"430500";"5766"
"LOK1378_1mm";"SILVA (only NR);Bacteria;Proteobacteria;Gammaproteobacteria;Enterobacterales;Pasteurellaceae;Basfia;";"0.0";"0";"6";"6";"0";"6";"0";"430518";"5766"
"LOK1378_1mm";"SILVA (only NR);Bacteria;Proteobacteria;Gammaproteobacteria;Enterobacterales;Pasteurellaceae;Bibersteinia;";"0.0";"0";"21";"21";"0";"21";"0";"430503";"5766"
"LOK1378_1mm";"SILVA (only NR);Bacteria;Proteobacteria;Gammaproteobacteria;Enterobacterales;Pasteurellaceae;Bisgaardia;";"0.0";"0";"10";"6";"0";"6";"4";"430518";"5766"
"LOK1378_1mm";"SILVA (only NR);Bacteria;Proteobacteria;Gammaproteobacteria;Enterobacterales;Pasteurellaceae;Caviibacterium;";"0.0";"0";"4";"2";"0";"2";"2";"430522";"5766"
"LOK1378_1mm";"SILVA (only NR);Bacteria;Proteobacteria;Gammaproteobacteria;Enterobacterales;Pasteurellaceae;Chelonobacter;";"0.0";"0";"4";"4";"0";"4";"0";"430520";"5766"
"LOK1378_1mm";"SILVA (only NR);Bacteria;Proteobacteria;Gammaproteobacteria;Enterobacterales;Pasteurellaceae;Conservatibacter;";"0.0";"0";"2";"2";"0";"2";"0";"430522";"5766"
"LOK1378_1mm";"SILVA (only NR);Bacteria;Proteobacteria;Gammaproteobacteria;Enterobacterales;Pasteurellaceae;Cricetibacter;";"0.0";"0";"2";"1";"0";"1";"1";"430523";"5766"
"LOK1378_1mm";"SILVA (only NR);Bacteria;Proteobacteria;Gammaproteobacteria;Enterobacterales;Pasteurellaceae;Frederiksenia;";"0.0";"0";"11";"10";"0";"10";"1";"430514";"5766"
"LOK1378_1mm";"SILVA (only NR);Bacteria;Proteobacteria;Gammaproteobacteria;Enterobacterales;Pasteurellaceae;Gallibacterium;";"0.0";"0";"35";"34";"0";"34";"1";"430490";"5766"
"LOK1378_1mm";"SILVA (only NR);Bacteria;Proteobacteria;Gammaproteobacteria;Enterobacterales;Pasteurellaceae;Haemophilus;";"0.0";"0";"1110";"1078";"0";"1078";"32";"429446";"5766"
"LOK1378_1mm";"SILVA (only NR);Bacteria;Proteobacteria;Gammaproteobacteria;Enterobacterales;Pasteurellaceae;Histophilus;";"0.0";"0";"32";"27";"0";"27";"5";"430497";"5766"
"LOK1378_1mm";"SILVA (only NR);Bacteria;Proteobacteria;Gammaproteobacteria;Enterobacterales;Pasteurellaceae;Lonepinella;";"0.0";"0";"3";"3";"0";"3";"0";"430521";"5766"
"LOK1378_1mm";"SILVA (only NR);Bacteria;Proteobacteria;Gammaproteobacteria;Enterobacterales;Pasteurellaceae;Mannheimia;";"0.0";"0";"65";"64";"0";"64";"1";"430460";"5766"
"LOK1378_1mm";"SILVA (only NR);Bacteria;Proteobacteria;Gammaproteobacteria;Enterobacterales;Pasteurellaceae;Mesocricetibacter;";"0.0";"0";"4";"3";"0";"3";"1";"430521";"5766"
"LOK1378_1mm";"SILVA (only NR);Bacteria;Proteobacteria;Gammaproteobacteria;Enterobacterales;Pasteurellaceae;Muribacter;";"0.0";"0";"27";"27";"0";"27";"0";"430497";"5766"
"LOK1378_1mm";"SILVA (only NR);Bacteria;Proteobacteria;Gammaproteobacteria;Enterobacterales;Pasteurellaceae;Necropsobacter;";"0.0";"0";"4";"2";"0";"2";"2";"430522";"5766"
"LOK1378_1mm";"SILVA (only NR);Bacteria;Proteobacteria;Gammaproteobacteria;Enterobacterales;Pasteurellaceae;Nicoletella;";"0.0";"0";"17";"17";"0";"17";"0";"430507";"5766"
"LOK1378_1mm";"SILVA (only NR);Bacteria;Proteobacteria;Gammaproteobacteria;Enterobacterales;Pasteurellaceae;Otariodibacter;";"0.0";"0";"98";"98";"0";"98";"0";"430426";"5766"
"LOK1378_1mm";"SILVA (only NR);Bacteria;Proteobacteria;Gammaproteobacteria;Enterobacterales;Pasteurellaceae;Pasteurella;";"0.0";"0";"114";"114";"0";"114";"0";"430410";"5766"
"LOK1378_1mm";"SILVA (only NR);Bacteria;Proteobacteria;Gammaproteobacteria;Enterobacterales;Pasteurellaceae;Phocoenobacter;";"0.0";"0";"141";"141";"0";"141";"0";"430383";"5766"
"LOK1378_1mm";"SILVA (only NR);Bacteria;Proteobacteria;Gammaproteobacteria;Enterobacterales;Pasteurellaceae;Rodentibacter;";"0.0";"0";"117";"110";"0";"110";"7";"430414";"5766"
"LOK1378_1mm";"SILVA (only NR);Bacteria;Proteobacteria;Gammaproteobacteria;Enterobacterales;Pasteurellaceae;Seminibacterium;";"0.0";"0";"1";"1";"0";"1";"0";"430523";"5766"
"LOK1378_1mm";"SILVA (only NR);Bacteria;Proteobacteria;Gammaproteobacteria;Enterobacterales;Pasteurellaceae;Testudinibacter;";"0.0";"0";"3";"0";"0";"0";"3";"430524";"5766"
"LOK1378_1mm";"SILVA (only NR);Bacteria;Proteobacteria;Gammaproteobacteria;Enterobacterales;Pasteurellaceae;Ursidibacter;";"0.0";"0";"6";"3";"0";"3";"3";"430521";"5766"
"LOK1378_1mm";"SILVA (only NR);Bacteria;Proteobacteria;Gammaproteobacteria;Enterobacterales;Pasteurellaceae;Vespertiliibacter;";"0.0";"0";"2";"2";"0";"2";"0";"430522";"5766"
"LOK1378_1mm";"SILVA (only NR);Bacteria;Proteobacteria;Gammaproteobacteria;Enterobacterales;Pasteurellaceae;Volucribacter;";"0.0";"0";"5";"4";"0";"4";"1";"430520";"5766"
"LOK1378_1mm";"SILVA (only NR);Bacteria;Proteobacteria;Gammaproteobacteria;Enterobacterales;Pasteurellaceae;uncultured;";"0.0";"0";"62";"60";"0";"60";"2";"430464";"5766"
"LOK1378_1mm";"SILVA (only NR);Bacteria;Proteobacteria;Gammaproteobacteria;Enterobacterales;Pectobacteriaceae;";"0.0";"0";"433";"418";"0";"418";"15";"430106";"5766"
"LOK1378_1mm";"SILVA (only NR);Bacteria;Proteobacteria;Gammaproteobacteria;Enterobacterales;Pectobacteriaceae;Biostraticola;";"0.0";"0";"1";"1";"0";"1";"0";"430523";"5766"
"LOK1378_1mm";"SILVA (only NR);Bacteria;Proteobacteria;Gammaproteobacteria;Enterobacterales;Pectobacteriaceae;Brenneria;";"0.0";"0";"25";"24";"0";"24";"1";"430500";"5766"
"LOK1378_1mm";"SILVA (only NR);Bacteria;Proteobacteria;Gammaproteobacteria;Enterobacterales;Pectobacteriaceae;Dickeya;";"0.0";"0";"122";"120";"0";"120";"2";"430404";"5766"
"LOK1378_1mm";"SILVA (only NR);Bacteria;Proteobacteria;Gammaproteobacteria;Enterobacterales;Pectobacteriaceae;Lonsdalea;";"0.0";"0";"16";"15";"0";"15";"1";"430509";"5766"
"LOK1378_1mm";"SILVA (only NR);Bacteria;Proteobacteria;Gammaproteobacteria;Enterobacterales;Pectobacteriaceae;Nissabacter;";"0.0";"0";"2";"2";"0";"2";"0";"430522";"5766"
"LOK1378_1mm";"SILVA (only NR);Bacteria;Proteobacteria;Gammaproteobacteria;Enterobacterales;Pectobacteriaceae;Pectobacterium;";"0.0";"0";"183";"175";"0";"175";"8";"430349";"5766"
"LOK1378_1mm";"SILVA (only NR);Bacteria;Proteobacteria;Gammaproteobacteria;Enterobacterales;Pectobacteriaceae;Sodalis;";"0.0";"0";"79";"76";"0";"76";"3";"430448";"5766"
"LOK1378_1mm";"SILVA (only NR);Bacteria;Proteobacteria;Gammaproteobacteria;Enterobacterales;Pectobacteriaceae;uncultured;";"0.0";"0";"5";"5";"0";"5";"0";"430519";"5766"
"LOK1378_1mm";"SILVA (only NR);Bacteria;Proteobacteria;Gammaproteobacteria;Enterobacterales;Pseudoalteromonadaceae;";"0.0";"0";"892";"849";"0";"849";"43";"429675";"5766"
"LOK1378_1mm";"SILVA (only NR);Bacteria;Proteobacteria;Gammaproteobacteria;Enterobacterales;Pseudoalteromonadaceae;Algicola;";"0.0";"0";"14";"14";"0";"14";"0";"430510";"5766"
"LOK1378_1mm";"SILVA (only NR);Bacteria;Proteobacteria;Gammaproteobacteria;Enterobacterales;Pseudoalteromonadaceae;Pseudoalteromonas;";"0.0";"0";"861";"818";"0";"818";"43";"429706";"5766"
"LOK1378_1mm";"SILVA (only NR);Bacteria;Proteobacteria;Gammaproteobacteria;Enterobacterales;Pseudoalteromonadaceae;Psychrosphaera;";"0.0";"0";"8";"8";"0";"8";"0";"430516";"5766"
"LOK1378_1mm";"SILVA (only NR);Bacteria;Proteobacteria;Gammaproteobacteria;Enterobacterales;Pseudoalteromonadaceae;uncultured;";"0.0";"0";"8";"8";"0";"8";"0";"430516";"5766"
"LOK1378_1mm";"SILVA (only NR);Bacteria;Proteobacteria;Gammaproteobacteria;Enterobacterales;Psychromonadaceae;";"0.0";"0";"116";"115";"0";"115";"1";"430409";"5766"
"LOK1378_1mm";"SILVA (only NR);Bacteria;Proteobacteria;Gammaproteobacteria;Enterobacterales;Psychromonadaceae;Agarivorans;";"0.0";"0";"34";"34";"0";"34";"0";"430490";"5766"
"LOK1378_1mm";"SILVA (only NR);Bacteria;Proteobacteria;Gammaproteobacteria;Enterobacterales;Psychromonadaceae;Aliagarivorans;";"0.0";"0";"2";"2";"0";"2";"0";"430522";"5766"
"LOK1378_1mm";"SILVA (only NR);Bacteria;Proteobacteria;Gammaproteobacteria;Enterobacterales;Psychromonadaceae;Motilimonas;";"0.0";"0";"4";"4";"0";"4";"0";"430520";"5766"
"LOK1378_1mm";"SILVA (only NR);Bacteria;Proteobacteria;Gammaproteobacteria;Enterobacterales;Psychromonadaceae;Psychromonas;";"0.0";"0";"74";"73";"0";"73";"1";"430451";"5766"
"LOK1378_1mm";"SILVA (only NR);Bacteria;Proteobacteria;Gammaproteobacteria;Enterobacterales;Shewanellaceae;";"0.0";"0";"702";"665";"0";"665";"37";"429859";"5766"
"LOK1378_1mm";"SILVA (only NR);Bacteria;Proteobacteria;Gammaproteobacteria;Enterobacterales;Shewanellaceae;Ferrimonas;";"0.0";"0";"38";"38";"0";"38";"0";"430486";"5766"
"LOK1378_1mm";"SILVA (only NR);Bacteria;Proteobacteria;Gammaproteobacteria;Enterobacterales;Shewanellaceae;Psychrobium;";"0.0";"0";"11";"11";"0";"11";"0";"430513";"5766"
"LOK1378_1mm";"SILVA (only NR);Bacteria;Proteobacteria;Gammaproteobacteria;Enterobacterales;Shewanellaceae;Shewanella;";"0.0";"0";"653";"616";"0";"616";"37";"429908";"5766"
"LOK1378_1mm";"SILVA (only NR);Bacteria;Proteobacteria;Gammaproteobacteria;Enterobacterales;Succinivibrionaceae;";"0.0";"0";"281";"277";"0";"277";"4";"430247";"5766"
"LOK1378_1mm";"SILVA (only NR);Bacteria;Proteobacteria;Gammaproteobacteria;Enterobacterales;Succinivibrionaceae;Anaerobiospirillum;";"0.0";"0";"19";"19";"0";"19";"0";"430505";"5766"
"LOK1378_1mm";"SILVA (only NR);Bacteria;Proteobacteria;Gammaproteobacteria;Enterobacterales;Succinivibrionaceae;Ruminobacter;";"0.0";"0";"47";"45";"0";"45";"2";"430479";"5766"
"LOK1378_1mm";"SILVA (only NR);Bacteria;Proteobacteria;Gammaproteobacteria;Enterobacterales;Succinivibrionaceae;Succinatimonas;";"0.0";"0";"9";"9";"0";"9";"0";"430515";"5766"
"LOK1378_1mm";"SILVA (only NR);Bacteria;Proteobacteria;Gammaproteobacteria;Enterobacterales;Succinivibrionaceae;Succinimonas;";"0.0";"0";"12";"12";"0";"12";"0";"430512";"5766"
"LOK1378_1mm";"SILVA (only NR);Bacteria;Proteobacteria;Gammaproteobacteria;Enterobacterales;Succinivibrionaceae;Succinivibrio;";"0.0";"0";"141";"139";"0";"139";"2";"430385";"5766"
"LOK1378_1mm";"SILVA (only NR);Bacteria;Proteobacteria;Gammaproteobacteria;Enterobacterales;Succinivibrionaceae;Succinivibrionaceae UCG-001;";"0.0";"0";"32";"32";"0";"32";"0";"430492";"5766"
"LOK1378_1mm";"SILVA (only NR);Bacteria;Proteobacteria;Gammaproteobacteria;Enterobacterales;Succinivibrionaceae;Succinivibrionaceae UCG-002;";"0.0";"0";"11";"11";"0";"11";"0";"430513";"5766"
"LOK1378_1mm";"SILVA (only NR);Bacteria;Proteobacteria;Gammaproteobacteria;Enterobacterales;Succinivibrionaceae;uncultured;";"0.0";"0";"10";"10";"0";"10";"0";"430514";"5766"
"LOK1378_1mm";"SILVA (only NR);Bacteria;Proteobacteria;Gammaproteobacteria;Enterobacterales;Thorselliaceae;";"0.0";"0";"4";"4";"0";"4";"0";"430520";"5766"
"LOK1378_1mm";"SILVA (only NR);Bacteria;Proteobacteria;Gammaproteobacteria;Enterobacterales;Thorselliaceae;Coetzeea;";"0.0";"0";"1";"1";"0";"1";"0";"430523";"5766"
"LOK1378_1mm";"SILVA (only NR);Bacteria;Proteobacteria;Gammaproteobacteria;Enterobacterales;Thorselliaceae;Thorsellia;";"0.0";"0";"3";"3";"0";"3";"0";"430521";"5766"
"LOK1378_1mm";"SILVA (only NR);Bacteria;Proteobacteria;Gammaproteobacteria;Enterobacterales;Vibrionaceae;";"0.0";"0";"2885";"2748";"0";"2748";"137";"427776";"5766"
"LOK1378_1mm";"SILVA (only NR);Bacteria;Proteobacteria;Gammaproteobacteria;Enterobacterales;Vibrionaceae;Aliivibrio;";"0.0";"0";"81";"79";"0";"79";"2";"430445";"5766"
"LOK1378_1mm";"SILVA (only NR);Bacteria;Proteobacteria;Gammaproteobacteria;Enterobacterales;Vibrionaceae;Candidatus Photodesmus;";"0.0";"0";"3";"3";"0";"3";"0";"430521";"5766"
"LOK1378_1mm";"SILVA (only NR);Bacteria;Proteobacteria;Gammaproteobacteria;Enterobacterales;Vibrionaceae;Catenococcus;";"0.0";"0";"12";"12";"0";"12";"0";"430512";"5766"
"LOK1378_1mm";"SILVA (only NR);Bacteria;Proteobacteria;Gammaproteobacteria;Enterobacterales;Vibrionaceae;Enterovibrio;";"0.0";"0";"26";"25";"0";"25";"1";"430499";"5766"
"LOK1378_1mm";"SILVA (only NR);Bacteria;Proteobacteria;Gammaproteobacteria;Enterobacterales;Vibrionaceae;Grimontia;";"0.0";"0";"24";"24";"0";"24";"0";"430500";"5766"
"LOK1378_1mm";"SILVA (only NR);Bacteria;Proteobacteria;Gammaproteobacteria;Enterobacterales;Vibrionaceae;Photobacterium;";"0.0";"0";"320";"305";"0";"305";"15";"430219";"5766"
"LOK1378_1mm";"SILVA (only NR);Bacteria;Proteobacteria;Gammaproteobacteria;Enterobacterales;Vibrionaceae;Salinivibrio;";"0.0";"0";"98";"89";"0";"89";"9";"430435";"5766"
"LOK1378_1mm";"SILVA (only NR);Bacteria;Proteobacteria;Gammaproteobacteria;Enterobacterales;Vibrionaceae;Thaumasiovibrio;";"0.0";"0";"16";"16";"0";"16";"0";"430508";"5766"
"LOK1378_1mm";"SILVA (only NR);Bacteria;Proteobacteria;Gammaproteobacteria;Enterobacterales;Vibrionaceae;Vibrio;";"0.0";"0";"2295";"2185";"0";"2185";"110";"428339";"5766"
"LOK1378_1mm";"SILVA (only NR);Bacteria;Proteobacteria;Gammaproteobacteria;Enterobacterales;Vibrionaceae;uncultured;";"0.0";"0";"7";"7";"0";"7";"0";"430517";"5766"
"LOK1378_1mm";"SILVA (only NR);Bacteria;Proteobacteria;Gammaproteobacteria;Enterobacterales;Yersiniaceae;";"0.0";"0";"1212";"1164";"0";"1164";"48";"429360";"5766"
"LOK1378_1mm";"SILVA (only NR);Bacteria;Proteobacteria;Gammaproteobacteria;Enterobacterales;Yersiniaceae;Chania;";"0.0";"0";"1";"1";"0";"1";"0";"430523";"5766"
"LOK1378_1mm";"SILVA (only NR);Bacteria;Proteobacteria;Gammaproteobacteria;Enterobacterales;Yersiniaceae;Gibbsiella;";"0.0";"0";"13";"13";"0";"13";"0";"430511";"5766"
"LOK1378_1mm";"SILVA (only NR);Bacteria;Proteobacteria;Gammaproteobacteria;Enterobacterales;Yersiniaceae;Rahnella1;";"0.0";"0";"61";"54";"0";"54";"7";"430470";"5766"
"LOK1378_1mm";"SILVA (only NR);Bacteria;Proteobacteria;Gammaproteobacteria;Enterobacterales;Yersiniaceae;Rahnella;";"0.0";"0";"1";"1";"0";"1";"0";"430523";"5766"
"LOK1378_1mm";"SILVA (only NR);Bacteria;Proteobacteria;Gammaproteobacteria;Enterobacterales;Yersiniaceae;Samsonia;";"0.0";"0";"1";"1";"0";"1";"0";"430523";"5766"
"LOK1378_1mm";"SILVA (only NR);Bacteria;Proteobacteria;Gammaproteobacteria;Enterobacterales;Yersiniaceae;Serratia;";"0.0";"0";"935";"897";"0";"897";"38";"429627";"5766"
"LOK1378_1mm";"SILVA (only NR);Bacteria;Proteobacteria;Gammaproteobacteria;Enterobacterales;Yersiniaceae;Yersinia;";"0.0";"0";"200";"197";"0";"197";"3";"430327";"5766"
"LOK1378_1mm";"SILVA (only NR);Bacteria;Proteobacteria;Gammaproteobacteria;Enterobacterales;uncultured;";"0.0";"0";"15";"15";"0";"15";"0";"430509";"5766"
"LOK1378_1mm";"SILVA (only NR);Bacteria;Proteobacteria;Gammaproteobacteria;F9P41300-M23;";"0.0";"0";"3";"3";"0";"3";"0";"430521";"5766"
"LOK1378_1mm";"SILVA (only NR);Bacteria;Proteobacteria;Gammaproteobacteria;FGL7S;";"0.0";"0";"5";"4";"0";"4";"1";"430520";"5766"
"LOK1378_1mm";"SILVA (only NR);Bacteria;Proteobacteria;Gammaproteobacteria;Francisellales;";"0.0";"0";"149";"148";"0";"148";"1";"430376";"5766"
"LOK1378_1mm";"SILVA (only NR);Bacteria;Proteobacteria;Gammaproteobacteria;Francisellales;Francisellaceae;";"0.0";"0";"149";"148";"0";"148";"1";"430376";"5766"
"LOK1378_1mm";"SILVA (only NR);Bacteria;Proteobacteria;Gammaproteobacteria;Francisellales;Francisellaceae;Allofrancisella;";"0.0";"0";"5";"5";"0";"5";"0";"430519";"5766"
"LOK1378_1mm";"SILVA (only NR);Bacteria;Proteobacteria;Gammaproteobacteria;Francisellales;Francisellaceae;Fangia;";"0.0";"0";"2";"2";"0";"2";"0";"430522";"5766"
"LOK1378_1mm";"SILVA (only NR);Bacteria;Proteobacteria;Gammaproteobacteria;Francisellales;Francisellaceae;Francisella;";"0.0";"0";"112";"111";"0";"111";"1";"430413";"5766"
"LOK1378_1mm";"SILVA (only NR);Bacteria;Proteobacteria;Gammaproteobacteria;Francisellales;Francisellaceae;[Caedibacter] taeniospiralis group;";"0.0";"0";"10";"10";"0";"10";"0";"430514";"5766"
"LOK1378_1mm";"SILVA (only NR);Bacteria;Proteobacteria;Gammaproteobacteria;Francisellales;Francisellaceae;uncultured;";"0.0";"0";"19";"19";"0";"19";"0";"430505";"5766"
"LOK1378_1mm";"SILVA (only NR);Bacteria;Proteobacteria;Gammaproteobacteria;GB102;";"0.0";"0";"2";"2";"0";"2";"0";"430522";"5766"
"LOK1378_1mm";"SILVA (only NR);Bacteria;Proteobacteria;Gammaproteobacteria;Ga0077536;";"0.0";"0";"80";"79";"0";"79";"1";"430445";"5766"
"LOK1378_1mm";"SILVA (only NR);Bacteria;Proteobacteria;Gammaproteobacteria;Gammaproteobacteria Incertae Sedis;";"0.0";"0";"805";"786";"0";"786";"19";"429738";"5766"
"LOK1378_1mm";"SILVA (only NR);Bacteria;Proteobacteria;Gammaproteobacteria;Gammaproteobacteria Incertae Sedis;Unknown Family;";"0.0";"0";"805";"786";"0";"786";"19";"429738";"5766"
"LOK1378_1mm";"SILVA (only NR);Bacteria;Proteobacteria;Gammaproteobacteria;Gammaproteobacteria Incertae Sedis;Unknown Family;Acidibacter;";"0.0";"0";"188";"182";"0";"182";"6";"430342";"5766"
"LOK1378_1mm";"SILVA (only NR);Bacteria;Proteobacteria;Gammaproteobacteria;Gammaproteobacteria Incertae Sedis;Unknown Family;Candidatus Berkiella;";"0.0";"0";"52";"48";"0";"48";"4";"430476";"5766"
"LOK1378_1mm";"SILVA (only NR);Bacteria;Proteobacteria;Gammaproteobacteria;Gammaproteobacteria Incertae Sedis;Unknown Family;Candidatus Carsonella;";"0.0";"0";"33";"33";"0";"33";"0";"430491";"5766"
"LOK1378_1mm";"SILVA (only NR);Bacteria;Proteobacteria;Gammaproteobacteria;Gammaproteobacteria Incertae Sedis;Unknown Family;Candidatus Endonucleariobacter;";"0.0";"0";"3";"3";"0";"3";"0";"430521";"5766"
"LOK1378_1mm";"SILVA (only NR);Bacteria;Proteobacteria;Gammaproteobacteria;Gammaproteobacteria Incertae Sedis;Unknown Family;Candidatus Ovatusbacter;";"0.0";"0";"37";"34";"0";"34";"3";"430490";"5766"
"LOK1378_1mm";"SILVA (only NR);Bacteria;Proteobacteria;Gammaproteobacteria;Gammaproteobacteria Incertae Sedis;Unknown Family;Endothiovibrio;";"0.0";"0";"3";"3";"0";"3";"0";"430521";"5766"
"LOK1378_1mm";"SILVA (only NR);Bacteria;Proteobacteria;Gammaproteobacteria;Gammaproteobacteria Incertae Sedis;Unknown Family;Marinicella;";"0.0";"0";"55";"54";"0";"54";"1";"430470";"5766"
"LOK1378_1mm";"SILVA (only NR);Bacteria;Proteobacteria;Gammaproteobacteria;Gammaproteobacteria Incertae Sedis;Unknown Family;Sulfuriflexus;";"0.0";"0";"2";"2";"0";"2";"0";"430522";"5766"
"LOK1378_1mm";"SILVA (only NR);Bacteria;Proteobacteria;Gammaproteobacteria;Gammaproteobacteria Incertae Sedis;Unknown Family;Wenzhouxiangella;";"0.0";"0";"24";"24";"0";"24";"0";"430500";"5766"
"LOK1378_1mm";"SILVA (only NR);Bacteria;Proteobacteria;Gammaproteobacteria;Gammaproteobacteria Incertae Sedis;Unknown Family;uncultured;";"0.0";"0";"347";"345";"0";"345";"2";"430179";"5766"
"LOK1378_1mm";"SILVA (only NR);Bacteria;Proteobacteria;Gammaproteobacteria;Granulosicoccales;";"0.0";"0";"61";"60";"0";"60";"1";"430464";"5766"
"LOK1378_1mm";"SILVA (only NR);Bacteria;Proteobacteria;Gammaproteobacteria;Granulosicoccales;Granulosicoccaceae;";"0.0";"0";"39";"38";"0";"38";"1";"430486";"5766"
"LOK1378_1mm";"SILVA (only NR);Bacteria;Proteobacteria;Gammaproteobacteria;Granulosicoccales;Granulosicoccaceae;Granulosicoccus;";"0.0";"0";"39";"38";"0";"38";"1";"430486";"5766"
"LOK1378_1mm";"SILVA (only NR);Bacteria;Proteobacteria;Gammaproteobacteria;Granulosicoccales;Methylohalomonas;";"0.0";"0";"6";"6";"0";"6";"0";"430518";"5766"
"LOK1378_1mm";"SILVA (only NR);Bacteria;Proteobacteria;Gammaproteobacteria;Granulosicoccales;uncultured;";"0.0";"0";"16";"16";"0";"16";"0";"430508";"5766"
"LOK1378_1mm";"SILVA (only NR);Bacteria;Proteobacteria;Gammaproteobacteria;HOC36;";"0.0";"0";"147";"145";"0";"145";"2";"430379";"5766"
"LOK1378_1mm";"SILVA (only NR);Bacteria;Proteobacteria;Gammaproteobacteria;Halothiobacillales;";"0.0";"0";"165";"159";"0";"159";"6";"430365";"5766"
"LOK1378_1mm";"SILVA (only NR);Bacteria;Proteobacteria;Gammaproteobacteria;Halothiobacillales;Halothiobacillaceae;";"0.0";"0";"142";"137";"0";"137";"5";"430387";"5766"
"LOK1378_1mm";"SILVA (only NR);Bacteria;Proteobacteria;Gammaproteobacteria;Halothiobacillales;Halothiobacillaceae;Halothiobacillus;";"0.0";"0";"33";"32";"0";"32";"1";"430492";"5766"
"LOK1378_1mm";"SILVA (only NR);Bacteria;Proteobacteria;Gammaproteobacteria;Halothiobacillales;Halothiobacillaceae;Thiofaba;";"0.0";"0";"22";"19";"0";"19";"3";"430505";"5766"
"LOK1378_1mm";"SILVA (only NR);Bacteria;Proteobacteria;Gammaproteobacteria;Halothiobacillales;Halothiobacillaceae;Thiovirga;";"0.0";"0";"47";"46";"0";"46";"1";"430478";"5766"
"LOK1378_1mm";"SILVA (only NR);Bacteria;Proteobacteria;Gammaproteobacteria;Halothiobacillales;Halothiobacillaceae;uncultured;";"0.0";"0";"40";"40";"0";"40";"0";"430484";"5766"
"LOK1378_1mm";"SILVA (only NR);Bacteria;Proteobacteria;Gammaproteobacteria;Halothiobacillales;Thioalkalibacteraceae;";"0.0";"0";"23";"22";"0";"22";"1";"430502";"5766"
"LOK1378_1mm";"SILVA (only NR);Bacteria;Proteobacteria;Gammaproteobacteria;Halothiobacillales;Thioalkalibacteraceae;Guyparkeria;";"0.0";"0";"20";"19";"0";"19";"1";"430505";"5766"
"LOK1378_1mm";"SILVA (only NR);Bacteria;Proteobacteria;Gammaproteobacteria;Halothiobacillales;Thioalkalibacteraceae;Thioalkalibacter;";"0.0";"0";"3";"3";"0";"3";"0";"430521";"5766"
"LOK1378_1mm";"SILVA (only NR);Bacteria;Proteobacteria;Gammaproteobacteria;HgCo23;";"0.0";"0";"6";"6";"0";"6";"0";"430518";"5766"
"LOK1378_1mm";"SILVA (only NR);Bacteria;Proteobacteria;Gammaproteobacteria;HglApr721;";"0.0";"0";"5";"5";"0";"5";"0";"430519";"5766"
"LOK1378_1mm";"SILVA (only NR);Bacteria;Proteobacteria;Gammaproteobacteria;I3A;";"0.0";"0";"8";"8";"0";"8";"0";"430516";"5766"
"LOK1378_1mm";"SILVA (only NR);Bacteria;Proteobacteria;Gammaproteobacteria;Immundisolibacterales;";"0.0";"0";"70";"66";"0";"66";"4";"430458";"5766"
"LOK1378_1mm";"SILVA (only NR);Bacteria;Proteobacteria;Gammaproteobacteria;Immundisolibacterales;Immundisolibacteraceae;";"0.0";"0";"70";"66";"0";"66";"4";"430458";"5766"
"LOK1378_1mm";"SILVA (only NR);Bacteria;Proteobacteria;Gammaproteobacteria;Immundisolibacterales;Immundisolibacteraceae;Immundisolibacter;";"0.0";"0";"41";"41";"0";"41";"0";"430483";"5766"
"LOK1378_1mm";"SILVA (only NR);Bacteria;Proteobacteria;Gammaproteobacteria;Immundisolibacterales;Immundisolibacteraceae;uncultured;";"0.0";"0";"27";"23";"0";"23";"4";"430501";"5766"
"LOK1378_1mm";"SILVA (only NR);Bacteria;Proteobacteria;Gammaproteobacteria;JG36-GS-52;";"0.0";"0";"13";"13";"0";"13";"0";"430511";"5766"
"LOK1378_1mm";"SILVA (only NR);Bacteria;Proteobacteria;Gammaproteobacteria;JG36-TzT-191;";"0.0";"0";"25";"21";"0";"21";"4";"430503";"5766"
"LOK1378_1mm";"SILVA (only NR);Bacteria;Proteobacteria;Gammaproteobacteria;JTB23;";"0.0";"0";"86";"84";"0";"84";"2";"430440";"5766"
"LOK1378_1mm";"SILVA (only NR);Bacteria;Proteobacteria;Gammaproteobacteria;KF-JG30-C25;";"0.0";"0";"41";"39";"0";"39";"2";"430485";"5766"
"LOK1378_1mm";"SILVA (only NR);Bacteria;Proteobacteria;Gammaproteobacteria;Legionellales;";"0.0";"0";"628";"610";"0";"610";"18";"429914";"5766"
"LOK1378_1mm";"SILVA (only NR);Bacteria;Proteobacteria;Gammaproteobacteria;Legionellales;Legionellaceae;";"0.0";"0";"628";"610";"0";"610";"18";"429914";"5766"
"LOK1378_1mm";"SILVA (only NR);Bacteria;Proteobacteria;Gammaproteobacteria;Legionellales;Legionellaceae;Legionella;";"0.0";"0";"566";"550";"0";"550";"16";"429974";"5766"
"LOK1378_1mm";"SILVA (only NR);Bacteria;Proteobacteria;Gammaproteobacteria;Legionellales;Legionellaceae;uncultured;";"0.0";"0";"61";"59";"0";"59";"2";"430465";"5766"
"LOK1378_1mm";"SILVA (only NR);Bacteria;Proteobacteria;Gammaproteobacteria;MBMPE27;";"0.0";"0";"45";"44";"0";"44";"1";"430480";"5766"
"LOK1378_1mm";"SILVA (only NR);Bacteria;Proteobacteria;Gammaproteobacteria;MD2904-B13;";"0.0";"0";"8";"8";"0";"8";"0";"430516";"5766"
"LOK1378_1mm";"SILVA (only NR);Bacteria;Proteobacteria;Gammaproteobacteria;Methylococcales;";"0.0";"0";"675";"614";"0";"614";"61";"429910";"5766"
"LOK1378_1mm";"SILVA (only NR);Bacteria;Proteobacteria;Gammaproteobacteria;Methylococcales;Cycloclasticaceae;";"0.0";"0";"28";"27";"0";"27";"1";"430497";"5766"
"LOK1378_1mm";"SILVA (only NR);Bacteria;Proteobacteria;Gammaproteobacteria;Methylococcales;Cycloclasticaceae;Cycloclasticus;";"0.0";"0";"28";"27";"0";"27";"1";"430497";"5766"
"LOK1378_1mm";"SILVA (only NR);Bacteria;Proteobacteria;Gammaproteobacteria;Methylococcales;Methylococcaceae;";"0.0";"0";"107";"81";"0";"81";"26";"430443";"5766"
"LOK1378_1mm";"SILVA (only NR);Bacteria;Proteobacteria;Gammaproteobacteria;Methylococcales;Methylococcaceae;Candidatus Methylospira;";"0.0";"0";"6";"6";"0";"6";"0";"430518";"5766"
"LOK1378_1mm";"SILVA (only NR);Bacteria;Proteobacteria;Gammaproteobacteria;Methylococcales;Methylococcaceae;Methylocaldum;";"0.0";"0";"20";"18";"0";"18";"2";"430506";"5766"
"LOK1378_1mm";"SILVA (only NR);Bacteria;Proteobacteria;Gammaproteobacteria;Methylococcales;Methylococcaceae;Methylococcus;";"0.0";"0";"18";"17";"0";"17";"1";"430507";"5766"
"LOK1378_1mm";"SILVA (only NR);Bacteria;Proteobacteria;Gammaproteobacteria;Methylococcales;Methylococcaceae;Methylogaea;";"0.0";"0";"1";"1";"0";"1";"0";"430523";"5766"
"LOK1378_1mm";"SILVA (only NR);Bacteria;Proteobacteria;Gammaproteobacteria;Methylococcales;Methylococcaceae;Methylomagnum;";"0.0";"0";"4";"4";"0";"4";"0";"430520";"5766"
"LOK1378_1mm";"SILVA (only NR);Bacteria;Proteobacteria;Gammaproteobacteria;Methylococcales;Methylococcaceae;Methyloparacoccus;";"0.0";"0";"14";"13";"0";"13";"1";"430511";"5766"
"LOK1378_1mm";"SILVA (only NR);Bacteria;Proteobacteria;Gammaproteobacteria;Methylococcales;Methylococcaceae;Methyloterricola;";"0.0";"0";"1";"1";"0";"1";"0";"430523";"5766"
"LOK1378_1mm";"SILVA (only NR);Bacteria;Proteobacteria;Gammaproteobacteria;Methylococcales;Methylococcaceae;uncultured;";"0.0";"0";"35";"14";"0";"14";"21";"430510";"5766"
"LOK1378_1mm";"SILVA (only NR);Bacteria;Proteobacteria;Gammaproteobacteria;Methylococcales;Methylohalobiaceae;";"0.0";"0";"12";"12";"0";"12";"0";"430512";"5766"
"LOK1378_1mm";"SILVA (only NR);Bacteria;Proteobacteria;Gammaproteobacteria;Methylococcales;Methylohalobiaceae;Methylohalobius;";"0.0";"0";"4";"4";"0";"4";"0";"430520";"5766"
"LOK1378_1mm";"SILVA (only NR);Bacteria;Proteobacteria;Gammaproteobacteria;Methylococcales;Methylohalobiaceae;Methylomarinovum;";"0.0";"0";"3";"3";"0";"3";"0";"430521";"5766"
"LOK1378_1mm";"SILVA (only NR);Bacteria;Proteobacteria;Gammaproteobacteria;Methylococcales;Methylohalobiaceae;Methylothermus;";"0.0";"0";"5";"5";"0";"5";"0";"430519";"5766"
"LOK1378_1mm";"SILVA (only NR);Bacteria;Proteobacteria;Gammaproteobacteria;Methylococcales;Methylomonadaceae;";"0.0";"0";"528";"494";"0";"494";"34";"430030";"5766"
"LOK1378_1mm";"SILVA (only NR);Bacteria;Proteobacteria;Gammaproteobacteria;Methylococcales;Methylomonadaceae;Crenothrix;";"0.0";"0";"64";"63";"0";"63";"1";"430461";"5766"
"LOK1378_1mm";"SILVA (only NR);Bacteria;Proteobacteria;Gammaproteobacteria;Methylococcales;Methylomonadaceae;ET-SHO;";"0.0";"0";"7";"7";"0";"7";"0";"430517";"5766"
"LOK1378_1mm";"SILVA (only NR);Bacteria;Proteobacteria;Gammaproteobacteria;Methylococcales;Methylomonadaceae;IheB2-23;";"0.0";"0";"19";"18";"0";"18";"1";"430506";"5766"
"LOK1378_1mm";"SILVA (only NR);Bacteria;Proteobacteria;Gammaproteobacteria;Methylococcales;Methylomonadaceae;Marine Methylotrophic Group 2;";"0.0";"0";"71";"68";"0";"68";"3";"430456";"5766"
"LOK1378_1mm";"SILVA (only NR);Bacteria;Proteobacteria;Gammaproteobacteria;Methylococcales;Methylomonadaceae;Methylobacter;";"0.0";"0";"55";"52";"0";"52";"3";"430472";"5766"
"LOK1378_1mm";"SILVA (only NR);Bacteria;Proteobacteria;Gammaproteobacteria;Methylococcales;Methylomonadaceae;Methyloglobulus;";"0.0";"0";"13";"11";"0";"11";"2";"430513";"5766"
"LOK1378_1mm";"SILVA (only NR);Bacteria;Proteobacteria;Gammaproteobacteria;Methylococcales;Methylomonadaceae;Methylomarinum;";"0.0";"0";"9";"7";"0";"7";"2";"430517";"5766"
"LOK1378_1mm";"SILVA (only NR);Bacteria;Proteobacteria;Gammaproteobacteria;Methylococcales;Methylomonadaceae;Methylomicrobium;";"0.0";"0";"31";"30";"0";"30";"1";"430494";"5766"
"LOK1378_1mm";"SILVA (only NR);Bacteria;Proteobacteria;Gammaproteobacteria;Methylococcales;Methylomonadaceae;Methylomonas;";"0.0";"0";"83";"74";"0";"74";"9";"430450";"5766"
"LOK1378_1mm";"SILVA (only NR);Bacteria;Proteobacteria;Gammaproteobacteria;Methylococcales;Methylomonadaceae;Methyloprofundus;";"0.0";"0";"55";"51";"0";"51";"4";"430473";"5766"
"LOK1378_1mm";"SILVA (only NR);Bacteria;Proteobacteria;Gammaproteobacteria;Methylococcales;Methylomonadaceae;Methylosarcina;";"0.0";"0";"9";"9";"0";"9";"0";"430515";"5766"
"LOK1378_1mm";"SILVA (only NR);Bacteria;Proteobacteria;Gammaproteobacteria;Methylococcales;Methylomonadaceae;Methylosoma;";"0.0";"0";"1";"1";"0";"1";"0";"430523";"5766"
"LOK1378_1mm";"SILVA (only NR);Bacteria;Proteobacteria;Gammaproteobacteria;Methylococcales;Methylomonadaceae;Methylosphaera;";"0.0";"0";"1";"1";"0";"1";"0";"430523";"5766"
"LOK1378_1mm";"SILVA (only NR);Bacteria;Proteobacteria;Gammaproteobacteria;Methylococcales;Methylomonadaceae;Methylovulum;";"0.0";"0";"19";"13";"0";"13";"6";"430511";"5766"
"LOK1378_1mm";"SILVA (only NR);Bacteria;Proteobacteria;Gammaproteobacteria;Methylococcales;Methylomonadaceae;Milano-WF1B-03;";"0.0";"0";"38";"38";"0";"38";"0";"430486";"5766"
"LOK1378_1mm";"SILVA (only NR);Bacteria;Proteobacteria;Gammaproteobacteria;Methylococcales;Methylomonadaceae;Milano-WF1B-42;";"0.0";"0";"3";"2";"0";"2";"1";"430522";"5766"
"LOK1378_1mm";"SILVA (only NR);Bacteria;Proteobacteria;Gammaproteobacteria;Methylococcales;Methylomonadaceae;pItb-vmat-59;";"0.0";"0";"10";"10";"0";"10";"0";"430514";"5766"
"LOK1378_1mm";"SILVA (only NR);Bacteria;Proteobacteria;Gammaproteobacteria;Methylococcales;Methylomonadaceae;pLW-20;";"0.0";"0";"21";"21";"0";"21";"0";"430503";"5766"
"LOK1378_1mm";"SILVA (only NR);Bacteria;Proteobacteria;Gammaproteobacteria;Methylococcales;Methylomonadaceae;uncultured;";"0.0";"0";"19";"18";"0";"18";"1";"430506";"5766"
"LOK1378_1mm";"SILVA (only NR);Bacteria;Proteobacteria;Gammaproteobacteria;Milano-WF1B-44;";"0.0";"0";"21";"19";"0";"19";"2";"430505";"5766"
"LOK1378_1mm";"SILVA (only NR);Bacteria;Proteobacteria;Gammaproteobacteria;NKB5;";"0.0";"0";"2";"2";"0";"2";"0";"430522";"5766"
"LOK1378_1mm";"SILVA (only NR);Bacteria;Proteobacteria;Gammaproteobacteria;Nitrococcales;";"0.0";"0";"138";"137";"0";"137";"1";"430387";"5766"
"LOK1378_1mm";"SILVA (only NR);Bacteria;Proteobacteria;Gammaproteobacteria;Nitrococcales;Halorhodospiraceae;";"0.0";"0";"61";"61";"0";"61";"0";"430463";"5766"
"LOK1378_1mm";"SILVA (only NR);Bacteria;Proteobacteria;Gammaproteobacteria;Nitrococcales;Halorhodospiraceae;Alkalilimnicola;";"0.0";"0";"3";"3";"0";"3";"0";"430521";"5766"
"LOK1378_1mm";"SILVA (only NR);Bacteria;Proteobacteria;Gammaproteobacteria;Nitrococcales;Halorhodospiraceae;Alkalispirillum;";"0.0";"0";"2";"2";"0";"2";"0";"430522";"5766"
"LOK1378_1mm";"SILVA (only NR);Bacteria;Proteobacteria;Gammaproteobacteria;Nitrococcales;Halorhodospiraceae;Halorhodospira;";"0.0";"0";"46";"46";"0";"46";"0";"430478";"5766"
"LOK1378_1mm";"SILVA (only NR);Bacteria;Proteobacteria;Gammaproteobacteria;Nitrococcales;Halorhodospiraceae;Sulfurivirga;";"0.0";"0";"6";"6";"0";"6";"0";"430518";"5766"
"LOK1378_1mm";"SILVA (only NR);Bacteria;Proteobacteria;Gammaproteobacteria;Nitrococcales;Halorhodospiraceae;uncultured;";"0.0";"0";"2";"2";"0";"2";"0";"430522";"5766"
"LOK1378_1mm";"SILVA (only NR);Bacteria;Proteobacteria;Gammaproteobacteria;Nitrococcales;Nitrococcaceae;";"0.0";"0";"66";"65";"0";"65";"1";"430459";"5766"
"LOK1378_1mm";"SILVA (only NR);Bacteria;Proteobacteria;Gammaproteobacteria;Nitrococcales;Nitrococcaceae;Aquisalimonas;";"0.0";"0";"10";"10";"0";"10";"0";"430514";"5766"
"LOK1378_1mm";"SILVA (only NR);Bacteria;Proteobacteria;Gammaproteobacteria;Nitrococcales;Nitrococcaceae;Arhodomonas;";"0.0";"0";"4";"4";"0";"4";"0";"430520";"5766"
"LOK1378_1mm";"SILVA (only NR);Bacteria;Proteobacteria;Gammaproteobacteria;Nitrococcales;Nitrococcaceae;Halopeptonella;";"0.0";"0";"18";"18";"0";"18";"0";"430506";"5766"
"LOK1378_1mm";"SILVA (only NR);Bacteria;Proteobacteria;Gammaproteobacteria;Nitrococcales;Nitrococcaceae;Nitrococcus;";"0.0";"0";"7";"7";"0";"7";"0";"430517";"5766"
"LOK1378_1mm";"SILVA (only NR);Bacteria;Proteobacteria;Gammaproteobacteria;Nitrococcales;Nitrococcaceae;Spiribacter;";"0.0";"0";"16";"15";"0";"15";"1";"430509";"5766"
"LOK1378_1mm";"SILVA (only NR);Bacteria;Proteobacteria;Gammaproteobacteria;Nitrococcales;Nitrococcaceae;uncultured;";"0.0";"0";"10";"10";"0";"10";"0";"430514";"5766"
"LOK1378_1mm";"SILVA (only NR);Bacteria;Proteobacteria;Gammaproteobacteria;Nitrococcales;Nitrococcales Incertae Sedis;";"0.0";"0";"11";"11";"0";"11";"0";"430513";"5766"
"LOK1378_1mm";"SILVA (only NR);Bacteria;Proteobacteria;Gammaproteobacteria;Nitrococcales;Nitrococcales Incertae Sedis;Methylonatrum;";"0.0";"0";"10";"10";"0";"10";"0";"430514";"5766"
"LOK1378_1mm";"SILVA (only NR);Bacteria;Proteobacteria;Gammaproteobacteria;Nitrococcales;Nitrococcales Incertae Sedis;Natronocella;";"0.0";"0";"1";"1";"0";"1";"0";"430523";"5766"
"LOK1378_1mm";"SILVA (only NR);Bacteria;Proteobacteria;Gammaproteobacteria;Nitrosococcales;";"0.0";"0";"424";"412";"0";"412";"12";"430112";"5766"
"LOK1378_1mm";"SILVA (only NR);Bacteria;Proteobacteria;Gammaproteobacteria;Nitrosococcales;Methylophagaceae;";"0.0";"0";"209";"203";"0";"203";"6";"430321";"5766"
"LOK1378_1mm";"SILVA (only NR);Bacteria;Proteobacteria;Gammaproteobacteria;Nitrosococcales;Methylophagaceae;Marine Methylotrophic Group 3;";"0.0";"0";"40";"39";"0";"39";"1";"430485";"5766"
"LOK1378_1mm";"SILVA (only NR);Bacteria;Proteobacteria;Gammaproteobacteria;Nitrosococcales;Methylophagaceae;Methylophaga;";"0.0";"0";"122";"117";"0";"117";"5";"430407";"5766"
"LOK1378_1mm";"SILVA (only NR);Bacteria;Proteobacteria;Gammaproteobacteria;Nitrosococcales;Methylophagaceae;uncultured;";"0.0";"0";"46";"46";"0";"46";"0";"430478";"5766"
"LOK1378_1mm";"SILVA (only NR);Bacteria;Proteobacteria;Gammaproteobacteria;Nitrosococcales;Nitrosococcaceae;";"0.0";"0";"215";"209";"0";"209";"6";"430315";"5766"
"LOK1378_1mm";"SILVA (only NR);Bacteria;Proteobacteria;Gammaproteobacteria;Nitrosococcales;Nitrosococcaceae;3PJM14;";"0.0";"0";"5";"5";"0";"5";"0";"430519";"5766"
"LOK1378_1mm";"SILVA (only NR);Bacteria;Proteobacteria;Gammaproteobacteria;Nitrosococcales;Nitrosococcaceae;AqS1;";"0.0";"0";"70";"69";"0";"69";"1";"430455";"5766"
"LOK1378_1mm";"SILVA (only NR);Bacteria;Proteobacteria;Gammaproteobacteria;Nitrosococcales;Nitrosococcaceae;CI75cm.2.12;";"0.0";"0";"12";"12";"0";"12";"0";"430512";"5766"
"LOK1378_1mm";"SILVA (only NR);Bacteria;Proteobacteria;Gammaproteobacteria;Nitrosococcales;Nitrosococcaceae;Candidatus Nitrosoglobus;";"0.0";"0";"3";"3";"0";"3";"0";"430521";"5766"
"LOK1378_1mm";"SILVA (only NR);Bacteria;Proteobacteria;Gammaproteobacteria;Nitrosococcales;Nitrosococcaceae;Cm1-21;";"0.0";"0";"19";"19";"0";"19";"0";"430505";"5766"
"LOK1378_1mm";"SILVA (only NR);Bacteria;Proteobacteria;Gammaproteobacteria;Nitrosococcales;Nitrosococcaceae;FS142-36B-02;";"0.0";"0";"14";"14";"0";"14";"0";"430510";"5766"
"LOK1378_1mm";"SILVA (only NR);Bacteria;Proteobacteria;Gammaproteobacteria;Nitrosococcales;Nitrosococcaceae;Inmirania;";"0.0";"0";"7";"7";"0";"7";"0";"430517";"5766"
"LOK1378_1mm";"SILVA (only NR);Bacteria;Proteobacteria;Gammaproteobacteria;Nitrosococcales;Nitrosococcaceae;MSB-1D1;";"0.0";"0";"6";"6";"0";"6";"0";"430518";"5766"
"LOK1378_1mm";"SILVA (only NR);Bacteria;Proteobacteria;Gammaproteobacteria;Nitrosococcales;Nitrosococcaceae;Nitrosococcus;";"0.0";"0";"12";"11";"0";"11";"1";"430513";"5766"
"LOK1378_1mm";"SILVA (only NR);Bacteria;Proteobacteria;Gammaproteobacteria;Nitrosococcales;Nitrosococcaceae;SZB85;";"0.0";"0";"13";"13";"0";"13";"0";"430511";"5766"
"LOK1378_1mm";"SILVA (only NR);Bacteria;Proteobacteria;Gammaproteobacteria;Nitrosococcales;Nitrosococcaceae;wb1-P19;";"0.0";"0";"54";"50";"0";"50";"4";"430474";"5766"
"LOK1378_1mm";"SILVA (only NR);Bacteria;Proteobacteria;Gammaproteobacteria;P0X4b2H11;";"0.0";"0";"2";"2";"0";"2";"0";"430522";"5766"
"LOK1378_1mm";"SILVA (only NR);Bacteria;Proteobacteria;Gammaproteobacteria;PLTA13;";"0.0";"0";"92";"90";"0";"90";"2";"430434";"5766"
"LOK1378_1mm";"SILVA (only NR);Bacteria;Proteobacteria;Gammaproteobacteria;Piscirickettsiales;";"0.0";"0";"57";"56";"0";"56";"1";"430468";"5766"
"LOK1378_1mm";"SILVA (only NR);Bacteria;Proteobacteria;Gammaproteobacteria;Piscirickettsiales;Piscirickettsiaceae;";"0.0";"0";"57";"56";"0";"56";"1";"430468";"5766"
"LOK1378_1mm";"SILVA (only NR);Bacteria;Proteobacteria;Gammaproteobacteria;Piscirickettsiales;Piscirickettsiaceae;Candidatus Endoecteinascidia;";"0.0";"0";"23";"22";"0";"22";"1";"430502";"5766"
"LOK1378_1mm";"SILVA (only NR);Bacteria;Proteobacteria;Gammaproteobacteria;Piscirickettsiales;Piscirickettsiaceae;Piscirickettsia;";"0.0";"0";"34";"34";"0";"34";"0";"430490";"5766"
"LOK1378_1mm";"SILVA (only NR);Bacteria;Proteobacteria;Gammaproteobacteria;Pseudomonadales;";"0.0";"0";"17709";"16750";"0";"16750";"959";"413774";"5766"
"LOK1378_1mm";"SILVA (only NR);Bacteria;Proteobacteria;Gammaproteobacteria;Pseudomonadales;211ds20;";"0.0";"0";"13";"13";"0";"13";"0";"430511";"5766"
"LOK1378_1mm";"SILVA (only NR);Bacteria;Proteobacteria;Gammaproteobacteria;Pseudomonadales;Alcanivoracaceae1;";"0.0";"0";"323";"301";"0";"301";"22";"430223";"5766"
"LOK1378_1mm";"SILVA (only NR);Bacteria;Proteobacteria;Gammaproteobacteria;Pseudomonadales;Alcanivoracaceae1;Alcanivorax;";"0.0";"0";"323";"301";"0";"301";"22";"430223";"5766"
"LOK1378_1mm";"SILVA (only NR);Bacteria;Proteobacteria;Gammaproteobacteria;Pseudomonadales;Alcanivoracaceae;";"0.0";"0";"39";"38";"0";"38";"1";"430486";"5766"
"LOK1378_1mm";"SILVA (only NR);Bacteria;Proteobacteria;Gammaproteobacteria;Pseudomonadales;Alcanivoracaceae;Ketobacter;";"0.0";"0";"39";"38";"0";"38";"1";"430486";"5766"
"LOK1378_1mm";"SILVA (only NR);Bacteria;Proteobacteria;Gammaproteobacteria;Pseudomonadales;BD2-7;";"0.0";"0";"14";"14";"0";"14";"0";"430510";"5766"
"LOK1378_1mm";"SILVA (only NR);Bacteria;Proteobacteria;Gammaproteobacteria;Pseudomonadales;Cellvibrionaceae;";"0.0";"0";"326";"314";"0";"314";"12";"430210";"5766"
"LOK1378_1mm";"SILVA (only NR);Bacteria;Proteobacteria;Gammaproteobacteria;Pseudomonadales;Cellvibrionaceae;Aestuariicella;";"0.0";"0";"17";"17";"0";"17";"0";"430507";"5766"
"LOK1378_1mm";"SILVA (only NR);Bacteria;Proteobacteria;Gammaproteobacteria;Pseudomonadales;Cellvibrionaceae;Agaribacterium;";"0.0";"0";"7";"6";"0";"6";"1";"430518";"5766"
"LOK1378_1mm";"SILVA (only NR);Bacteria;Proteobacteria;Gammaproteobacteria;Pseudomonadales;Cellvibrionaceae;Agarilytica;";"0.0";"0";"6";"6";"0";"6";"0";"430518";"5766"
"LOK1378_1mm";"SILVA (only NR);Bacteria;Proteobacteria;Gammaproteobacteria;Pseudomonadales;Cellvibrionaceae;Candidatus Endobugula;";"0.0";"0";"6";"6";"0";"6";"0";"430518";"5766"
"LOK1378_1mm";"SILVA (only NR);Bacteria;Proteobacteria;Gammaproteobacteria;Pseudomonadales;Cellvibrionaceae;Cellvibrio;";"0.0";"0";"100";"98";"0";"98";"2";"430426";"5766"
"LOK1378_1mm";"SILVA (only NR);Bacteria;Proteobacteria;Gammaproteobacteria;Pseudomonadales;Cellvibrionaceae;Eionea;";"0.0";"0";"4";"4";"0";"4";"0";"430520";"5766"
"LOK1378_1mm";"SILVA (only NR);Bacteria;Proteobacteria;Gammaproteobacteria;Pseudomonadales;Cellvibrionaceae;Gilvimarinus;";"0.0";"0";"16";"16";"0";"16";"0";"430508";"5766"
"LOK1378_1mm";"SILVA (only NR);Bacteria;Proteobacteria;Gammaproteobacteria;Pseudomonadales;Cellvibrionaceae;Halioxenophilus;";"0.0";"0";"3";"3";"0";"3";"0";"430521";"5766"
"LOK1378_1mm";"SILVA (only NR);Bacteria;Proteobacteria;Gammaproteobacteria;Pseudomonadales;Cellvibrionaceae;Maricurvus;";"0.0";"0";"2";"2";"0";"2";"0";"430522";"5766"
"LOK1378_1mm";"SILVA (only NR);Bacteria;Proteobacteria;Gammaproteobacteria;Pseudomonadales;Cellvibrionaceae;Marinagarivorans;";"0.0";"0";"4";"4";"0";"4";"0";"430520";"5766"
"LOK1378_1mm";"SILVA (only NR);Bacteria;Proteobacteria;Gammaproteobacteria;Pseudomonadales;Cellvibrionaceae;Marinibactrum;";"0.0";"0";"1";"1";"0";"1";"0";"430523";"5766"
"LOK1378_1mm";"SILVA (only NR);Bacteria;Proteobacteria;Gammaproteobacteria;Pseudomonadales;Cellvibrionaceae;Marinimicrobium;";"0.0";"0";"40";"39";"0";"39";"1";"430485";"5766"
"LOK1378_1mm";"SILVA (only NR);Bacteria;Proteobacteria;Gammaproteobacteria;Pseudomonadales;Cellvibrionaceae;Pseudomaricurvus;";"0.0";"0";"2";"2";"0";"2";"0";"430522";"5766"
"LOK1378_1mm";"SILVA (only NR);Bacteria;Proteobacteria;Gammaproteobacteria;Pseudomonadales;Cellvibrionaceae;Pseudoteredinibacter;";"0.0";"0";"5";"5";"0";"5";"0";"430519";"5766"
"LOK1378_1mm";"SILVA (only NR);Bacteria;Proteobacteria;Gammaproteobacteria;Pseudomonadales;Cellvibrionaceae;Saccharophagus;";"0.0";"0";"3";"3";"0";"3";"0";"430521";"5766"
"LOK1378_1mm";"SILVA (only NR);Bacteria;Proteobacteria;Gammaproteobacteria;Pseudomonadales;Cellvibrionaceae;Simiduia;";"0.0";"0";"6";"6";"0";"6";"0";"430518";"5766"
"LOK1378_1mm";"SILVA (only NR);Bacteria;Proteobacteria;Gammaproteobacteria;Pseudomonadales;Cellvibrionaceae;Teredinibacter;";"0.0";"0";"4";"4";"0";"4";"0";"430520";"5766"
"LOK1378_1mm";"SILVA (only NR);Bacteria;Proteobacteria;Gammaproteobacteria;Pseudomonadales;Cellvibrionaceae;Umboniibacter;";"0.0";"0";"7";"7";"0";"7";"0";"430517";"5766"
"LOK1378_1mm";"SILVA (only NR);Bacteria;Proteobacteria;Gammaproteobacteria;Pseudomonadales;Cellvibrionaceae;uncultured;";"0.0";"0";"77";"72";"0";"72";"5";"430452";"5766"
"LOK1378_1mm";"SILVA (only NR);Bacteria;Proteobacteria;Gammaproteobacteria;Pseudomonadales;Endozoicomonadaceae;";"0.0";"0";"334";"330";"0";"330";"4";"430194";"5766"
"LOK1378_1mm";"SILVA (only NR);Bacteria;Proteobacteria;Gammaproteobacteria;Pseudomonadales;Endozoicomonadaceae;Endozoicomonas;";"0.0";"0";"320";"316";"0";"316";"4";"430208";"5766"
"LOK1378_1mm";"SILVA (only NR);Bacteria;Proteobacteria;Gammaproteobacteria;Pseudomonadales;Endozoicomonadaceae;Kistimonas;";"0.0";"0";"9";"9";"0";"9";"0";"430515";"5766"
"LOK1378_1mm";"SILVA (only NR);Bacteria;Proteobacteria;Gammaproteobacteria;Pseudomonadales;Endozoicomonadaceae;Zooshikella;";"0.0";"0";"5";"5";"0";"5";"0";"430519";"5766"
"LOK1378_1mm";"SILVA (only NR);Bacteria;Proteobacteria;Gammaproteobacteria;Pseudomonadales;Gven-F17;";"0.0";"0";"3";"3";"0";"3";"0";"430521";"5766"
"LOK1378_1mm";"SILVA (only NR);Bacteria;Proteobacteria;Gammaproteobacteria;Pseudomonadales;Hahellaceae;";"0.0";"0";"27";"27";"0";"27";"0";"430497";"5766"
"LOK1378_1mm";"SILVA (only NR);Bacteria;Proteobacteria;Gammaproteobacteria;Pseudomonadales;Hahellaceae;Hahella;";"0.0";"0";"27";"27";"0";"27";"0";"430497";"5766"
"LOK1378_1mm";"SILVA (only NR);Bacteria;Proteobacteria;Gammaproteobacteria;Pseudomonadales;Halieaceae;";"0.0";"0";"517";"510";"0";"510";"7";"430014";"5766"
"LOK1378_1mm";"SILVA (only NR);Bacteria;Proteobacteria;Gammaproteobacteria;Pseudomonadales;Halieaceae;Chromatocurvus;";"0.0";"0";"2";"2";"0";"2";"0";"430522";"5766"
"LOK1378_1mm";"SILVA (only NR);Bacteria;Proteobacteria;Gammaproteobacteria;Pseudomonadales;Halieaceae;Congregibacter;";"0.0";"0";"9";"9";"0";"9";"0";"430515";"5766"
"LOK1378_1mm";"SILVA (only NR);Bacteria;Proteobacteria;Gammaproteobacteria;Pseudomonadales;Halieaceae;Haliea;";"0.0";"0";"12";"12";"0";"12";"0";"430512";"5766"
"LOK1378_1mm";"SILVA (only NR);Bacteria;Proteobacteria;Gammaproteobacteria;Pseudomonadales;Halieaceae;Halioglobus;";"0.0";"0";"160";"157";"0";"157";"3";"430367";"5766"
"LOK1378_1mm";"SILVA (only NR);Bacteria;Proteobacteria;Gammaproteobacteria;Pseudomonadales;Halieaceae;Luminiphilus;";"0.0";"0";"29";"29";"0";"29";"0";"430495";"5766"
"LOK1378_1mm";"SILVA (only NR);Bacteria;Proteobacteria;Gammaproteobacteria;Pseudomonadales;Halieaceae;Marimicrobium;";"0.0";"0";"8";"8";"0";"8";"0";"430516";"5766"
"LOK1378_1mm";"SILVA (only NR);Bacteria;Proteobacteria;Gammaproteobacteria;Pseudomonadales;Halieaceae;OM60(NOR5) clade;";"0.0";"0";"211";"209";"0";"209";"2";"430315";"5766"
"LOK1378_1mm";"SILVA (only NR);Bacteria;Proteobacteria;Gammaproteobacteria;Pseudomonadales;Halieaceae;Parahaliea;";"0.0";"0";"25";"25";"0";"25";"0";"430499";"5766"
"LOK1378_1mm";"SILVA (only NR);Bacteria;Proteobacteria;Gammaproteobacteria;Pseudomonadales;Halieaceae;Pseudohaliea;";"0.0";"0";"56";"54";"0";"54";"2";"430470";"5766"
"LOK1378_1mm";"SILVA (only NR);Bacteria;Proteobacteria;Gammaproteobacteria;Pseudomonadales;Halomonadaceae;";"0.0";"0";"1697";"1563";"0";"1563";"134";"428961";"5766"
"LOK1378_1mm";"SILVA (only NR);Bacteria;Proteobacteria;Gammaproteobacteria;Pseudomonadales;Halomonadaceae;Aidingimonas;";"0.0";"0";"6";"4";"0";"4";"2";"430520";"5766"
"LOK1378_1mm";"SILVA (only NR);Bacteria;Proteobacteria;Gammaproteobacteria;Pseudomonadales;Halomonadaceae;Candidatus Evansia;";"0.0";"0";"9";"9";"0";"9";"0";"430515";"5766"
"LOK1378_1mm";"SILVA (only NR);Bacteria;Proteobacteria;Gammaproteobacteria;Pseudomonadales;Halomonadaceae;Candidatus Portiera;";"0.0";"0";"41";"41";"0";"41";"0";"430483";"5766"
"LOK1378_1mm";"SILVA (only NR);Bacteria;Proteobacteria;Gammaproteobacteria;Pseudomonadales;Halomonadaceae;Carnimonas;";"0.0";"0";"14";"14";"0";"14";"0";"430510";"5766"
"LOK1378_1mm";"SILVA (only NR);Bacteria;Proteobacteria;Gammaproteobacteria;Pseudomonadales;Halomonadaceae;Chromohalobacter;";"0.0";"0";"65";"59";"0";"59";"6";"430465";"5766"
"LOK1378_1mm";"SILVA (only NR);Bacteria;Proteobacteria;Gammaproteobacteria;Pseudomonadales;Halomonadaceae;Cobetia;";"0.0";"0";"73";"63";"0";"63";"10";"430461";"5766"
"LOK1378_1mm";"SILVA (only NR);Bacteria;Proteobacteria;Gammaproteobacteria;Pseudomonadales;Halomonadaceae;Halomonas;";"0.0";"0";"1246";"1138";"0";"1138";"108";"429386";"5766"
"LOK1378_1mm";"SILVA (only NR);Bacteria;Proteobacteria;Gammaproteobacteria;Pseudomonadales;Halomonadaceae;Halospina;";"0.0";"0";"6";"6";"0";"6";"0";"430518";"5766"
"LOK1378_1mm";"SILVA (only NR);Bacteria;Proteobacteria;Gammaproteobacteria;Pseudomonadales;Halomonadaceae;Halotalea;";"0.0";"0";"2";"2";"0";"2";"0";"430522";"5766"
"LOK1378_1mm";"SILVA (only NR);Bacteria;Proteobacteria;Gammaproteobacteria;Pseudomonadales;Halomonadaceae;Halovibrio;";"0.0";"0";"7";"7";"0";"7";"0";"430517";"5766"
"LOK1378_1mm";"SILVA (only NR);Bacteria;Proteobacteria;Gammaproteobacteria;Pseudomonadales;Halomonadaceae;HdN1;";"0.0";"0";"1";"1";"0";"1";"0";"430523";"5766"
"LOK1378_1mm";"SILVA (only NR);Bacteria;Proteobacteria;Gammaproteobacteria;Pseudomonadales;Halomonadaceae;Kushneria;";"0.0";"0";"22";"22";"0";"22";"0";"430502";"5766"
"LOK1378_1mm";"SILVA (only NR);Bacteria;Proteobacteria;Gammaproteobacteria;Pseudomonadales;Halomonadaceae;Larsenimonas;";"0.0";"0";"3";"3";"0";"3";"0";"430521";"5766"
"LOK1378_1mm";"SILVA (only NR);Bacteria;Proteobacteria;Gammaproteobacteria;Pseudomonadales;Halomonadaceae;Marinospirillum;";"0.0";"0";"25";"25";"0";"25";"0";"430499";"5766"
"LOK1378_1mm";"SILVA (only NR);Bacteria;Proteobacteria;Gammaproteobacteria;Pseudomonadales;Halomonadaceae;Modicisalibacter;";"0.0";"0";"4";"4";"0";"4";"0";"430520";"5766"
"LOK1378_1mm";"SILVA (only NR);Bacteria;Proteobacteria;Gammaproteobacteria;Pseudomonadales;Halomonadaceae;Salicola;";"0.0";"0";"16";"15";"0";"15";"1";"430509";"5766"
"LOK1378_1mm";"SILVA (only NR);Bacteria;Proteobacteria;Gammaproteobacteria;Pseudomonadales;Halomonadaceae;Salinicola;";"0.0";"0";"86";"81";"0";"81";"5";"430443";"5766"
"LOK1378_1mm";"SILVA (only NR);Bacteria;Proteobacteria;Gammaproteobacteria;Pseudomonadales;Halomonadaceae;Terasakiispira;";"0.0";"0";"7";"7";"0";"7";"0";"430517";"5766"
"LOK1378_1mm";"SILVA (only NR);Bacteria;Proteobacteria;Gammaproteobacteria;Pseudomonadales;Halomonadaceae;Zymobacter;";"0.0";"0";"4";"4";"0";"4";"0";"430520";"5766"
"LOK1378_1mm";"SILVA (only NR);Bacteria;Proteobacteria;Gammaproteobacteria;Pseudomonadales;Halomonadaceae;uncultured;";"0.0";"0";"44";"42";"0";"42";"2";"430482";"5766"
"LOK1378_1mm";"SILVA (only NR);Bacteria;Proteobacteria;Gammaproteobacteria;Pseudomonadales;KI89A clade;";"0.0";"0";"78";"77";"0";"77";"1";"430447";"5766"
"LOK1378_1mm";"SILVA (only NR);Bacteria;Proteobacteria;Gammaproteobacteria;Pseudomonadales;Litoricolaceae;";"0.0";"0";"27";"27";"0";"27";"0";"430497";"5766"
"LOK1378_1mm";"SILVA (only NR);Bacteria;Proteobacteria;Gammaproteobacteria;Pseudomonadales;Litoricolaceae;Litoricola;";"0.0";"0";"27";"27";"0";"27";"0";"430497";"5766"
"LOK1378_1mm";"SILVA (only NR);Bacteria;Proteobacteria;Gammaproteobacteria;Pseudomonadales;MBAE14;";"0.0";"0";"41";"40";"0";"40";"1";"430484";"5766"
"LOK1378_1mm";"SILVA (only NR);Bacteria;Proteobacteria;Gammaproteobacteria;Pseudomonadales;Marinobacteraceae;";"0.0";"0";"590";"558";"0";"558";"32";"429966";"5766"
"LOK1378_1mm";"SILVA (only NR);Bacteria;Proteobacteria;Gammaproteobacteria;Pseudomonadales;Marinobacteraceae;Marinobacter;";"0.0";"0";"590";"558";"0";"558";"32";"429966";"5766"
"LOK1378_1mm";"SILVA (only NR);Bacteria;Proteobacteria;Gammaproteobacteria;Pseudomonadales;Marinomonadaceae;";"0.0";"0";"152";"147";"0";"147";"5";"430377";"5766"
"LOK1378_1mm";"SILVA (only NR);Bacteria;Proteobacteria;Gammaproteobacteria;Pseudomonadales;Marinomonadaceae;Marinomonas;";"0.0";"0";"152";"147";"0";"147";"5";"430377";"5766"
"LOK1378_1mm";"SILVA (only NR);Bacteria;Proteobacteria;Gammaproteobacteria;Pseudomonadales;Microbulbiferaceae;";"0.0";"0";"90";"90";"0";"90";"0";"430434";"5766"
"LOK1378_1mm";"SILVA (only NR);Bacteria;Proteobacteria;Gammaproteobacteria;Pseudomonadales;Microbulbiferaceae;Microbulbifer;";"0.0";"0";"90";"90";"0";"90";"0";"430434";"5766"
"LOK1378_1mm";"SILVA (only NR);Bacteria;Proteobacteria;Gammaproteobacteria;Pseudomonadales;Moraxellaceae;";"0.0";"0";"3680";"3458";"0";"3458";"222";"427066";"5766"
"LOK1378_1mm";"SILVA (only NR);Bacteria;Proteobacteria;Gammaproteobacteria;Pseudomonadales;Moraxellaceae;Acinetobacter;";"0.0";"0";"2460";"2304";"0";"2304";"156";"428220";"5766"
"LOK1378_1mm";"SILVA (only NR);Bacteria;Proteobacteria;Gammaproteobacteria;Pseudomonadales;Moraxellaceae;Alkanindiges;";"0.0";"0";"57";"57";"0";"57";"0";"430467";"5766"
"LOK1378_1mm";"SILVA (only NR);Bacteria;Proteobacteria;Gammaproteobacteria;Pseudomonadales;Moraxellaceae;Cavicella;";"0.0";"0";"14";"12";"0";"12";"2";"430512";"5766"
"LOK1378_1mm";"SILVA (only NR);Bacteria;Proteobacteria;Gammaproteobacteria;Pseudomonadales;Moraxellaceae;Enhydrobacter;";"0.0";"0";"132";"130";"0";"130";"2";"430394";"5766"
"LOK1378_1mm";"SILVA (only NR);Bacteria;Proteobacteria;Gammaproteobacteria;Pseudomonadales;Moraxellaceae;Faucicola;";"0.0";"0";"1";"1";"0";"1";"0";"430523";"5766"
"LOK1378_1mm";"SILVA (only NR);Bacteria;Proteobacteria;Gammaproteobacteria;Pseudomonadales;Moraxellaceae;Fluviicoccus;";"0.0";"0";"6";"6";"0";"6";"0";"430518";"5766"
"LOK1378_1mm";"SILVA (only NR);Bacteria;Proteobacteria;Gammaproteobacteria;Pseudomonadales;Moraxellaceae;Moraxella;";"0.0";"0";"285";"283";"0";"283";"2";"430241";"5766"
"LOK1378_1mm";"SILVA (only NR);Bacteria;Proteobacteria;Gammaproteobacteria;Pseudomonadales;Moraxellaceae;Paraperlucidibaca;";"0.0";"0";"5";"5";"0";"5";"0";"430519";"5766"
"LOK1378_1mm";"SILVA (only NR);Bacteria;Proteobacteria;Gammaproteobacteria;Pseudomonadales;Moraxellaceae;Perlucidibaca;";"0.0";"0";"7";"7";"0";"7";"0";"430517";"5766"
"LOK1378_1mm";"SILVA (only NR);Bacteria;Proteobacteria;Gammaproteobacteria;Pseudomonadales;Moraxellaceae;Permianibacter;";"0.0";"0";"3";"2";"0";"2";"1";"430522";"5766"
"LOK1378_1mm";"SILVA (only NR);Bacteria;Proteobacteria;Gammaproteobacteria;Pseudomonadales;Moraxellaceae;Psychrobacter;";"0.0";"0";"580";"522";"0";"522";"58";"430002";"5766"
"LOK1378_1mm";"SILVA (only NR);Bacteria;Proteobacteria;Gammaproteobacteria;Pseudomonadales;Moraxellaceae;[Agitococcus] lubricus group;";"0.0";"0";"29";"29";"0";"29";"0";"430495";"5766"
"LOK1378_1mm";"SILVA (only NR);Bacteria;Proteobacteria;Gammaproteobacteria;Pseudomonadales;Moraxellaceae;uncultured;";"0.0";"0";"95";"94";"0";"94";"1";"430430";"5766"
"LOK1378_1mm";"SILVA (only NR);Bacteria;Proteobacteria;Gammaproteobacteria;Pseudomonadales;Nitrincolaceae;";"0.0";"0";"397";"382";"0";"382";"15";"430142";"5766"
"LOK1378_1mm";"SILVA (only NR);Bacteria;Proteobacteria;Gammaproteobacteria;Pseudomonadales;Nitrincolaceae;Amphritea;";"0.0";"0";"34";"34";"0";"34";"0";"430490";"5766"
"LOK1378_1mm";"SILVA (only NR);Bacteria;Proteobacteria;Gammaproteobacteria;Pseudomonadales;Nitrincolaceae;Balneatrix;";"0.0";"0";"3";"3";"0";"3";"0";"430521";"5766"
"LOK1378_1mm";"SILVA (only NR);Bacteria;Proteobacteria;Gammaproteobacteria;Pseudomonadales;Nitrincolaceae;Corallomonas;";"0.0";"0";"2";"2";"0";"2";"0";"430522";"5766"
"LOK1378_1mm";"SILVA (only NR);Bacteria;Proteobacteria;Gammaproteobacteria;Pseudomonadales;Nitrincolaceae;Marinobacterium;";"0.0";"0";"124";"118";"0";"118";"6";"430406";"5766"
"LOK1378_1mm";"SILVA (only NR);Bacteria;Proteobacteria;Gammaproteobacteria;Pseudomonadales;Nitrincolaceae;Motiliproteus;";"0.0";"0";"14";"14";"0";"14";"0";"430510";"5766"
"LOK1378_1mm";"SILVA (only NR);Bacteria;Proteobacteria;Gammaproteobacteria;Pseudomonadales;Nitrincolaceae;Neptuniibacter;";"0.0";"0";"32";"31";"0";"31";"1";"430493";"5766"
"LOK1378_1mm";"SILVA (only NR);Bacteria;Proteobacteria;Gammaproteobacteria;Pseudomonadales;Nitrincolaceae;Neptunomonas;";"0.0";"0";"18";"17";"0";"17";"1";"430507";"5766"
"LOK1378_1mm";"SILVA (only NR);Bacteria;Proteobacteria;Gammaproteobacteria;Pseudomonadales;Nitrincolaceae;Nitrincola;";"0.0";"0";"24";"22";"0";"22";"2";"430502";"5766"
"LOK1378_1mm";"SILVA (only NR);Bacteria;Proteobacteria;Gammaproteobacteria;Pseudomonadales;Nitrincolaceae;Pontibacterium;";"0.0";"0";"3";"3";"0";"3";"0";"430521";"5766"
"LOK1378_1mm";"SILVA (only NR);Bacteria;Proteobacteria;Gammaproteobacteria;Pseudomonadales;Nitrincolaceae;Profundimonas;";"0.0";"0";"22";"22";"0";"22";"0";"430502";"5766"
"LOK1378_1mm";"SILVA (only NR);Bacteria;Proteobacteria;Gammaproteobacteria;Pseudomonadales;Nitrincolaceae;uncultured;";"0.0";"0";"118";"113";"0";"113";"5";"430411";"5766"
"LOK1378_1mm";"SILVA (only NR);Bacteria;Proteobacteria;Gammaproteobacteria;Pseudomonadales;OM182 clade;";"0.0";"0";"63";"60";"0";"60";"3";"430464";"5766"
"LOK1378_1mm";"SILVA (only NR);Bacteria;Proteobacteria;Gammaproteobacteria;Pseudomonadales;Oceanospirillaceae;";"0.0";"0";"19";"19";"0";"19";"0";"430505";"5766"
"LOK1378_1mm";"SILVA (only NR);Bacteria;Proteobacteria;Gammaproteobacteria;Pseudomonadales;Oceanospirillaceae;Oceanospirillum;";"0.0";"0";"19";"19";"0";"19";"0";"430505";"5766"
"LOK1378_1mm";"SILVA (only NR);Bacteria;Proteobacteria;Gammaproteobacteria;Pseudomonadales;Oleiphilaceae;";"0.0";"0";"32";"32";"0";"32";"0";"430492";"5766"
"LOK1378_1mm";"SILVA (only NR);Bacteria;Proteobacteria;Gammaproteobacteria;Pseudomonadales;Oleiphilaceae;Oleiphilus;";"0.0";"0";"32";"32";"0";"32";"0";"430492";"5766"
"LOK1378_1mm";"SILVA (only NR);Bacteria;Proteobacteria;Gammaproteobacteria;Pseudomonadales;P13-46;";"0.0";"0";"6";"6";"0";"6";"0";"430518";"5766"
"LOK1378_1mm";"SILVA (only NR);Bacteria;Proteobacteria;Gammaproteobacteria;Pseudomonadales;Porticoccaceae;";"0.0";"0";"240";"236";"0";"236";"4";"430288";"5766"
"LOK1378_1mm";"SILVA (only NR);Bacteria;Proteobacteria;Gammaproteobacteria;Pseudomonadales;Porticoccaceae;C1-B045;";"0.0";"0";"100";"98";"0";"98";"2";"430426";"5766"
"LOK1378_1mm";"SILVA (only NR);Bacteria;Proteobacteria;Gammaproteobacteria;Pseudomonadales;Porticoccaceae;Porticoccus;";"0.0";"0";"43";"42";"0";"42";"1";"430482";"5766"
"LOK1378_1mm";"SILVA (only NR);Bacteria;Proteobacteria;Gammaproteobacteria;Pseudomonadales;Porticoccaceae;SAR92 clade;";"0.0";"0";"97";"96";"0";"96";"1";"430428";"5766"
"LOK1378_1mm";"SILVA (only NR);Bacteria;Proteobacteria;Gammaproteobacteria;Pseudomonadales;Pseudohongiellaceae;";"0.0";"0";"250";"247";"0";"247";"3";"430277";"5766"
"LOK1378_1mm";"SILVA (only NR);Bacteria;Proteobacteria;Gammaproteobacteria;Pseudomonadales;Pseudohongiellaceae;BIyi10;";"0.0";"0";"29";"29";"0";"29";"0";"430495";"5766"
"LOK1378_1mm";"SILVA (only NR);Bacteria;Proteobacteria;Gammaproteobacteria;Pseudomonadales;Pseudohongiellaceae;Pseudohongiella;";"0.0";"0";"217";"214";"0";"214";"3";"430310";"5766"
"LOK1378_1mm";"SILVA (only NR);Bacteria;Proteobacteria;Gammaproteobacteria;Pseudomonadales;Pseudohongiellaceae;Pseudospirillum;";"0.0";"0";"4";"4";"0";"4";"0";"430520";"5766"
"LOK1378_1mm";"SILVA (only NR);Bacteria;Proteobacteria;Gammaproteobacteria;Pseudomonadales;Pseudomonadaceae;";"0.0";"0";"7564";"7109";"0";"7109";"455";"423415";"5766"
"LOK1378_1mm";"SILVA (only NR);Bacteria;Proteobacteria;Gammaproteobacteria;Pseudomonadales;Pseudomonadaceae;Azomonas;";"0.0";"0";"4";"4";"0";"4";"0";"430520";"5766"
"LOK1378_1mm";"SILVA (only NR);Bacteria;Proteobacteria;Gammaproteobacteria;Pseudomonadales;Pseudomonadaceae;Azorhizophilus;";"0.0";"0";"4";"4";"0";"4";"0";"430520";"5766"
"LOK1378_1mm";"SILVA (only NR);Bacteria;Proteobacteria;Gammaproteobacteria;Pseudomonadales;Pseudomonadaceae;Azotobacter;";"0.0";"0";"75";"72";"0";"72";"3";"430452";"5766"
"LOK1378_1mm";"SILVA (only NR);Bacteria;Proteobacteria;Gammaproteobacteria;Pseudomonadales;Pseudomonadaceae;Oblitimonas;";"0.0";"0";"9";"9";"0";"9";"0";"430515";"5766"
"LOK1378_1mm";"SILVA (only NR);Bacteria;Proteobacteria;Gammaproteobacteria;Pseudomonadales;Pseudomonadaceae;Pseudomonas;";"0.0";"0";"7435";"6985";"0";"6985";"450";"423539";"5766"
"LOK1378_1mm";"SILVA (only NR);Bacteria;Proteobacteria;Gammaproteobacteria;Pseudomonadales;Pseudomonadaceae;Thiopseudomonas;";"0.0";"0";"35";"33";"0";"33";"2";"430491";"5766"
"LOK1378_1mm";"SILVA (only NR);Bacteria;Proteobacteria;Gammaproteobacteria;Pseudomonadales;Pseudomonadaceae;Ventosimonas;";"0.0";"0";"1";"1";"0";"1";"0";"430523";"5766"
"LOK1378_1mm";"SILVA (only NR);Bacteria;Proteobacteria;Gammaproteobacteria;Pseudomonadales;SAR86 clade;";"0.0";"0";"503";"493";"0";"493";"10";"430031";"5766"
"LOK1378_1mm";"SILVA (only NR);Bacteria;Proteobacteria;Gammaproteobacteria;Pseudomonadales;Saccharospirillaceae;";"0.0";"0";"211";"206";"0";"206";"5";"430318";"5766"
"LOK1378_1mm";"SILVA (only NR);Bacteria;Proteobacteria;Gammaproteobacteria;Pseudomonadales;Saccharospirillaceae;Bermanella;";"0.0";"0";"4";"3";"0";"3";"1";"430521";"5766"
"LOK1378_1mm";"SILVA (only NR);Bacteria;Proteobacteria;Gammaproteobacteria;Pseudomonadales;Saccharospirillaceae;Gynuella;";"0.0";"0";"3";"3";"0";"3";"0";"430521";"5766"
"LOK1378_1mm";"SILVA (only NR);Bacteria;Proteobacteria;Gammaproteobacteria;Pseudomonadales;Saccharospirillaceae;Litoribacillus;";"0.0";"0";"2";"2";"0";"2";"0";"430522";"5766"
"LOK1378_1mm";"SILVA (only NR);Bacteria;Proteobacteria;Gammaproteobacteria;Pseudomonadales;Saccharospirillaceae;Litoribrevibacter;";"0.0";"0";"2";"2";"0";"2";"0";"430522";"5766"
"LOK1378_1mm";"SILVA (only NR);Bacteria;Proteobacteria;Gammaproteobacteria;Pseudomonadales;Saccharospirillaceae;Oceaniserpentilla;";"0.0";"0";"5";"5";"0";"5";"0";"430519";"5766"
"LOK1378_1mm";"SILVA (only NR);Bacteria;Proteobacteria;Gammaproteobacteria;Pseudomonadales;Saccharospirillaceae;Oceanobacter;";"0.0";"0";"18";"18";"0";"18";"0";"430506";"5766"
"LOK1378_1mm";"SILVA (only NR);Bacteria;Proteobacteria;Gammaproteobacteria;Pseudomonadales;Saccharospirillaceae;Oleibacter;";"0.0";"0";"24";"23";"0";"23";"1";"430501";"5766"
"LOK1378_1mm";"SILVA (only NR);Bacteria;Proteobacteria;Gammaproteobacteria;Pseudomonadales;Saccharospirillaceae;Oleispira;";"0.0";"0";"26";"26";"0";"26";"0";"430498";"5766"
"LOK1378_1mm";"SILVA (only NR);Bacteria;Proteobacteria;Gammaproteobacteria;Pseudomonadales;Saccharospirillaceae;Reinekea;";"0.0";"0";"30";"30";"0";"30";"0";"430494";"5766"
"LOK1378_1mm";"SILVA (only NR);Bacteria;Proteobacteria;Gammaproteobacteria;Pseudomonadales;Saccharospirillaceae;Saccharospirillum;";"0.0";"0";"15";"15";"0";"15";"0";"430509";"5766"
"LOK1378_1mm";"SILVA (only NR);Bacteria;Proteobacteria;Gammaproteobacteria;Pseudomonadales;Saccharospirillaceae;Salinispirillum;";"0.0";"0";"2";"2";"0";"2";"0";"430522";"5766"
"LOK1378_1mm";"SILVA (only NR);Bacteria;Proteobacteria;Gammaproteobacteria;Pseudomonadales;Saccharospirillaceae;Spongiispira;";"0.0";"0";"1";"1";"0";"1";"0";"430523";"5766"
"LOK1378_1mm";"SILVA (only NR);Bacteria;Proteobacteria;Gammaproteobacteria;Pseudomonadales;Saccharospirillaceae;Thalassolituus;";"0.0";"0";"15";"13";"0";"13";"2";"430511";"5766"
"LOK1378_1mm";"SILVA (only NR);Bacteria;Proteobacteria;Gammaproteobacteria;Pseudomonadales;Saccharospirillaceae;uncultured;";"0.0";"0";"58";"57";"0";"57";"1";"430467";"5766"
"LOK1378_1mm";"SILVA (only NR);Bacteria;Proteobacteria;Gammaproteobacteria;Pseudomonadales;Spongiibacteraceae;";"0.0";"0";"203";"193";"0";"193";"10";"430331";"5766"
"LOK1378_1mm";"SILVA (only NR);Bacteria;Proteobacteria;Gammaproteobacteria;Pseudomonadales;Spongiibacteraceae;BD1-7 clade;";"0.0";"0";"130";"122";"0";"122";"8";"430402";"5766"
"LOK1378_1mm";"SILVA (only NR);Bacteria;Proteobacteria;Gammaproteobacteria;Pseudomonadales;Spongiibacteraceae;Dasania;";"0.0";"0";"7";"7";"0";"7";"0";"430517";"5766"
"LOK1378_1mm";"SILVA (only NR);Bacteria;Proteobacteria;Gammaproteobacteria;Pseudomonadales;Spongiibacteraceae;Litorivivens;";"0.0";"0";"7";"7";"0";"7";"0";"430517";"5766"
"LOK1378_1mm";"SILVA (only NR);Bacteria;Proteobacteria;Gammaproteobacteria;Pseudomonadales;Spongiibacteraceae;Oceanicoccus;";"0.0";"0";"2";"2";"0";"2";"0";"430522";"5766"
"LOK1378_1mm";"SILVA (only NR);Bacteria;Proteobacteria;Gammaproteobacteria;Pseudomonadales;Spongiibacteraceae;Sinobacterium;";"0.0";"0";"8";"7";"0";"7";"1";"430517";"5766"
"LOK1378_1mm";"SILVA (only NR);Bacteria;Proteobacteria;Gammaproteobacteria;Pseudomonadales;Spongiibacteraceae;Spongiibacter;";"0.0";"0";"16";"15";"0";"15";"1";"430509";"5766"
"LOK1378_1mm";"SILVA (only NR);Bacteria;Proteobacteria;Gammaproteobacteria;Pseudomonadales;Spongiibacteraceae;Zhongshania;";"0.0";"0";"14";"14";"0";"14";"0";"430510";"5766"
"LOK1378_1mm";"SILVA (only NR);Bacteria;Proteobacteria;Gammaproteobacteria;Pseudomonadales;Spongiibacteraceae;uncultured;";"0.0";"0";"15";"15";"0";"15";"0";"430509";"5766"
"LOK1378_1mm";"SILVA (only NR);Bacteria;Proteobacteria;Gammaproteobacteria;Pseudomonadales;Thioglobaceae;";"0.0";"0";"257";"244";"0";"244";"13";"430280";"5766"
"LOK1378_1mm";"SILVA (only NR);Bacteria;Proteobacteria;Gammaproteobacteria;Pseudomonadales;Thioglobaceae;Candidatus Ruthia;";"0.0";"0";"4";"4";"0";"4";"0";"430520";"5766"
"LOK1378_1mm";"SILVA (only NR);Bacteria;Proteobacteria;Gammaproteobacteria;Pseudomonadales;Thioglobaceae;Candidatus Thioglobus;";"0.0";"0";"3";"3";"0";"3";"0";"430521";"5766"
"LOK1378_1mm";"SILVA (only NR);Bacteria;Proteobacteria;Gammaproteobacteria;Pseudomonadales;Thioglobaceae;Candidatus Vesicomyosocius;";"0.0";"0";"7";"6";"0";"6";"1";"430518";"5766"
"LOK1378_1mm";"SILVA (only NR);Bacteria;Proteobacteria;Gammaproteobacteria;Pseudomonadales;Thioglobaceae;IheB2-31;";"0.0";"0";"3";"2";"0";"2";"1";"430522";"5766"
"LOK1378_1mm";"SILVA (only NR);Bacteria;Proteobacteria;Gammaproteobacteria;Pseudomonadales;Thioglobaceae;JL-ETNP-Z34;";"0.0";"0";"2";"2";"0";"2";"0";"430522";"5766"
"LOK1378_1mm";"SILVA (only NR);Bacteria;Proteobacteria;Gammaproteobacteria;Pseudomonadales;Thioglobaceae;SUP05 cluster;";"0.0";"0";"228";"217";"0";"217";"11";"430307";"5766"
"LOK1378_1mm";"SILVA (only NR);Bacteria;Proteobacteria;Gammaproteobacteria;Pseudomonadales;Thioglobaceae;V38;";"0.0";"0";"10";"10";"0";"10";"0";"430514";"5766"
"LOK1378_1mm";"SILVA (only NR);Bacteria;Proteobacteria;Gammaproteobacteria;Pseudomonadales;Unknown Family;";"0.0";"0";"5";"5";"0";"5";"0";"430519";"5766"
"LOK1378_1mm";"SILVA (only NR);Bacteria;Proteobacteria;Gammaproteobacteria;Pseudomonadales;Unknown Family;Alkalimarinus;";"0.0";"0";"5";"5";"0";"5";"0";"430519";"5766"
"LOK1378_1mm";"SILVA (only NR);Bacteria;Proteobacteria;Gammaproteobacteria;R7C24;";"0.0";"0";"80";"78";"0";"78";"2";"430446";"5766"
"LOK1378_1mm";"SILVA (only NR);Bacteria;Proteobacteria;Gammaproteobacteria;Run-SP154;";"0.0";"0";"27";"26";"0";"26";"1";"430498";"5766"
"LOK1378_1mm";"SILVA (only NR);Bacteria;Proteobacteria;Gammaproteobacteria;S1-3-65;";"0.0";"0";"2";"2";"0";"2";"0";"430522";"5766"
"LOK1378_1mm";"SILVA (only NR);Bacteria;Proteobacteria;Gammaproteobacteria;SBYH-1030;";"0.0";"0";"2";"2";"0";"2";"0";"430522";"5766"
"LOK1378_1mm";"SILVA (only NR);Bacteria;Proteobacteria;Gammaproteobacteria;SS1-B-04-55;";"0.0";"0";"6";"6";"0";"6";"0";"430518";"5766"
"LOK1378_1mm";"SILVA (only NR);Bacteria;Proteobacteria;Gammaproteobacteria;SS1-B-07-19;";"0.0";"0";"5";"5";"0";"5";"0";"430519";"5766"
"LOK1378_1mm";"SILVA (only NR);Bacteria;Proteobacteria;Gammaproteobacteria;SS1-B-09-64;";"0.0";"0";"9";"9";"0";"9";"0";"430515";"5766"
"LOK1378_1mm";"SILVA (only NR);Bacteria;Proteobacteria;Gammaproteobacteria;SZB30;";"0.0";"0";"10";"10";"0";"10";"0";"430514";"5766"
"LOK1378_1mm";"SILVA (only NR);Bacteria;Proteobacteria;Gammaproteobacteria;SZB50;";"0.0";"0";"13";"13";"0";"13";"0";"430511";"5766"
"LOK1378_1mm";"SILVA (only NR);Bacteria;Proteobacteria;Gammaproteobacteria;SZB7;";"0.0";"0";"3";"3";"0";"3";"0";"430521";"5766"
"LOK1378_1mm";"SILVA (only NR);Bacteria;Proteobacteria;Gammaproteobacteria;Salinisphaerales;";"0.0";"0";"245";"241";"0";"241";"4";"430283";"5766"
"LOK1378_1mm";"SILVA (only NR);Bacteria;Proteobacteria;Gammaproteobacteria;Salinisphaerales;Algiphilaceae;";"0.0";"0";"5";"5";"0";"5";"0";"430519";"5766"
"LOK1378_1mm";"SILVA (only NR);Bacteria;Proteobacteria;Gammaproteobacteria;Salinisphaerales;Algiphilaceae;Algiphilus;";"0.0";"0";"5";"5";"0";"5";"0";"430519";"5766"
"LOK1378_1mm";"SILVA (only NR);Bacteria;Proteobacteria;Gammaproteobacteria;Salinisphaerales;Salinisphaeraceae;";"0.0";"0";"42";"40";"0";"40";"2";"430484";"5766"
"LOK1378_1mm";"SILVA (only NR);Bacteria;Proteobacteria;Gammaproteobacteria;Salinisphaerales;Salinisphaeraceae;Salinisphaera;";"0.0";"0";"42";"40";"0";"40";"2";"430484";"5766"
"LOK1378_1mm";"SILVA (only NR);Bacteria;Proteobacteria;Gammaproteobacteria;Salinisphaerales;Solimonadaceae;";"0.0";"0";"198";"196";"0";"196";"2";"430328";"5766"
"LOK1378_1mm";"SILVA (only NR);Bacteria;Proteobacteria;Gammaproteobacteria;Salinisphaerales;Solimonadaceae;Alkanibacter;";"0.0";"0";"13";"13";"0";"13";"0";"430511";"5766"
"LOK1378_1mm";"SILVA (only NR);Bacteria;Proteobacteria;Gammaproteobacteria;Salinisphaerales;Solimonadaceae;Fontimonas;";"0.0";"0";"17";"16";"0";"16";"1";"430508";"5766"
"LOK1378_1mm";"SILVA (only NR);Bacteria;Proteobacteria;Gammaproteobacteria;Salinisphaerales;Solimonadaceae;Hydrocarboniphaga;";"0.0";"0";"19";"19";"0";"19";"0";"430505";"5766"
"LOK1378_1mm";"SILVA (only NR);Bacteria;Proteobacteria;Gammaproteobacteria;Salinisphaerales;Solimonadaceae;Nevskia;";"0.0";"0";"40";"40";"0";"40";"0";"430484";"5766"
"LOK1378_1mm";"SILVA (only NR);Bacteria;Proteobacteria;Gammaproteobacteria;Salinisphaerales;Solimonadaceae;Oceanococcus;";"0.0";"0";"4";"4";"0";"4";"0";"430520";"5766"
"LOK1378_1mm";"SILVA (only NR);Bacteria;Proteobacteria;Gammaproteobacteria;Salinisphaerales;Solimonadaceae;Panacagrimonas;";"0.0";"0";"14";"14";"0";"14";"0";"430510";"5766"
"LOK1378_1mm";"SILVA (only NR);Bacteria;Proteobacteria;Gammaproteobacteria;Salinisphaerales;Solimonadaceae;Polycyclovorans;";"0.0";"0";"39";"38";"0";"38";"1";"430486";"5766"
"LOK1378_1mm";"SILVA (only NR);Bacteria;Proteobacteria;Gammaproteobacteria;Salinisphaerales;Solimonadaceae;Solimonas;";"0.0";"0";"18";"18";"0";"18";"0";"430506";"5766"
"LOK1378_1mm";"SILVA (only NR);Bacteria;Proteobacteria;Gammaproteobacteria;Salinisphaerales;Solimonadaceae;uncultured;";"0.0";"0";"31";"31";"0";"31";"0";"430493";"5766"
"LOK1378_1mm";"SILVA (only NR);Bacteria;Proteobacteria;Gammaproteobacteria;Steroidobacterales;";"0.0";"0";"827";"814";"0";"814";"13";"429710";"5766"
"LOK1378_1mm";"SILVA (only NR);Bacteria;Proteobacteria;Gammaproteobacteria;Steroidobacterales;Steroidobacteraceae;";"0.0";"0";"317";"307";"0";"307";"10";"430217";"5766"
"LOK1378_1mm";"SILVA (only NR);Bacteria;Proteobacteria;Gammaproteobacteria;Steroidobacterales;Steroidobacteraceae;Povalibacter;";"0.0";"0";"3";"3";"0";"3";"0";"430521";"5766"
"LOK1378_1mm";"SILVA (only NR);Bacteria;Proteobacteria;Gammaproteobacteria;Steroidobacterales;Steroidobacteraceae;Steroidobacter;";"0.0";"0";"157";"154";"0";"154";"3";"430370";"5766"
"LOK1378_1mm";"SILVA (only NR);Bacteria;Proteobacteria;Gammaproteobacteria;Steroidobacterales;Steroidobacteraceae;uncultured;";"0.0";"0";"155";"149";"0";"149";"6";"430375";"5766"
"LOK1378_1mm";"SILVA (only NR);Bacteria;Proteobacteria;Gammaproteobacteria;Steroidobacterales;Woeseiaceae;";"0.0";"0";"510";"507";"0";"507";"3";"430017";"5766"
"LOK1378_1mm";"SILVA (only NR);Bacteria;Proteobacteria;Gammaproteobacteria;Steroidobacterales;Woeseiaceae;JTB255 marine benthic group;";"0.0";"0";"46";"46";"0";"46";"0";"430478";"5766"
"LOK1378_1mm";"SILVA (only NR);Bacteria;Proteobacteria;Gammaproteobacteria;Steroidobacterales;Woeseiaceae;Woeseia;";"0.0";"0";"464";"461";"0";"461";"3";"430063";"5766"
"LOK1378_1mm";"SILVA (only NR);Bacteria;Proteobacteria;Gammaproteobacteria;TDNP-Wbc97-11-7-16;";"0.0";"0";"2";"2";"0";"2";"0";"430522";"5766"
"LOK1378_1mm";"SILVA (only NR);Bacteria;Proteobacteria;Gammaproteobacteria;Tenderiales;";"0.0";"0";"33";"32";"0";"32";"1";"430492";"5766"
"LOK1378_1mm";"SILVA (only NR);Bacteria;Proteobacteria;Gammaproteobacteria;Tenderiales;Tenderiaceae;";"0.0";"0";"33";"32";"0";"32";"1";"430492";"5766"
"LOK1378_1mm";"SILVA (only NR);Bacteria;Proteobacteria;Gammaproteobacteria;Tenderiales;Tenderiaceae;Candidatus Tenderia;";"0.0";"0";"33";"32";"0";"32";"1";"430492";"5766"
"LOK1378_1mm";"SILVA (only NR);Bacteria;Proteobacteria;Gammaproteobacteria;Thiohalorhabdales;";"0.0";"0";"56";"56";"0";"56";"0";"430468";"5766"
"LOK1378_1mm";"SILVA (only NR);Bacteria;Proteobacteria;Gammaproteobacteria;Thiohalorhabdales;Thiohalorhabdaceae;";"0.0";"0";"56";"56";"0";"56";"0";"430468";"5766"
"LOK1378_1mm";"SILVA (only NR);Bacteria;Proteobacteria;Gammaproteobacteria;Thiohalorhabdales;Thiohalorhabdaceae;Thiohalorhabdus;";"0.0";"0";"34";"34";"0";"34";"0";"430490";"5766"
"LOK1378_1mm";"SILVA (only NR);Bacteria;Proteobacteria;Gammaproteobacteria;Thiohalorhabdales;Thiohalorhabdaceae;uncultured;";"0.0";"0";"22";"22";"0";"22";"0";"430502";"5766"
"LOK1378_1mm";"SILVA (only NR);Bacteria;Proteobacteria;Gammaproteobacteria;Thiomicrospirales;";"0.0";"0";"281";"278";"0";"278";"3";"430246";"5766"
"LOK1378_1mm";"SILVA (only NR);Bacteria;Proteobacteria;Gammaproteobacteria;Thiomicrospirales;Thiomicrospiraceae;";"0.0";"0";"281";"278";"0";"278";"3";"430246";"5766"
"LOK1378_1mm";"SILVA (only NR);Bacteria;Proteobacteria;Gammaproteobacteria;Thiomicrospirales;Thiomicrospiraceae;Galenea;";"0.0";"0";"2";"2";"0";"2";"0";"430522";"5766"
"LOK1378_1mm";"SILVA (only NR);Bacteria;Proteobacteria;Gammaproteobacteria;Thiomicrospirales;Thiomicrospiraceae;Hydrogenovibrio;";"0.0";"0";"4";"4";"0";"4";"0";"430520";"5766"
"LOK1378_1mm";"SILVA (only NR);Bacteria;Proteobacteria;Gammaproteobacteria;Thiomicrospirales;Thiomicrospiraceae;Thioalkalimicrobium;";"0.0";"0";"12";"12";"0";"12";"0";"430512";"5766"
"LOK1378_1mm";"SILVA (only NR);Bacteria;Proteobacteria;Gammaproteobacteria;Thiomicrospirales;Thiomicrospiraceae;Thiomicrorhabdus;";"0.0";"0";"111";"108";"0";"108";"3";"430416";"5766"
"LOK1378_1mm";"SILVA (only NR);Bacteria;Proteobacteria;Gammaproteobacteria;Thiomicrospirales;Thiomicrospiraceae;Thiomicrospira;";"0.0";"0";"29";"29";"0";"29";"0";"430495";"5766"
"LOK1378_1mm";"SILVA (only NR);Bacteria;Proteobacteria;Gammaproteobacteria;Thiomicrospirales;Thiomicrospiraceae;endosymbionts;";"0.0";"0";"108";"108";"0";"108";"0";"430416";"5766"
"LOK1378_1mm";"SILVA (only NR);Bacteria;Proteobacteria;Gammaproteobacteria;Thiomicrospirales;Thiomicrospiraceae;uncultured;";"0.0";"0";"13";"13";"0";"13";"0";"430511";"5766"
"LOK1378_1mm";"SILVA (only NR);Bacteria;Proteobacteria;Gammaproteobacteria;Thioprofundaceae;";"0.0";"0";"8";"8";"0";"8";"0";"430516";"5766"
"LOK1378_1mm";"SILVA (only NR);Bacteria;Proteobacteria;Gammaproteobacteria;Thioprofundaceae;Thioprofundum;";"0.0";"0";"8";"8";"0";"8";"0";"430516";"5766"
"LOK1378_1mm";"SILVA (only NR);Bacteria;Proteobacteria;Gammaproteobacteria;Thiotrichales;";"0.0";"0";"623";"612";"0";"612";"11";"429912";"5766"
"LOK1378_1mm";"SILVA (only NR);Bacteria;Proteobacteria;Gammaproteobacteria;Thiotrichales;Thiotrichaceae;";"0.0";"0";"623";"612";"0";"612";"11";"429912";"5766"
"LOK1378_1mm";"SILVA (only NR);Bacteria;Proteobacteria;Gammaproteobacteria;Thiotrichales;Thiotrichaceae;Candidatus Navis;";"0.0";"0";"3";"3";"0";"3";"0";"430521";"5766"
"LOK1378_1mm";"SILVA (only NR);Bacteria;Proteobacteria;Gammaproteobacteria;Thiotrichales;Thiotrichaceae;Cocleimonas;";"0.0";"0";"73";"72";"0";"72";"1";"430452";"5766"
"LOK1378_1mm";"SILVA (only NR);Bacteria;Proteobacteria;Gammaproteobacteria;Thiotrichales;Thiotrichaceae;Leucothrix;";"0.0";"0";"24";"23";"0";"23";"1";"430501";"5766"
"LOK1378_1mm";"SILVA (only NR);Bacteria;Proteobacteria;Gammaproteobacteria;Thiotrichales;Thiotrichaceae;Thiothrix;";"0.0";"0";"216";"211";"0";"211";"5";"430313";"5766"
"LOK1378_1mm";"SILVA (only NR);Bacteria;Proteobacteria;Gammaproteobacteria;Thiotrichales;Thiotrichaceae;uncultured;";"0.0";"0";"306";"302";"0";"302";"4";"430222";"5766"
"LOK1378_1mm";"SILVA (only NR);Bacteria;Proteobacteria;Gammaproteobacteria;UBA10353 marine group;";"0.0";"0";"194";"190";"0";"190";"4";"430334";"5766"
"LOK1378_1mm";"SILVA (only NR);Bacteria;Proteobacteria;Gammaproteobacteria;UBA4486;";"0.0";"0";"14";"14";"0";"14";"0";"430510";"5766"
"LOK1378_1mm";"SILVA (only NR);Bacteria;Proteobacteria;Gammaproteobacteria;WD260;";"0.0";"0";"47";"43";"0";"43";"4";"430481";"5766"
"LOK1378_1mm";"SILVA (only NR);Bacteria;Proteobacteria;Gammaproteobacteria;WN-HWB-116;";"0.0";"0";"16";"16";"0";"16";"0";"430508";"5766"
"LOK1378_1mm";"SILVA (only NR);Bacteria;Proteobacteria;Gammaproteobacteria;Xanthomonadales;";"0.0";"0";"3619";"3479";"0";"3479";"140";"427045";"5766"
"LOK1378_1mm";"SILVA (only NR);Bacteria;Proteobacteria;Gammaproteobacteria;Xanthomonadales;Coralloluteibacterium;";"0.0";"0";"1";"1";"0";"1";"0";"430523";"5766"
"LOK1378_1mm";"SILVA (only NR);Bacteria;Proteobacteria;Gammaproteobacteria;Xanthomonadales;Rhodanobacteraceae;";"0.0";"0";"828";"807";"0";"807";"21";"429717";"5766"
"LOK1378_1mm";"SILVA (only NR);Bacteria;Proteobacteria;Gammaproteobacteria;Xanthomonadales;Rhodanobacteraceae;Ahniella;";"0.0";"0";"59";"55";"0";"55";"4";"430469";"5766"
"LOK1378_1mm";"SILVA (only NR);Bacteria;Proteobacteria;Gammaproteobacteria;Xanthomonadales;Rhodanobacteraceae;Aquimonas;";"0.0";"0";"20";"19";"0";"19";"1";"430505";"5766"
"LOK1378_1mm";"SILVA (only NR);Bacteria;Proteobacteria;Gammaproteobacteria;Xanthomonadales;Rhodanobacteraceae;Chiayiivirga;";"0.0";"0";"6";"6";"0";"6";"0";"430518";"5766"
"LOK1378_1mm";"SILVA (only NR);Bacteria;Proteobacteria;Gammaproteobacteria;Xanthomonadales;Rhodanobacteraceae;Chujaibacter;";"0.0";"0";"40";"40";"0";"40";"0";"430484";"5766"
"LOK1378_1mm";"SILVA (only NR);Bacteria;Proteobacteria;Gammaproteobacteria;Xanthomonadales;Rhodanobacteraceae;Dokdonella;";"0.0";"0";"95";"93";"0";"93";"2";"430431";"5766"
"LOK1378_1mm";"SILVA (only NR);Bacteria;Proteobacteria;Gammaproteobacteria;Xanthomonadales;Rhodanobacteraceae;Dyella;";"0.0";"0";"102";"101";"0";"101";"1";"430423";"5766"
"LOK1378_1mm";"SILVA (only NR);Bacteria;Proteobacteria;Gammaproteobacteria;Xanthomonadales;Rhodanobacteraceae;Frateuria;";"0.0";"0";"30";"29";"0";"29";"1";"430495";"5766"
"LOK1378_1mm";"SILVA (only NR);Bacteria;Proteobacteria;Gammaproteobacteria;Xanthomonadales;Rhodanobacteraceae;Fulvimonas;";"0.0";"0";"8";"8";"0";"8";"0";"430516";"5766"
"LOK1378_1mm";"SILVA (only NR);Bacteria;Proteobacteria;Gammaproteobacteria;Xanthomonadales;Rhodanobacteraceae;Luteibacter;";"0.0";"0";"62";"60";"0";"60";"2";"430464";"5766"
"LOK1378_1mm";"SILVA (only NR);Bacteria;Proteobacteria;Gammaproteobacteria;Xanthomonadales;Rhodanobacteraceae;Metallibacterium;";"0.0";"0";"15";"14";"0";"14";"1";"430510";"5766"
"LOK1378_1mm";"SILVA (only NR);Bacteria;Proteobacteria;Gammaproteobacteria;Xanthomonadales;Rhodanobacteraceae;Mizugakiibacter;";"0.0";"0";"8";"8";"0";"8";"0";"430516";"5766"
"LOK1378_1mm";"SILVA (only NR);Bacteria;Proteobacteria;Gammaproteobacteria;Xanthomonadales;Rhodanobacteraceae;Oleiagrimonas;";"0.0";"0";"6";"6";"0";"6";"0";"430518";"5766"
"LOK1378_1mm";"SILVA (only NR);Bacteria;Proteobacteria;Gammaproteobacteria;Xanthomonadales;Rhodanobacteraceae;Pseudofulvimonas;";"0.0";"0";"27";"27";"0";"27";"0";"430497";"5766"
"LOK1378_1mm";"SILVA (only NR);Bacteria;Proteobacteria;Gammaproteobacteria;Xanthomonadales;Rhodanobacteraceae;Rhodanobacter;";"0.0";"0";"238";"232";"0";"232";"6";"430292";"5766"
"LOK1378_1mm";"SILVA (only NR);Bacteria;Proteobacteria;Gammaproteobacteria;Xanthomonadales;Rhodanobacteraceae;Rudaea;";"0.0";"0";"8";"8";"0";"8";"0";"430516";"5766"
"LOK1378_1mm";"SILVA (only NR);Bacteria;Proteobacteria;Gammaproteobacteria;Xanthomonadales;Rhodanobacteraceae;Tahibacter;";"0.0";"0";"24";"23";"0";"23";"1";"430501";"5766"
"LOK1378_1mm";"SILVA (only NR);Bacteria;Proteobacteria;Gammaproteobacteria;Xanthomonadales;Rhodanobacteraceae;uncultured;";"0.0";"0";"75";"73";"0";"73";"2";"430451";"5766"
"LOK1378_1mm";"SILVA (only NR);Bacteria;Proteobacteria;Gammaproteobacteria;Xanthomonadales;Xanthomonadaceae;";"0.0";"0";"2774";"2655";"0";"2655";"119";"427869";"5766"
"LOK1378_1mm";"SILVA (only NR);Bacteria;Proteobacteria;Gammaproteobacteria;Xanthomonadales;Xanthomonadaceae;Arenimonas;";"0.0";"0";"207";"196";"0";"196";"11";"430328";"5766"
"LOK1378_1mm";"SILVA (only NR);Bacteria;Proteobacteria;Gammaproteobacteria;Xanthomonadales;Xanthomonadaceae;Luteimonas;";"0.0";"0";"244";"244";"0";"244";"0";"430280";"5766"
"LOK1378_1mm";"SILVA (only NR);Bacteria;Proteobacteria;Gammaproteobacteria;Xanthomonadales;Xanthomonadaceae;Lysobacter;";"0.0";"0";"455";"446";"0";"446";"9";"430078";"5766"
"LOK1378_1mm";"SILVA (only NR);Bacteria;Proteobacteria;Gammaproteobacteria;Xanthomonadales;Xanthomonadaceae;Pseudoxanthomonas;";"0.0";"0";"173";"168";"0";"168";"5";"430356";"5766"
"LOK1378_1mm";"SILVA (only NR);Bacteria;Proteobacteria;Gammaproteobacteria;Xanthomonadales;Xanthomonadaceae;Rehaibacterium;";"0.0";"0";"10";"10";"0";"10";"0";"430514";"5766"
"LOK1378_1mm";"SILVA (only NR);Bacteria;Proteobacteria;Gammaproteobacteria;Xanthomonadales;Xanthomonadaceae;SN8;";"0.0";"0";"6";"6";"0";"6";"0";"430518";"5766"
"LOK1378_1mm";"SILVA (only NR);Bacteria;Proteobacteria;Gammaproteobacteria;Xanthomonadales;Xanthomonadaceae;Silanimonas;";"0.0";"0";"19";"17";"0";"17";"2";"430507";"5766"
"LOK1378_1mm";"SILVA (only NR);Bacteria;Proteobacteria;Gammaproteobacteria;Xanthomonadales;Xanthomonadaceae;Stenotrophomonas;";"0.0";"0";"1011";"934";"0";"934";"77";"429590";"5766"
"LOK1378_1mm";"SILVA (only NR);Bacteria;Proteobacteria;Gammaproteobacteria;Xanthomonadales;Xanthomonadaceae;Thermomonas;";"0.0";"0";"130";"130";"0";"130";"0";"430394";"5766"
"LOK1378_1mm";"SILVA (only NR);Bacteria;Proteobacteria;Gammaproteobacteria;Xanthomonadales;Xanthomonadaceae;Vulcaniibacterium;";"0.0";"0";"22";"22";"0";"22";"0";"430502";"5766"
"LOK1378_1mm";"SILVA (only NR);Bacteria;Proteobacteria;Gammaproteobacteria;Xanthomonadales;Xanthomonadaceae;Xanthomonas;";"0.0";"0";"369";"354";"0";"354";"15";"430170";"5766"
"LOK1378_1mm";"SILVA (only NR);Bacteria;Proteobacteria;Gammaproteobacteria;Xanthomonadales;Xanthomonadaceae;Xylella;";"0.0";"0";"52";"52";"0";"52";"0";"430472";"5766"
"LOK1378_1mm";"SILVA (only NR);Bacteria;Proteobacteria;Gammaproteobacteria;Xanthomonadales;Xanthomonadaceae;uncultured;";"0.0";"0";"65";"65";"0";"65";"0";"430459";"5766"
"LOK1378_1mm";"SILVA (only NR);Bacteria;Proteobacteria;Gammaproteobacteria;Xanthomonadales;uncultured;";"0.0";"0";"16";"16";"0";"16";"0";"430508";"5766"
"LOK1378_1mm";"SILVA (only NR);Bacteria;Proteobacteria;Gammaproteobacteria;eub62A3;";"0.0";"0";"9";"9";"0";"9";"0";"430515";"5766"
"LOK1378_1mm";"SILVA (only NR);Bacteria;Proteobacteria;Gammaproteobacteria;pItb-vmat-80;";"0.0";"0";"23";"23";"0";"23";"0";"430501";"5766"
"LOK1378_1mm";"SILVA (only NR);Bacteria;Proteobacteria;Gammaproteobacteria;sediment-surface35;";"0.0";"0";"2";"2";"0";"2";"0";"430522";"5766"
"LOK1378_1mm";"SILVA (only NR);Bacteria;Proteobacteria;Gammaproteobacteria;uncultured;";"0.0";"0";"240";"233";"0";"233";"7";"430291";"5766"
"LOK1378_1mm";"SILVA (only NR);Bacteria;Proteobacteria;Magnetococcia;";"0.0";"0";"194";"193";"0";"193";"1";"430331";"5766"
"LOK1378_1mm";"SILVA (only NR);Bacteria;Proteobacteria;Magnetococcia;Magnetococcales;";"0.0";"0";"194";"193";"0";"193";"1";"430331";"5766"
"LOK1378_1mm";"SILVA (only NR);Bacteria;Proteobacteria;Magnetococcia;Magnetococcales;Magnetococcaceae;";"0.0";"0";"194";"193";"0";"193";"1";"430331";"5766"
"LOK1378_1mm";"SILVA (only NR);Bacteria;Proteobacteria;Magnetococcia;Magnetococcales;Magnetococcaceae;Magnetococcus;";"0.0";"0";"194";"193";"0";"193";"1";"430331";"5766"
"LOK1378_1mm";"SILVA (only NR);Bacteria;Proteobacteria;Zetaproteobacteria;";"0.0";"0";"136";"135";"0";"135";"1";"430389";"5766"
"LOK1378_1mm";"SILVA (only NR);Bacteria;Proteobacteria;Zetaproteobacteria;Mariprofundales;";"0.0";"0";"136";"135";"0";"135";"1";"430389";"5766"
"LOK1378_1mm";"SILVA (only NR);Bacteria;Proteobacteria;Zetaproteobacteria;Mariprofundales;Mariprofundaceae;";"0.0";"0";"136";"135";"0";"135";"1";"430389";"5766"
"LOK1378_1mm";"SILVA (only NR);Bacteria;Proteobacteria;Zetaproteobacteria;Mariprofundales;Mariprofundaceae;Mariprofundus;";"0.0";"0";"136";"135";"0";"135";"1";"430389";"5766"
"LOK1378_1mm";"SILVA (only NR);Bacteria;RCP2-54;";"0.0";"0";"137";"132";"0";"132";"5";"430392";"5766"
"LOK1378_1mm";"SILVA (only NR);Bacteria;Rs-K70 termite group;";"0.0";"0";"31";"31";"0";"31";"0";"430493";"5766"
"LOK1378_1mm";"SILVA (only NR);Bacteria;SAR324 clade(Marine group B);";"0.0";"0";"629";"610";"0";"610";"19";"429914";"5766"
"LOK1378_1mm";"SILVA (only NR);Bacteria;Schekmanbacteria;";"0.0";"0";"42";"41";"0";"41";"1";"430483";"5766"
"LOK1378_1mm";"SILVA (only NR);Bacteria;Spirochaetota;";"0.0";"0";"4069";"3940";"0";"3940";"129";"426584";"5766"
"LOK1378_1mm";"SILVA (only NR);Bacteria;Spirochaetota;Brachyspirae;";"0.0";"0";"111";"108";"0";"108";"3";"430416";"5766"
"LOK1378_1mm";"SILVA (only NR);Bacteria;Spirochaetota;Brachyspirae;Brachyspirales;";"0.0";"0";"111";"108";"0";"108";"3";"430416";"5766"
"LOK1378_1mm";"SILVA (only NR);Bacteria;Spirochaetota;Brachyspirae;Brachyspirales;Brachyspiraceae;";"0.0";"0";"63";"62";"0";"62";"1";"430462";"5766"
"LOK1378_1mm";"SILVA (only NR);Bacteria;Spirochaetota;Brachyspirae;Brachyspirales;Brachyspiraceae;Brachyspira;";"0.0";"0";"63";"62";"0";"62";"1";"430462";"5766"
"LOK1378_1mm";"SILVA (only NR);Bacteria;Spirochaetota;Brachyspirae;Brachyspirales;Brachyspirales Incertae Sedis;";"0.0";"0";"15";"15";"0";"15";"0";"430509";"5766"
"LOK1378_1mm";"SILVA (only NR);Bacteria;Spirochaetota;Brachyspirae;Brachyspirales;Brachyspirales Incertae Sedis;Exilispira;";"0.0";"0";"15";"15";"0";"15";"0";"430509";"5766"
"LOK1378_1mm";"SILVA (only NR);Bacteria;Spirochaetota;Brachyspirae;Brachyspirales;LH041;";"0.0";"0";"33";"31";"0";"31";"2";"430493";"5766"
"LOK1378_1mm";"SILVA (only NR);Bacteria;Spirochaetota;Brevinematia;";"0.0";"0";"17";"17";"0";"17";"0";"430507";"5766"
"LOK1378_1mm";"SILVA (only NR);Bacteria;Spirochaetota;Brevinematia;Brevinematales;";"0.0";"0";"17";"17";"0";"17";"0";"430507";"5766"
"LOK1378_1mm";"SILVA (only NR);Bacteria;Spirochaetota;Brevinematia;Brevinematales;Brevinemataceae;";"0.0";"0";"17";"17";"0";"17";"0";"430507";"5766"
"LOK1378_1mm";"SILVA (only NR);Bacteria;Spirochaetota;Brevinematia;Brevinematales;Brevinemataceae;Brevinema;";"0.0";"0";"17";"17";"0";"17";"0";"430507";"5766"
"LOK1378_1mm";"SILVA (only NR);Bacteria;Spirochaetota;Leptospirae;";"0.0";"0";"336";"331";"0";"331";"5";"430193";"5766"
"LOK1378_1mm";"SILVA (only NR);Bacteria;Spirochaetota;Leptospirae;Leptospirales;";"0.0";"0";"336";"331";"0";"331";"5";"430193";"5766"
"LOK1378_1mm";"SILVA (only NR);Bacteria;Spirochaetota;Leptospirae;Leptospirales;Leptospiraceae;";"0.0";"0";"336";"331";"0";"331";"5";"430193";"5766"
"LOK1378_1mm";"SILVA (only NR);Bacteria;Spirochaetota;Leptospirae;Leptospirales;Leptospiraceae;Leptonema;";"0.0";"0";"5";"5";"0";"5";"0";"430519";"5766"
"LOK1378_1mm";"SILVA (only NR);Bacteria;Spirochaetota;Leptospirae;Leptospirales;Leptospiraceae;Leptospira;";"0.0";"0";"178";"178";"0";"178";"0";"430346";"5766"
"LOK1378_1mm";"SILVA (only NR);Bacteria;Spirochaetota;Leptospirae;Leptospirales;Leptospiraceae;RBG-16-49-21;";"0.0";"0";"104";"99";"0";"99";"5";"430425";"5766"
"LOK1378_1mm";"SILVA (only NR);Bacteria;Spirochaetota;Leptospirae;Leptospirales;Leptospiraceae;Rs-H88 termite group;";"0.0";"0";"6";"6";"0";"6";"0";"430518";"5766"
"LOK1378_1mm";"SILVA (only NR);Bacteria;Spirochaetota;Leptospirae;Leptospirales;Leptospiraceae;Turneriella;";"0.0";"0";"16";"16";"0";"16";"0";"430508";"5766"
"LOK1378_1mm";"SILVA (only NR);Bacteria;Spirochaetota;Leptospirae;Leptospirales;Leptospiraceae;uncultured;";"0.0";"0";"25";"25";"0";"25";"0";"430499";"5766"
"LOK1378_1mm";"SILVA (only NR);Bacteria;Spirochaetota;MVP-15;";"0.0";"0";"66";"62";"0";"62";"4";"430462";"5766"
"LOK1378_1mm";"SILVA (only NR);Bacteria;Spirochaetota;Spirochaetia;";"0.0";"0";"3514";"3397";"0";"3397";"117";"427127";"5766"
"LOK1378_1mm";"SILVA (only NR);Bacteria;Spirochaetota;Spirochaetia;Spirochaetales;";"0.0";"0";"3514";"3397";"0";"3397";"117";"427127";"5766"
"LOK1378_1mm";"SILVA (only NR);Bacteria;Spirochaetota;Spirochaetia;Spirochaetales;Spirochaetaceae;";"0.0";"0";"3514";"3397";"0";"3397";"117";"427127";"5766"
"LOK1378_1mm";"SILVA (only NR);Bacteria;Spirochaetota;Spirochaetia;Spirochaetales;Spirochaetaceae;Alkalispirochaeta;";"0.0";"0";"44";"42";"0";"42";"2";"430482";"5766"
"LOK1378_1mm";"SILVA (only NR);Bacteria;Spirochaetota;Spirochaetia;Spirochaetales;Spirochaetaceae;Borrelia;";"0.0";"0";"58";"54";"0";"54";"4";"430470";"5766"
"LOK1378_1mm";"SILVA (only NR);Bacteria;Spirochaetota;Spirochaetia;Spirochaetales;Spirochaetaceae;Borreliella;";"0.0";"0";"59";"58";"0";"58";"1";"430466";"5766"
"LOK1378_1mm";"SILVA (only NR);Bacteria;Spirochaetota;Spirochaetia;Spirochaetales;Spirochaetaceae;Candidatus Marispirochaeta;";"0.0";"0";"35";"34";"0";"34";"1";"430490";"5766"
"LOK1378_1mm";"SILVA (only NR);Bacteria;Spirochaetota;Spirochaetia;Spirochaetales;Spirochaetaceae;GWE2-31-10;";"0.0";"0";"22";"21";"0";"21";"1";"430503";"5766"
"LOK1378_1mm";"SILVA (only NR);Bacteria;Spirochaetota;Spirochaetia;Spirochaetales;Spirochaetaceae;M2PT2-76 termite group;";"0.0";"0";"11";"11";"0";"11";"0";"430513";"5766"
"LOK1378_1mm";"SILVA (only NR);Bacteria;Spirochaetota;Spirochaetia;Spirochaetales;Spirochaetaceae;Salinispira;";"0.0";"0";"11";"11";"0";"11";"0";"430513";"5766"
"LOK1378_1mm";"SILVA (only NR);Bacteria;Spirochaetota;Spirochaetia;Spirochaetales;Spirochaetaceae;Sediminispirochaeta;";"0.0";"0";"182";"177";"0";"177";"5";"430347";"5766"
"LOK1378_1mm";"SILVA (only NR);Bacteria;Spirochaetota;Spirochaetia;Spirochaetales;Spirochaetaceae;Sphaerochaeta;";"0.0";"0";"198";"181";"0";"181";"17";"430343";"5766"
"LOK1378_1mm";"SILVA (only NR);Bacteria;Spirochaetota;Spirochaetia;Spirochaetales;Spirochaetaceae;Spirochaeta 2;";"0.0";"0";"404";"382";"0";"382";"22";"430142";"5766"
"LOK1378_1mm";"SILVA (only NR);Bacteria;Spirochaetota;Spirochaetia;Spirochaetales;Spirochaetaceae;Spirochaeta;";"0.0";"0";"412";"393";"0";"393";"19";"430131";"5766"
"LOK1378_1mm";"SILVA (only NR);Bacteria;Spirochaetota;Spirochaetia;Spirochaetales;Spirochaetaceae;Termite Treponema cluster;";"0.0";"0";"261";"259";"0";"259";"2";"430265";"5766"
"LOK1378_1mm";"SILVA (only NR);Bacteria;Spirochaetota;Spirochaetia;Spirochaetales;Spirochaetaceae;Treponema;";"0.0";"0";"1427";"1403";"0";"1403";"24";"429121";"5766"
"LOK1378_1mm";"SILVA (only NR);Bacteria;Spirochaetota;Spirochaetia;Spirochaetales;Spirochaetaceae;uncultured;";"0.0";"0";"390";"371";"0";"371";"19";"430153";"5766"
"LOK1378_1mm";"SILVA (only NR);Bacteria;Spirochaetota;V2072-189E03;";"0.0";"0";"16";"16";"0";"16";"0";"430508";"5766"
"LOK1378_1mm";"SILVA (only NR);Bacteria;Spirochaetota;uncultured;";"0.0";"0";"7";"7";"0";"7";"0";"430517";"5766"
"LOK1378_1mm";"SILVA (only NR);Bacteria;Sumerlaeota;";"0.0";"0";"392";"358";"0";"358";"34";"430166";"5766"
"LOK1378_1mm";"SILVA (only NR);Bacteria;Sumerlaeota;Sumerlaeia;";"0.0";"0";"392";"358";"0";"358";"34";"430166";"5766"
"LOK1378_1mm";"SILVA (only NR);Bacteria;Sumerlaeota;Sumerlaeia;Sumerlaeales;";"0.0";"0";"261";"245";"0";"245";"16";"430279";"5766"
"LOK1378_1mm";"SILVA (only NR);Bacteria;Sumerlaeota;Sumerlaeia;Sumerlaeales;Sumerlaeaceae;";"0.0";"0";"261";"245";"0";"245";"16";"430279";"5766"
"LOK1378_1mm";"SILVA (only NR);Bacteria;Sumerlaeota;Sumerlaeia;Sumerlaeales;Sumerlaeaceae;Sumerlaea;";"0.0";"0";"261";"245";"0";"245";"16";"430279";"5766"
"LOK1378_1mm";"SILVA (only NR);Bacteria;Sumerlaeota;Sumerlaeia;uncultured;";"0.0";"0";"131";"113";"0";"113";"18";"430411";"5766"
"LOK1378_1mm";"SILVA (only NR);Bacteria;Sva0485;";"0.0";"0";"387";"366";"0";"366";"21";"430158";"5766"
"LOK1378_1mm";"SILVA (only NR);Bacteria;Synergistota;";"0.0";"0";"925";"913";"0";"913";"12";"429611";"5766"
"LOK1378_1mm";"SILVA (only NR);Bacteria;Synergistota;Synergistia;";"0.0";"0";"925";"913";"0";"913";"12";"429611";"5766"
"LOK1378_1mm";"SILVA (only NR);Bacteria;Synergistota;Synergistia;Synergistales;";"0.0";"0";"925";"913";"0";"913";"12";"429611";"5766"
"LOK1378_1mm";"SILVA (only NR);Bacteria;Synergistota;Synergistia;Synergistales;Synergistaceae;";"0.0";"0";"925";"913";"0";"913";"12";"429611";"5766"
"LOK1378_1mm";"SILVA (only NR);Bacteria;Synergistota;Synergistia;Synergistales;Synergistaceae;Acetomicrobium;";"0.0";"0";"33";"33";"0";"33";"0";"430491";"5766"
"LOK1378_1mm";"SILVA (only NR);Bacteria;Synergistota;Synergistia;Synergistales;Synergistaceae;Aminiphilus;";"0.0";"0";"7";"7";"0";"7";"0";"430517";"5766"
"LOK1378_1mm";"SILVA (only NR);Bacteria;Synergistota;Synergistia;Synergistales;Synergistaceae;Aminivibrio;";"0.0";"0";"12";"12";"0";"12";"0";"430512";"5766"
"LOK1378_1mm";"SILVA (only NR);Bacteria;Synergistota;Synergistia;Synergistales;Synergistaceae;Aminobacterium;";"0.0";"0";"22";"22";"0";"22";"0";"430502";"5766"
"LOK1378_1mm";"SILVA (only NR);Bacteria;Synergistota;Synergistia;Synergistales;Synergistaceae;Aminomonas;";"0.0";"0";"3";"3";"0";"3";"0";"430521";"5766"
"LOK1378_1mm";"SILVA (only NR);Bacteria;Synergistota;Synergistia;Synergistales;Synergistaceae;Candidatus Tammella;";"0.0";"0";"25";"25";"0";"25";"0";"430499";"5766"
"LOK1378_1mm";"SILVA (only NR);Bacteria;Synergistota;Synergistia;Synergistales;Synergistaceae;Cloacibacillus;";"0.0";"0";"22";"22";"0";"22";"0";"430502";"5766"
"LOK1378_1mm";"SILVA (only NR);Bacteria;Synergistota;Synergistia;Synergistales;Synergistaceae;Dethiosulfovibrio;";"0.0";"0";"13";"12";"0";"12";"1";"430512";"5766"
"LOK1378_1mm";"SILVA (only NR);Bacteria;Synergistota;Synergistia;Synergistales;Synergistaceae;EBM-39;";"0.0";"0";"9";"9";"0";"9";"0";"430515";"5766"
"LOK1378_1mm";"SILVA (only NR);Bacteria;Synergistota;Synergistia;Synergistales;Synergistaceae;Fretibacterium;";"0.0";"0";"181";"180";"0";"180";"1";"430344";"5766"
"LOK1378_1mm";"SILVA (only NR);Bacteria;Synergistota;Synergistia;Synergistales;Synergistaceae;JGI-0000079-D21;";"0.0";"0";"50";"48";"0";"48";"2";"430476";"5766"
"LOK1378_1mm";"SILVA (only NR);Bacteria;Synergistota;Synergistia;Synergistales;Synergistaceae;Jonquetella;";"0.0";"0";"1";"1";"0";"1";"0";"430523";"5766"
"LOK1378_1mm";"SILVA (only NR);Bacteria;Synergistota;Synergistia;Synergistales;Synergistaceae;Lactivibrio;";"0.0";"0";"15";"14";"0";"14";"1";"430510";"5766"
"LOK1378_1mm";"SILVA (only NR);Bacteria;Synergistota;Synergistia;Synergistales;Synergistaceae;Pyramidobacter;";"0.0";"0";"29";"29";"0";"29";"0";"430495";"5766"
"LOK1378_1mm";"SILVA (only NR);Bacteria;Synergistota;Synergistia;Synergistales;Synergistaceae;Syner-01;";"0.0";"0";"48";"48";"0";"48";"0";"430476";"5766"
"LOK1378_1mm";"SILVA (only NR);Bacteria;Synergistota;Synergistia;Synergistales;Synergistaceae;Synergistes;";"0.0";"0";"4";"4";"0";"4";"0";"430520";"5766"
"LOK1378_1mm";"SILVA (only NR);Bacteria;Synergistota;Synergistia;Synergistales;Synergistaceae;Thermanaerovibrio;";"0.0";"0";"4";"4";"0";"4";"0";"430520";"5766"
"LOK1378_1mm";"SILVA (only NR);Bacteria;Synergistota;Synergistia;Synergistales;Synergistaceae;Thermovirga;";"0.0";"0";"88";"87";"0";"87";"1";"430437";"5766"
"LOK1378_1mm";"SILVA (only NR);Bacteria;Synergistota;Synergistia;Synergistales;Synergistaceae;uncultured;";"0.0";"0";"358";"352";"0";"352";"6";"430172";"5766"
"LOK1378_1mm";"SILVA (only NR);Bacteria;TA06;";"0.0";"0";"72";"67";"0";"67";"5";"430457";"5766"
"LOK1378_1mm";"SILVA (only NR);Bacteria;TX1A-33;";"0.0";"0";"4";"4";"0";"4";"0";"430520";"5766"
"LOK1378_1mm";"SILVA (only NR);Bacteria;Thermodesulfobiota;";"0.0";"0";"7";"7";"0";"7";"0";"430517";"5766"
"LOK1378_1mm";"SILVA (only NR);Bacteria;Thermodesulfobiota;Thermodesulfobiia;";"0.0";"0";"7";"7";"0";"7";"0";"430517";"5766"
"LOK1378_1mm";"SILVA (only NR);Bacteria;Thermodesulfobiota;Thermodesulfobiia;Thermodesulfobiales;";"0.0";"0";"7";"7";"0";"7";"0";"430517";"5766"
"LOK1378_1mm";"SILVA (only NR);Bacteria;Thermodesulfobiota;Thermodesulfobiia;Thermodesulfobiales;Thermodesulfobiaceae;";"0.0";"0";"7";"7";"0";"7";"0";"430517";"5766"
"LOK1378_1mm";"SILVA (only NR);Bacteria;Thermodesulfobiota;Thermodesulfobiia;Thermodesulfobiales;Thermodesulfobiaceae;Thermodesulfobium;";"0.0";"0";"7";"7";"0";"7";"0";"430517";"5766"
"LOK1378_1mm";"SILVA (only NR);Bacteria;Thermosulfidibacterota;";"0.0";"0";"3";"3";"0";"3";"0";"430521";"5766"
"LOK1378_1mm";"SILVA (only NR);Bacteria;Thermosulfidibacterota;Thermosulfidibacteria;";"0.0";"0";"3";"3";"0";"3";"0";"430521";"5766"
"LOK1378_1mm";"SILVA (only NR);Bacteria;Thermosulfidibacterota;Thermosulfidibacteria;Thermosulfidibacterales;";"0.0";"0";"3";"3";"0";"3";"0";"430521";"5766"
"LOK1378_1mm";"SILVA (only NR);Bacteria;Thermosulfidibacterota;Thermosulfidibacteria;Thermosulfidibacterales;Thermosulfidibacteraceae;";"0.0";"0";"3";"3";"0";"3";"0";"430521";"5766"
"LOK1378_1mm";"SILVA (only NR);Bacteria;Thermosulfidibacterota;Thermosulfidibacteria;Thermosulfidibacterales;Thermosulfidibacteraceae;Thermosulfidibacter;";"0.0";"0";"3";"3";"0";"3";"0";"430521";"5766"
"LOK1378_1mm";"SILVA (only NR);Bacteria;Thermotogota;";"0.0";"0";"288";"273";"0";"273";"15";"430251";"5766"
"LOK1378_1mm";"SILVA (only NR);Bacteria;Thermotogota;Thermotogae;";"0.0";"0";"288";"273";"0";"273";"15";"430251";"5766"
"LOK1378_1mm";"SILVA (only NR);Bacteria;Thermotogota;Thermotogae;Kosmotogales;";"0.0";"0";"46";"42";"0";"42";"4";"430482";"5766"
"LOK1378_1mm";"SILVA (only NR);Bacteria;Thermotogota;Thermotogae;Kosmotogales;Kosmotogaceae;";"0.0";"0";"46";"42";"0";"42";"4";"430482";"5766"
"LOK1378_1mm";"SILVA (only NR);Bacteria;Thermotogota;Thermotogae;Kosmotogales;Kosmotogaceae;Kosmotoga;";"0.0";"0";"7";"7";"0";"7";"0";"430517";"5766"
"LOK1378_1mm";"SILVA (only NR);Bacteria;Thermotogota;Thermotogae;Kosmotogales;Kosmotogaceae;Mesotoga;";"0.0";"0";"34";"30";"0";"30";"4";"430494";"5766"
"LOK1378_1mm";"SILVA (only NR);Bacteria;Thermotogota;Thermotogae;Kosmotogales;Kosmotogaceae;uncultured;";"0.0";"0";"5";"5";"0";"5";"0";"430519";"5766"
"LOK1378_1mm";"SILVA (only NR);Bacteria;Thermotogota;Thermotogae;Mesoaciditogales;";"0.0";"0";"15";"15";"0";"15";"0";"430509";"5766"
"LOK1378_1mm";"SILVA (only NR);Bacteria;Thermotogota;Thermotogae;Mesoaciditogales;Mesoaciditogaceae;";"0.0";"0";"15";"15";"0";"15";"0";"430509";"5766"
"LOK1378_1mm";"SILVA (only NR);Bacteria;Thermotogota;Thermotogae;Mesoaciditogales;Mesoaciditogaceae;Mesoaciditoga;";"0.0";"0";"13";"13";"0";"13";"0";"430511";"5766"
"LOK1378_1mm";"SILVA (only NR);Bacteria;Thermotogota;Thermotogae;Mesoaciditogales;Mesoaciditogaceae;uncultured;";"0.0";"0";"2";"2";"0";"2";"0";"430522";"5766"
"LOK1378_1mm";"SILVA (only NR);Bacteria;Thermotogota;Thermotogae;Petrotogales;";"0.0";"0";"95";"95";"0";"95";"0";"430429";"5766"
"LOK1378_1mm";"SILVA (only NR);Bacteria;Thermotogota;Thermotogae;Petrotogales;Petrotogaceae;";"0.0";"0";"95";"95";"0";"95";"0";"430429";"5766"
"LOK1378_1mm";"SILVA (only NR);Bacteria;Thermotogota;Thermotogae;Petrotogales;Petrotogaceae;AUTHM297;";"0.0";"0";"4";"4";"0";"4";"0";"430520";"5766"
"LOK1378_1mm";"SILVA (only NR);Bacteria;Thermotogota;Thermotogae;Petrotogales;Petrotogaceae;Defluviitoga;";"0.0";"0";"34";"34";"0";"34";"0";"430490";"5766"
"LOK1378_1mm";"SILVA (only NR);Bacteria;Thermotogota;Thermotogae;Petrotogales;Petrotogaceae;Geotoga;";"0.0";"0";"4";"4";"0";"4";"0";"430520";"5766"
"LOK1378_1mm";"SILVA (only NR);Bacteria;Thermotogota;Thermotogae;Petrotogales;Petrotogaceae;Marinitoga;";"0.0";"0";"10";"10";"0";"10";"0";"430514";"5766"
"LOK1378_1mm";"SILVA (only NR);Bacteria;Thermotogota;Thermotogae;Petrotogales;Petrotogaceae;Oceanotoga;";"0.0";"0";"2";"2";"0";"2";"0";"430522";"5766"
"LOK1378_1mm";"SILVA (only NR);Bacteria;Thermotogota;Thermotogae;Petrotogales;Petrotogaceae;Petrotoga;";"0.0";"0";"16";"16";"0";"16";"0";"430508";"5766"
"LOK1378_1mm";"SILVA (only NR);Bacteria;Thermotogota;Thermotogae;Petrotogales;Petrotogaceae;SC103;";"0.0";"0";"24";"24";"0";"24";"0";"430500";"5766"
"LOK1378_1mm";"SILVA (only NR);Bacteria;Thermotogota;Thermotogae;Thermotogales;";"0.0";"0";"129";"119";"0";"119";"10";"430405";"5766"
"LOK1378_1mm";"SILVA (only NR);Bacteria;Thermotogota;Thermotogae;Thermotogales;Fervidobacteriaceae;";"0.0";"0";"74";"66";"0";"66";"8";"430458";"5766"
"LOK1378_1mm";"SILVA (only NR);Bacteria;Thermotogota;Thermotogae;Thermotogales;Fervidobacteriaceae;Fervidobacterium;";"0.0";"0";"48";"44";"0";"44";"4";"430480";"5766"
"LOK1378_1mm";"SILVA (only NR);Bacteria;Thermotogota;Thermotogae;Thermotogales;Fervidobacteriaceae;Thermopallium;";"0.0";"0";"3";"3";"0";"3";"0";"430521";"5766"
"LOK1378_1mm";"SILVA (only NR);Bacteria;Thermotogota;Thermotogae;Thermotogales;Fervidobacteriaceae;Thermosipho;";"0.0";"0";"23";"19";"0";"19";"4";"430505";"5766"
"LOK1378_1mm";"SILVA (only NR);Bacteria;Thermotogota;Thermotogae;Thermotogales;Thermotogaceae;";"0.0";"0";"55";"53";"0";"53";"2";"430471";"5766"
"LOK1378_1mm";"SILVA (only NR);Bacteria;Thermotogota;Thermotogae;Thermotogales;Thermotogaceae;Pseudothermotoga;";"0.0";"0";"27";"27";"0";"27";"0";"430497";"5766"
"LOK1378_1mm";"SILVA (only NR);Bacteria;Thermotogota;Thermotogae;Thermotogales;Thermotogaceae;Thermotoga;";"0.0";"0";"28";"26";"0";"26";"2";"430498";"5766"
"LOK1378_1mm";"SILVA (only NR);Bacteria;Thermotogota;Thermotogae;uncultured;";"0.0";"0";"2";"1";"0";"1";"1";"430523";"5766"
"LOK1378_1mm";"SILVA (only NR);Bacteria;Verrucomicrobiota;";"0.0";"0";"6648";"6382";"0";"6382";"266";"424142";"5766"
"LOK1378_1mm";"SILVA (only NR);Bacteria;Verrucomicrobiota;Chlamydiae;";"0.0";"0";"519";"503";"0";"503";"16";"430021";"5766"
"LOK1378_1mm";"SILVA (only NR);Bacteria;Verrucomicrobiota;Chlamydiae;Chlamydiales;";"0.0";"0";"433";"420";"0";"420";"13";"430104";"5766"
"LOK1378_1mm";"SILVA (only NR);Bacteria;Verrucomicrobiota;Chlamydiae;Chlamydiales;Chlamydiaceae;";"0.0";"0";"251";"249";"0";"249";"2";"430275";"5766"
"LOK1378_1mm";"SILVA (only NR);Bacteria;Verrucomicrobiota;Chlamydiae;Chlamydiales;Chlamydiaceae;Candidatus Amphibiichlamydia;";"0.0";"0";"3";"3";"0";"3";"0";"430521";"5766"
"LOK1378_1mm";"SILVA (only NR);Bacteria;Verrucomicrobiota;Chlamydiae;Chlamydiales;Chlamydiaceae;Candidatus Clavichlamydia;";"0.0";"0";"2";"2";"0";"2";"0";"430522";"5766"
"LOK1378_1mm";"SILVA (only NR);Bacteria;Verrucomicrobiota;Chlamydiae;Chlamydiales;Chlamydiaceae;Chlamydia;";"0.0";"0";"233";"232";"0";"232";"1";"430292";"5766"
"LOK1378_1mm";"SILVA (only NR);Bacteria;Verrucomicrobiota;Chlamydiae;Chlamydiales;Chlamydiaceae;uncultured;";"0.0";"0";"10";"10";"0";"10";"0";"430514";"5766"
"LOK1378_1mm";"SILVA (only NR);Bacteria;Verrucomicrobiota;Chlamydiae;Chlamydiales;Chlamydiales Incertae Sedis;";"0.0";"0";"15";"13";"0";"13";"2";"430511";"5766"
"LOK1378_1mm";"SILVA (only NR);Bacteria;Verrucomicrobiota;Chlamydiae;Chlamydiales;Chlamydiales Incertae Sedis;Candidatus Piscichlamydia;";"0.0";"0";"3";"1";"0";"1";"2";"430523";"5766"
"LOK1378_1mm";"SILVA (only NR);Bacteria;Verrucomicrobiota;Chlamydiae;Chlamydiales;Chlamydiales Incertae Sedis;Candidatus Similichlamydia;";"0.0";"0";"11";"11";"0";"11";"0";"430513";"5766"
"LOK1378_1mm";"SILVA (only NR);Bacteria;Verrucomicrobiota;Chlamydiae;Chlamydiales;Criblamydiaceae;";"0.0";"0";"6";"6";"0";"6";"0";"430518";"5766"
"LOK1378_1mm";"SILVA (only NR);Bacteria;Verrucomicrobiota;Chlamydiae;Chlamydiales;Criblamydiaceae;Criblamydia;";"0.0";"0";"1";"1";"0";"1";"0";"430523";"5766"
"LOK1378_1mm";"SILVA (only NR);Bacteria;Verrucomicrobiota;Chlamydiae;Chlamydiales;Criblamydiaceae;Estrella;";"0.0";"0";"1";"1";"0";"1";"0";"430523";"5766"
"LOK1378_1mm";"SILVA (only NR);Bacteria;Verrucomicrobiota;Chlamydiae;Chlamydiales;Criblamydiaceae;uncultured;";"0.0";"0";"2";"2";"0";"2";"0";"430522";"5766"
"LOK1378_1mm";"SILVA (only NR);Bacteria;Verrucomicrobiota;Chlamydiae;Chlamydiales;Parachlamydiaceae;";"0.0";"0";"62";"59";"0";"59";"3";"430465";"5766"
"LOK1378_1mm";"SILVA (only NR);Bacteria;Verrucomicrobiota;Chlamydiae;Chlamydiales;Parachlamydiaceae;Candidatus Mesochlamydia;";"0.0";"0";"1";"1";"0";"1";"0";"430523";"5766"
"LOK1378_1mm";"SILVA (only NR);Bacteria;Verrucomicrobiota;Chlamydiae;Chlamydiales;Parachlamydiaceae;Candidatus Metachlamydia;";"0.0";"0";"1";"1";"0";"1";"0";"430523";"5766"
"LOK1378_1mm";"SILVA (only NR);Bacteria;Verrucomicrobiota;Chlamydiae;Chlamydiales;Parachlamydiaceae;Candidatus Protochlamydia;";"0.0";"0";"19";"19";"0";"19";"0";"430505";"5766"
"LOK1378_1mm";"SILVA (only NR);Bacteria;Verrucomicrobiota;Chlamydiae;Chlamydiales;Parachlamydiaceae;Candidatus Rubidus;";"0.0";"0";"1";"1";"0";"1";"0";"430523";"5766"
"LOK1378_1mm";"SILVA (only NR);Bacteria;Verrucomicrobiota;Chlamydiae;Chlamydiales;Parachlamydiaceae;Neochlamydia;";"0.0";"0";"25";"23";"0";"23";"2";"430501";"5766"
"LOK1378_1mm";"SILVA (only NR);Bacteria;Verrucomicrobiota;Chlamydiae;Chlamydiales;Parachlamydiaceae;Parachlamydia;";"0.0";"0";"6";"6";"0";"6";"0";"430518";"5766"
"LOK1378_1mm";"SILVA (only NR);Bacteria;Verrucomicrobiota;Chlamydiae;Chlamydiales;Parachlamydiaceae;uncultured;";"0.0";"0";"7";"6";"0";"6";"1";"430518";"5766"
"LOK1378_1mm";"SILVA (only NR);Bacteria;Verrucomicrobiota;Chlamydiae;Chlamydiales;Simkaniaceae;";"0.0";"0";"70";"66";"0";"66";"4";"430458";"5766"
"LOK1378_1mm";"SILVA (only NR);Bacteria;Verrucomicrobiota;Chlamydiae;Chlamydiales;Simkaniaceae;Candidatus Fritschea;";"0.0";"0";"5";"4";"0";"4";"1";"430520";"5766"
"LOK1378_1mm";"SILVA (only NR);Bacteria;Verrucomicrobiota;Chlamydiae;Chlamydiales;Simkaniaceae;Candidatus Renichlamydia;";"0.0";"0";"2";"2";"0";"2";"0";"430522";"5766"
"LOK1378_1mm";"SILVA (only NR);Bacteria;Verrucomicrobiota;Chlamydiae;Chlamydiales;Simkaniaceae;Candidatus Rhabdochlamydia;";"0.0";"0";"6";"6";"0";"6";"0";"430518";"5766"
"LOK1378_1mm";"SILVA (only NR);Bacteria;Verrucomicrobiota;Chlamydiae;Chlamydiales;Simkaniaceae;Ga0074140;";"0.0";"0";"3";"3";"0";"3";"0";"430521";"5766"
"LOK1378_1mm";"SILVA (only NR);Bacteria;Verrucomicrobiota;Chlamydiae;Chlamydiales;Simkaniaceae;Simkania;";"0.0";"0";"2";"2";"0";"2";"0";"430522";"5766"
"LOK1378_1mm";"SILVA (only NR);Bacteria;Verrucomicrobiota;Chlamydiae;Chlamydiales;Simkaniaceae;uncultured;";"0.0";"0";"51";"48";"0";"48";"3";"430476";"5766"
"LOK1378_1mm";"SILVA (only NR);Bacteria;Verrucomicrobiota;Chlamydiae;Chlamydiales;Waddliaceae;";"0.0";"0";"6";"6";"0";"6";"0";"430518";"5766"
"LOK1378_1mm";"SILVA (only NR);Bacteria;Verrucomicrobiota;Chlamydiae;Chlamydiales;Waddliaceae;Waddlia;";"0.0";"0";"6";"6";"0";"6";"0";"430518";"5766"
"LOK1378_1mm";"SILVA (only NR);Bacteria;Verrucomicrobiota;Chlamydiae;Chlamydiales;cvE6;";"0.0";"0";"22";"20";"0";"20";"2";"430504";"5766"
"LOK1378_1mm";"SILVA (only NR);Bacteria;Verrucomicrobiota;Chlamydiae;LD1-PA32;";"0.0";"0";"86";"83";"0";"83";"3";"430441";"5766"
"LOK1378_1mm";"SILVA (only NR);Bacteria;Verrucomicrobiota;Kiritimatiellae;";"0.0";"0";"971";"947";"0";"947";"24";"429577";"5766"
"LOK1378_1mm";"SILVA (only NR);Bacteria;Verrucomicrobiota;Kiritimatiellae;113B434;";"0.0";"0";"4";"4";"0";"4";"0";"430520";"5766"
"LOK1378_1mm";"SILVA (only NR);Bacteria;Verrucomicrobiota;Kiritimatiellae;Kiritimatiellales;";"0.0";"0";"106";"105";"0";"105";"1";"430419";"5766"
"LOK1378_1mm";"SILVA (only NR);Bacteria;Verrucomicrobiota;Kiritimatiellae;Kiritimatiellales;Kiritimatiellaceae;";"0.0";"0";"106";"105";"0";"105";"1";"430419";"5766"
"LOK1378_1mm";"SILVA (only NR);Bacteria;Verrucomicrobiota;Kiritimatiellae;Kiritimatiellales;Kiritimatiellaceae;Kiritimatiella;";"0.0";"0";"3";"3";"0";"3";"0";"430521";"5766"
"LOK1378_1mm";"SILVA (only NR);Bacteria;Verrucomicrobiota;Kiritimatiellae;Kiritimatiellales;Kiritimatiellaceae;MSBL3;";"0.0";"0";"36";"35";"0";"35";"1";"430489";"5766"
"LOK1378_1mm";"SILVA (only NR);Bacteria;Verrucomicrobiota;Kiritimatiellae;Kiritimatiellales;Kiritimatiellaceae;R76-B128;";"0.0";"0";"65";"65";"0";"65";"0";"430459";"5766"
"LOK1378_1mm";"SILVA (only NR);Bacteria;Verrucomicrobiota;Kiritimatiellae;Kiritimatiellales;Kiritimatiellaceae;uncultured;";"0.0";"0";"2";"2";"0";"2";"0";"430522";"5766"
"LOK1378_1mm";"SILVA (only NR);Bacteria;Verrucomicrobiota;Kiritimatiellae;WCHB1-41;";"0.0";"0";"861";"838";"0";"838";"23";"429686";"5766"
"LOK1378_1mm";"SILVA (only NR);Bacteria;Verrucomicrobiota;Lentisphaeria;";"0.0";"0";"472";"461";"0";"461";"11";"430063";"5766"
"LOK1378_1mm";"SILVA (only NR);Bacteria;Verrucomicrobiota;Lentisphaeria;Lentisphaerales;";"0.0";"0";"33";"33";"0";"33";"0";"430491";"5766"
"LOK1378_1mm";"SILVA (only NR);Bacteria;Verrucomicrobiota;Lentisphaeria;Lentisphaerales;Lentisphaeraceae;";"0.0";"0";"33";"33";"0";"33";"0";"430491";"5766"
"LOK1378_1mm";"SILVA (only NR);Bacteria;Verrucomicrobiota;Lentisphaeria;Lentisphaerales;Lentisphaeraceae;Lentisphaera;";"0.0";"0";"33";"33";"0";"33";"0";"430491";"5766"
"LOK1378_1mm";"SILVA (only NR);Bacteria;Verrucomicrobiota;Lentisphaeria;Oligosphaerales;";"0.0";"0";"198";"192";"0";"192";"6";"430332";"5766"
"LOK1378_1mm";"SILVA (only NR);Bacteria;Verrucomicrobiota;Lentisphaeria;Oligosphaerales;Lenti-02;";"0.0";"0";"112";"108";"0";"108";"4";"430416";"5766"
"LOK1378_1mm";"SILVA (only NR);Bacteria;Verrucomicrobiota;Lentisphaeria;Oligosphaerales;Oligosphaeraceae;";"0.0";"0";"84";"82";"0";"82";"2";"430442";"5766"
"LOK1378_1mm";"SILVA (only NR);Bacteria;Verrucomicrobiota;Lentisphaeria;Oligosphaerales;Oligosphaeraceae;ADurb.Bin063-2;";"0.0";"0";"16";"16";"0";"16";"0";"430508";"5766"
"LOK1378_1mm";"SILVA (only NR);Bacteria;Verrucomicrobiota;Lentisphaeria;Oligosphaerales;Oligosphaeraceae;Oligosphaera;";"0.0";"0";"4";"4";"0";"4";"0";"430520";"5766"
"LOK1378_1mm";"SILVA (only NR);Bacteria;Verrucomicrobiota;Lentisphaeria;Oligosphaerales;Oligosphaeraceae;SBZC-1223;";"0.0";"0";"6";"6";"0";"6";"0";"430518";"5766"
"LOK1378_1mm";"SILVA (only NR);Bacteria;Verrucomicrobiota;Lentisphaeria;Oligosphaerales;Oligosphaeraceae;Z20;";"0.0";"0";"37";"35";"0";"35";"2";"430489";"5766"
"LOK1378_1mm";"SILVA (only NR);Bacteria;Verrucomicrobiota;Lentisphaeria;Oligosphaerales;Oligosphaeraceae;horsej-a03;";"0.0";"0";"18";"18";"0";"18";"0";"430506";"5766"
"LOK1378_1mm";"SILVA (only NR);Bacteria;Verrucomicrobiota;Lentisphaeria;Oligosphaerales;uncultured;";"0.0";"0";"2";"2";"0";"2";"0";"430522";"5766"
"LOK1378_1mm";"SILVA (only NR);Bacteria;Verrucomicrobiota;Lentisphaeria;P.palmC41;";"0.0";"0";"25";"25";"0";"25";"0";"430499";"5766"
"LOK1378_1mm";"SILVA (only NR);Bacteria;Verrucomicrobiota;Lentisphaeria;SS1-B-02-17;";"0.0";"0";"52";"50";"0";"50";"2";"430474";"5766"
"LOK1378_1mm";"SILVA (only NR);Bacteria;Verrucomicrobiota;Lentisphaeria;Victivallales;";"0.0";"0";"164";"161";"0";"161";"3";"430363";"5766"
"LOK1378_1mm";"SILVA (only NR);Bacteria;Verrucomicrobiota;Lentisphaeria;Victivallales;Arctic95B-14;";"0.0";"0";"12";"12";"0";"12";"0";"430512";"5766"
"LOK1378_1mm";"SILVA (only NR);Bacteria;Verrucomicrobiota;Lentisphaeria;Victivallales;BD2-3;";"0.0";"0";"10";"10";"0";"10";"0";"430514";"5766"
"LOK1378_1mm";"SILVA (only NR);Bacteria;Verrucomicrobiota;Lentisphaeria;Victivallales;GWF2-44-16;";"0.0";"0";"17";"16";"0";"16";"1";"430508";"5766"
"LOK1378_1mm";"SILVA (only NR);Bacteria;Verrucomicrobiota;Lentisphaeria;Victivallales;PRD18C08;";"0.0";"0";"16";"16";"0";"16";"0";"430508";"5766"
"LOK1378_1mm";"SILVA (only NR);Bacteria;Verrucomicrobiota;Lentisphaeria;Victivallales;SBYX-4944;";"0.0";"0";"6";"5";"0";"5";"1";"430519";"5766"
"LOK1378_1mm";"SILVA (only NR);Bacteria;Verrucomicrobiota;Lentisphaeria;Victivallales;SBZC-4624;";"0.0";"0";"5";"5";"0";"5";"0";"430519";"5766"
"LOK1378_1mm";"SILVA (only NR);Bacteria;Verrucomicrobiota;Lentisphaeria;Victivallales;Victivallaceae;";"0.0";"0";"52";"51";"0";"51";"1";"430473";"5766"
"LOK1378_1mm";"SILVA (only NR);Bacteria;Verrucomicrobiota;Lentisphaeria;Victivallales;Victivallaceae;Victivallis;";"0.0";"0";"15";"14";"0";"14";"1";"430510";"5766"
"LOK1378_1mm";"SILVA (only NR);Bacteria;Verrucomicrobiota;Lentisphaeria;Victivallales;vadinBE97;";"0.0";"0";"42";"42";"0";"42";"0";"430482";"5766"
"LOK1378_1mm";"SILVA (only NR);Bacteria;Verrucomicrobiota;Omnitrophia;";"0.0";"0";"520";"495";"0";"495";"25";"430029";"5766"
"LOK1378_1mm";"SILVA (only NR);Bacteria;Verrucomicrobiota;Omnitrophia;Omnitrophales;";"0.0";"0";"519";"494";"0";"494";"25";"430030";"5766"
"LOK1378_1mm";"SILVA (only NR);Bacteria;Verrucomicrobiota;Omnitrophia;Omnitrophales;Omnitrophaceae;";"0.0";"0";"426";"401";"0";"401";"25";"430123";"5766"
"LOK1378_1mm";"SILVA (only NR);Bacteria;Verrucomicrobiota;Omnitrophia;Omnitrophales;Omnitrophaceae;Candidatus Omnitrophus;";"0.0";"0";"426";"401";"0";"401";"25";"430123";"5766"
"LOK1378_1mm";"SILVA (only NR);Bacteria;Verrucomicrobiota;Omnitrophia;Omnitrophales;koll11;";"0.0";"0";"16";"16";"0";"16";"0";"430508";"5766"
"LOK1378_1mm";"SILVA (only NR);Bacteria;Verrucomicrobiota;Verrucomicrobiae;";"0.0";"0";"4166";"3976";"0";"3976";"190";"426548";"5766"
"LOK1378_1mm";"SILVA (only NR);Bacteria;Verrucomicrobiota;Verrucomicrobiae;Arctic97B-4 marine group;";"0.0";"0";"80";"79";"0";"79";"1";"430445";"5766"
"LOK1378_1mm";"SILVA (only NR);Bacteria;Verrucomicrobiota;Verrucomicrobiae;B29;";"0.0";"0";"2";"2";"0";"2";"0";"430522";"5766"
"LOK1378_1mm";"SILVA (only NR);Bacteria;Verrucomicrobiota;Verrucomicrobiae;Chthoniobacterales;";"0.0";"0";"1004";"948";"0";"948";"56";"429576";"5766"
"LOK1378_1mm";"SILVA (only NR);Bacteria;Verrucomicrobiota;Verrucomicrobiae;Chthoniobacterales;01D2Z36;";"0.0";"0";"132";"116";"0";"116";"16";"430408";"5766"
"LOK1378_1mm";"SILVA (only NR);Bacteria;Verrucomicrobiota;Verrucomicrobiae;Chthoniobacterales;Chthoniobacteraceae;";"0.0";"0";"724";"692";"0";"692";"32";"429832";"5766"
"LOK1378_1mm";"SILVA (only NR);Bacteria;Verrucomicrobiota;Verrucomicrobiae;Chthoniobacterales;Chthoniobacteraceae;Candidatus Udaeobacter;";"0.0";"0";"397";"389";"0";"389";"8";"430135";"5766"
"LOK1378_1mm";"SILVA (only NR);Bacteria;Verrucomicrobiota;Verrucomicrobiae;Chthoniobacterales;Chthoniobacteraceae;Chthoniobacter;";"0.0";"0";"274";"250";"0";"250";"24";"430274";"5766"
"LOK1378_1mm";"SILVA (only NR);Bacteria;Verrucomicrobiota;Verrucomicrobiae;Chthoniobacterales;Chthoniobacteraceae;LD29;";"0.0";"0";"51";"51";"0";"51";"0";"430473";"5766"
"LOK1378_1mm";"SILVA (only NR);Bacteria;Verrucomicrobiota;Verrucomicrobiae;Chthoniobacterales;Terrimicrobiaceae;";"0.0";"0";"70";"64";"0";"64";"6";"430460";"5766"
"LOK1378_1mm";"SILVA (only NR);Bacteria;Verrucomicrobiota;Verrucomicrobiae;Chthoniobacterales;Terrimicrobiaceae;FukuN18 freshwater group;";"0.0";"0";"20";"17";"0";"17";"3";"430507";"5766"
"LOK1378_1mm";"SILVA (only NR);Bacteria;Verrucomicrobiota;Verrucomicrobiae;Chthoniobacterales;Terrimicrobiaceae;Terrimicrobium;";"0.0";"0";"50";"47";"0";"47";"3";"430477";"5766"
"LOK1378_1mm";"SILVA (only NR);Bacteria;Verrucomicrobiota;Verrucomicrobiae;Chthoniobacterales;Xiphinematobacteraceae;";"0.0";"0";"66";"64";"0";"64";"2";"430460";"5766"
"LOK1378_1mm";"SILVA (only NR);Bacteria;Verrucomicrobiota;Verrucomicrobiae;Chthoniobacterales;Xiphinematobacteraceae;Candidatus Xiphinematobacter;";"0.0";"0";"66";"64";"0";"64";"2";"430460";"5766"
"LOK1378_1mm";"SILVA (only NR);Bacteria;Verrucomicrobiota;Verrucomicrobiae;Chthoniobacterales;uncultured;";"0.0";"0";"12";"12";"0";"12";"0";"430512";"5766"
"LOK1378_1mm";"SILVA (only NR);Bacteria;Verrucomicrobiota;Verrucomicrobiae;LD1-PB3;";"0.0";"0";"70";"70";"0";"70";"0";"430454";"5766"
"LOK1378_1mm";"SILVA (only NR);Bacteria;Verrucomicrobiota;Verrucomicrobiae;Methylacidiphilales;";"0.0";"0";"101";"87";"0";"87";"14";"430437";"5766"
"LOK1378_1mm";"SILVA (only NR);Bacteria;Verrucomicrobiota;Verrucomicrobiae;Methylacidiphilales;Methylacidiphilaceae;";"0.0";"0";"101";"87";"0";"87";"14";"430437";"5766"
"LOK1378_1mm";"SILVA (only NR);Bacteria;Verrucomicrobiota;Verrucomicrobiae;Methylacidiphilales;Methylacidiphilaceae;Candidatus Methylacidiphilum;";"0.0";"0";"14";"14";"0";"14";"0";"430510";"5766"
"LOK1378_1mm";"SILVA (only NR);Bacteria;Verrucomicrobiota;Verrucomicrobiae;Methylacidiphilales;Methylacidiphilaceae;uncultured;";"0.0";"0";"87";"73";"0";"73";"14";"430451";"5766"
"LOK1378_1mm";"SILVA (only NR);Bacteria;Verrucomicrobiota;Verrucomicrobiae;Opitutales;";"0.0";"0";"833";"803";"0";"803";"30";"429721";"5766"
"LOK1378_1mm";"SILVA (only NR);Bacteria;Verrucomicrobiota;Verrucomicrobiae;Opitutales;Opitutaceae;";"0.0";"0";"315";"306";"0";"306";"9";"430218";"5766"
"LOK1378_1mm";"SILVA (only NR);Bacteria;Verrucomicrobiota;Verrucomicrobiae;Opitutales;Opitutaceae;Alterococcus;";"0.0";"0";"14";"13";"0";"13";"1";"430511";"5766"
"LOK1378_1mm";"SILVA (only NR);Bacteria;Verrucomicrobiota;Verrucomicrobiae;Opitutales;Opitutaceae;Cephaloticoccus;";"0.0";"0";"32";"31";"0";"31";"1";"430493";"5766"
"LOK1378_1mm";"SILVA (only NR);Bacteria;Verrucomicrobiota;Verrucomicrobiae;Opitutales;Opitutaceae;Diplosphaera;";"0.0";"0";"14";"14";"0";"14";"0";"430510";"5766"
"LOK1378_1mm";"SILVA (only NR);Bacteria;Verrucomicrobiota;Verrucomicrobiae;Opitutales;Opitutaceae;Ereboglobus;";"0.0";"0";"10";"10";"0";"10";"0";"430514";"5766"
"LOK1378_1mm";"SILVA (only NR);Bacteria;Verrucomicrobiota;Verrucomicrobiae;Opitutales;Opitutaceae;IMCC26134;";"0.0";"0";"23";"22";"0";"22";"1";"430502";"5766"
"LOK1378_1mm";"SILVA (only NR);Bacteria;Verrucomicrobiota;Verrucomicrobiae;Opitutales;Opitutaceae;Lacunisphaera;";"0.0";"0";"95";"92";"0";"92";"3";"430432";"5766"
"LOK1378_1mm";"SILVA (only NR);Bacteria;Verrucomicrobiota;Verrucomicrobiae;Opitutales;Opitutaceae;Opitutus;";"0.0";"0";"106";"104";"0";"104";"2";"430420";"5766"
"LOK1378_1mm";"SILVA (only NR);Bacteria;Verrucomicrobiota;Verrucomicrobiae;Opitutales;Opitutaceae;uncultured;";"0.0";"0";"20";"19";"0";"19";"1";"430505";"5766"
"LOK1378_1mm";"SILVA (only NR);Bacteria;Verrucomicrobiota;Verrucomicrobiae;Opitutales;Puniceicoccaceae;";"0.0";"0";"515";"494";"0";"494";"21";"430030";"5766"
"LOK1378_1mm";"SILVA (only NR);Bacteria;Verrucomicrobiota;Verrucomicrobiae;Opitutales;Puniceicoccaceae;A714019;";"0.0";"0";"4";"4";"0";"4";"0";"430520";"5766"
"LOK1378_1mm";"SILVA (only NR);Bacteria;Verrucomicrobiota;Verrucomicrobiae;Opitutales;Puniceicoccaceae;Cerasicoccus;";"0.0";"0";"56";"54";"0";"54";"2";"430470";"5766"
"LOK1378_1mm";"SILVA (only NR);Bacteria;Verrucomicrobiota;Verrucomicrobiae;Opitutales;Puniceicoccaceae;Coraliomargarita;";"0.0";"0";"34";"32";"0";"32";"2";"430492";"5766"
"LOK1378_1mm";"SILVA (only NR);Bacteria;Verrucomicrobiota;Verrucomicrobiae;Opitutales;Puniceicoccaceae;Lentimonas;";"0.0";"0";"83";"80";"0";"80";"3";"430444";"5766"
"LOK1378_1mm";"SILVA (only NR);Bacteria;Verrucomicrobiota;Verrucomicrobiae;Opitutales;Puniceicoccaceae;MB11C04 marine group;";"0.0";"0";"79";"74";"0";"74";"5";"430450";"5766"
"LOK1378_1mm";"SILVA (only NR);Bacteria;Verrucomicrobiota;Verrucomicrobiae;Opitutales;Puniceicoccaceae;Pelagicoccus;";"0.0";"0";"19";"19";"0";"19";"0";"430505";"5766"
"LOK1378_1mm";"SILVA (only NR);Bacteria;Verrucomicrobiota;Verrucomicrobiae;Opitutales;Puniceicoccaceae;Puniceicoccus;";"0.0";"0";"134";"130";"0";"130";"4";"430394";"5766"
"LOK1378_1mm";"SILVA (only NR);Bacteria;Verrucomicrobiota;Verrucomicrobiae;Opitutales;Puniceicoccaceae;Verruc-01;";"0.0";"0";"89";"86";"0";"86";"3";"430438";"5766"
"LOK1378_1mm";"SILVA (only NR);Bacteria;Verrucomicrobiota;Verrucomicrobiae;Opitutales;Puniceicoccaceae;uncultured;";"0.0";"0";"16";"14";"0";"14";"2";"430510";"5766"
"LOK1378_1mm";"SILVA (only NR);Bacteria;Verrucomicrobiota;Verrucomicrobiae;Opitutales;uncultured;";"0.0";"0";"3";"3";"0";"3";"0";"430521";"5766"
"LOK1378_1mm";"SILVA (only NR);Bacteria;Verrucomicrobiota;Verrucomicrobiae;Pedosphaerales;";"0.0";"0";"770";"737";"0";"737";"33";"429787";"5766"
"LOK1378_1mm";"SILVA (only NR);Bacteria;Verrucomicrobiota;Verrucomicrobiae;Pedosphaerales;Pedosphaeraceae;";"0.0";"0";"770";"737";"0";"737";"33";"429787";"5766"
"LOK1378_1mm";"SILVA (only NR);Bacteria;Verrucomicrobiota;Verrucomicrobiae;Pedosphaerales;Pedosphaeraceae;ADurb.Bin063-1;";"0.0";"0";"77";"75";"0";"75";"2";"430449";"5766"
"LOK1378_1mm";"SILVA (only NR);Bacteria;Verrucomicrobiota;Verrucomicrobiae;Pedosphaerales;Pedosphaeraceae;ADurb.Bin118;";"0.0";"0";"9";"8";"0";"8";"1";"430516";"5766"
"LOK1378_1mm";"SILVA (only NR);Bacteria;Verrucomicrobiota;Verrucomicrobiae;Pedosphaerales;Pedosphaeraceae;DEV008;";"0.0";"0";"24";"23";"0";"23";"1";"430501";"5766"
"LOK1378_1mm";"SILVA (only NR);Bacteria;Verrucomicrobiota;Verrucomicrobiae;Pedosphaerales;Pedosphaeraceae;DEV114;";"0.0";"0";"29";"29";"0";"29";"0";"430495";"5766"
"LOK1378_1mm";"SILVA (only NR);Bacteria;Verrucomicrobiota;Verrucomicrobiae;Pedosphaerales;Pedosphaeraceae;Ellin516;";"0.0";"0";"24";"23";"0";"23";"1";"430501";"5766"
"LOK1378_1mm";"SILVA (only NR);Bacteria;Verrucomicrobiota;Verrucomicrobiae;Pedosphaerales;Pedosphaeraceae;Ellin517;";"0.0";"0";"34";"33";"0";"33";"1";"430491";"5766"
"LOK1378_1mm";"SILVA (only NR);Bacteria;Verrucomicrobiota;Verrucomicrobiae;Pedosphaerales;Pedosphaeraceae;Limisphaera;";"0.0";"0";"4";"4";"0";"4";"0";"430520";"5766"
"LOK1378_1mm";"SILVA (only NR);Bacteria;Verrucomicrobiota;Verrucomicrobiae;Pedosphaerales;Pedosphaeraceae;Oikopleura;";"0.0";"0";"20";"19";"0";"19";"1";"430505";"5766"
"LOK1378_1mm";"SILVA (only NR);Bacteria;Verrucomicrobiota;Verrucomicrobiae;Pedosphaerales;Pedosphaeraceae;Pedosphaera;";"0.0";"0";"12";"12";"0";"12";"0";"430512";"5766"
"LOK1378_1mm";"SILVA (only NR);Bacteria;Verrucomicrobiota;Verrucomicrobiae;Pedosphaerales;Pedosphaeraceae;RS25G;";"0.0";"0";"2";"2";"0";"2";"0";"430522";"5766"
"LOK1378_1mm";"SILVA (only NR);Bacteria;Verrucomicrobiota;Verrucomicrobiae;Pedosphaerales;Pedosphaeraceae;SCGC AAA164-E04;";"0.0";"0";"23";"23";"0";"23";"0";"430501";"5766"
"LOK1378_1mm";"SILVA (only NR);Bacteria;Verrucomicrobiota;Verrucomicrobiae;Pedosphaerales;Pedosphaeraceae;SH3-11;";"0.0";"0";"31";"31";"0";"31";"0";"430493";"5766"
"LOK1378_1mm";"SILVA (only NR);Bacteria;Verrucomicrobiota;Verrucomicrobiae;Pedosphaerales;Pedosphaeraceae;uncultured;";"0.0";"0";"125";"119";"0";"119";"6";"430405";"5766"
"LOK1378_1mm";"SILVA (only NR);Bacteria;Verrucomicrobiota;Verrucomicrobiae;S-BQ2-57 soil group;";"0.0";"0";"38";"36";"0";"36";"2";"430488";"5766"
"LOK1378_1mm";"SILVA (only NR);Bacteria;Verrucomicrobiota;Verrucomicrobiae;UA11;";"0.0";"0";"2";"2";"0";"2";"0";"430522";"5766"
"LOK1378_1mm";"SILVA (only NR);Bacteria;Verrucomicrobiota;Verrucomicrobiae;Verrucomicrobiales;";"0.0";"0";"1241";"1188";"0";"1188";"53";"429336";"5766"
"LOK1378_1mm";"SILVA (only NR);Bacteria;Verrucomicrobiota;Verrucomicrobiae;Verrucomicrobiales;Akkermansiaceae;";"0.0";"0";"470";"438";"0";"438";"32";"430086";"5766"
"LOK1378_1mm";"SILVA (only NR);Bacteria;Verrucomicrobiota;Verrucomicrobiae;Verrucomicrobiales;Akkermansiaceae;Akkermansia;";"0.0";"0";"470";"438";"0";"438";"32";"430086";"5766"
"LOK1378_1mm";"SILVA (only NR);Bacteria;Verrucomicrobiota;Verrucomicrobiae;Verrucomicrobiales;DEV007;";"0.0";"0";"141";"139";"0";"139";"2";"430385";"5766"
"LOK1378_1mm";"SILVA (only NR);Bacteria;Verrucomicrobiota;Verrucomicrobiae;Verrucomicrobiales;Rubritaleaceae;";"0.0";"0";"413";"401";"0";"401";"12";"430123";"5766"
"LOK1378_1mm";"SILVA (only NR);Bacteria;Verrucomicrobiota;Verrucomicrobiae;Verrucomicrobiales;Rubritaleaceae;DBS1;";"0.0";"0";"10";"10";"0";"10";"0";"430514";"5766"
"LOK1378_1mm";"SILVA (only NR);Bacteria;Verrucomicrobiota;Verrucomicrobiae;Verrucomicrobiales;Rubritaleaceae;Haloferula;";"0.0";"0";"29";"28";"0";"28";"1";"430496";"5766"
"LOK1378_1mm";"SILVA (only NR);Bacteria;Verrucomicrobiota;Verrucomicrobiae;Verrucomicrobiales;Rubritaleaceae;Luteolibacter;";"0.0";"0";"211";"205";"0";"205";"6";"430319";"5766"
"LOK1378_1mm";"SILVA (only NR);Bacteria;Verrucomicrobiota;Verrucomicrobiae;Verrucomicrobiales;Rubritaleaceae;Persicirhabdus;";"0.0";"0";"32";"31";"0";"31";"1";"430493";"5766"
"LOK1378_1mm";"SILVA (only NR);Bacteria;Verrucomicrobiota;Verrucomicrobiae;Verrucomicrobiales;Rubritaleaceae;Roseibacillus;";"0.0";"0";"63";"60";"0";"60";"3";"430464";"5766"
"LOK1378_1mm";"SILVA (only NR);Bacteria;Verrucomicrobiota;Verrucomicrobiae;Verrucomicrobiales;Rubritaleaceae;Rubritalea;";"0.0";"0";"64";"64";"0";"64";"0";"430460";"5766"
"LOK1378_1mm";"SILVA (only NR);Bacteria;Verrucomicrobiota;Verrucomicrobiae;Verrucomicrobiales;Rubritaleaceae;uncultured;";"0.0";"0";"3";"3";"0";"3";"0";"430521";"5766"
"LOK1378_1mm";"SILVA (only NR);Bacteria;Verrucomicrobiota;Verrucomicrobiae;Verrucomicrobiales;Verrucomicrobiaceae;";"0.0";"0";"216";"209";"0";"209";"7";"430315";"5766"
"LOK1378_1mm";"SILVA (only NR);Bacteria;Verrucomicrobiota;Verrucomicrobiae;Verrucomicrobiales;Verrucomicrobiaceae;Brevifollis;";"0.0";"0";"6";"6";"0";"6";"0";"430518";"5766"
"LOK1378_1mm";"SILVA (only NR);Bacteria;Verrucomicrobiota;Verrucomicrobiae;Verrucomicrobiales;Verrucomicrobiaceae;Prosthecobacter;";"0.0";"0";"61";"58";"0";"58";"3";"430466";"5766"
"LOK1378_1mm";"SILVA (only NR);Bacteria;Verrucomicrobiota;Verrucomicrobiae;Verrucomicrobiales;Verrucomicrobiaceae;Roseimicrobium;";"0.0";"0";"39";"38";"0";"38";"1";"430486";"5766"
"LOK1378_1mm";"SILVA (only NR);Bacteria;Verrucomicrobiota;Verrucomicrobiae;Verrucomicrobiales;Verrucomicrobiaceae;Verrucomicrobium;";"0.0";"0";"19";"17";"0";"17";"2";"430507";"5766"
"LOK1378_1mm";"SILVA (only NR);Bacteria;Verrucomicrobiota;Verrucomicrobiae;Verrucomicrobiales;Verrucomicrobiaceae;uncultured;";"0.0";"0";"91";"90";"0";"90";"1";"430434";"5766"
"LOK1378_1mm";"SILVA (only NR);Bacteria;Verrucomicrobiota;Verrucomicrobiae;uncultured;";"0.0";"0";"25";"24";"0";"24";"1";"430500";"5766"
"LOK1378_1mm";"SILVA (only NR);Bacteria;WOR-1;";"0.0";"0";"38";"38";"0";"38";"0";"430486";"5766"
"LOK1378_1mm";"SILVA (only NR);Bacteria;WPS-2;";"0.0";"0";"61";"60";"0";"60";"1";"430464";"5766"
"LOK1378_1mm";"SILVA (only NR);Bacteria;WS1;";"0.0";"0";"93";"92";"0";"92";"1";"430432";"5766"
"LOK1378_1mm";"SILVA (only NR);Bacteria;WS2;";"0.0";"0";"59";"58";"0";"58";"1";"430466";"5766"
"LOK1378_1mm";"SILVA (only NR);Bacteria;WS4;";"0.0";"0";"17";"17";"0";"17";"0";"430507";"5766"
"LOK1378_1mm";"SILVA (only NR);Bacteria;Zixibacteria;";"0.0";"0";"207";"202";"0";"202";"5";"430322";"5766"
"LOK1378_1mm";"SILVA (only NR);Bacteria;uncultured;";"0.0";"0";"5";"5";"0";"5";"0";"430519";"5766"
"LOK1378_1mm";"SILVA (only NR);Eukaryota;";"0.0";"0";"56829";"53479";"0";"53479";"3350";"377045";"5766"
"LOK1378_1mm";"SILVA (only NR);Eukaryota;Amorphea;";"0.0";"0";"31959";"30032";"0";"30032";"1927";"400492";"5766"
"LOK1378_1mm";"SILVA (only NR);Eukaryota;Amorphea;Amoebozoa;";"0.0";"0";"1148";"967";"0";"967";"181";"429557";"5766"
"LOK1378_1mm";"SILVA (only NR);Eukaryota;Amorphea;Amoebozoa;Archamoebae;";"0.0";"0";"15";"14";"0";"14";"1";"430510";"5766"
"LOK1378_1mm";"SILVA (only NR);Eukaryota;Amorphea;Amoebozoa;Archamoebae;Entamoebida;";"0.0";"0";"4";"3";"0";"3";"1";"430521";"5766"
"LOK1378_1mm";"SILVA (only NR);Eukaryota;Amorphea;Amoebozoa;Archamoebae;Entamoebida;Entamoeba;";"0.0";"0";"4";"3";"0";"3";"1";"430521";"5766"
"LOK1378_1mm";"SILVA (only NR);Eukaryota;Amorphea;Amoebozoa;Archamoebae;Incertae Sedis;";"0.0";"0";"11";"11";"0";"11";"0";"430513";"5766"
"LOK1378_1mm";"SILVA (only NR);Eukaryota;Amorphea;Amoebozoa;Archamoebae;Incertae Sedis;Rhizomastix;";"0.0";"0";"11";"11";"0";"11";"0";"430513";"5766"
"LOK1378_1mm";"SILVA (only NR);Eukaryota;Amorphea;Amoebozoa;Cavosteliida;";"0.0";"0";"13";"13";"0";"13";"0";"430511";"5766"
"LOK1378_1mm";"SILVA (only NR);Eukaryota;Amorphea;Amoebozoa;Cavosteliida;Cavostelium;";"0.0";"0";"1";"1";"0";"1";"0";"430523";"5766"
"LOK1378_1mm";"SILVA (only NR);Eukaryota;Amorphea;Amoebozoa;Cavosteliida;Schizoplasmodiopsis;";"0.0";"0";"5";"5";"0";"5";"0";"430519";"5766"
"LOK1378_1mm";"SILVA (only NR);Eukaryota;Amorphea;Amoebozoa;Cavosteliida;Tychosporium;";"0.0";"0";"2";"2";"0";"2";"0";"430522";"5766"
"LOK1378_1mm";"SILVA (only NR);Eukaryota;Amorphea;Amoebozoa;Centrohelida;";"0.0";"0";"77";"27";"0";"27";"50";"430497";"5766"
"LOK1378_1mm";"SILVA (only NR);Eukaryota;Amorphea;Amoebozoa;Centrohelida;Acanthocystidae;";"0.0";"0";"24";"4";"0";"4";"20";"430520";"5766"
"LOK1378_1mm";"SILVA (only NR);Eukaryota;Amorphea;Amoebozoa;Centrohelida;Acanthocystidae;Choanocystis;";"0.0";"0";"5";"0";"0";"0";"5";"430524";"5766"
"LOK1378_1mm";"SILVA (only NR);Eukaryota;Amorphea;Amoebozoa;Centrohelida;Acanthocystidae;Pterocystis;";"0.0";"0";"16";"4";"0";"4";"12";"430520";"5766"
"LOK1378_1mm";"SILVA (only NR);Eukaryota;Amorphea;Amoebozoa;Centrohelida;Acanthocystidae;Raineriophrys;";"0.0";"0";"1";"0";"0";"0";"1";"430524";"5766"
"LOK1378_1mm";"SILVA (only NR);Eukaryota;Amorphea;Amoebozoa;Centrohelida;CV1-B1-93;";"0.0";"0";"3";"3";"0";"3";"0";"430521";"5766"
"LOK1378_1mm";"SILVA (only NR);Eukaryota;Amorphea;Amoebozoa;Centrohelida;H1-10;";"0.0";"0";"7";"1";"0";"1";"6";"430523";"5766"
"LOK1378_1mm";"SILVA (only NR);Eukaryota;Amorphea;Amoebozoa;Centrohelida;H15-6;";"0.0";"0";"9";"0";"0";"0";"9";"430524";"5766"
"LOK1378_1mm";"SILVA (only NR);Eukaryota;Amorphea;Amoebozoa;Centrohelida;H26-1;";"0.0";"0";"3";"0";"0";"0";"3";"430524";"5766"
"LOK1378_1mm";"SILVA (only NR);Eukaryota;Amorphea;Amoebozoa;Centrohelida;Heterophryidae;";"0.0";"0";"11";"6";"0";"6";"5";"430518";"5766"
"LOK1378_1mm";"SILVA (only NR);Eukaryota;Amorphea;Amoebozoa;Centrohelida;Heterophryidae;Chlamydaster;";"0.0";"0";"2";"2";"0";"2";"0";"430522";"5766"
"LOK1378_1mm";"SILVA (only NR);Eukaryota;Amorphea;Amoebozoa;Centrohelida;Heterophryidae;Heterophrys;";"0.0";"0";"2";"1";"0";"1";"1";"430523";"5766"
"LOK1378_1mm";"SILVA (only NR);Eukaryota;Amorphea;Amoebozoa;Centrohelida;Heterophryidae;Oxnerella;";"0.0";"0";"1";"1";"0";"1";"0";"430523";"5766"
"LOK1378_1mm";"SILVA (only NR);Eukaryota;Amorphea;Amoebozoa;Centrohelida;Heterophryidae;Sphaerastrum;";"0.0";"0";"1";"0";"0";"0";"1";"430524";"5766"
"LOK1378_1mm";"SILVA (only NR);Eukaryota;Amorphea;Amoebozoa;Centrohelida;Incertae Sedis;";"0.0";"0";"1";"1";"0";"1";"0";"430523";"5766"
"LOK1378_1mm";"SILVA (only NR);Eukaryota;Amorphea;Amoebozoa;Centrohelida;Incertae Sedis;Spiculophrys;";"0.0";"0";"1";"1";"0";"1";"0";"430523";"5766"
"LOK1378_1mm";"SILVA (only NR);Eukaryota;Amorphea;Amoebozoa;Centrohelida;M1-18D08;";"0.0";"0";"3";"3";"0";"3";"0";"430521";"5766"
"LOK1378_1mm";"SILVA (only NR);Eukaryota;Amorphea;Amoebozoa;Centrohelida;Raphidiophryidae;";"0.0";"0";"1";"0";"0";"0";"1";"430524";"5766"
"LOK1378_1mm";"SILVA (only NR);Eukaryota;Amorphea;Amoebozoa;Centrohelida;Raphidiophryidae;Raphidiophrys;";"0.0";"0";"1";"0";"0";"0";"1";"430524";"5766"
"LOK1378_1mm";"SILVA (only NR);Eukaryota;Amorphea;Amoebozoa;Collodictyonidae;";"0.0";"0";"2";"1";"0";"1";"1";"430523";"5766"
"LOK1378_1mm";"SILVA (only NR);Eukaryota;Amorphea;Amoebozoa;Collodictyonidae;Diphylleia;";"0.0";"0";"2";"1";"0";"1";"1";"430523";"5766"
"LOK1378_1mm";"SILVA (only NR);Eukaryota;Amorphea;Amoebozoa;Dictyostelia;";"0.0";"0";"66";"64";"0";"64";"2";"430460";"5766"
"LOK1378_1mm";"SILVA (only NR);Eukaryota;Amorphea;Amoebozoa;Dictyostelia;Acytostelium;";"0.0";"0";"3";"3";"0";"3";"0";"430521";"5766"
"LOK1378_1mm";"SILVA (only NR);Eukaryota;Amorphea;Amoebozoa;Dictyostelia;Dictyostelium;";"0.0";"0";"45";"45";"0";"45";"0";"430479";"5766"
"LOK1378_1mm";"SILVA (only NR);Eukaryota;Amorphea;Amoebozoa;Dictyostelia;Polysphondylium;";"0.0";"0";"17";"15";"0";"15";"2";"430509";"5766"
"LOK1378_1mm";"SILVA (only NR);Eukaryota;Amorphea;Amoebozoa;Discosea;";"0.0";"0";"431";"376";"0";"376";"55";"430148";"5766"
"LOK1378_1mm";"SILVA (only NR);Eukaryota;Amorphea;Amoebozoa;Discosea;Flabellinia;";"0.0";"0";"233";"206";"0";"206";"27";"430318";"5766"
"LOK1378_1mm";"SILVA (only NR);Eukaryota;Amorphea;Amoebozoa;Discosea;Flabellinia;Dactylopodida;";"0.0";"0";"110";"100";"0";"100";"10";"430424";"5766"
"LOK1378_1mm";"SILVA (only NR);Eukaryota;Amorphea;Amoebozoa;Discosea;Flabellinia;Dactylopodida;Angulamoeba;";"0.0";"0";"10";"9";"0";"9";"1";"430515";"5766"
"LOK1378_1mm";"SILVA (only NR);Eukaryota;Amorphea;Amoebozoa;Discosea;Flabellinia;Dactylopodida;Korotnevella;";"0.0";"0";"22";"21";"0";"21";"1";"430503";"5766"
"LOK1378_1mm";"SILVA (only NR);Eukaryota;Amorphea;Amoebozoa;Discosea;Flabellinia;Dactylopodida;Neoparamoeba;";"0.0";"0";"9";"8";"0";"8";"1";"430516";"5766"
"LOK1378_1mm";"SILVA (only NR);Eukaryota;Amorphea;Amoebozoa;Discosea;Flabellinia;Dactylopodida;Paramoeba;";"0.0";"0";"55";"49";"0";"49";"6";"430475";"5766"
"LOK1378_1mm";"SILVA (only NR);Eukaryota;Amorphea;Amoebozoa;Discosea;Flabellinia;Dactylopodida;Parvamoeba;";"0.0";"0";"1";"1";"0";"1";"0";"430523";"5766"
"LOK1378_1mm";"SILVA (only NR);Eukaryota;Amorphea;Amoebozoa;Discosea;Flabellinia;Dactylopodida;Pseudoparamoeba;";"0.0";"0";"2";"2";"0";"2";"0";"430522";"5766"
"LOK1378_1mm";"SILVA (only NR);Eukaryota;Amorphea;Amoebozoa;Discosea;Flabellinia;Stygamoebida;";"0.0";"0";"7";"6";"0";"6";"1";"430518";"5766"
"LOK1378_1mm";"SILVA (only NR);Eukaryota;Amorphea;Amoebozoa;Discosea;Flabellinia;Stygamoebida;Stygamoeba;";"0.0";"0";"1";"1";"0";"1";"0";"430523";"5766"
"LOK1378_1mm";"SILVA (only NR);Eukaryota;Amorphea;Amoebozoa;Discosea;Flabellinia;Stygamoebida;Vermistella;";"0.0";"0";"5";"5";"0";"5";"0";"430519";"5766"
"LOK1378_1mm";"SILVA (only NR);Eukaryota;Amorphea;Amoebozoa;Discosea;Flabellinia;Vannellida;";"0.0";"0";"116";"100";"0";"100";"16";"430424";"5766"
"LOK1378_1mm";"SILVA (only NR);Eukaryota;Amorphea;Amoebozoa;Discosea;Flabellinia;Vannellida;BIO10-D10;";"0.0";"0";"4";"4";"0";"4";"0";"430520";"5766"
"LOK1378_1mm";"SILVA (only NR);Eukaryota;Amorphea;Amoebozoa;Discosea;Flabellinia;Vannellida;Platyamoeba;";"0.0";"0";"34";"29";"0";"29";"5";"430495";"5766"
"LOK1378_1mm";"SILVA (only NR);Eukaryota;Amorphea;Amoebozoa;Discosea;Flabellinia;Vannellida;Protosteliopsis;";"0.0";"0";"4";"4";"0";"4";"0";"430520";"5766"
"LOK1378_1mm";"SILVA (only NR);Eukaryota;Amorphea;Amoebozoa;Discosea;Flabellinia;Vannellida;Unda;";"0.0";"0";"1";"1";"0";"1";"0";"430523";"5766"
"LOK1378_1mm";"SILVA (only NR);Eukaryota;Amorphea;Amoebozoa;Discosea;Flabellinia;Vannellida;Vannella;";"0.0";"0";"36";"30";"0";"30";"6";"430494";"5766"
"LOK1378_1mm";"SILVA (only NR);Eukaryota;Amorphea;Amoebozoa;Discosea;Flabellinia;Vannellida;uncultured;";"0.0";"0";"14";"11";"0";"11";"3";"430513";"5766"
"LOK1378_1mm";"SILVA (only NR);Eukaryota;Amorphea;Amoebozoa;Discosea;Longamoebia;";"0.0";"0";"193";"166";"0";"166";"27";"430358";"5766"
"LOK1378_1mm";"SILVA (only NR);Eukaryota;Amorphea;Amoebozoa;Discosea;Longamoebia;Centramoebida;";"0.0";"0";"193";"166";"0";"166";"27";"430358";"5766"
"LOK1378_1mm";"SILVA (only NR);Eukaryota;Amorphea;Amoebozoa;Discosea;Longamoebia;Centramoebida;Acanthamoeba;";"0.0";"0";"169";"145";"0";"145";"24";"430379";"5766"
"LOK1378_1mm";"SILVA (only NR);Eukaryota;Amorphea;Amoebozoa;Discosea;Longamoebia;Centramoebida;Balamuthia;";"0.0";"0";"21";"19";"0";"19";"2";"430505";"5766"
"LOK1378_1mm";"SILVA (only NR);Eukaryota;Amorphea;Amoebozoa;Fractovitelliida;";"0.0";"0";"3";"3";"0";"3";"0";"430521";"5766"
"LOK1378_1mm";"SILVA (only NR);Eukaryota;Amorphea;Amoebozoa;Fractovitelliida;Soliformovum;";"0.0";"0";"3";"3";"0";"3";"0";"430521";"5766"
"LOK1378_1mm";"SILVA (only NR);Eukaryota;Amorphea;Amoebozoa;Gracilipodida;";"0.0";"0";"34";"32";"0";"32";"2";"430492";"5766"
"LOK1378_1mm";"SILVA (only NR);Eukaryota;Amorphea;Amoebozoa;Gracilipodida;Filamoeba;";"0.0";"0";"4";"4";"0";"4";"0";"430520";"5766"
"LOK1378_1mm";"SILVA (only NR);Eukaryota;Amorphea;Amoebozoa;Gracilipodida;Flamella;";"0.0";"0";"17";"16";"0";"16";"1";"430508";"5766"
"LOK1378_1mm";"SILVA (only NR);Eukaryota;Amorphea;Amoebozoa;Gracilipodida;Heliamoeba;";"0.0";"0";"1";"1";"0";"1";"0";"430523";"5766"
"LOK1378_1mm";"SILVA (only NR);Eukaryota;Amorphea;Amoebozoa;Gracilipodida;LEMD267;";"0.0";"0";"4";"3";"0";"3";"1";"430521";"5766"
"LOK1378_1mm";"SILVA (only NR);Eukaryota;Amorphea;Amoebozoa;Gracilipodida;Telaepolella;";"0.0";"0";"3";"3";"0";"3";"0";"430521";"5766"
"LOK1378_1mm";"SILVA (only NR);Eukaryota;Amorphea;Amoebozoa;Incertae Sedis;";"0.0";"0";"114";"86";"0";"86";"28";"430438";"5766"
"LOK1378_1mm";"SILVA (only NR);Eukaryota;Amorphea;Amoebozoa;Incertae Sedis;Apusomonadidae;";"0.0";"0";"63";"38";"0";"38";"25";"430486";"5766"
"LOK1378_1mm";"SILVA (only NR);Eukaryota;Amorphea;Amoebozoa;Incertae Sedis;Apusomonadidae;Amastigomonas;";"0.0";"0";"34";"18";"0";"18";"16";"430506";"5766"
"LOK1378_1mm";"SILVA (only NR);Eukaryota;Amorphea;Amoebozoa;Incertae Sedis;Apusomonadidae;Apusomonas;";"0.0";"0";"7";"6";"0";"6";"1";"430518";"5766"
"LOK1378_1mm";"SILVA (only NR);Eukaryota;Amorphea;Amoebozoa;Incertae Sedis;Apusomonadidae;Fabomonas;";"0.0";"0";"1";"1";"0";"1";"0";"430523";"5766"
"LOK1378_1mm";"SILVA (only NR);Eukaryota;Amorphea;Amoebozoa;Incertae Sedis;Apusomonadidae;Multimonas;";"0.0";"0";"3";"3";"0";"3";"0";"430521";"5766"
"LOK1378_1mm";"SILVA (only NR);Eukaryota;Amorphea;Amoebozoa;Incertae Sedis;Apusomonadidae;Planomonas;";"0.0";"0";"1";"1";"0";"1";"0";"430523";"5766"
"LOK1378_1mm";"SILVA (only NR);Eukaryota;Amorphea;Amoebozoa;Incertae Sedis;Arboramoeba;";"0.0";"0";"4";"4";"0";"4";"0";"430520";"5766"
"LOK1378_1mm";"SILVA (only NR);Eukaryota;Amorphea;Amoebozoa;Incertae Sedis;Breviatea;";"0.0";"0";"27";"24";"0";"24";"3";"430500";"5766"
"LOK1378_1mm";"SILVA (only NR);Eukaryota;Amorphea;Amoebozoa;Incertae Sedis;Breviatea;Breviata;";"0.0";"0";"2";"2";"0";"2";"0";"430522";"5766"
"LOK1378_1mm";"SILVA (only NR);Eukaryota;Amorphea;Amoebozoa;Incertae Sedis;Breviatea;NAMAKO-2;";"0.0";"0";"8";"8";"0";"8";"0";"430516";"5766"
"LOK1378_1mm";"SILVA (only NR);Eukaryota;Amorphea;Amoebozoa;Incertae Sedis;Breviatea;Pygsuia;";"0.0";"0";"1";"1";"0";"1";"0";"430523";"5766"
"LOK1378_1mm";"SILVA (only NR);Eukaryota;Amorphea;Amoebozoa;Incertae Sedis;Breviatea;Subulatomonas;";"0.0";"0";"13";"10";"0";"10";"3";"430514";"5766"
"LOK1378_1mm";"SILVA (only NR);Eukaryota;Amorphea;Amoebozoa;Incertae Sedis;Dictyamoeba;";"0.0";"0";"3";"3";"0";"3";"0";"430521";"5766"
"LOK1378_1mm";"SILVA (only NR);Eukaryota;Amorphea;Amoebozoa;Incertae Sedis;Ischnamoeba;";"0.0";"0";"4";"4";"0";"4";"0";"430520";"5766"
"LOK1378_1mm";"SILVA (only NR);Eukaryota;Amorphea;Amoebozoa;Incertae Sedis;Luapeleamoeba;";"0.0";"0";"1";"1";"0";"1";"0";"430523";"5766"
"LOK1378_1mm";"SILVA (only NR);Eukaryota;Amorphea;Amoebozoa;Incertae Sedis;Rigifilida;";"0.0";"0";"3";"3";"0";"3";"0";"430521";"5766"
"LOK1378_1mm";"SILVA (only NR);Eukaryota;Amorphea;Amoebozoa;Incertae Sedis;Rigifilida;Micronuclearia;";"0.0";"0";"1";"1";"0";"1";"0";"430523";"5766"
"LOK1378_1mm";"SILVA (only NR);Eukaryota;Amorphea;Amoebozoa;Incertae Sedis;Rigifilida;Rigifila;";"0.0";"0";"1";"1";"0";"1";"0";"430523";"5766"
"LOK1378_1mm";"SILVA (only NR);Eukaryota;Amorphea;Amoebozoa;Mycamoeba;";"0.0";"0";"5";"3";"0";"3";"2";"430521";"5766"
"LOK1378_1mm";"SILVA (only NR);Eukaryota;Amorphea;Amoebozoa;Myxogastria;";"0.0";"0";"111";"97";"0";"97";"14";"430427";"5766"
"LOK1378_1mm";"SILVA (only NR);Eukaryota;Amorphea;Amoebozoa;Myxogastria;Amaurochaete;";"0.0";"0";"1";"1";"0";"1";"0";"430523";"5766"
"LOK1378_1mm";"SILVA (only NR);Eukaryota;Amorphea;Amoebozoa;Myxogastria;Badhamia;";"0.0";"0";"16";"13";"0";"13";"3";"430511";"5766"
"LOK1378_1mm";"SILVA (only NR);Eukaryota;Amorphea;Amoebozoa;Myxogastria;Brefeldia;";"0.0";"0";"1";"1";"0";"1";"0";"430523";"5766"
"LOK1378_1mm";"SILVA (only NR);Eukaryota;Amorphea;Amoebozoa;Myxogastria;Comatricha;";"0.0";"0";"4";"4";"0";"4";"0";"430520";"5766"
"LOK1378_1mm";"SILVA (only NR);Eukaryota;Amorphea;Amoebozoa;Myxogastria;Diderma;";"0.0";"0";"1";"1";"0";"1";"0";"430523";"5766"
"LOK1378_1mm";"SILVA (only NR);Eukaryota;Amorphea;Amoebozoa;Myxogastria;Didymium;";"0.0";"0";"12";"10";"0";"10";"2";"430514";"5766"
"LOK1378_1mm";"SILVA (only NR);Eukaryota;Amorphea;Amoebozoa;Myxogastria;Fuligo;";"0.0";"0";"2";"1";"0";"1";"1";"430523";"5766"
"LOK1378_1mm";"SILVA (only NR);Eukaryota;Amorphea;Amoebozoa;Myxogastria;Lamproderma;";"0.0";"0";"25";"25";"0";"25";"0";"430499";"5766"
"LOK1378_1mm";"SILVA (only NR);Eukaryota;Amorphea;Amoebozoa;Myxogastria;Lepidoderma;";"0.0";"0";"3";"3";"0";"3";"0";"430521";"5766"
"LOK1378_1mm";"SILVA (only NR);Eukaryota;Amorphea;Amoebozoa;Myxogastria;Macbrideola;";"0.0";"0";"1";"1";"0";"1";"0";"430523";"5766"
"LOK1378_1mm";"SILVA (only NR);Eukaryota;Amorphea;Amoebozoa;Myxogastria;Meriderma;";"0.0";"0";"4";"3";"0";"3";"1";"430521";"5766"
"LOK1378_1mm";"SILVA (only NR);Eukaryota;Amorphea;Amoebozoa;Myxogastria;Mucilago;";"0.0";"0";"1";"1";"0";"1";"0";"430523";"5766"
"LOK1378_1mm";"SILVA (only NR);Eukaryota;Amorphea;Amoebozoa;Myxogastria;Physarella;";"0.0";"0";"2";"1";"0";"1";"1";"430523";"5766"
"LOK1378_1mm";"SILVA (only NR);Eukaryota;Amorphea;Amoebozoa;Myxogastria;Physarum;";"0.0";"0";"18";"12";"0";"12";"6";"430512";"5766"
"LOK1378_1mm";"SILVA (only NR);Eukaryota;Amorphea;Amoebozoa;Myxogastria;Protophysarum;";"0.0";"0";"11";"11";"0";"11";"0";"430513";"5766"
"LOK1378_1mm";"SILVA (only NR);Eukaryota;Amorphea;Amoebozoa;Myxogastria;Stemonitis;";"0.0";"0";"2";"2";"0";"2";"0";"430522";"5766"
"LOK1378_1mm";"SILVA (only NR);Eukaryota;Amorphea;Amoebozoa;Myxogastria;Symphytocarpus;";"0.0";"0";"1";"1";"0";"1";"0";"430523";"5766"
"LOK1378_1mm";"SILVA (only NR);Eukaryota;Amorphea;Amoebozoa;Protosporangiida;";"0.0";"0";"18";"14";"0";"14";"4";"430510";"5766"
"LOK1378_1mm";"SILVA (only NR);Eukaryota;Amorphea;Amoebozoa;Protosporangiida;Protosporangiidae;";"0.0";"0";"18";"14";"0";"14";"4";"430510";"5766"
"LOK1378_1mm";"SILVA (only NR);Eukaryota;Amorphea;Amoebozoa;Protosporangiida;Protosporangiidae;Protosporangium;";"0.0";"0";"18";"14";"0";"14";"4";"430510";"5766"
"LOK1378_1mm";"SILVA (only NR);Eukaryota;Amorphea;Amoebozoa;Protosteliida;";"0.0";"0";"32";"31";"0";"31";"1";"430493";"5766"
"LOK1378_1mm";"SILVA (only NR);Eukaryota;Amorphea;Amoebozoa;Protosteliida;Planoprotostelium;";"0.0";"0";"3";"3";"0";"3";"0";"430521";"5766"
"LOK1378_1mm";"SILVA (only NR);Eukaryota;Amorphea;Amoebozoa;Protosteliida;Protostelium;";"0.0";"0";"18";"18";"0";"18";"0";"430506";"5766"
"LOK1378_1mm";"SILVA (only NR);Eukaryota;Amorphea;Amoebozoa;Protosteliida;Schoutedamoeba;";"0.0";"0";"1";"1";"0";"1";"0";"430523";"5766"
"LOK1378_1mm";"SILVA (only NR);Eukaryota;Amorphea;Amoebozoa;SAR;";"0.0";"0";"60";"57";"0";"57";"3";"430467";"5766"
"LOK1378_1mm";"SILVA (only NR);Eukaryota;Amorphea;Amoebozoa;SAR;Stramenopiles;";"0.0";"0";"60";"57";"0";"57";"3";"430467";"5766"
"LOK1378_1mm";"SILVA (only NR);Eukaryota;Amorphea;Amoebozoa;SAR;Stramenopiles;Labyrinthulomycetes;";"0.0";"0";"60";"57";"0";"57";"3";"430467";"5766"
"LOK1378_1mm";"SILVA (only NR);Eukaryota;Amorphea;Amoebozoa;SAR;Stramenopiles;Labyrinthulomycetes;Sorodiplophrys;";"0.0";"0";"60";"57";"0";"57";"3";"430467";"5766"
"LOK1378_1mm";"SILVA (only NR);Eukaryota;Amorphea;Amoebozoa;Schizoplasmodiida;";"0.0";"0";"14";"12";"0";"12";"2";"430512";"5766"
"LOK1378_1mm";"SILVA (only NR);Eukaryota;Amorphea;Amoebozoa;Schizoplasmodiida;Ceratiomyxella;";"0.0";"0";"1";"1";"0";"1";"0";"430523";"5766"
"LOK1378_1mm";"SILVA (only NR);Eukaryota;Amorphea;Amoebozoa;Schizoplasmodiida;Nematostelium;";"0.0";"0";"1";"1";"0";"1";"0";"430523";"5766"
"LOK1378_1mm";"SILVA (only NR);Eukaryota;Amorphea;Amoebozoa;Schizoplasmodiida;Phalansterium;";"0.0";"0";"10";"9";"0";"9";"1";"430515";"5766"
"LOK1378_1mm";"SILVA (only NR);Eukaryota;Amorphea;Amoebozoa;Schizoplasmodiida;Schizoplasmodium;";"0.0";"0";"1";"1";"0";"1";"0";"430523";"5766"
"LOK1378_1mm";"SILVA (only NR);Eukaryota;Amorphea;Amoebozoa;Tubulinea;";"0.0";"0";"132";"118";"0";"118";"14";"430406";"5766"
"LOK1378_1mm";"SILVA (only NR);Eukaryota;Amorphea;Amoebozoa;Tubulinea;Arcellinida;";"0.0";"0";"35";"29";"0";"29";"6";"430495";"5766"
"LOK1378_1mm";"SILVA (only NR);Eukaryota;Amorphea;Amoebozoa;Tubulinea;Arcellinida;Arcellina;";"0.0";"0";"4";"4";"0";"4";"0";"430520";"5766"
"LOK1378_1mm";"SILVA (only NR);Eukaryota;Amorphea;Amoebozoa;Tubulinea;Arcellinida;Arcellina;Arcella;";"0.0";"0";"4";"4";"0";"4";"0";"430520";"5766"
"LOK1378_1mm";"SILVA (only NR);Eukaryota;Amorphea;Amoebozoa;Tubulinea;Arcellinida;Echinamoebida;";"0.0";"0";"21";"20";"0";"20";"1";"430504";"5766"
"LOK1378_1mm";"SILVA (only NR);Eukaryota;Amorphea;Amoebozoa;Tubulinea;Arcellinida;Echinamoebida;Echinamoeba;";"0.0";"0";"5";"5";"0";"5";"0";"430519";"5766"
"LOK1378_1mm";"SILVA (only NR);Eukaryota;Amorphea;Amoebozoa;Tubulinea;Arcellinida;Echinamoebida;Vermamoeba;";"0.0";"0";"8";"8";"0";"8";"0";"430516";"5766"
"LOK1378_1mm";"SILVA (only NR);Eukaryota;Amorphea;Amoebozoa;Tubulinea;Arcellinida;Phryganellina;";"0.0";"0";"5";"2";"0";"2";"3";"430522";"5766"
"LOK1378_1mm";"SILVA (only NR);Eukaryota;Amorphea;Amoebozoa;Tubulinea;Arcellinida;Phryganellina;Cryptodifflugia;";"0.0";"0";"5";"2";"0";"2";"3";"430522";"5766"
"LOK1378_1mm";"SILVA (only NR);Eukaryota;Amorphea;Amoebozoa;Tubulinea;Euamoebida;";"0.0";"0";"57";"52";"0";"52";"5";"430472";"5766"
"LOK1378_1mm";"SILVA (only NR);Eukaryota;Amorphea;Amoebozoa;Tubulinea;Euamoebida;Amoeba;";"0.0";"0";"2";"2";"0";"2";"0";"430522";"5766"
"LOK1378_1mm";"SILVA (only NR);Eukaryota;Amorphea;Amoebozoa;Tubulinea;Euamoebida;BOLA868;";"0.0";"0";"8";"7";"0";"7";"1";"430517";"5766"
"LOK1378_1mm";"SILVA (only NR);Eukaryota;Amorphea;Amoebozoa;Tubulinea;Euamoebida;Chaos;";"0.0";"0";"1";"1";"0";"1";"0";"430523";"5766"
"LOK1378_1mm";"SILVA (only NR);Eukaryota;Amorphea;Amoebozoa;Tubulinea;Euamoebida;Copromyxa;";"0.0";"0";"3";"3";"0";"3";"0";"430521";"5766"
"LOK1378_1mm";"SILVA (only NR);Eukaryota;Amorphea;Amoebozoa;Tubulinea;Euamoebida;Glaeseria;";"0.0";"0";"1";"1";"0";"1";"0";"430523";"5766"
"LOK1378_1mm";"SILVA (only NR);Eukaryota;Amorphea;Amoebozoa;Tubulinea;Euamoebida;Hartmannella;";"0.0";"0";"6";"6";"0";"6";"0";"430518";"5766"
"LOK1378_1mm";"SILVA (only NR);Eukaryota;Amorphea;Amoebozoa;Tubulinea;Euamoebida;Ptolemeba;";"0.0";"0";"2";"2";"0";"2";"0";"430522";"5766"
"LOK1378_1mm";"SILVA (only NR);Eukaryota;Amorphea;Amoebozoa;Tubulinea;Euamoebida;Saccamoeba;";"0.0";"0";"3";"3";"0";"3";"0";"430521";"5766"
"LOK1378_1mm";"SILVA (only NR);Eukaryota;Amorphea;Amoebozoa;Tubulinea;Euamoebida;Sacchamoeba;";"0.0";"0";"1";"1";"0";"1";"0";"430523";"5766"
"LOK1378_1mm";"SILVA (only NR);Eukaryota;Amorphea;Amoebozoa;Tubulinea;Incertae Sedis;";"0.0";"0";"1";"1";"0";"1";"0";"430523";"5766"
"LOK1378_1mm";"SILVA (only NR);Eukaryota;Amorphea;Amoebozoa;Tubulinea;Incertae Sedis;Pyxidicula;";"0.0";"0";"1";"1";"0";"1";"0";"430523";"5766"
"LOK1378_1mm";"SILVA (only NR);Eukaryota;Amorphea;Amoebozoa;Tubulinea;Leptomyxida;";"0.0";"0";"35";"32";"0";"32";"3";"430492";"5766"
"LOK1378_1mm";"SILVA (only NR);Eukaryota;Amorphea;Amoebozoa;Tubulinea;Leptomyxida;Flabellula;";"0.0";"0";"9";"8";"0";"8";"1";"430516";"5766"
"LOK1378_1mm";"SILVA (only NR);Eukaryota;Amorphea;Amoebozoa;Tubulinea;Leptomyxida;Leptomyxa;";"0.0";"0";"7";"6";"0";"6";"1";"430518";"5766"
"LOK1378_1mm";"SILVA (only NR);Eukaryota;Amorphea;Amoebozoa;Tubulinea;Leptomyxida;NETC3-I;";"0.0";"0";"2";"2";"0";"2";"0";"430522";"5766"
"LOK1378_1mm";"SILVA (only NR);Eukaryota;Amorphea;Amoebozoa;Tubulinea;Leptomyxida;Paraflabellula;";"0.0";"0";"2";"2";"0";"2";"0";"430522";"5766"
"LOK1378_1mm";"SILVA (only NR);Eukaryota;Amorphea;Amoebozoa;Tubulinea;Leptomyxida;Rhizamoeba;";"0.0";"0";"2";"2";"0";"2";"0";"430522";"5766"
"LOK1378_1mm";"SILVA (only NR);Eukaryota;Amorphea;Amoebozoa;uncultured;";"0.0";"0";"12";"10";"0";"10";"2";"430514";"5766"
"LOK1378_1mm";"SILVA (only NR);Eukaryota;Amorphea;Obazoa;";"0.0";"0";"30811";"29065";"0";"29065";"1746";"401459";"5766"
"LOK1378_1mm";"SILVA (only NR);Eukaryota;Amorphea;Obazoa;Opisthokonta;";"0.0";"0";"30811";"29065";"0";"29065";"1746";"401459";"5766"
"LOK1378_1mm";"SILVA (only NR);Eukaryota;Amorphea;Obazoa;Opisthokonta;Holozoa;";"0.0";"0";"21360";"20224";"0";"20224";"1136";"410300";"5766"
"LOK1378_1mm";"SILVA (only NR);Eukaryota;Amorphea;Obazoa;Opisthokonta;Holozoa;Choanozoa;";"0.0";"0";"21360";"20224";"0";"20224";"1136";"410300";"5766"
"LOK1378_1mm";"SILVA (only NR);Eukaryota;Amorphea;Obazoa;Opisthokonta;Holozoa;Choanozoa;Choanoflagellata;";"0.0";"0";"328";"294";"0";"294";"34";"430230";"5766"
"LOK1378_1mm";"SILVA (only NR);Eukaryota;Amorphea;Obazoa;Opisthokonta;Holozoa;Choanozoa;Choanoflagellata;Choanoflagellida;";"0.0";"0";"200";"175";"0";"175";"25";"430349";"5766"
"LOK1378_1mm";"SILVA (only NR);Eukaryota;Amorphea;Obazoa;Opisthokonta;Holozoa;Choanozoa;Choanoflagellata;Choanoflagellida;Acanthoecida;";"0.0";"0";"67";"58";"0";"58";"9";"430466";"5766"
"LOK1378_1mm";"SILVA (only NR);Eukaryota;Amorphea;Obazoa;Opisthokonta;Holozoa;Choanozoa;Choanoflagellata;Choanoflagellida;Acanthoecida;Acanthoecidae;";"0.0";"0";"18";"16";"0";"16";"2";"430508";"5766"
"LOK1378_1mm";"SILVA (only NR);Eukaryota;Amorphea;Obazoa;Opisthokonta;Holozoa;Choanozoa;Choanoflagellata;Choanoflagellida;Acanthoecida;Acanthoecidae;Acanthoeca;";"0.0";"0";"2";"2";"0";"2";"0";"430522";"5766"
"LOK1378_1mm";"SILVA (only NR);Eukaryota;Amorphea;Obazoa;Opisthokonta;Holozoa;Choanozoa;Choanoflagellata;Choanoflagellida;Acanthoecida;Acanthoecidae;FV23-1A4;";"0.0";"0";"6";"6";"0";"6";"0";"430518";"5766"
"LOK1378_1mm";"SILVA (only NR);Eukaryota;Amorphea;Obazoa;Opisthokonta;Holozoa;Choanozoa;Choanoflagellata;Choanoflagellida;Acanthoecida;Acanthoecidae;Pleurasiga;";"0.0";"0";"3";"3";"0";"3";"0";"430521";"5766"
"LOK1378_1mm";"SILVA (only NR);Eukaryota;Amorphea;Obazoa;Opisthokonta;Holozoa;Choanozoa;Choanoflagellata;Choanoflagellida;Acanthoecida;Acanthoecidae;Polyoeca;";"0.0";"0";"1";"1";"0";"1";"0";"430523";"5766"
"LOK1378_1mm";"SILVA (only NR);Eukaryota;Amorphea;Obazoa;Opisthokonta;Holozoa;Choanozoa;Choanoflagellata;Choanoflagellida;Acanthoecida;Acanthoecidae;Savillea;";"0.0";"0";"1";"1";"0";"1";"0";"430523";"5766"
"LOK1378_1mm";"SILVA (only NR);Eukaryota;Amorphea;Obazoa;Opisthokonta;Holozoa;Choanozoa;Choanoflagellata;Choanoflagellida;Acanthoecida;Stephanoecidae;";"0.0";"0";"48";"41";"0";"41";"7";"430483";"5766"
"LOK1378_1mm";"SILVA (only NR);Eukaryota;Amorphea;Obazoa;Opisthokonta;Holozoa;Choanozoa;Choanoflagellata;Choanoflagellida;Acanthoecida;Stephanoecidae;Bicosta;";"0.0";"0";"6";"6";"0";"6";"0";"430518";"5766"
"LOK1378_1mm";"SILVA (only NR);Eukaryota;Amorphea;Obazoa;Opisthokonta;Holozoa;Choanozoa;Choanoflagellata;Choanoflagellida;Acanthoecida;Stephanoecidae;Calliacantha;";"0.0";"0";"2";"2";"0";"2";"0";"430522";"5766"
"LOK1378_1mm";"SILVA (only NR);Eukaryota;Amorphea;Obazoa;Opisthokonta;Holozoa;Choanozoa;Choanoflagellata;Choanoflagellida;Acanthoecida;Stephanoecidae;Diaphanoeca;";"0.0";"0";"15";"13";"0";"13";"2";"430511";"5766"
"LOK1378_1mm";"SILVA (only NR);Eukaryota;Amorphea;Obazoa;Opisthokonta;Holozoa;Choanozoa;Choanoflagellata;Choanoflagellida;Acanthoecida;Stephanoecidae;Didymoeca;";"0.0";"0";"2";"1";"0";"1";"1";"430523";"5766"
"LOK1378_1mm";"SILVA (only NR);Eukaryota;Amorphea;Obazoa;Opisthokonta;Holozoa;Choanozoa;Choanoflagellata;Choanoflagellida;Acanthoecida;Stephanoecidae;Marine Choanoflagellates 1;";"0.0";"0";"6";"6";"0";"6";"0";"430518";"5766"
"LOK1378_1mm";"SILVA (only NR);Eukaryota;Amorphea;Obazoa;Opisthokonta;Holozoa;Choanozoa;Choanoflagellata;Choanoflagellida;Acanthoecida;Stephanoecidae;Marine Choanoflagellates 2;";"0.0";"0";"2";"0";"0";"0";"2";"430524";"5766"
"LOK1378_1mm";"SILVA (only NR);Eukaryota;Amorphea;Obazoa;Opisthokonta;Holozoa;Choanozoa;Choanoflagellata;Choanoflagellida;Acanthoecida;Stephanoecidae;Stephanoeca;";"0.0";"0";"10";"9";"0";"9";"1";"430515";"5766"
"LOK1378_1mm";"SILVA (only NR);Eukaryota;Amorphea;Obazoa;Opisthokonta;Holozoa;Choanozoa;Choanoflagellata;Choanoflagellida;Clade L;";"0.0";"0";"4";"4";"0";"4";"0";"430520";"5766"
"LOK1378_1mm";"SILVA (only NR);Eukaryota;Amorphea;Obazoa;Opisthokonta;Holozoa;Choanozoa;Choanoflagellata;Choanoflagellida;Craspedida;";"0.0";"0";"129";"113";"0";"113";"16";"430411";"5766"
"LOK1378_1mm";"SILVA (only NR);Eukaryota;Amorphea;Obazoa;Opisthokonta;Holozoa;Choanozoa;Choanoflagellata;Choanoflagellida;Craspedida;Codonosigidae;";"0.0";"0";"28";"24";"0";"24";"4";"430500";"5766"
"LOK1378_1mm";"SILVA (only NR);Eukaryota;Amorphea;Obazoa;Opisthokonta;Holozoa;Choanozoa;Choanoflagellata;Choanoflagellida;Craspedida;Codonosigidae;Codosiga;";"0.0";"0";"9";"9";"0";"9";"0";"430515";"5766"
"LOK1378_1mm";"SILVA (only NR);Eukaryota;Amorphea;Obazoa;Opisthokonta;Holozoa;Choanozoa;Choanoflagellata;Choanoflagellida;Craspedida;Codonosigidae;Desmarella;";"0.0";"0";"1";"1";"0";"1";"0";"430523";"5766"
"LOK1378_1mm";"SILVA (only NR);Eukaryota;Amorphea;Obazoa;Opisthokonta;Holozoa;Choanozoa;Choanoflagellata;Choanoflagellida;Craspedida;Codonosigidae;Monosiga;";"0.0";"0";"10";"9";"0";"9";"1";"430515";"5766"
"LOK1378_1mm";"SILVA (only NR);Eukaryota;Amorphea;Obazoa;Opisthokonta;Holozoa;Choanozoa;Choanoflagellata;Choanoflagellida;Craspedida;Codonosigidae;Proterospongia;";"0.0";"0";"1";"1";"0";"1";"0";"430523";"5766"
"LOK1378_1mm";"SILVA (only NR);Eukaryota;Amorphea;Obazoa;Opisthokonta;Holozoa;Choanozoa;Choanoflagellata;Choanoflagellida;Craspedida;Codonosigidae;Sphaeroeca;";"0.0";"0";"5";"2";"0";"2";"3";"430522";"5766"
"LOK1378_1mm";"SILVA (only NR);Eukaryota;Amorphea;Obazoa;Opisthokonta;Holozoa;Choanozoa;Choanoflagellata;Choanoflagellida;Craspedida;Codosigidae;";"0.0";"0";"19";"18";"0";"18";"1";"430506";"5766"
"LOK1378_1mm";"SILVA (only NR);Eukaryota;Amorphea;Obazoa;Opisthokonta;Holozoa;Choanozoa;Choanoflagellata;Choanoflagellida;Craspedida;Codosigidae;Freshwater Choanoflagellates 1;";"0.0";"0";"10";"10";"0";"10";"0";"430514";"5766"
"LOK1378_1mm";"SILVA (only NR);Eukaryota;Amorphea;Obazoa;Opisthokonta;Holozoa;Choanozoa;Choanoflagellata;Choanoflagellida;Craspedida;Codosigidae;Lagenoeca;";"0.0";"0";"9";"8";"0";"8";"1";"430516";"5766"
"LOK1378_1mm";"SILVA (only NR);Eukaryota;Amorphea;Obazoa;Opisthokonta;Holozoa;Choanozoa;Choanoflagellata;Choanoflagellida;Craspedida;Incertae Sedis;";"0.0";"0";"1";"1";"0";"1";"0";"430523";"5766"
"LOK1378_1mm";"SILVA (only NR);Eukaryota;Amorphea;Obazoa;Opisthokonta;Holozoa;Choanozoa;Choanoflagellata;Choanoflagellida;Craspedida;Incertae Sedis;Paramonosiga;";"0.0";"0";"1";"1";"0";"1";"0";"430523";"5766"
"LOK1378_1mm";"SILVA (only NR);Eukaryota;Amorphea;Obazoa;Opisthokonta;Holozoa;Choanozoa;Choanoflagellata;Choanoflagellida;Craspedida;Salpingoecidae;";"0.0";"0";"70";"60";"0";"60";"10";"430464";"5766"
"LOK1378_1mm";"SILVA (only NR);Eukaryota;Amorphea;Obazoa;Opisthokonta;Holozoa;Choanozoa;Choanoflagellata;Choanoflagellida;Craspedida;Salpingoecidae;Choanoeca;";"0.0";"0";"1";"1";"0";"1";"0";"430523";"5766"
"LOK1378_1mm";"SILVA (only NR);Eukaryota;Amorphea;Obazoa;Opisthokonta;Holozoa;Choanozoa;Choanoflagellata;Choanoflagellida;Craspedida;Salpingoecidae;Freshwater Choanoflagellates 2;";"0.0";"0";"6";"6";"0";"6";"0";"430518";"5766"
"LOK1378_1mm";"SILVA (only NR);Eukaryota;Amorphea;Obazoa;Opisthokonta;Holozoa;Choanozoa;Choanoflagellata;Choanoflagellida;Craspedida;Salpingoecidae;Hartaetosiga;";"0.0";"0";"9";"6";"0";"6";"3";"430518";"5766"
"LOK1378_1mm";"SILVA (only NR);Eukaryota;Amorphea;Obazoa;Opisthokonta;Holozoa;Choanozoa;Choanoflagellata;Choanoflagellida;Craspedida;Salpingoecidae;Salpingoeca;";"0.0";"0";"28";"21";"0";"21";"7";"430503";"5766"
"LOK1378_1mm";"SILVA (only NR);Eukaryota;Amorphea;Obazoa;Opisthokonta;Holozoa;Choanozoa;Choanoflagellata;Choanoflagellida;Craspedida;Salpingoecidae;Stagondoeca;";"0.0";"0";"1";"1";"0";"1";"0";"430523";"5766"
"LOK1378_1mm";"SILVA (only NR);Eukaryota;Amorphea;Obazoa;Opisthokonta;Holozoa;Choanozoa;Choanoflagellata;Choanoflagellida;Craspedida;uncultured;";"0.0";"0";"4";"4";"0";"4";"0";"430520";"5766"
"LOK1378_1mm";"SILVA (only NR);Eukaryota;Amorphea;Obazoa;Opisthokonta;Holozoa;Choanozoa;Choanoflagellata;Corallochytrea;";"0.0";"0";"1";"1";"0";"1";"0";"430523";"5766"
"LOK1378_1mm";"SILVA (only NR);Eukaryota;Amorphea;Obazoa;Opisthokonta;Holozoa;Choanozoa;Choanoflagellata;Corallochytrea;Corallochytrida;";"0.0";"0";"1";"1";"0";"1";"0";"430523";"5766"
"LOK1378_1mm";"SILVA (only NR);Eukaryota;Amorphea;Obazoa;Opisthokonta;Holozoa;Choanozoa;Choanoflagellata;Corallochytrea;Corallochytrida;Corallochytridae;";"0.0";"0";"1";"1";"0";"1";"0";"430523";"5766"
"LOK1378_1mm";"SILVA (only NR);Eukaryota;Amorphea;Obazoa;Opisthokonta;Holozoa;Choanozoa;Choanoflagellata;Corallochytrea;Corallochytrida;Corallochytridae;Corallochytrium;";"0.0";"0";"1";"1";"0";"1";"0";"430523";"5766"
"LOK1378_1mm";"SILVA (only NR);Eukaryota;Amorphea;Obazoa;Opisthokonta;Holozoa;Choanozoa;Choanoflagellata;Eccrinales;";"0.0";"0";"27";"27";"0";"27";"0";"430497";"5766"
"LOK1378_1mm";"SILVA (only NR);Eukaryota;Amorphea;Obazoa;Opisthokonta;Holozoa;Choanozoa;Choanoflagellata;Eccrinales;Alacrinella;";"0.0";"0";"1";"1";"0";"1";"0";"430523";"5766"
"LOK1378_1mm";"SILVA (only NR);Eukaryota;Amorphea;Obazoa;Opisthokonta;Holozoa;Choanozoa;Choanoflagellata;Eccrinales;Arundinula;";"0.0";"0";"2";"2";"0";"2";"0";"430522";"5766"
"LOK1378_1mm";"SILVA (only NR);Eukaryota;Amorphea;Obazoa;Opisthokonta;Holozoa;Choanozoa;Choanoflagellata;Eccrinales;Astreptonema;";"0.0";"0";"3";"3";"0";"3";"0";"430521";"5766"
"LOK1378_1mm";"SILVA (only NR);Eukaryota;Amorphea;Obazoa;Opisthokonta;Holozoa;Choanozoa;Choanoflagellata;Eccrinales;Eccrinidus;";"0.0";"0";"1";"1";"0";"1";"0";"430523";"5766"
"LOK1378_1mm";"SILVA (only NR);Eukaryota;Amorphea;Obazoa;Opisthokonta;Holozoa;Choanozoa;Choanoflagellata;Eccrinales;Enterobryus;";"0.0";"0";"7";"7";"0";"7";"0";"430517";"5766"
"LOK1378_1mm";"SILVA (only NR);Eukaryota;Amorphea;Obazoa;Opisthokonta;Holozoa;Choanozoa;Choanoflagellata;Eccrinales;Enteromyces;";"0.0";"0";"1";"1";"0";"1";"0";"430523";"5766"
"LOK1378_1mm";"SILVA (only NR);Eukaryota;Amorphea;Obazoa;Opisthokonta;Holozoa;Choanozoa;Choanoflagellata;Eccrinales;Enteropogon;";"0.0";"0";"1";"1";"0";"1";"0";"430523";"5766"
"LOK1378_1mm";"SILVA (only NR);Eukaryota;Amorphea;Obazoa;Opisthokonta;Holozoa;Choanozoa;Choanoflagellata;Eccrinales;Leidyomyces;";"0.0";"0";"2";"2";"0";"2";"0";"430522";"5766"
"LOK1378_1mm";"SILVA (only NR);Eukaryota;Amorphea;Obazoa;Opisthokonta;Holozoa;Choanozoa;Choanoflagellata;Eccrinales;Palavascia;";"0.0";"0";"2";"2";"0";"2";"0";"430522";"5766"
"LOK1378_1mm";"SILVA (only NR);Eukaryota;Amorphea;Obazoa;Opisthokonta;Holozoa;Choanozoa;Choanoflagellata;Eccrinales;Parataeniella;";"0.0";"0";"3";"3";"0";"3";"0";"430521";"5766"
"LOK1378_1mm";"SILVA (only NR);Eukaryota;Amorphea;Obazoa;Opisthokonta;Holozoa;Choanozoa;Choanoflagellata;Eccrinales;Taeniella;";"0.0";"0";"1";"1";"0";"1";"0";"430523";"5766"
"LOK1378_1mm";"SILVA (only NR);Eukaryota;Amorphea;Obazoa;Opisthokonta;Holozoa;Choanozoa;Choanoflagellata;Filasterea;";"0.0";"0";"18";"17";"0";"17";"1";"430507";"5766"
"LOK1378_1mm";"SILVA (only NR);Eukaryota;Amorphea;Obazoa;Opisthokonta;Holozoa;Choanozoa;Choanoflagellata;Filasterea;Ministeriida;";"0.0";"0";"18";"17";"0";"17";"1";"430507";"5766"
"LOK1378_1mm";"SILVA (only NR);Eukaryota;Amorphea;Obazoa;Opisthokonta;Holozoa;Choanozoa;Choanoflagellata;Filasterea;Ministeriida;Capsasporidae;";"0.0";"0";"16";"15";"0";"15";"1";"430509";"5766"
"LOK1378_1mm";"SILVA (only NR);Eukaryota;Amorphea;Obazoa;Opisthokonta;Holozoa;Choanozoa;Choanoflagellata;Filasterea;Ministeriida;Capsasporidae;AT4-11;";"0.0";"0";"6";"6";"0";"6";"0";"430518";"5766"
"LOK1378_1mm";"SILVA (only NR);Eukaryota;Amorphea;Obazoa;Opisthokonta;Holozoa;Choanozoa;Choanoflagellata;Filasterea;Ministeriida;Capsasporidae;Capsaspora;";"0.0";"0";"1";"1";"0";"1";"0";"430523";"5766"
"LOK1378_1mm";"SILVA (only NR);Eukaryota;Amorphea;Obazoa;Opisthokonta;Holozoa;Choanozoa;Choanoflagellata;Filasterea;Ministeriida;Capsasporidae;Marine Group;";"0.0";"0";"7";"6";"0";"6";"1";"430518";"5766"
"LOK1378_1mm";"SILVA (only NR);Eukaryota;Amorphea;Obazoa;Opisthokonta;Holozoa;Choanozoa;Choanoflagellata;Filasterea;Ministeriida;Ministeridae;";"0.0";"0";"1";"1";"0";"1";"0";"430523";"5766"
"LOK1378_1mm";"SILVA (only NR);Eukaryota;Amorphea;Obazoa;Opisthokonta;Holozoa;Choanozoa;Choanoflagellata;Filasterea;Ministeriida;Ministeridae;Ministeria;";"0.0";"0";"1";"1";"0";"1";"0";"430523";"5766"
"LOK1378_1mm";"SILVA (only NR);Eukaryota;Amorphea;Obazoa;Opisthokonta;Holozoa;Choanozoa;Choanoflagellata;Ichthyosporea;";"0.0";"0";"80";"72";"0";"72";"8";"430452";"5766"
"LOK1378_1mm";"SILVA (only NR);Eukaryota;Amorphea;Obazoa;Opisthokonta;Holozoa;Choanozoa;Choanoflagellata;Ichthyosporea;Dermocystida;";"0.0";"0";"13";"10";"0";"10";"3";"430514";"5766"
"LOK1378_1mm";"SILVA (only NR);Eukaryota;Amorphea;Obazoa;Opisthokonta;Holozoa;Choanozoa;Choanoflagellata;Ichthyosporea;Dermocystida;Rhinosporideacae;";"0.0";"0";"13";"10";"0";"10";"3";"430514";"5766"
"LOK1378_1mm";"SILVA (only NR);Eukaryota;Amorphea;Obazoa;Opisthokonta;Holozoa;Choanozoa;Choanoflagellata;Ichthyosporea;Dermocystida;Rhinosporideacae;Amphibiocystidium;";"0.0";"0";"2";"2";"0";"2";"0";"430522";"5766"
"LOK1378_1mm";"SILVA (only NR);Eukaryota;Amorphea;Obazoa;Opisthokonta;Holozoa;Choanozoa;Choanoflagellata;Ichthyosporea;Dermocystida;Rhinosporideacae;Amphibiothecum;";"0.0";"0";"1";"0";"0";"0";"1";"430524";"5766"
"LOK1378_1mm";"SILVA (only NR);Eukaryota;Amorphea;Obazoa;Opisthokonta;Holozoa;Choanozoa;Choanoflagellata;Ichthyosporea;Dermocystida;Rhinosporideacae;Dermocystidium;";"0.0";"0";"4";"4";"0";"4";"0";"430520";"5766"
"LOK1378_1mm";"SILVA (only NR);Eukaryota;Amorphea;Obazoa;Opisthokonta;Holozoa;Choanozoa;Choanoflagellata;Ichthyosporea;Dermocystida;Rhinosporideacae;Rhinosporidium;";"0.0";"0";"1";"1";"0";"1";"0";"430523";"5766"
"LOK1378_1mm";"SILVA (only NR);Eukaryota;Amorphea;Obazoa;Opisthokonta;Holozoa;Choanozoa;Choanoflagellata;Ichthyosporea;Ichthyophonae;";"0.0";"0";"67";"62";"0";"62";"5";"430462";"5766"
"LOK1378_1mm";"SILVA (only NR);Eukaryota;Amorphea;Obazoa;Opisthokonta;Holozoa;Choanozoa;Choanoflagellata;Ichthyosporea;Ichthyophonae;Abeoformidae;";"0.0";"0";"11";"10";"0";"10";"1";"430514";"5766"
"LOK1378_1mm";"SILVA (only NR);Eukaryota;Amorphea;Obazoa;Opisthokonta;Holozoa;Choanozoa;Choanoflagellata;Ichthyosporea;Ichthyophonae;Abeoformidae;Abeoforma;";"0.0";"0";"2";"2";"0";"2";"0";"430522";"5766"
"LOK1378_1mm";"SILVA (only NR);Eukaryota;Amorphea;Obazoa;Opisthokonta;Holozoa;Choanozoa;Choanoflagellata;Ichthyosporea;Ichthyophonae;Abeoformidae;Caullerya;";"0.0";"0";"1";"1";"0";"1";"0";"430523";"5766"
"LOK1378_1mm";"SILVA (only NR);Eukaryota;Amorphea;Obazoa;Opisthokonta;Holozoa;Choanozoa;Choanoflagellata;Ichthyosporea;Ichthyophonae;Abeoformidae;Marine Ichthyosporeans 1;";"0.0";"0";"2";"2";"0";"2";"0";"430522";"5766"
"LOK1378_1mm";"SILVA (only NR);Eukaryota;Amorphea;Obazoa;Opisthokonta;Holozoa;Choanozoa;Choanoflagellata;Ichthyosporea;Ichthyophonae;Abeoformidae;Pirum;";"0.0";"0";"3";"2";"0";"2";"1";"430522";"5766"
"LOK1378_1mm";"SILVA (only NR);Eukaryota;Amorphea;Obazoa;Opisthokonta;Holozoa;Choanozoa;Choanoflagellata;Ichthyosporea;Ichthyophonae;Ichthyophonidae;";"0.0";"0";"43";"42";"0";"42";"1";"430482";"5766"
"LOK1378_1mm";"SILVA (only NR);Eukaryota;Amorphea;Obazoa;Opisthokonta;Holozoa;Choanozoa;Choanoflagellata;Ichthyosporea;Ichthyophonae;Ichthyophonidae;Amoebidium;";"0.0";"0";"1";"1";"0";"1";"0";"430523";"5766"
"LOK1378_1mm";"SILVA (only NR);Eukaryota;Amorphea;Obazoa;Opisthokonta;Holozoa;Choanozoa;Choanoflagellata;Ichthyosporea;Ichthyophonae;Ichthyophonidae;Freshwater Ichthyosporeans 1;";"0.0";"0";"3";"2";"0";"2";"1";"430522";"5766"
"LOK1378_1mm";"SILVA (only NR);Eukaryota;Amorphea;Obazoa;Opisthokonta;Holozoa;Choanozoa;Choanoflagellata;Ichthyosporea;Ichthyophonae;Ichthyophonidae;Ichthyophonus;";"0.0";"0";"4";"4";"0";"4";"0";"430520";"5766"
"LOK1378_1mm";"SILVA (only NR);Eukaryota;Amorphea;Obazoa;Opisthokonta;Holozoa;Choanozoa;Choanoflagellata;Ichthyosporea;Ichthyophonae;Ichthyophonidae;Paramoebidium;";"0.0";"0";"32";"32";"0";"32";"0";"430492";"5766"
"LOK1378_1mm";"SILVA (only NR);Eukaryota;Amorphea;Obazoa;Opisthokonta;Holozoa;Choanozoa;Choanoflagellata;Ichthyosporea;Ichthyophonae;Ichthyophonidae;Psorospermium;";"0.0";"0";"1";"1";"0";"1";"0";"430523";"5766"
"LOK1378_1mm";"SILVA (only NR);Eukaryota;Amorphea;Obazoa;Opisthokonta;Holozoa;Choanozoa;Choanoflagellata;Ichthyosporea;Ichthyophonae;Pseudoperkinsidae;";"0.0";"0";"12";"10";"0";"10";"2";"430514";"5766"
"LOK1378_1mm";"SILVA (only NR);Eukaryota;Amorphea;Obazoa;Opisthokonta;Holozoa;Choanozoa;Choanoflagellata;Ichthyosporea;Ichthyophonae;Pseudoperkinsidae;Anurofeca;";"0.0";"0";"3";"3";"0";"3";"0";"430521";"5766"
"LOK1378_1mm";"SILVA (only NR);Eukaryota;Amorphea;Obazoa;Opisthokonta;Holozoa;Choanozoa;Choanoflagellata;Ichthyosporea;Ichthyophonae;Pseudoperkinsidae;Creolimax;";"0.0";"0";"1";"1";"0";"1";"0";"430523";"5766"
"LOK1378_1mm";"SILVA (only NR);Eukaryota;Amorphea;Obazoa;Opisthokonta;Holozoa;Choanozoa;Choanoflagellata;Ichthyosporea;Ichthyophonae;Pseudoperkinsidae;LKM51;";"0.0";"0";"2";"1";"0";"1";"1";"430523";"5766"
"LOK1378_1mm";"SILVA (only NR);Eukaryota;Amorphea;Obazoa;Opisthokonta;Holozoa;Choanozoa;Metazoa;";"0.0";"0";"21032";"19930";"0";"19930";"1102";"410594";"5766"
"LOK1378_1mm";"SILVA (only NR);Eukaryota;Amorphea;Obazoa;Opisthokonta;Holozoa;Choanozoa;Metazoa;Animalia;";"0.0";"0";"20636";"19544";"0";"19544";"1092";"410980";"5766"
"LOK1378_1mm";"SILVA (only NR);Eukaryota;Amorphea;Obazoa;Opisthokonta;Holozoa;Choanozoa;Metazoa;Animalia;BCP clade;";"0.0";"0";"20636";"19544";"0";"19544";"1092";"410980";"5766"
"LOK1378_1mm";"SILVA (only NR);Eukaryota;Amorphea;Obazoa;Opisthokonta;Holozoa;Choanozoa;Metazoa;Animalia;BCP clade;Bilateria;";"0.0";"0";"19180";"18287";"0";"18287";"893";"412237";"5766"
"LOK1378_1mm";"SILVA (only NR);Eukaryota;Amorphea;Obazoa;Opisthokonta;Holozoa;Choanozoa;Metazoa;Animalia;BCP clade;Bilateria;Deuterostomia;";"0.0";"0";"1400";"1252";"0";"1252";"148";"429272";"5766"
"LOK1378_1mm";"SILVA (only NR);Eukaryota;Amorphea;Obazoa;Opisthokonta;Holozoa;Choanozoa;Metazoa;Animalia;BCP clade;Bilateria;Deuterostomia;Ambulacraria;";"0.0";"0";"178";"175";"0";"175";"3";"430349";"5766"
"LOK1378_1mm";"SILVA (only NR);Eukaryota;Amorphea;Obazoa;Opisthokonta;Holozoa;Choanozoa;Metazoa;Animalia;BCP clade;Bilateria;Deuterostomia;Ambulacraria;Echinodermata;";"0.0";"0";"146";"143";"0";"143";"3";"430381";"5766"
"LOK1378_1mm";"SILVA (only NR);Eukaryota;Amorphea;Obazoa;Opisthokonta;Holozoa;Choanozoa;Metazoa;Animalia;BCP clade;Bilateria;Deuterostomia;Ambulacraria;Echinodermata;Asteroidea;";"0.0";"0";"35";"35";"0";"35";"0";"430489";"5766"
"LOK1378_1mm";"SILVA (only NR);Eukaryota;Amorphea;Obazoa;Opisthokonta;Holozoa;Choanozoa;Metazoa;Animalia;BCP clade;Bilateria;Deuterostomia;Ambulacraria;Echinodermata;Crinoidea;";"0.0";"0";"13";"13";"0";"13";"0";"430511";"5766"
"LOK1378_1mm";"SILVA (only NR);Eukaryota;Amorphea;Obazoa;Opisthokonta;Holozoa;Choanozoa;Metazoa;Animalia;BCP clade;Bilateria;Deuterostomia;Ambulacraria;Echinodermata;Echinoidea;";"0.0";"0";"39";"37";"0";"37";"2";"430487";"5766"
"LOK1378_1mm";"SILVA (only NR);Eukaryota;Amorphea;Obazoa;Opisthokonta;Holozoa;Choanozoa;Metazoa;Animalia;BCP clade;Bilateria;Deuterostomia;Ambulacraria;Echinodermata;Holothuroidea;";"0.0";"0";"44";"44";"0";"44";"0";"430480";"5766"
"LOK1378_1mm";"SILVA (only NR);Eukaryota;Amorphea;Obazoa;Opisthokonta;Holozoa;Choanozoa;Metazoa;Animalia;BCP clade;Bilateria;Deuterostomia;Ambulacraria;Echinodermata;Ophiuroidea;";"0.0";"0";"14";"14";"0";"14";"0";"430510";"5766"
"LOK1378_1mm";"SILVA (only NR);Eukaryota;Amorphea;Obazoa;Opisthokonta;Holozoa;Choanozoa;Metazoa;Animalia;BCP clade;Bilateria;Deuterostomia;Ambulacraria;Hemichordata;";"0.0";"0";"32";"32";"0";"32";"0";"430492";"5766"
"LOK1378_1mm";"SILVA (only NR);Eukaryota;Amorphea;Obazoa;Opisthokonta;Holozoa;Choanozoa;Metazoa;Animalia;BCP clade;Bilateria;Deuterostomia;Ambulacraria;Hemichordata;Enteropneusta;";"0.0";"0";"29";"29";"0";"29";"0";"430495";"5766"
"LOK1378_1mm";"SILVA (only NR);Eukaryota;Amorphea;Obazoa;Opisthokonta;Holozoa;Choanozoa;Metazoa;Animalia;BCP clade;Bilateria;Deuterostomia;Ambulacraria;Hemichordata;Enteropneusta;Harrimaniidae;";"0.0";"0";"14";"14";"0";"14";"0";"430510";"5766"
"LOK1378_1mm";"SILVA (only NR);Eukaryota;Amorphea;Obazoa;Opisthokonta;Holozoa;Choanozoa;Metazoa;Animalia;BCP clade;Bilateria;Deuterostomia;Ambulacraria;Hemichordata;Enteropneusta;Ptychoderidae;";"0.0";"0";"11";"11";"0";"11";"0";"430513";"5766"
"LOK1378_1mm";"SILVA (only NR);Eukaryota;Amorphea;Obazoa;Opisthokonta;Holozoa;Choanozoa;Metazoa;Animalia;BCP clade;Bilateria;Deuterostomia;Ambulacraria;Hemichordata;Enteropneusta;Saxipendiidae;";"0.0";"0";"2";"2";"0";"2";"0";"430522";"5766"
"LOK1378_1mm";"SILVA (only NR);Eukaryota;Amorphea;Obazoa;Opisthokonta;Holozoa;Choanozoa;Metazoa;Animalia;BCP clade;Bilateria;Deuterostomia;Ambulacraria;Hemichordata;Enteropneusta;Spengelidae;";"0.0";"0";"2";"2";"0";"2";"0";"430522";"5766"
"LOK1378_1mm";"SILVA (only NR);Eukaryota;Amorphea;Obazoa;Opisthokonta;Holozoa;Choanozoa;Metazoa;Animalia;BCP clade;Bilateria;Deuterostomia;Ambulacraria;Hemichordata;Graptolithoidea;";"0.0";"0";"3";"3";"0";"3";"0";"430521";"5766"
"LOK1378_1mm";"SILVA (only NR);Eukaryota;Amorphea;Obazoa;Opisthokonta;Holozoa;Choanozoa;Metazoa;Animalia;BCP clade;Bilateria;Deuterostomia;Ambulacraria;Hemichordata;Graptolithoidea;Cephalodiscidae;";"0.0";"0";"3";"3";"0";"3";"0";"430521";"5766"
"LOK1378_1mm";"SILVA (only NR);Eukaryota;Amorphea;Obazoa;Opisthokonta;Holozoa;Choanozoa;Metazoa;Animalia;BCP clade;Bilateria;Deuterostomia;Chordata;";"0.0";"0";"1221";"1076";"0";"1076";"145";"429448";"5766"
"LOK1378_1mm";"SILVA (only NR);Eukaryota;Amorphea;Obazoa;Opisthokonta;Holozoa;Choanozoa;Metazoa;Animalia;BCP clade;Bilateria;Deuterostomia;Chordata;Cephalochordata;";"0.0";"0";"6";"5";"0";"5";"1";"430519";"5766"
"LOK1378_1mm";"SILVA (only NR);Eukaryota;Amorphea;Obazoa;Opisthokonta;Holozoa;Choanozoa;Metazoa;Animalia;BCP clade;Bilateria;Deuterostomia;Chordata;Cephalochordata;Leptocardii;";"0.0";"0";"6";"5";"0";"5";"1";"430519";"5766"
"LOK1378_1mm";"SILVA (only NR);Eukaryota;Amorphea;Obazoa;Opisthokonta;Holozoa;Choanozoa;Metazoa;Animalia;BCP clade;Bilateria;Deuterostomia;Chordata;Cephalochordata;Leptocardii;Amphioxiformes;";"0.0";"0";"6";"5";"0";"5";"1";"430519";"5766"
"LOK1378_1mm";"SILVA (only NR);Eukaryota;Amorphea;Obazoa;Opisthokonta;Holozoa;Choanozoa;Metazoa;Animalia;BCP clade;Bilateria;Deuterostomia;Chordata;Cephalochordata;Leptocardii;Amphioxiformes;Branchiostomidae;";"0.0";"0";"6";"5";"0";"5";"1";"430519";"5766"
"LOK1378_1mm";"SILVA (only NR);Eukaryota;Amorphea;Obazoa;Opisthokonta;Holozoa;Choanozoa;Metazoa;Animalia;BCP clade;Bilateria;Deuterostomia;Chordata;Tunicata;";"0.0";"0";"130";"121";"0";"121";"9";"430403";"5766"
"LOK1378_1mm";"SILVA (only NR);Eukaryota;Amorphea;Obazoa;Opisthokonta;Holozoa;Choanozoa;Metazoa;Animalia;BCP clade;Bilateria;Deuterostomia;Chordata;Tunicata;Appendicularia;";"0.0";"0";"29";"28";"0";"28";"1";"430496";"5766"
"LOK1378_1mm";"SILVA (only NR);Eukaryota;Amorphea;Obazoa;Opisthokonta;Holozoa;Choanozoa;Metazoa;Animalia;BCP clade;Bilateria;Deuterostomia;Chordata;Tunicata;Appendicularia;Copelata;";"0.0";"0";"29";"28";"0";"28";"1";"430496";"5766"
"LOK1378_1mm";"SILVA (only NR);Eukaryota;Amorphea;Obazoa;Opisthokonta;Holozoa;Choanozoa;Metazoa;Animalia;BCP clade;Bilateria;Deuterostomia;Chordata;Tunicata;Appendicularia;Copelata;Oikopleuridae;";"0.0";"0";"29";"28";"0";"28";"1";"430496";"5766"
"LOK1378_1mm";"SILVA (only NR);Eukaryota;Amorphea;Obazoa;Opisthokonta;Holozoa;Choanozoa;Metazoa;Animalia;BCP clade;Bilateria;Deuterostomia;Chordata;Tunicata;Ascidiacea;";"0.0";"0";"78";"70";"0";"70";"8";"430454";"5766"
"LOK1378_1mm";"SILVA (only NR);Eukaryota;Amorphea;Obazoa;Opisthokonta;Holozoa;Choanozoa;Metazoa;Animalia;BCP clade;Bilateria;Deuterostomia;Chordata;Tunicata;Ascidiacea;Enterogona;";"0.0";"0";"39";"31";"0";"31";"8";"430493";"5766"
"LOK1378_1mm";"SILVA (only NR);Eukaryota;Amorphea;Obazoa;Opisthokonta;Holozoa;Choanozoa;Metazoa;Animalia;BCP clade;Bilateria;Deuterostomia;Chordata;Tunicata;Ascidiacea;Stolidobranchia;";"0.0";"0";"39";"39";"0";"39";"0";"430485";"5766"
"LOK1378_1mm";"SILVA (only NR);Eukaryota;Amorphea;Obazoa;Opisthokonta;Holozoa;Choanozoa;Metazoa;Animalia;BCP clade;Bilateria;Deuterostomia;Chordata;Tunicata;Thaliacea;";"0.0";"0";"23";"23";"0";"23";"0";"430501";"5766"
"LOK1378_1mm";"SILVA (only NR);Eukaryota;Amorphea;Obazoa;Opisthokonta;Holozoa;Choanozoa;Metazoa;Animalia;BCP clade;Bilateria;Deuterostomia;Chordata;Tunicata;Thaliacea;Doliolida;";"0.0";"0";"2";"2";"0";"2";"0";"430522";"5766"
"LOK1378_1mm";"SILVA (only NR);Eukaryota;Amorphea;Obazoa;Opisthokonta;Holozoa;Choanozoa;Metazoa;Animalia;BCP clade;Bilateria;Deuterostomia;Chordata;Tunicata;Thaliacea;Pyrosomata;";"0.0";"0";"3";"3";"0";"3";"0";"430521";"5766"
"LOK1378_1mm";"SILVA (only NR);Eukaryota;Amorphea;Obazoa;Opisthokonta;Holozoa;Choanozoa;Metazoa;Animalia;BCP clade;Bilateria;Deuterostomia;Chordata;Tunicata;Thaliacea;Salpida;";"0.0";"0";"18";"18";"0";"18";"0";"430506";"5766"
"LOK1378_1mm";"SILVA (only NR);Eukaryota;Amorphea;Obazoa;Opisthokonta;Holozoa;Choanozoa;Metazoa;Animalia;BCP clade;Bilateria;Deuterostomia;Chordata;Vertebrata;";"0.0";"0";"1085";"950";"0";"950";"135";"429574";"5766"
"LOK1378_1mm";"SILVA (only NR);Eukaryota;Amorphea;Obazoa;Opisthokonta;Holozoa;Choanozoa;Metazoa;Animalia;BCP clade;Bilateria;Deuterostomia;Chordata;Vertebrata;Agnatha;";"0.0";"0";"9";"8";"0";"8";"1";"430516";"5766"
"LOK1378_1mm";"SILVA (only NR);Eukaryota;Amorphea;Obazoa;Opisthokonta;Holozoa;Choanozoa;Metazoa;Animalia;BCP clade;Bilateria;Deuterostomia;Chordata;Vertebrata;Agnatha;Cephalaspidomorphi;";"0.0";"0";"7";"6";"0";"6";"1";"430518";"5766"
"LOK1378_1mm";"SILVA (only NR);Eukaryota;Amorphea;Obazoa;Opisthokonta;Holozoa;Choanozoa;Metazoa;Animalia;BCP clade;Bilateria;Deuterostomia;Chordata;Vertebrata;Agnatha;Cephalaspidomorphi;Petromyzontiformes;";"0.0";"0";"7";"6";"0";"6";"1";"430518";"5766"
"LOK1378_1mm";"SILVA (only NR);Eukaryota;Amorphea;Obazoa;Opisthokonta;Holozoa;Choanozoa;Metazoa;Animalia;BCP clade;Bilateria;Deuterostomia;Chordata;Vertebrata;Agnatha;Myxini;";"0.0";"0";"2";"2";"0";"2";"0";"430522";"5766"
"LOK1378_1mm";"SILVA (only NR);Eukaryota;Amorphea;Obazoa;Opisthokonta;Holozoa;Choanozoa;Metazoa;Animalia;BCP clade;Bilateria;Deuterostomia;Chordata;Vertebrata;Agnatha;Myxini;Myxiniformes;";"0.0";"0";"2";"2";"0";"2";"0";"430522";"5766"
"LOK1378_1mm";"SILVA (only NR);Eukaryota;Amorphea;Obazoa;Opisthokonta;Holozoa;Choanozoa;Metazoa;Animalia;BCP clade;Bilateria;Deuterostomia;Chordata;Vertebrata;Gnathostomata;";"0.0";"0";"1076";"942";"0";"942";"134";"429582";"5766"
"LOK1378_1mm";"SILVA (only NR);Eukaryota;Amorphea;Obazoa;Opisthokonta;Holozoa;Choanozoa;Metazoa;Animalia;BCP clade;Bilateria;Deuterostomia;Chordata;Vertebrata;Gnathostomata;Chimaeriformes;";"0.0";"0";"2";"1";"0";"1";"1";"430523";"5766"
"LOK1378_1mm";"SILVA (only NR);Eukaryota;Amorphea;Obazoa;Opisthokonta;Holozoa;Choanozoa;Metazoa;Animalia;BCP clade;Bilateria;Deuterostomia;Chordata;Vertebrata;Gnathostomata;Chimaeriformes;Callorhinchus;";"0.0";"0";"2";"1";"0";"1";"1";"430523";"5766"
"LOK1378_1mm";"SILVA (only NR);Eukaryota;Amorphea;Obazoa;Opisthokonta;Holozoa;Choanozoa;Metazoa;Animalia;BCP clade;Bilateria;Deuterostomia;Chordata;Vertebrata;Gnathostomata;Chondrichthyes;";"0.0";"0";"14";"14";"0";"14";"0";"430510";"5766"
"LOK1378_1mm";"SILVA (only NR);Eukaryota;Amorphea;Obazoa;Opisthokonta;Holozoa;Choanozoa;Metazoa;Animalia;BCP clade;Bilateria;Deuterostomia;Chordata;Vertebrata;Gnathostomata;Chondrichthyes;Elasmobranchii;";"0.0";"0";"14";"14";"0";"14";"0";"430510";"5766"
"LOK1378_1mm";"SILVA (only NR);Eukaryota;Amorphea;Obazoa;Opisthokonta;Holozoa;Choanozoa;Metazoa;Animalia;BCP clade;Bilateria;Deuterostomia;Chordata;Vertebrata;Gnathostomata;Chondrichthyes;Elasmobranchii;Batoidea;";"0.0";"0";"3";"3";"0";"3";"0";"430521";"5766"
"LOK1378_1mm";"SILVA (only NR);Eukaryota;Amorphea;Obazoa;Opisthokonta;Holozoa;Choanozoa;Metazoa;Animalia;BCP clade;Bilateria;Deuterostomia;Chordata;Vertebrata;Gnathostomata;Chondrichthyes;Elasmobranchii;Galeomorphii;";"0.0";"0";"8";"8";"0";"8";"0";"430516";"5766"
"LOK1378_1mm";"SILVA (only NR);Eukaryota;Amorphea;Obazoa;Opisthokonta;Holozoa;Choanozoa;Metazoa;Animalia;BCP clade;Bilateria;Deuterostomia;Chordata;Vertebrata;Gnathostomata;Chondrichthyes;Elasmobranchii;Squalimorphii;";"0.0";"0";"3";"3";"0";"3";"0";"430521";"5766"
"LOK1378_1mm";"SILVA (only NR);Eukaryota;Amorphea;Obazoa;Opisthokonta;Holozoa;Choanozoa;Metazoa;Animalia;BCP clade;Bilateria;Deuterostomia;Chordata;Vertebrata;Gnathostomata;Euteleostomi;";"0.0";"0";"1060";"927";"0";"927";"133";"429597";"5766"
"LOK1378_1mm";"SILVA (only NR);Eukaryota;Amorphea;Obazoa;Opisthokonta;Holozoa;Choanozoa;Metazoa;Animalia;BCP clade;Bilateria;Deuterostomia;Chordata;Vertebrata;Gnathostomata;Euteleostomi;Actinopterygii;";"0.0";"0";"426";"367";"0";"367";"59";"430157";"5766"
"LOK1378_1mm";"SILVA (only NR);Eukaryota;Amorphea;Obazoa;Opisthokonta;Holozoa;Choanozoa;Metazoa;Animalia;BCP clade;Bilateria;Deuterostomia;Chordata;Vertebrata;Gnathostomata;Euteleostomi;Actinopterygii;Chondrostei;";"0.0";"0";"13";"13";"0";"13";"0";"430511";"5766"
"LOK1378_1mm";"SILVA (only NR);Eukaryota;Amorphea;Obazoa;Opisthokonta;Holozoa;Choanozoa;Metazoa;Animalia;BCP clade;Bilateria;Deuterostomia;Chordata;Vertebrata;Gnathostomata;Euteleostomi;Actinopterygii;Chondrostei;Acipenseriformes;";"0.0";"0";"13";"13";"0";"13";"0";"430511";"5766"
"LOK1378_1mm";"SILVA (only NR);Eukaryota;Amorphea;Obazoa;Opisthokonta;Holozoa;Choanozoa;Metazoa;Animalia;BCP clade;Bilateria;Deuterostomia;Chordata;Vertebrata;Gnathostomata;Euteleostomi;Actinopterygii;Neopterygii;";"0.0";"0";"412";"353";"0";"353";"59";"430171";"5766"
"LOK1378_1mm";"SILVA (only NR);Eukaryota;Amorphea;Obazoa;Opisthokonta;Holozoa;Choanozoa;Metazoa;Animalia;BCP clade;Bilateria;Deuterostomia;Chordata;Vertebrata;Gnathostomata;Euteleostomi;Actinopterygii;Neopterygii;Amiiformes;";"0.0";"0";"10";"9";"0";"9";"1";"430515";"5766"
"LOK1378_1mm";"SILVA (only NR);Eukaryota;Amorphea;Obazoa;Opisthokonta;Holozoa;Choanozoa;Metazoa;Animalia;BCP clade;Bilateria;Deuterostomia;Chordata;Vertebrata;Gnathostomata;Euteleostomi;Actinopterygii;Neopterygii;Semionotiformes;";"0.0";"0";"4";"4";"0";"4";"0";"430520";"5766"
"LOK1378_1mm";"SILVA (only NR);Eukaryota;Amorphea;Obazoa;Opisthokonta;Holozoa;Choanozoa;Metazoa;Animalia;BCP clade;Bilateria;Deuterostomia;Chordata;Vertebrata;Gnathostomata;Euteleostomi;Actinopterygii;Neopterygii;Teleostei;";"0.0";"0";"397";"339";"0";"339";"58";"430185";"5766"
"LOK1378_1mm";"SILVA (only NR);Eukaryota;Amorphea;Obazoa;Opisthokonta;Holozoa;Choanozoa;Metazoa;Animalia;BCP clade;Bilateria;Deuterostomia;Chordata;Vertebrata;Gnathostomata;Euteleostomi;Sarcopterygii;";"0.0";"0";"6";"6";"0";"6";"0";"430518";"5766"
"LOK1378_1mm";"SILVA (only NR);Eukaryota;Amorphea;Obazoa;Opisthokonta;Holozoa;Choanozoa;Metazoa;Animalia;BCP clade;Bilateria;Deuterostomia;Chordata;Vertebrata;Gnathostomata;Euteleostomi;Sarcopterygii;Coelacanthiformes;";"0.0";"0";"3";"3";"0";"3";"0";"430521";"5766"
"LOK1378_1mm";"SILVA (only NR);Eukaryota;Amorphea;Obazoa;Opisthokonta;Holozoa;Choanozoa;Metazoa;Animalia;BCP clade;Bilateria;Deuterostomia;Chordata;Vertebrata;Gnathostomata;Euteleostomi;Sarcopterygii;Dipnoi;";"0.0";"0";"3";"3";"0";"3";"0";"430521";"5766"
"LOK1378_1mm";"SILVA (only NR);Eukaryota;Amorphea;Obazoa;Opisthokonta;Holozoa;Choanozoa;Metazoa;Animalia;BCP clade;Bilateria;Deuterostomia;Chordata;Vertebrata;Gnathostomata;Euteleostomi;Tetrapoda;";"0.0";"0";"627";"553";"0";"553";"74";"429971";"5766"
"LOK1378_1mm";"SILVA (only NR);Eukaryota;Amorphea;Obazoa;Opisthokonta;Holozoa;Choanozoa;Metazoa;Animalia;BCP clade;Bilateria;Deuterostomia;Chordata;Vertebrata;Gnathostomata;Euteleostomi;Tetrapoda;Amphibia;";"0.0";"0";"24";"20";"0";"20";"4";"430504";"5766"
"LOK1378_1mm";"SILVA (only NR);Eukaryota;Amorphea;Obazoa;Opisthokonta;Holozoa;Choanozoa;Metazoa;Animalia;BCP clade;Bilateria;Deuterostomia;Chordata;Vertebrata;Gnathostomata;Euteleostomi;Tetrapoda;Aves;";"0.0";"0";"10";"9";"0";"9";"1";"430515";"5766"
"LOK1378_1mm";"SILVA (only NR);Eukaryota;Amorphea;Obazoa;Opisthokonta;Holozoa;Choanozoa;Metazoa;Animalia;BCP clade;Bilateria;Deuterostomia;Chordata;Vertebrata;Gnathostomata;Euteleostomi;Tetrapoda;Crocodylia;";"0.0";"0";"23";"21";"0";"21";"2";"430503";"5766"
"LOK1378_1mm";"SILVA (only NR);Eukaryota;Amorphea;Obazoa;Opisthokonta;Holozoa;Choanozoa;Metazoa;Animalia;BCP clade;Bilateria;Deuterostomia;Chordata;Vertebrata;Gnathostomata;Euteleostomi;Tetrapoda;Lepidosauria;";"0.0";"0";"7";"7";"0";"7";"0";"430517";"5766"
"LOK1378_1mm";"SILVA (only NR);Eukaryota;Amorphea;Obazoa;Opisthokonta;Holozoa;Choanozoa;Metazoa;Animalia;BCP clade;Bilateria;Deuterostomia;Chordata;Vertebrata;Gnathostomata;Euteleostomi;Tetrapoda;Mammalia;";"0.0";"0";"550";"483";"0";"483";"67";"430041";"5766"
"LOK1378_1mm";"SILVA (only NR);Eukaryota;Amorphea;Obazoa;Opisthokonta;Holozoa;Choanozoa;Metazoa;Animalia;BCP clade;Bilateria;Deuterostomia;Chordata;Vertebrata;Gnathostomata;Euteleostomi;Tetrapoda;Testudines;";"0.0";"0";"13";"13";"0";"13";"0";"430511";"5766"
"LOK1378_1mm";"SILVA (only NR);Eukaryota;Amorphea;Obazoa;Opisthokonta;Holozoa;Choanozoa;Metazoa;Animalia;BCP clade;Bilateria;Protostomia;";"0.0";"0";"17780";"17035";"0";"17035";"745";"413489";"5766"
"LOK1378_1mm";"SILVA (only NR);Eukaryota;Amorphea;Obazoa;Opisthokonta;Holozoa;Choanozoa;Metazoa;Animalia;BCP clade;Bilateria;Protostomia;Chaetognatha;";"0.0";"0";"46";"43";"0";"43";"3";"430481";"5766"
"LOK1378_1mm";"SILVA (only NR);Eukaryota;Amorphea;Obazoa;Opisthokonta;Holozoa;Choanozoa;Metazoa;Animalia;BCP clade;Bilateria;Protostomia;Chaetognatha;Sagittoidea;";"0.0";"0";"46";"43";"0";"43";"3";"430481";"5766"
"LOK1378_1mm";"SILVA (only NR);Eukaryota;Amorphea;Obazoa;Opisthokonta;Holozoa;Choanozoa;Metazoa;Animalia;BCP clade;Bilateria;Protostomia;Chaetognatha;Sagittoidea;Aphragmophora;";"0.0";"0";"35";"35";"0";"35";"0";"430489";"5766"
"LOK1378_1mm";"SILVA (only NR);Eukaryota;Amorphea;Obazoa;Opisthokonta;Holozoa;Choanozoa;Metazoa;Animalia;BCP clade;Bilateria;Protostomia;Chaetognatha;Sagittoidea;Monophragmophora;";"0.0";"0";"4";"1";"0";"1";"3";"430523";"5766"
"LOK1378_1mm";"SILVA (only NR);Eukaryota;Amorphea;Obazoa;Opisthokonta;Holozoa;Choanozoa;Metazoa;Animalia;BCP clade;Bilateria;Protostomia;Chaetognatha;Sagittoidea;Phragmophora;";"0.0";"0";"7";"7";"0";"7";"0";"430517";"5766"
"LOK1378_1mm";"SILVA (only NR);Eukaryota;Amorphea;Obazoa;Opisthokonta;Holozoa;Choanozoa;Metazoa;Animalia;BCP clade;Bilateria;Protostomia;Ecdysozoa;";"0.0";"0";"12526";"11941";"0";"11941";"585";"418583";"5766"
"LOK1378_1mm";"SILVA (only NR);Eukaryota;Amorphea;Obazoa;Opisthokonta;Holozoa;Choanozoa;Metazoa;Animalia;BCP clade;Bilateria;Protostomia;Ecdysozoa;Arthropoda;";"0.0";"0";"10152";"9687";"0";"9687";"465";"420837";"5766"
"LOK1378_1mm";"SILVA (only NR);Eukaryota;Amorphea;Obazoa;Opisthokonta;Holozoa;Choanozoa;Metazoa;Animalia;BCP clade;Bilateria;Protostomia;Ecdysozoa;Arthropoda;Chelicerata;";"0.0";"0";"2232";"2172";"0";"2172";"60";"428352";"5766"
"LOK1378_1mm";"SILVA (only NR);Eukaryota;Amorphea;Obazoa;Opisthokonta;Holozoa;Choanozoa;Metazoa;Animalia;BCP clade;Bilateria;Protostomia;Ecdysozoa;Arthropoda;Chelicerata;Arachnida;";"0.0";"0";"2150";"2091";"0";"2091";"59";"428433";"5766"
"LOK1378_1mm";"SILVA (only NR);Eukaryota;Amorphea;Obazoa;Opisthokonta;Holozoa;Choanozoa;Metazoa;Animalia;BCP clade;Bilateria;Protostomia;Ecdysozoa;Arthropoda;Chelicerata;Arachnida;Acari;";"0.0";"0";"855";"837";"0";"837";"18";"429687";"5766"
"LOK1378_1mm";"SILVA (only NR);Eukaryota;Amorphea;Obazoa;Opisthokonta;Holozoa;Choanozoa;Metazoa;Animalia;BCP clade;Bilateria;Protostomia;Ecdysozoa;Arthropoda;Chelicerata;Arachnida;Amblypygi;";"0.0";"0";"15";"10";"0";"10";"5";"430514";"5766"
"LOK1378_1mm";"SILVA (only NR);Eukaryota;Amorphea;Obazoa;Opisthokonta;Holozoa;Choanozoa;Metazoa;Animalia;BCP clade;Bilateria;Protostomia;Ecdysozoa;Arthropoda;Chelicerata;Arachnida;Araneae;";"0.0";"0";"864";"839";"0";"839";"25";"429685";"5766"
"LOK1378_1mm";"SILVA (only NR);Eukaryota;Amorphea;Obazoa;Opisthokonta;Holozoa;Choanozoa;Metazoa;Animalia;BCP clade;Bilateria;Protostomia;Ecdysozoa;Arthropoda;Chelicerata;Arachnida;Opiliones;";"0.0";"0";"294";"288";"0";"288";"6";"430236";"5766"
"LOK1378_1mm";"SILVA (only NR);Eukaryota;Amorphea;Obazoa;Opisthokonta;Holozoa;Choanozoa;Metazoa;Animalia;BCP clade;Bilateria;Protostomia;Ecdysozoa;Arthropoda;Chelicerata;Arachnida;Palpigradi;";"0.0";"0";"10";"10";"0";"10";"0";"430514";"5766"
"LOK1378_1mm";"SILVA (only NR);Eukaryota;Amorphea;Obazoa;Opisthokonta;Holozoa;Choanozoa;Metazoa;Animalia;BCP clade;Bilateria;Protostomia;Ecdysozoa;Arthropoda;Chelicerata;Arachnida;Pseudoscorpiones;";"0.0";"0";"88";"83";"0";"83";"5";"430441";"5766"
"LOK1378_1mm";"SILVA (only NR);Eukaryota;Amorphea;Obazoa;Opisthokonta;Holozoa;Choanozoa;Metazoa;Animalia;BCP clade;Bilateria;Protostomia;Ecdysozoa;Arthropoda;Chelicerata;Arachnida;Ricinulei;";"0.0";"0";"3";"3";"0";"3";"0";"430521";"5766"
"LOK1378_1mm";"SILVA (only NR);Eukaryota;Amorphea;Obazoa;Opisthokonta;Holozoa;Choanozoa;Metazoa;Animalia;BCP clade;Bilateria;Protostomia;Ecdysozoa;Arthropoda;Chelicerata;Arachnida;Scorpiones;";"0.0";"0";"12";"12";"0";"12";"0";"430512";"5766"
"LOK1378_1mm";"SILVA (only NR);Eukaryota;Amorphea;Obazoa;Opisthokonta;Holozoa;Choanozoa;Metazoa;Animalia;BCP clade;Bilateria;Protostomia;Ecdysozoa;Arthropoda;Chelicerata;Arachnida;Solifugae;";"0.0";"0";"7";"7";"0";"7";"0";"430517";"5766"
"LOK1378_1mm";"SILVA (only NR);Eukaryota;Amorphea;Obazoa;Opisthokonta;Holozoa;Choanozoa;Metazoa;Animalia;BCP clade;Bilateria;Protostomia;Ecdysozoa;Arthropoda;Chelicerata;Arachnida;Uropygi;";"0.0";"0";"2";"2";"0";"2";"0";"430522";"5766"
"LOK1378_1mm";"SILVA (only NR);Eukaryota;Amorphea;Obazoa;Opisthokonta;Holozoa;Choanozoa;Metazoa;Animalia;BCP clade;Bilateria;Protostomia;Ecdysozoa;Arthropoda;Chelicerata;Merostomata;";"0.0";"0";"9";"9";"0";"9";"0";"430515";"5766"
"LOK1378_1mm";"SILVA (only NR);Eukaryota;Amorphea;Obazoa;Opisthokonta;Holozoa;Choanozoa;Metazoa;Animalia;BCP clade;Bilateria;Protostomia;Ecdysozoa;Arthropoda;Chelicerata;Merostomata;Xiphosura;";"0.0";"0";"9";"9";"0";"9";"0";"430515";"5766"
"LOK1378_1mm";"SILVA (only NR);Eukaryota;Amorphea;Obazoa;Opisthokonta;Holozoa;Choanozoa;Metazoa;Animalia;BCP clade;Bilateria;Protostomia;Ecdysozoa;Arthropoda;Chelicerata;Pycnogonida;";"0.0";"0";"72";"71";"0";"71";"1";"430453";"5766"
"LOK1378_1mm";"SILVA (only NR);Eukaryota;Amorphea;Obazoa;Opisthokonta;Holozoa;Choanozoa;Metazoa;Animalia;BCP clade;Bilateria;Protostomia;Ecdysozoa;Arthropoda;Chelicerata;Pycnogonida;Pantopoda;";"0.0";"0";"72";"71";"0";"71";"1";"430453";"5766"
"LOK1378_1mm";"SILVA (only NR);Eukaryota;Amorphea;Obazoa;Opisthokonta;Holozoa;Choanozoa;Metazoa;Animalia;BCP clade;Bilateria;Protostomia;Ecdysozoa;Arthropoda;Crustacea;";"0.0";"0";"1909";"1825";"0";"1825";"84";"428699";"5766"
"LOK1378_1mm";"SILVA (only NR);Eukaryota;Amorphea;Obazoa;Opisthokonta;Holozoa;Choanozoa;Metazoa;Animalia;BCP clade;Bilateria;Protostomia;Ecdysozoa;Arthropoda;Crustacea;Branchiopoda;";"0.0";"0";"82";"66";"0";"66";"16";"430458";"5766"
"LOK1378_1mm";"SILVA (only NR);Eukaryota;Amorphea;Obazoa;Opisthokonta;Holozoa;Choanozoa;Metazoa;Animalia;BCP clade;Bilateria;Protostomia;Ecdysozoa;Arthropoda;Crustacea;Branchiopoda;Phyllopoda;";"0.0";"0";"75";"59";"0";"59";"16";"430465";"5766"
"LOK1378_1mm";"SILVA (only NR);Eukaryota;Amorphea;Obazoa;Opisthokonta;Holozoa;Choanozoa;Metazoa;Animalia;BCP clade;Bilateria;Protostomia;Ecdysozoa;Arthropoda;Crustacea;Branchiopoda;Phyllopoda;Diplostraca;";"0.0";"0";"73";"57";"0";"57";"16";"430467";"5766"
"LOK1378_1mm";"SILVA (only NR);Eukaryota;Amorphea;Obazoa;Opisthokonta;Holozoa;Choanozoa;Metazoa;Animalia;BCP clade;Bilateria;Protostomia;Ecdysozoa;Arthropoda;Crustacea;Branchiopoda;Phyllopoda;Notostraca;";"0.0";"0";"2";"2";"0";"2";"0";"430522";"5766"
"LOK1378_1mm";"SILVA (only NR);Eukaryota;Amorphea;Obazoa;Opisthokonta;Holozoa;Choanozoa;Metazoa;Animalia;BCP clade;Bilateria;Protostomia;Ecdysozoa;Arthropoda;Crustacea;Branchiopoda;Sarsostraca;";"0.0";"0";"7";"7";"0";"7";"0";"430517";"5766"
"LOK1378_1mm";"SILVA (only NR);Eukaryota;Amorphea;Obazoa;Opisthokonta;Holozoa;Choanozoa;Metazoa;Animalia;BCP clade;Bilateria;Protostomia;Ecdysozoa;Arthropoda;Crustacea;Branchiopoda;Sarsostraca;Anostraca;";"0.0";"0";"7";"7";"0";"7";"0";"430517";"5766"
"LOK1378_1mm";"SILVA (only NR);Eukaryota;Amorphea;Obazoa;Opisthokonta;Holozoa;Choanozoa;Metazoa;Animalia;BCP clade;Bilateria;Protostomia;Ecdysozoa;Arthropoda;Crustacea;Malacostraca;";"0.0";"0";"839";"799";"0";"799";"40";"429725";"5766"
"LOK1378_1mm";"SILVA (only NR);Eukaryota;Amorphea;Obazoa;Opisthokonta;Holozoa;Choanozoa;Metazoa;Animalia;BCP clade;Bilateria;Protostomia;Ecdysozoa;Arthropoda;Crustacea;Malacostraca;Eumalacostraca;";"0.0";"0";"834";"794";"0";"794";"40";"429730";"5766"
"LOK1378_1mm";"SILVA (only NR);Eukaryota;Amorphea;Obazoa;Opisthokonta;Holozoa;Choanozoa;Metazoa;Animalia;BCP clade;Bilateria;Protostomia;Ecdysozoa;Arthropoda;Crustacea;Malacostraca;Eumalacostraca;Eucarida;";"0.0";"0";"477";"468";"0";"468";"9";"430056";"5766"
"LOK1378_1mm";"SILVA (only NR);Eukaryota;Amorphea;Obazoa;Opisthokonta;Holozoa;Choanozoa;Metazoa;Animalia;BCP clade;Bilateria;Protostomia;Ecdysozoa;Arthropoda;Crustacea;Malacostraca;Eumalacostraca;Hoplocarida;";"0.0";"0";"10";"10";"0";"10";"0";"430514";"5766"
"LOK1378_1mm";"SILVA (only NR);Eukaryota;Amorphea;Obazoa;Opisthokonta;Holozoa;Choanozoa;Metazoa;Animalia;BCP clade;Bilateria;Protostomia;Ecdysozoa;Arthropoda;Crustacea;Malacostraca;Eumalacostraca;Peracarida;";"0.0";"0";"312";"303";"0";"303";"9";"430221";"5766"
"LOK1378_1mm";"SILVA (only NR);Eukaryota;Amorphea;Obazoa;Opisthokonta;Holozoa;Choanozoa;Metazoa;Animalia;BCP clade;Bilateria;Protostomia;Ecdysozoa;Arthropoda;Crustacea;Malacostraca;Eumalacostraca;Syncarida;";"0.0";"0";"32";"10";"0";"10";"22";"430514";"5766"
"LOK1378_1mm";"SILVA (only NR);Eukaryota;Amorphea;Obazoa;Opisthokonta;Holozoa;Choanozoa;Metazoa;Animalia;BCP clade;Bilateria;Protostomia;Ecdysozoa;Arthropoda;Crustacea;Malacostraca;Phyllocarida;";"0.0";"0";"4";"4";"0";"4";"0";"430520";"5766"
"LOK1378_1mm";"SILVA (only NR);Eukaryota;Amorphea;Obazoa;Opisthokonta;Holozoa;Choanozoa;Metazoa;Animalia;BCP clade;Bilateria;Protostomia;Ecdysozoa;Arthropoda;Crustacea;Malacostraca;Phyllocarida;Leptostraca;";"0.0";"0";"4";"4";"0";"4";"0";"430520";"5766"
"LOK1378_1mm";"SILVA (only NR);Eukaryota;Amorphea;Obazoa;Opisthokonta;Holozoa;Choanozoa;Metazoa;Animalia;BCP clade;Bilateria;Protostomia;Ecdysozoa;Arthropoda;Crustacea;Maxillopoda;";"0.0";"0";"841";"821";"0";"821";"20";"429703";"5766"
"LOK1378_1mm";"SILVA (only NR);Eukaryota;Amorphea;Obazoa;Opisthokonta;Holozoa;Choanozoa;Metazoa;Animalia;BCP clade;Bilateria;Protostomia;Ecdysozoa;Arthropoda;Crustacea;Maxillopoda;Branchiura;";"0.0";"0";"12";"4";"0";"4";"8";"430520";"5766"
"LOK1378_1mm";"SILVA (only NR);Eukaryota;Amorphea;Obazoa;Opisthokonta;Holozoa;Choanozoa;Metazoa;Animalia;BCP clade;Bilateria;Protostomia;Ecdysozoa;Arthropoda;Crustacea;Maxillopoda;Branchiura;Arguloida;";"0.0";"0";"12";"4";"0";"4";"8";"430520";"5766"
"LOK1378_1mm";"SILVA (only NR);Eukaryota;Amorphea;Obazoa;Opisthokonta;Holozoa;Choanozoa;Metazoa;Animalia;BCP clade;Bilateria;Protostomia;Ecdysozoa;Arthropoda;Crustacea;Maxillopoda;Copepoda;";"0.0";"0";"673";"662";"0";"662";"11";"429862";"5766"
"LOK1378_1mm";"SILVA (only NR);Eukaryota;Amorphea;Obazoa;Opisthokonta;Holozoa;Choanozoa;Metazoa;Animalia;BCP clade;Bilateria;Protostomia;Ecdysozoa;Arthropoda;Crustacea;Maxillopoda;Copepoda;Calanoida;";"0.0";"0";"263";"256";"0";"256";"7";"430268";"5766"
"LOK1378_1mm";"SILVA (only NR);Eukaryota;Amorphea;Obazoa;Opisthokonta;Holozoa;Choanozoa;Metazoa;Animalia;BCP clade;Bilateria;Protostomia;Ecdysozoa;Arthropoda;Crustacea;Maxillopoda;Copepoda;Cyclopoida;";"0.0";"0";"159";"158";"0";"158";"1";"430366";"5766"
"LOK1378_1mm";"SILVA (only NR);Eukaryota;Amorphea;Obazoa;Opisthokonta;Holozoa;Choanozoa;Metazoa;Animalia;BCP clade;Bilateria;Protostomia;Ecdysozoa;Arthropoda;Crustacea;Maxillopoda;Copepoda;Harpacticoida;";"0.0";"0";"95";"95";"0";"95";"0";"430429";"5766"
"LOK1378_1mm";"SILVA (only NR);Eukaryota;Amorphea;Obazoa;Opisthokonta;Holozoa;Choanozoa;Metazoa;Animalia;BCP clade;Bilateria;Protostomia;Ecdysozoa;Arthropoda;Crustacea;Maxillopoda;Copepoda;Misophrioida;";"0.0";"0";"6";"6";"0";"6";"0";"430518";"5766"
"LOK1378_1mm";"SILVA (only NR);Eukaryota;Amorphea;Obazoa;Opisthokonta;Holozoa;Choanozoa;Metazoa;Animalia;BCP clade;Bilateria;Protostomia;Ecdysozoa;Arthropoda;Crustacea;Maxillopoda;Copepoda;Monstrilloida;";"0.0";"0";"18";"17";"0";"17";"1";"430507";"5766"
"LOK1378_1mm";"SILVA (only NR);Eukaryota;Amorphea;Obazoa;Opisthokonta;Holozoa;Choanozoa;Metazoa;Animalia;BCP clade;Bilateria;Protostomia;Ecdysozoa;Arthropoda;Crustacea;Maxillopoda;Copepoda;Poecilostomatoida;";"0.0";"0";"46";"46";"0";"46";"0";"430478";"5766"
"LOK1378_1mm";"SILVA (only NR);Eukaryota;Amorphea;Obazoa;Opisthokonta;Holozoa;Choanozoa;Metazoa;Animalia;BCP clade;Bilateria;Protostomia;Ecdysozoa;Arthropoda;Crustacea;Maxillopoda;Copepoda;Siphonostomatoida;";"0.0";"0";"58";"57";"0";"57";"1";"430467";"5766"
"LOK1378_1mm";"SILVA (only NR);Eukaryota;Amorphea;Obazoa;Opisthokonta;Holozoa;Choanozoa;Metazoa;Animalia;BCP clade;Bilateria;Protostomia;Ecdysozoa;Arthropoda;Crustacea;Maxillopoda;Pentastomida;";"0.0";"0";"13";"13";"0";"13";"0";"430511";"5766"
"LOK1378_1mm";"SILVA (only NR);Eukaryota;Amorphea;Obazoa;Opisthokonta;Holozoa;Choanozoa;Metazoa;Animalia;BCP clade;Bilateria;Protostomia;Ecdysozoa;Arthropoda;Crustacea;Maxillopoda;Pentastomida;Cephalobaenida;";"0.0";"0";"4";"4";"0";"4";"0";"430520";"5766"
"LOK1378_1mm";"SILVA (only NR);Eukaryota;Amorphea;Obazoa;Opisthokonta;Holozoa;Choanozoa;Metazoa;Animalia;BCP clade;Bilateria;Protostomia;Ecdysozoa;Arthropoda;Crustacea;Maxillopoda;Pentastomida;Porocephalida;";"0.0";"0";"8";"8";"0";"8";"0";"430516";"5766"
"LOK1378_1mm";"SILVA (only NR);Eukaryota;Amorphea;Obazoa;Opisthokonta;Holozoa;Choanozoa;Metazoa;Animalia;BCP clade;Bilateria;Protostomia;Ecdysozoa;Arthropoda;Crustacea;Maxillopoda;Tantulocarida;";"0.0";"0";"2";"2";"0";"2";"0";"430522";"5766"
"LOK1378_1mm";"SILVA (only NR);Eukaryota;Amorphea;Obazoa;Opisthokonta;Holozoa;Choanozoa;Metazoa;Animalia;BCP clade;Bilateria;Protostomia;Ecdysozoa;Arthropoda;Crustacea;Maxillopoda;Thecostraca;";"0.0";"0";"140";"140";"0";"140";"0";"430384";"5766"
"LOK1378_1mm";"SILVA (only NR);Eukaryota;Amorphea;Obazoa;Opisthokonta;Holozoa;Choanozoa;Metazoa;Animalia;BCP clade;Bilateria;Protostomia;Ecdysozoa;Arthropoda;Crustacea;Maxillopoda;Thecostraca;Akentrogonida;";"0.0";"0";"7";"7";"0";"7";"0";"430517";"5766"
"LOK1378_1mm";"SILVA (only NR);Eukaryota;Amorphea;Obazoa;Opisthokonta;Holozoa;Choanozoa;Metazoa;Animalia;BCP clade;Bilateria;Protostomia;Ecdysozoa;Arthropoda;Crustacea;Maxillopoda;Thecostraca;Apygophora;";"0.0";"0";"2";"2";"0";"2";"0";"430522";"5766"
"LOK1378_1mm";"SILVA (only NR);Eukaryota;Amorphea;Obazoa;Opisthokonta;Holozoa;Choanozoa;Metazoa;Animalia;BCP clade;Bilateria;Protostomia;Ecdysozoa;Arthropoda;Crustacea;Maxillopoda;Thecostraca;Dendrogastrida;";"0.0";"0";"4";"4";"0";"4";"0";"430520";"5766"
"LOK1378_1mm";"SILVA (only NR);Eukaryota;Amorphea;Obazoa;Opisthokonta;Holozoa;Choanozoa;Metazoa;Animalia;BCP clade;Bilateria;Protostomia;Ecdysozoa;Arthropoda;Crustacea;Maxillopoda;Thecostraca;Facetotecta;";"0.0";"0";"5";"5";"0";"5";"0";"430519";"5766"
"LOK1378_1mm";"SILVA (only NR);Eukaryota;Amorphea;Obazoa;Opisthokonta;Holozoa;Choanozoa;Metazoa;Animalia;BCP clade;Bilateria;Protostomia;Ecdysozoa;Arthropoda;Crustacea;Maxillopoda;Thecostraca;Kentrogonida;";"0.0";"0";"22";"22";"0";"22";"0";"430502";"5766"
"LOK1378_1mm";"SILVA (only NR);Eukaryota;Amorphea;Obazoa;Opisthokonta;Holozoa;Choanozoa;Metazoa;Animalia;BCP clade;Bilateria;Protostomia;Ecdysozoa;Arthropoda;Crustacea;Maxillopoda;Thecostraca;Laurida;";"0.0";"0";"2";"2";"0";"2";"0";"430522";"5766"
"LOK1378_1mm";"SILVA (only NR);Eukaryota;Amorphea;Obazoa;Opisthokonta;Holozoa;Choanozoa;Metazoa;Animalia;BCP clade;Bilateria;Protostomia;Ecdysozoa;Arthropoda;Crustacea;Maxillopoda;Thecostraca;Pedunculata;";"0.0";"0";"41";"41";"0";"41";"0";"430483";"5766"
"LOK1378_1mm";"SILVA (only NR);Eukaryota;Amorphea;Obazoa;Opisthokonta;Holozoa;Choanozoa;Metazoa;Animalia;BCP clade;Bilateria;Protostomia;Ecdysozoa;Arthropoda;Crustacea;Maxillopoda;Thecostraca;Pygophora;";"0.0";"0";"4";"4";"0";"4";"0";"430520";"5766"
"LOK1378_1mm";"SILVA (only NR);Eukaryota;Amorphea;Obazoa;Opisthokonta;Holozoa;Choanozoa;Metazoa;Animalia;BCP clade;Bilateria;Protostomia;Ecdysozoa;Arthropoda;Crustacea;Maxillopoda;Thecostraca;Sessilia;";"0.0";"0";"50";"50";"0";"50";"0";"430474";"5766"
"LOK1378_1mm";"SILVA (only NR);Eukaryota;Amorphea;Obazoa;Opisthokonta;Holozoa;Choanozoa;Metazoa;Animalia;BCP clade;Bilateria;Protostomia;Ecdysozoa;Arthropoda;Crustacea;Ostracoda;";"0.0";"0";"141";"135";"0";"135";"6";"430389";"5766"
"LOK1378_1mm";"SILVA (only NR);Eukaryota;Amorphea;Obazoa;Opisthokonta;Holozoa;Choanozoa;Metazoa;Animalia;BCP clade;Bilateria;Protostomia;Ecdysozoa;Arthropoda;Crustacea;Ostracoda;Myodocopa;";"0.0";"0";"35";"34";"0";"34";"1";"430490";"5766"
"LOK1378_1mm";"SILVA (only NR);Eukaryota;Amorphea;Obazoa;Opisthokonta;Holozoa;Choanozoa;Metazoa;Animalia;BCP clade;Bilateria;Protostomia;Ecdysozoa;Arthropoda;Crustacea;Ostracoda;Myodocopa;Halocyprida;";"0.0";"0";"14";"13";"0";"13";"1";"430511";"5766"
"LOK1378_1mm";"SILVA (only NR);Eukaryota;Amorphea;Obazoa;Opisthokonta;Holozoa;Choanozoa;Metazoa;Animalia;BCP clade;Bilateria;Protostomia;Ecdysozoa;Arthropoda;Crustacea;Ostracoda;Myodocopa;Myodocopida;";"0.0";"0";"21";"21";"0";"21";"0";"430503";"5766"
"LOK1378_1mm";"SILVA (only NR);Eukaryota;Amorphea;Obazoa;Opisthokonta;Holozoa;Choanozoa;Metazoa;Animalia;BCP clade;Bilateria;Protostomia;Ecdysozoa;Arthropoda;Crustacea;Ostracoda;Podocopa;";"0.0";"0";"106";"101";"0";"101";"5";"430423";"5766"
"LOK1378_1mm";"SILVA (only NR);Eukaryota;Amorphea;Obazoa;Opisthokonta;Holozoa;Choanozoa;Metazoa;Animalia;BCP clade;Bilateria;Protostomia;Ecdysozoa;Arthropoda;Crustacea;Ostracoda;Podocopa;Podocopida;";"0.0";"0";"105";"100";"0";"100";"5";"430424";"5766"
"LOK1378_1mm";"SILVA (only NR);Eukaryota;Amorphea;Obazoa;Opisthokonta;Holozoa;Choanozoa;Metazoa;Animalia;BCP clade;Bilateria;Protostomia;Ecdysozoa;Arthropoda;Hexapoda;";"0.0";"0";"5800";"5489";"0";"5489";"311";"425035";"5766"
"LOK1378_1mm";"SILVA (only NR);Eukaryota;Amorphea;Obazoa;Opisthokonta;Holozoa;Choanozoa;Metazoa;Animalia;BCP clade;Bilateria;Protostomia;Ecdysozoa;Arthropoda;Hexapoda;Diplura;";"0.0";"0";"13";"13";"0";"13";"0";"430511";"5766"
"LOK1378_1mm";"SILVA (only NR);Eukaryota;Amorphea;Obazoa;Opisthokonta;Holozoa;Choanozoa;Metazoa;Animalia;BCP clade;Bilateria;Protostomia;Ecdysozoa;Arthropoda;Hexapoda;Diplura;Campodeoidea;";"0.0";"0";"7";"7";"0";"7";"0";"430517";"5766"
"LOK1378_1mm";"SILVA (only NR);Eukaryota;Amorphea;Obazoa;Opisthokonta;Holozoa;Choanozoa;Metazoa;Animalia;BCP clade;Bilateria;Protostomia;Ecdysozoa;Arthropoda;Hexapoda;Diplura;Japygoidea;";"0.0";"0";"4";"4";"0";"4";"0";"430520";"5766"
"LOK1378_1mm";"SILVA (only NR);Eukaryota;Amorphea;Obazoa;Opisthokonta;Holozoa;Choanozoa;Metazoa;Animalia;BCP clade;Bilateria;Protostomia;Ecdysozoa;Arthropoda;Hexapoda;Ellipura;";"0.0";"0";"156";"149";"0";"149";"7";"430375";"5766"
"LOK1378_1mm";"SILVA (only NR);Eukaryota;Amorphea;Obazoa;Opisthokonta;Holozoa;Choanozoa;Metazoa;Animalia;BCP clade;Bilateria;Protostomia;Ecdysozoa;Arthropoda;Hexapoda;Ellipura;Collembola;";"0.0";"0";"129";"122";"0";"122";"7";"430402";"5766"
"LOK1378_1mm";"SILVA (only NR);Eukaryota;Amorphea;Obazoa;Opisthokonta;Holozoa;Choanozoa;Metazoa;Animalia;BCP clade;Bilateria;Protostomia;Ecdysozoa;Arthropoda;Hexapoda;Ellipura;Protura;";"0.0";"0";"27";"27";"0";"27";"0";"430497";"5766"
"LOK1378_1mm";"SILVA (only NR);Eukaryota;Amorphea;Obazoa;Opisthokonta;Holozoa;Choanozoa;Metazoa;Animalia;BCP clade;Bilateria;Protostomia;Ecdysozoa;Arthropoda;Hexapoda;Insecta;";"0.0";"0";"5631";"5327";"0";"5327";"304";"425197";"5766"
"LOK1378_1mm";"SILVA (only NR);Eukaryota;Amorphea;Obazoa;Opisthokonta;Holozoa;Choanozoa;Metazoa;Animalia;BCP clade;Bilateria;Protostomia;Ecdysozoa;Arthropoda;Hexapoda;Insecta;Monocondylia;";"0.0";"0";"11";"11";"0";"11";"0";"430513";"5766"
"LOK1378_1mm";"SILVA (only NR);Eukaryota;Amorphea;Obazoa;Opisthokonta;Holozoa;Choanozoa;Metazoa;Animalia;BCP clade;Bilateria;Protostomia;Ecdysozoa;Arthropoda;Hexapoda;Insecta;Monocondylia;Archaeognatha;";"0.0";"0";"11";"11";"0";"11";"0";"430513";"5766"
"LOK1378_1mm";"SILVA (only NR);Eukaryota;Amorphea;Obazoa;Opisthokonta;Holozoa;Choanozoa;Metazoa;Animalia;BCP clade;Bilateria;Protostomia;Ecdysozoa;Arthropoda;Hexapoda;Insecta;Pterygota;";"0.0";"0";"5605";"5301";"0";"5301";"304";"425223";"5766"
"LOK1378_1mm";"SILVA (only NR);Eukaryota;Amorphea;Obazoa;Opisthokonta;Holozoa;Choanozoa;Metazoa;Animalia;BCP clade;Bilateria;Protostomia;Ecdysozoa;Arthropoda;Hexapoda;Insecta;Pterygota;Neoptera;";"0.0";"0";"5443";"5140";"0";"5140";"303";"425384";"5766"
"LOK1378_1mm";"SILVA (only NR);Eukaryota;Amorphea;Obazoa;Opisthokonta;Holozoa;Choanozoa;Metazoa;Animalia;BCP clade;Bilateria;Protostomia;Ecdysozoa;Arthropoda;Hexapoda;Insecta;Pterygota;Neoptera;Amphiesmenoptera;";"0.0";"0";"84";"68";"0";"68";"16";"430456";"5766"
"LOK1378_1mm";"SILVA (only NR);Eukaryota;Amorphea;Obazoa;Opisthokonta;Holozoa;Choanozoa;Metazoa;Animalia;BCP clade;Bilateria;Protostomia;Ecdysozoa;Arthropoda;Hexapoda;Insecta;Pterygota;Neoptera;Amphiesmenoptera;Lepidoptera;";"0.0";"0";"69";"54";"0";"54";"15";"430470";"5766"
"LOK1378_1mm";"SILVA (only NR);Eukaryota;Amorphea;Obazoa;Opisthokonta;Holozoa;Choanozoa;Metazoa;Animalia;BCP clade;Bilateria;Protostomia;Ecdysozoa;Arthropoda;Hexapoda;Insecta;Pterygota;Neoptera;Amphiesmenoptera;Trichoptera;";"0.0";"0";"13";"12";"0";"12";"1";"430512";"5766"
"LOK1378_1mm";"SILVA (only NR);Eukaryota;Amorphea;Obazoa;Opisthokonta;Holozoa;Choanozoa;Metazoa;Animalia;BCP clade;Bilateria;Protostomia;Ecdysozoa;Arthropoda;Hexapoda;Insecta;Pterygota;Neoptera;Coleoptera;";"0.0";"0";"2365";"2286";"0";"2286";"79";"428238";"5766"
"LOK1378_1mm";"SILVA (only NR);Eukaryota;Amorphea;Obazoa;Opisthokonta;Holozoa;Choanozoa;Metazoa;Animalia;BCP clade;Bilateria;Protostomia;Ecdysozoa;Arthropoda;Hexapoda;Insecta;Pterygota;Neoptera;Dermaptera;";"0.0";"0";"19";"17";"0";"17";"2";"430507";"5766"
"LOK1378_1mm";"SILVA (only NR);Eukaryota;Amorphea;Obazoa;Opisthokonta;Holozoa;Choanozoa;Metazoa;Animalia;BCP clade;Bilateria;Protostomia;Ecdysozoa;Arthropoda;Hexapoda;Insecta;Pterygota;Neoptera;Dictyoptera;";"0.0";"0";"132";"129";"0";"129";"3";"430395";"5766"
"LOK1378_1mm";"SILVA (only NR);Eukaryota;Amorphea;Obazoa;Opisthokonta;Holozoa;Choanozoa;Metazoa;Animalia;BCP clade;Bilateria;Protostomia;Ecdysozoa;Arthropoda;Hexapoda;Insecta;Pterygota;Neoptera;Dictyoptera;Blattodea;";"0.0";"0";"84";"83";"0";"83";"1";"430441";"5766"
"LOK1378_1mm";"SILVA (only NR);Eukaryota;Amorphea;Obazoa;Opisthokonta;Holozoa;Choanozoa;Metazoa;Animalia;BCP clade;Bilateria;Protostomia;Ecdysozoa;Arthropoda;Hexapoda;Insecta;Pterygota;Neoptera;Dictyoptera;Isoptera;";"0.0";"0";"14";"14";"0";"14";"0";"430510";"5766"
"LOK1378_1mm";"SILVA (only NR);Eukaryota;Amorphea;Obazoa;Opisthokonta;Holozoa;Choanozoa;Metazoa;Animalia;BCP clade;Bilateria;Protostomia;Ecdysozoa;Arthropoda;Hexapoda;Insecta;Pterygota;Neoptera;Dictyoptera;Mantodea;";"0.0";"0";"32";"30";"0";"30";"2";"430494";"5766"
"LOK1378_1mm";"SILVA (only NR);Eukaryota;Amorphea;Obazoa;Opisthokonta;Holozoa;Choanozoa;Metazoa;Animalia;BCP clade;Bilateria;Protostomia;Ecdysozoa;Arthropoda;Hexapoda;Insecta;Pterygota;Neoptera;Diptera;";"0.0";"0";"810";"728";"0";"728";"82";"429796";"5766"
"LOK1378_1mm";"SILVA (only NR);Eukaryota;Amorphea;Obazoa;Opisthokonta;Holozoa;Choanozoa;Metazoa;Animalia;BCP clade;Bilateria;Protostomia;Ecdysozoa;Arthropoda;Hexapoda;Insecta;Pterygota;Neoptera;Embioptera;";"0.0";"0";"28";"28";"0";"28";"0";"430496";"5766"
"LOK1378_1mm";"SILVA (only NR);Eukaryota;Amorphea;Obazoa;Opisthokonta;Holozoa;Choanozoa;Metazoa;Animalia;BCP clade;Bilateria;Protostomia;Ecdysozoa;Arthropoda;Hexapoda;Insecta;Pterygota;Neoptera;Grylloblattodea;";"0.0";"0";"14";"13";"0";"13";"1";"430511";"5766"
"LOK1378_1mm";"SILVA (only NR);Eukaryota;Amorphea;Obazoa;Opisthokonta;Holozoa;Choanozoa;Metazoa;Animalia;BCP clade;Bilateria;Protostomia;Ecdysozoa;Arthropoda;Hexapoda;Insecta;Pterygota;Neoptera;Hemiptera;";"0.0";"0";"757";"694";"0";"694";"63";"429830";"5766"
"LOK1378_1mm";"SILVA (only NR);Eukaryota;Amorphea;Obazoa;Opisthokonta;Holozoa;Choanozoa;Metazoa;Animalia;BCP clade;Bilateria;Protostomia;Ecdysozoa;Arthropoda;Hexapoda;Insecta;Pterygota;Neoptera;Hymenoptera;";"0.0";"0";"418";"389";"0";"389";"29";"430135";"5766"
"LOK1378_1mm";"SILVA (only NR);Eukaryota;Amorphea;Obazoa;Opisthokonta;Holozoa;Choanozoa;Metazoa;Animalia;BCP clade;Bilateria;Protostomia;Ecdysozoa;Arthropoda;Hexapoda;Insecta;Pterygota;Neoptera;Mantophasmatodea;";"0.0";"0";"3";"3";"0";"3";"0";"430521";"5766"
"LOK1378_1mm";"SILVA (only NR);Eukaryota;Amorphea;Obazoa;Opisthokonta;Holozoa;Choanozoa;Metazoa;Animalia;BCP clade;Bilateria;Protostomia;Ecdysozoa;Arthropoda;Hexapoda;Insecta;Pterygota;Neoptera;Mecoptera;";"0.0";"0";"27";"27";"0";"27";"0";"430497";"5766"
"LOK1378_1mm";"SILVA (only NR);Eukaryota;Amorphea;Obazoa;Opisthokonta;Holozoa;Choanozoa;Metazoa;Animalia;BCP clade;Bilateria;Protostomia;Ecdysozoa;Arthropoda;Hexapoda;Insecta;Pterygota;Neoptera;Megaloptera;";"0.0";"0";"4";"3";"0";"3";"1";"430521";"5766"
"LOK1378_1mm";"SILVA (only NR);Eukaryota;Amorphea;Obazoa;Opisthokonta;Holozoa;Choanozoa;Metazoa;Animalia;BCP clade;Bilateria;Protostomia;Ecdysozoa;Arthropoda;Hexapoda;Insecta;Pterygota;Neoptera;Neuroptera;";"0.0";"0";"71";"70";"0";"70";"1";"430454";"5766"
"LOK1378_1mm";"SILVA (only NR);Eukaryota;Amorphea;Obazoa;Opisthokonta;Holozoa;Choanozoa;Metazoa;Animalia;BCP clade;Bilateria;Protostomia;Ecdysozoa;Arthropoda;Hexapoda;Insecta;Pterygota;Neoptera;Orthoptera;";"0.0";"0";"133";"131";"0";"131";"2";"430393";"5766"
"LOK1378_1mm";"SILVA (only NR);Eukaryota;Amorphea;Obazoa;Opisthokonta;Holozoa;Choanozoa;Metazoa;Animalia;BCP clade;Bilateria;Protostomia;Ecdysozoa;Arthropoda;Hexapoda;Insecta;Pterygota;Neoptera;Phasmatodea;";"0.0";"0";"32";"32";"0";"32";"0";"430492";"5766"
"LOK1378_1mm";"SILVA (only NR);Eukaryota;Amorphea;Obazoa;Opisthokonta;Holozoa;Choanozoa;Metazoa;Animalia;BCP clade;Bilateria;Protostomia;Ecdysozoa;Arthropoda;Hexapoda;Insecta;Pterygota;Neoptera;Phthiraptera;";"0.0";"0";"40";"35";"0";"35";"5";"430489";"5766"
"LOK1378_1mm";"SILVA (only NR);Eukaryota;Amorphea;Obazoa;Opisthokonta;Holozoa;Choanozoa;Metazoa;Animalia;BCP clade;Bilateria;Protostomia;Ecdysozoa;Arthropoda;Hexapoda;Insecta;Pterygota;Neoptera;Plecoptera;";"0.0";"0";"132";"131";"0";"131";"1";"430393";"5766"
"LOK1378_1mm";"SILVA (only NR);Eukaryota;Amorphea;Obazoa;Opisthokonta;Holozoa;Choanozoa;Metazoa;Animalia;BCP clade;Bilateria;Protostomia;Ecdysozoa;Arthropoda;Hexapoda;Insecta;Pterygota;Neoptera;Psocoptera;";"0.0";"0";"151";"145";"0";"145";"6";"430379";"5766"
"LOK1378_1mm";"SILVA (only NR);Eukaryota;Amorphea;Obazoa;Opisthokonta;Holozoa;Choanozoa;Metazoa;Animalia;BCP clade;Bilateria;Protostomia;Ecdysozoa;Arthropoda;Hexapoda;Insecta;Pterygota;Neoptera;Raphidioptera;";"0.0";"0";"5";"5";"0";"5";"0";"430519";"5766"
"LOK1378_1mm";"SILVA (only NR);Eukaryota;Amorphea;Obazoa;Opisthokonta;Holozoa;Choanozoa;Metazoa;Animalia;BCP clade;Bilateria;Protostomia;Ecdysozoa;Arthropoda;Hexapoda;Insecta;Pterygota;Neoptera;Siphonaptera;";"0.0";"0";"52";"52";"0";"52";"0";"430472";"5766"
"LOK1378_1mm";"SILVA (only NR);Eukaryota;Amorphea;Obazoa;Opisthokonta;Holozoa;Choanozoa;Metazoa;Animalia;BCP clade;Bilateria;Protostomia;Ecdysozoa;Arthropoda;Hexapoda;Insecta;Pterygota;Neoptera;Strepsiptera;";"0.0";"0";"7";"4";"0";"4";"3";"430520";"5766"
"LOK1378_1mm";"SILVA (only NR);Eukaryota;Amorphea;Obazoa;Opisthokonta;Holozoa;Choanozoa;Metazoa;Animalia;BCP clade;Bilateria;Protostomia;Ecdysozoa;Arthropoda;Hexapoda;Insecta;Pterygota;Neoptera;Thysanoptera;";"0.0";"0";"102";"97";"0";"97";"5";"430427";"5766"
"LOK1378_1mm";"SILVA (only NR);Eukaryota;Amorphea;Obazoa;Opisthokonta;Holozoa;Choanozoa;Metazoa;Animalia;BCP clade;Bilateria;Protostomia;Ecdysozoa;Arthropoda;Hexapoda;Insecta;Pterygota;Neoptera;Zoraptera;";"0.0";"0";"10";"9";"0";"9";"1";"430515";"5766"
"LOK1378_1mm";"SILVA (only NR);Eukaryota;Amorphea;Obazoa;Opisthokonta;Holozoa;Choanozoa;Metazoa;Animalia;BCP clade;Bilateria;Protostomia;Ecdysozoa;Arthropoda;Hexapoda;Insecta;Pterygota;Palaeoptera;";"0.0";"0";"162";"161";"0";"161";"1";"430363";"5766"
"LOK1378_1mm";"SILVA (only NR);Eukaryota;Amorphea;Obazoa;Opisthokonta;Holozoa;Choanozoa;Metazoa;Animalia;BCP clade;Bilateria;Protostomia;Ecdysozoa;Arthropoda;Hexapoda;Insecta;Pterygota;Palaeoptera;Ephemeroptera;";"0.0";"0";"115";"115";"0";"115";"0";"430409";"5766"
"LOK1378_1mm";"SILVA (only NR);Eukaryota;Amorphea;Obazoa;Opisthokonta;Holozoa;Choanozoa;Metazoa;Animalia;BCP clade;Bilateria;Protostomia;Ecdysozoa;Arthropoda;Hexapoda;Insecta;Pterygota;Palaeoptera;Odonata;";"0.0";"0";"47";"46";"0";"46";"1";"430478";"5766"
"LOK1378_1mm";"SILVA (only NR);Eukaryota;Amorphea;Obazoa;Opisthokonta;Holozoa;Choanozoa;Metazoa;Animalia;BCP clade;Bilateria;Protostomia;Ecdysozoa;Arthropoda;Hexapoda;Insecta;Thysanura;";"0.0";"0";"5";"5";"0";"5";"0";"430519";"5766"
"LOK1378_1mm";"SILVA (only NR);Eukaryota;Amorphea;Obazoa;Opisthokonta;Holozoa;Choanozoa;Metazoa;Animalia;BCP clade;Bilateria;Protostomia;Ecdysozoa;Arthropoda;Hexapoda;Insecta;Thysanura;Nicoletiidae;";"0.0";"0";"5";"5";"0";"5";"0";"430519";"5766"
"LOK1378_1mm";"SILVA (only NR);Eukaryota;Amorphea;Obazoa;Opisthokonta;Holozoa;Choanozoa;Metazoa;Animalia;BCP clade;Bilateria;Protostomia;Ecdysozoa;Arthropoda;Hexapoda;Insecta;Zygentoma;";"0.0";"0";"8";"8";"0";"8";"0";"430516";"5766"
"LOK1378_1mm";"SILVA (only NR);Eukaryota;Amorphea;Obazoa;Opisthokonta;Holozoa;Choanozoa;Metazoa;Animalia;BCP clade;Bilateria;Protostomia;Ecdysozoa;Arthropoda;Hexapoda;Insecta;Zygentoma;Lepismatidae;";"0.0";"0";"8";"8";"0";"8";"0";"430516";"5766"
"LOK1378_1mm";"SILVA (only NR);Eukaryota;Amorphea;Obazoa;Opisthokonta;Holozoa;Choanozoa;Metazoa;Animalia;BCP clade;Bilateria;Protostomia;Ecdysozoa;Arthropoda;Hexapoda;Insecta;Zygentoma;Lepismatidae;Lepisma;";"0.0";"0";"2";"2";"0";"2";"0";"430522";"5766"
"LOK1378_1mm";"SILVA (only NR);Eukaryota;Amorphea;Obazoa;Opisthokonta;Holozoa;Choanozoa;Metazoa;Animalia;BCP clade;Bilateria;Protostomia;Ecdysozoa;Arthropoda;Myriapoda;";"0.0";"0";"211";"201";"0";"201";"10";"430323";"5766"
"LOK1378_1mm";"SILVA (only NR);Eukaryota;Amorphea;Obazoa;Opisthokonta;Holozoa;Choanozoa;Metazoa;Animalia;BCP clade;Bilateria;Protostomia;Ecdysozoa;Arthropoda;Myriapoda;Chilopoda;";"0.0";"0";"126";"124";"0";"124";"2";"430400";"5766"
"LOK1378_1mm";"SILVA (only NR);Eukaryota;Amorphea;Obazoa;Opisthokonta;Holozoa;Choanozoa;Metazoa;Animalia;BCP clade;Bilateria;Protostomia;Ecdysozoa;Arthropoda;Myriapoda;Chilopoda;Notostigmophora;";"0.0";"0";"5";"5";"0";"5";"0";"430519";"5766"
"LOK1378_1mm";"SILVA (only NR);Eukaryota;Amorphea;Obazoa;Opisthokonta;Holozoa;Choanozoa;Metazoa;Animalia;BCP clade;Bilateria;Protostomia;Ecdysozoa;Arthropoda;Myriapoda;Chilopoda;Pleurostigmophora;";"0.0";"0";"120";"118";"0";"118";"2";"430406";"5766"
"LOK1378_1mm";"SILVA (only NR);Eukaryota;Amorphea;Obazoa;Opisthokonta;Holozoa;Choanozoa;Metazoa;Animalia;BCP clade;Bilateria;Protostomia;Ecdysozoa;Arthropoda;Myriapoda;Diplopoda;";"0.0";"0";"85";"77";"0";"77";"8";"430447";"5766"
"LOK1378_1mm";"SILVA (only NR);Eukaryota;Amorphea;Obazoa;Opisthokonta;Holozoa;Choanozoa;Metazoa;Animalia;BCP clade;Bilateria;Protostomia;Ecdysozoa;Arthropoda;Myriapoda;Diplopoda;Helminthomorpha;";"0.0";"0";"75";"74";"0";"74";"1";"430450";"5766"
"LOK1378_1mm";"SILVA (only NR);Eukaryota;Amorphea;Obazoa;Opisthokonta;Holozoa;Choanozoa;Metazoa;Animalia;BCP clade;Bilateria;Protostomia;Ecdysozoa;Arthropoda;Myriapoda;Diplopoda;Penicillata;";"0.0";"0";"8";"3";"0";"3";"5";"430521";"5766"
"LOK1378_1mm";"SILVA (only NR);Eukaryota;Amorphea;Obazoa;Opisthokonta;Holozoa;Choanozoa;Metazoa;Animalia;BCP clade;Bilateria;Protostomia;Ecdysozoa;Incertae Sedis;";"0.0";"0";"3";"3";"0";"3";"0";"430521";"5766"
"LOK1378_1mm";"SILVA (only NR);Eukaryota;Amorphea;Obazoa;Opisthokonta;Holozoa;Choanozoa;Metazoa;Animalia;BCP clade;Bilateria;Protostomia;Ecdysozoa;Nematozoa;";"0.0";"0";"2184";"2075";"0";"2075";"109";"428449";"5766"
"LOK1378_1mm";"SILVA (only NR);Eukaryota;Amorphea;Obazoa;Opisthokonta;Holozoa;Choanozoa;Metazoa;Animalia;BCP clade;Bilateria;Protostomia;Ecdysozoa;Nematozoa;Nematoda;";"0.0";"0";"2170";"2061";"0";"2061";"109";"428463";"5766"
"LOK1378_1mm";"SILVA (only NR);Eukaryota;Amorphea;Obazoa;Opisthokonta;Holozoa;Choanozoa;Metazoa;Animalia;BCP clade;Bilateria;Protostomia;Ecdysozoa;Nematozoa;Nematoda;Chromadorea;";"0.0";"0";"1443";"1363";"0";"1363";"80";"429161";"5766"
"LOK1378_1mm";"SILVA (only NR);Eukaryota;Amorphea;Obazoa;Opisthokonta;Holozoa;Choanozoa;Metazoa;Animalia;BCP clade;Bilateria;Protostomia;Ecdysozoa;Nematozoa;Nematoda;Chromadorea;Araeolaimida;";"0.0";"0";"55";"52";"0";"52";"3";"430472";"5766"
"LOK1378_1mm";"SILVA (only NR);Eukaryota;Amorphea;Obazoa;Opisthokonta;Holozoa;Choanozoa;Metazoa;Animalia;BCP clade;Bilateria;Protostomia;Ecdysozoa;Nematozoa;Nematoda;Chromadorea;Ascaridida;";"0.0";"0";"47";"43";"0";"43";"4";"430481";"5766"
"LOK1378_1mm";"SILVA (only NR);Eukaryota;Amorphea;Obazoa;Opisthokonta;Holozoa;Choanozoa;Metazoa;Animalia;BCP clade;Bilateria;Protostomia;Ecdysozoa;Nematozoa;Nematoda;Chromadorea;Chromadorida;";"0.0";"0";"39";"32";"0";"32";"7";"430492";"5766"
"LOK1378_1mm";"SILVA (only NR);Eukaryota;Amorphea;Obazoa;Opisthokonta;Holozoa;Choanozoa;Metazoa;Animalia;BCP clade;Bilateria;Protostomia;Ecdysozoa;Nematozoa;Nematoda;Chromadorea;Desmodorida;";"0.0";"0";"74";"67";"0";"67";"7";"430457";"5766"
"LOK1378_1mm";"SILVA (only NR);Eukaryota;Amorphea;Obazoa;Opisthokonta;Holozoa;Choanozoa;Metazoa;Animalia;BCP clade;Bilateria;Protostomia;Ecdysozoa;Nematozoa;Nematoda;Chromadorea;Desmoscolecida;";"0.0";"0";"2";"2";"0";"2";"0";"430522";"5766"
"LOK1378_1mm";"SILVA (only NR);Eukaryota;Amorphea;Obazoa;Opisthokonta;Holozoa;Choanozoa;Metazoa;Animalia;BCP clade;Bilateria;Protostomia;Ecdysozoa;Nematozoa;Nematoda;Chromadorea;Diplogasterida;";"0.0";"0";"107";"106";"0";"106";"1";"430418";"5766"
"LOK1378_1mm";"SILVA (only NR);Eukaryota;Amorphea;Obazoa;Opisthokonta;Holozoa;Choanozoa;Metazoa;Animalia;BCP clade;Bilateria;Protostomia;Ecdysozoa;Nematozoa;Nematoda;Chromadorea;Monhysterida;";"0.0";"0";"89";"76";"0";"76";"13";"430448";"5766"
"LOK1378_1mm";"SILVA (only NR);Eukaryota;Amorphea;Obazoa;Opisthokonta;Holozoa;Choanozoa;Metazoa;Animalia;BCP clade;Bilateria;Protostomia;Ecdysozoa;Nematozoa;Nematoda;Chromadorea;Oxyurida;";"0.0";"0";"30";"29";"0";"29";"1";"430495";"5766"
"LOK1378_1mm";"SILVA (only NR);Eukaryota;Amorphea;Obazoa;Opisthokonta;Holozoa;Choanozoa;Metazoa;Animalia;BCP clade;Bilateria;Protostomia;Ecdysozoa;Nematozoa;Nematoda;Chromadorea;Rhabditida;";"0.0";"0";"297";"279";"0";"279";"18";"430245";"5766"
"LOK1378_1mm";"SILVA (only NR);Eukaryota;Amorphea;Obazoa;Opisthokonta;Holozoa;Choanozoa;Metazoa;Animalia;BCP clade;Bilateria;Protostomia;Ecdysozoa;Nematozoa;Nematoda;Chromadorea;Rhigonematida;";"0.0";"0";"10";"10";"0";"10";"0";"430514";"5766"
"LOK1378_1mm";"SILVA (only NR);Eukaryota;Amorphea;Obazoa;Opisthokonta;Holozoa;Choanozoa;Metazoa;Animalia;BCP clade;Bilateria;Protostomia;Ecdysozoa;Nematozoa;Nematoda;Chromadorea;Spirurida;";"0.0";"0";"116";"110";"0";"110";"6";"430414";"5766"
"LOK1378_1mm";"SILVA (only NR);Eukaryota;Amorphea;Obazoa;Opisthokonta;Holozoa;Choanozoa;Metazoa;Animalia;BCP clade;Bilateria;Protostomia;Ecdysozoa;Nematozoa;Nematoda;Chromadorea;Tylenchida;";"0.0";"0";"565";"546";"0";"546";"19";"429978";"5766"
"LOK1378_1mm";"SILVA (only NR);Eukaryota;Amorphea;Obazoa;Opisthokonta;Holozoa;Choanozoa;Metazoa;Animalia;BCP clade;Bilateria;Protostomia;Ecdysozoa;Nematozoa;Nematoda;Chromadorea;Tylenchida;Anomyctus;";"0.0";"0";"1";"1";"0";"1";"0";"430523";"5766"
"LOK1378_1mm";"SILVA (only NR);Eukaryota;Amorphea;Obazoa;Opisthokonta;Holozoa;Choanozoa;Metazoa;Animalia;BCP clade;Bilateria;Protostomia;Ecdysozoa;Nematozoa;Nematoda;Chromadorea;Tylenchida;Aphelenchoides;";"0.0";"0";"40";"38";"0";"38";"2";"430486";"5766"
"LOK1378_1mm";"SILVA (only NR);Eukaryota;Amorphea;Obazoa;Opisthokonta;Holozoa;Choanozoa;Metazoa;Animalia;BCP clade;Bilateria;Protostomia;Ecdysozoa;Nematozoa;Nematoda;Chromadorea;Tylenchida;Basilaphelenchus;";"0.0";"0";"1";"1";"0";"1";"0";"430523";"5766"
"LOK1378_1mm";"SILVA (only NR);Eukaryota;Amorphea;Obazoa;Opisthokonta;Holozoa;Choanozoa;Metazoa;Animalia;BCP clade;Bilateria;Protostomia;Ecdysozoa;Nematozoa;Nematoda;Chromadorea;Tylenchida;Bursaphelenchus;";"0.0";"0";"59";"59";"0";"59";"0";"430465";"5766"
"LOK1378_1mm";"SILVA (only NR);Eukaryota;Amorphea;Obazoa;Opisthokonta;Holozoa;Choanozoa;Metazoa;Animalia;BCP clade;Bilateria;Protostomia;Ecdysozoa;Nematozoa;Nematoda;Chromadorea;Tylenchida;Cryptaphelenchus;";"0.0";"0";"2";"2";"0";"2";"0";"430522";"5766"
"LOK1378_1mm";"SILVA (only NR);Eukaryota;Amorphea;Obazoa;Opisthokonta;Holozoa;Choanozoa;Metazoa;Animalia;BCP clade;Bilateria;Protostomia;Ecdysozoa;Nematozoa;Nematoda;Chromadorea;Tylenchida;Ektaphelenchoides;";"0.0";"0";"1";"1";"0";"1";"0";"430523";"5766"
"LOK1378_1mm";"SILVA (only NR);Eukaryota;Amorphea;Obazoa;Opisthokonta;Holozoa;Choanozoa;Metazoa;Animalia;BCP clade;Bilateria;Protostomia;Ecdysozoa;Nematozoa;Nematoda;Chromadorea;Tylenchida;Ektaphelenchus;";"0.0";"0";"2";"2";"0";"2";"0";"430522";"5766"
"LOK1378_1mm";"SILVA (only NR);Eukaryota;Amorphea;Obazoa;Opisthokonta;Holozoa;Choanozoa;Metazoa;Animalia;BCP clade;Bilateria;Protostomia;Ecdysozoa;Nematozoa;Nematoda;Chromadorea;Tylenchida;Laimaphelenchus;";"0.0";"0";"15";"14";"0";"14";"1";"430510";"5766"
"LOK1378_1mm";"SILVA (only NR);Eukaryota;Amorphea;Obazoa;Opisthokonta;Holozoa;Choanozoa;Metazoa;Animalia;BCP clade;Bilateria;Protostomia;Ecdysozoa;Nematozoa;Nematoda;Chromadorea;Tylenchida;Noctuidonema;";"0.0";"0";"1";"1";"0";"1";"0";"430523";"5766"
"LOK1378_1mm";"SILVA (only NR);Eukaryota;Amorphea;Obazoa;Opisthokonta;Holozoa;Choanozoa;Metazoa;Animalia;BCP clade;Bilateria;Protostomia;Ecdysozoa;Nematozoa;Nematoda;Chromadorea;Tylenchida;Peraphelenchus;";"0.0";"0";"1";"1";"0";"1";"0";"430523";"5766"
"LOK1378_1mm";"SILVA (only NR);Eukaryota;Amorphea;Obazoa;Opisthokonta;Holozoa;Choanozoa;Metazoa;Animalia;BCP clade;Bilateria;Protostomia;Ecdysozoa;Nematozoa;Nematoda;Chromadorea;Tylenchida;Pseudaphelenchus;";"0.0";"0";"4";"4";"0";"4";"0";"430520";"5766"
"LOK1378_1mm";"SILVA (only NR);Eukaryota;Amorphea;Obazoa;Opisthokonta;Holozoa;Choanozoa;Metazoa;Animalia;BCP clade;Bilateria;Protostomia;Ecdysozoa;Nematozoa;Nematoda;Chromadorea;Tylenchida;Robustodorus;";"0.0";"0";"3";"3";"0";"3";"0";"430521";"5766"
"LOK1378_1mm";"SILVA (only NR);Eukaryota;Amorphea;Obazoa;Opisthokonta;Holozoa;Choanozoa;Metazoa;Animalia;BCP clade;Bilateria;Protostomia;Ecdysozoa;Nematozoa;Nematoda;Chromadorea;Tylenchida;Ruehmaphelenchus;";"0.0";"0";"4";"4";"0";"4";"0";"430520";"5766"
"LOK1378_1mm";"SILVA (only NR);Eukaryota;Amorphea;Obazoa;Opisthokonta;Holozoa;Choanozoa;Metazoa;Animalia;BCP clade;Bilateria;Protostomia;Ecdysozoa;Nematozoa;Nematoda;Chromadorea;Tylenchida;Schistonchus;";"0.0";"0";"22";"22";"0";"22";"0";"430502";"5766"
"LOK1378_1mm";"SILVA (only NR);Eukaryota;Amorphea;Obazoa;Opisthokonta;Holozoa;Choanozoa;Metazoa;Animalia;BCP clade;Bilateria;Protostomia;Ecdysozoa;Nematozoa;Nematoda;Chromadorea;Tylenchida;Tylaphelenchus;";"0.0";"0";"1";"1";"0";"1";"0";"430523";"5766"
"LOK1378_1mm";"SILVA (only NR);Eukaryota;Amorphea;Obazoa;Opisthokonta;Holozoa;Choanozoa;Metazoa;Animalia;BCP clade;Bilateria;Protostomia;Ecdysozoa;Nematozoa;Nematoda;Enoplea;";"0.0";"0";"727";"698";"0";"698";"29";"429826";"5766"
"LOK1378_1mm";"SILVA (only NR);Eukaryota;Amorphea;Obazoa;Opisthokonta;Holozoa;Choanozoa;Metazoa;Animalia;BCP clade;Bilateria;Protostomia;Ecdysozoa;Nematozoa;Nematoda;Enoplea;Dorylaimia;";"0.0";"0";"445";"430";"0";"430";"15";"430094";"5766"
"LOK1378_1mm";"SILVA (only NR);Eukaryota;Amorphea;Obazoa;Opisthokonta;Holozoa;Choanozoa;Metazoa;Animalia;BCP clade;Bilateria;Protostomia;Ecdysozoa;Nematozoa;Nematoda;Enoplea;Dorylaimia;Dioctophymatoidea;";"0.0";"0";"2";"1";"0";"1";"1";"430523";"5766"
"LOK1378_1mm";"SILVA (only NR);Eukaryota;Amorphea;Obazoa;Opisthokonta;Holozoa;Choanozoa;Metazoa;Animalia;BCP clade;Bilateria;Protostomia;Ecdysozoa;Nematozoa;Nematoda;Enoplea;Dorylaimia;Dorylaimida;";"0.0";"0";"147";"143";"0";"143";"4";"430381";"5766"
"LOK1378_1mm";"SILVA (only NR);Eukaryota;Amorphea;Obazoa;Opisthokonta;Holozoa;Choanozoa;Metazoa;Animalia;BCP clade;Bilateria;Protostomia;Ecdysozoa;Nematozoa;Nematoda;Enoplea;Dorylaimia;Mermithida;";"0.0";"0";"19";"18";"0";"18";"1";"430506";"5766"
"LOK1378_1mm";"SILVA (only NR);Eukaryota;Amorphea;Obazoa;Opisthokonta;Holozoa;Choanozoa;Metazoa;Animalia;BCP clade;Bilateria;Protostomia;Ecdysozoa;Nematozoa;Nematoda;Enoplea;Dorylaimia;Mononchida;";"0.0";"0";"30";"29";"0";"29";"1";"430495";"5766"
"LOK1378_1mm";"SILVA (only NR);Eukaryota;Amorphea;Obazoa;Opisthokonta;Holozoa;Choanozoa;Metazoa;Animalia;BCP clade;Bilateria;Protostomia;Ecdysozoa;Nematozoa;Nematoda;Enoplea;Dorylaimia;Trichocephalida;";"0.0";"0";"242";"234";"0";"234";"8";"430290";"5766"
"LOK1378_1mm";"SILVA (only NR);Eukaryota;Amorphea;Obazoa;Opisthokonta;Holozoa;Choanozoa;Metazoa;Animalia;BCP clade;Bilateria;Protostomia;Ecdysozoa;Nematozoa;Nematoda;Enoplea;Enoplia;";"0.0";"0";"282";"268";"0";"268";"14";"430256";"5766"
"LOK1378_1mm";"SILVA (only NR);Eukaryota;Amorphea;Obazoa;Opisthokonta;Holozoa;Choanozoa;Metazoa;Animalia;BCP clade;Bilateria;Protostomia;Ecdysozoa;Nematozoa;Nematoda;Enoplea;Enoplia;Enoplida;";"0.0";"0";"182";"169";"0";"169";"13";"430355";"5766"
"LOK1378_1mm";"SILVA (only NR);Eukaryota;Amorphea;Obazoa;Opisthokonta;Holozoa;Choanozoa;Metazoa;Animalia;BCP clade;Bilateria;Protostomia;Ecdysozoa;Nematozoa;Nematoda;Enoplea;Enoplia;Triplonchida;";"0.0";"0";"98";"97";"0";"97";"1";"430427";"5766"
"LOK1378_1mm";"SILVA (only NR);Eukaryota;Amorphea;Obazoa;Opisthokonta;Holozoa;Choanozoa;Metazoa;Animalia;BCP clade;Bilateria;Protostomia;Ecdysozoa;Nematozoa;Nematomorpha;";"0.0";"0";"14";"14";"0";"14";"0";"430510";"5766"
"LOK1378_1mm";"SILVA (only NR);Eukaryota;Amorphea;Obazoa;Opisthokonta;Holozoa;Choanozoa;Metazoa;Animalia;BCP clade;Bilateria;Protostomia;Ecdysozoa;Nematozoa;Nematomorpha;Gordioida;";"0.0";"0";"13";"13";"0";"13";"0";"430511";"5766"
"LOK1378_1mm";"SILVA (only NR);Eukaryota;Amorphea;Obazoa;Opisthokonta;Holozoa;Choanozoa;Metazoa;Animalia;BCP clade;Bilateria;Protostomia;Ecdysozoa;Nematozoa;Nematomorpha;Gordioida;Chordodea;";"0.0";"0";"6";"6";"0";"6";"0";"430518";"5766"
"LOK1378_1mm";"SILVA (only NR);Eukaryota;Amorphea;Obazoa;Opisthokonta;Holozoa;Choanozoa;Metazoa;Animalia;BCP clade;Bilateria;Protostomia;Ecdysozoa;Nematozoa;Nematomorpha;Gordioida;Gordea;";"0.0";"0";"7";"7";"0";"7";"0";"430517";"5766"
"LOK1378_1mm";"SILVA (only NR);Eukaryota;Amorphea;Obazoa;Opisthokonta;Holozoa;Choanozoa;Metazoa;Animalia;BCP clade;Bilateria;Protostomia;Ecdysozoa;Onychophora;";"0.0";"0";"23";"19";"0";"19";"4";"430505";"5766"
"LOK1378_1mm";"SILVA (only NR);Eukaryota;Amorphea;Obazoa;Opisthokonta;Holozoa;Choanozoa;Metazoa;Animalia;BCP clade;Bilateria;Protostomia;Ecdysozoa;Onychophora;Udeonycophora;";"0.0";"0";"23";"19";"0";"19";"4";"430505";"5766"
"LOK1378_1mm";"SILVA (only NR);Eukaryota;Amorphea;Obazoa;Opisthokonta;Holozoa;Choanozoa;Metazoa;Animalia;BCP clade;Bilateria;Protostomia;Ecdysozoa;Onychophora;Udeonycophora;Euonycophora;";"0.0";"0";"23";"19";"0";"19";"4";"430505";"5766"
"LOK1378_1mm";"SILVA (only NR);Eukaryota;Amorphea;Obazoa;Opisthokonta;Holozoa;Choanozoa;Metazoa;Animalia;BCP clade;Bilateria;Protostomia;Ecdysozoa;Onychophora;Udeonycophora;Euonycophora;Peripatopsidae;";"0.0";"0";"23";"19";"0";"19";"4";"430505";"5766"
"LOK1378_1mm";"SILVA (only NR);Eukaryota;Amorphea;Obazoa;Opisthokonta;Holozoa;Choanozoa;Metazoa;Animalia;BCP clade;Bilateria;Protostomia;Ecdysozoa;Scalidophora;";"0.0";"0";"52";"48";"0";"48";"4";"430476";"5766"
"LOK1378_1mm";"SILVA (only NR);Eukaryota;Amorphea;Obazoa;Opisthokonta;Holozoa;Choanozoa;Metazoa;Animalia;BCP clade;Bilateria;Protostomia;Ecdysozoa;Scalidophora;Kinorhyncha;";"0.0";"0";"42";"40";"0";"40";"2";"430484";"5766"
"LOK1378_1mm";"SILVA (only NR);Eukaryota;Amorphea;Obazoa;Opisthokonta;Holozoa;Choanozoa;Metazoa;Animalia;BCP clade;Bilateria;Protostomia;Ecdysozoa;Scalidophora;Kinorhyncha;Cyclorhagida;";"0.0";"0";"26";"25";"0";"25";"1";"430499";"5766"
"LOK1378_1mm";"SILVA (only NR);Eukaryota;Amorphea;Obazoa;Opisthokonta;Holozoa;Choanozoa;Metazoa;Animalia;BCP clade;Bilateria;Protostomia;Ecdysozoa;Scalidophora;Kinorhyncha;Homalorhagida;";"0.0";"0";"14";"13";"0";"13";"1";"430511";"5766"
"LOK1378_1mm";"SILVA (only NR);Eukaryota;Amorphea;Obazoa;Opisthokonta;Holozoa;Choanozoa;Metazoa;Animalia;BCP clade;Bilateria;Protostomia;Ecdysozoa;Scalidophora;Kinorhyncha;Kinorhyncha Incertae Sedis;";"0.0";"0";"2";"2";"0";"2";"0";"430522";"5766"
"LOK1378_1mm";"SILVA (only NR);Eukaryota;Amorphea;Obazoa;Opisthokonta;Holozoa;Choanozoa;Metazoa;Animalia;BCP clade;Bilateria;Protostomia;Ecdysozoa;Scalidophora;Loricifera;";"0.0";"0";"2";"2";"0";"2";"0";"430522";"5766"
"LOK1378_1mm";"SILVA (only NR);Eukaryota;Amorphea;Obazoa;Opisthokonta;Holozoa;Choanozoa;Metazoa;Animalia;BCP clade;Bilateria;Protostomia;Ecdysozoa;Scalidophora;Priapulida;";"0.0";"0";"8";"6";"0";"6";"2";"430518";"5766"
"LOK1378_1mm";"SILVA (only NR);Eukaryota;Amorphea;Obazoa;Opisthokonta;Holozoa;Choanozoa;Metazoa;Animalia;BCP clade;Bilateria;Protostomia;Ecdysozoa;Scalidophora;Priapulida;Priapulidae;";"0.0";"0";"4";"4";"0";"4";"0";"430520";"5766"
"LOK1378_1mm";"SILVA (only NR);Eukaryota;Amorphea;Obazoa;Opisthokonta;Holozoa;Choanozoa;Metazoa;Animalia;BCP clade;Bilateria;Protostomia;Ecdysozoa;Scalidophora;Priapulida;Tubiluchidae;";"0.0";"0";"4";"2";"0";"2";"2";"430522";"5766"
"LOK1378_1mm";"SILVA (only NR);Eukaryota;Amorphea;Obazoa;Opisthokonta;Holozoa;Choanozoa;Metazoa;Animalia;BCP clade;Bilateria;Protostomia;Ecdysozoa;Tardigrada;";"0.0";"0";"108";"105";"0";"105";"3";"430419";"5766"
"LOK1378_1mm";"SILVA (only NR);Eukaryota;Amorphea;Obazoa;Opisthokonta;Holozoa;Choanozoa;Metazoa;Animalia;BCP clade;Bilateria;Protostomia;Ecdysozoa;Tardigrada;Eutardigrada;";"0.0";"0";"78";"77";"0";"77";"1";"430447";"5766"
"LOK1378_1mm";"SILVA (only NR);Eukaryota;Amorphea;Obazoa;Opisthokonta;Holozoa;Choanozoa;Metazoa;Animalia;BCP clade;Bilateria;Protostomia;Ecdysozoa;Tardigrada;Eutardigrada;Apochela;";"0.0";"0";"7";"7";"0";"7";"0";"430517";"5766"
"LOK1378_1mm";"SILVA (only NR);Eukaryota;Amorphea;Obazoa;Opisthokonta;Holozoa;Choanozoa;Metazoa;Animalia;BCP clade;Bilateria;Protostomia;Ecdysozoa;Tardigrada;Eutardigrada;Parachaela;";"0.0";"0";"71";"70";"0";"70";"1";"430454";"5766"
"LOK1378_1mm";"SILVA (only NR);Eukaryota;Amorphea;Obazoa;Opisthokonta;Holozoa;Choanozoa;Metazoa;Animalia;BCP clade;Bilateria;Protostomia;Ecdysozoa;Tardigrada;Heterotardigrada;";"0.0";"0";"30";"28";"0";"28";"2";"430496";"5766"
"LOK1378_1mm";"SILVA (only NR);Eukaryota;Amorphea;Obazoa;Opisthokonta;Holozoa;Choanozoa;Metazoa;Animalia;BCP clade;Bilateria;Protostomia;Ecdysozoa;Tardigrada;Heterotardigrada;Echiniscoidea;";"0.0";"0";"29";"27";"0";"27";"2";"430497";"5766"
"LOK1378_1mm";"SILVA (only NR);Eukaryota;Amorphea;Obazoa;Opisthokonta;Holozoa;Choanozoa;Metazoa;Animalia;BCP clade;Bilateria;Protostomia;Lophotrochozoa;";"0.0";"0";"5194";"5038";"0";"5038";"156";"425486";"5766"
"LOK1378_1mm";"SILVA (only NR);Eukaryota;Amorphea;Obazoa;Opisthokonta;Holozoa;Choanozoa;Metazoa;Animalia;BCP clade;Bilateria;Protostomia;Lophotrochozoa;Acanthocephala;";"0.0";"0";"66";"64";"0";"64";"2";"430460";"5766"
"LOK1378_1mm";"SILVA (only NR);Eukaryota;Amorphea;Obazoa;Opisthokonta;Holozoa;Choanozoa;Metazoa;Animalia;BCP clade;Bilateria;Protostomia;Lophotrochozoa;Acanthocephala;Archiacanthocephala;";"0.0";"0";"7";"7";"0";"7";"0";"430517";"5766"
"LOK1378_1mm";"SILVA (only NR);Eukaryota;Amorphea;Obazoa;Opisthokonta;Holozoa;Choanozoa;Metazoa;Animalia;BCP clade;Bilateria;Protostomia;Lophotrochozoa;Acanthocephala;Archiacanthocephala;Gigantorhynchida;";"0.0";"0";"2";"2";"0";"2";"0";"430522";"5766"
"LOK1378_1mm";"SILVA (only NR);Eukaryota;Amorphea;Obazoa;Opisthokonta;Holozoa;Choanozoa;Metazoa;Animalia;BCP clade;Bilateria;Protostomia;Lophotrochozoa;Acanthocephala;Archiacanthocephala;Oligacanthorhynchida;";"0.0";"0";"4";"4";"0";"4";"0";"430520";"5766"
"LOK1378_1mm";"SILVA (only NR);Eukaryota;Amorphea;Obazoa;Opisthokonta;Holozoa;Choanozoa;Metazoa;Animalia;BCP clade;Bilateria;Protostomia;Lophotrochozoa;Acanthocephala;Eoacanthocephala;";"0.0";"0";"10";"10";"0";"10";"0";"430514";"5766"
"LOK1378_1mm";"SILVA (only NR);Eukaryota;Amorphea;Obazoa;Opisthokonta;Holozoa;Choanozoa;Metazoa;Animalia;BCP clade;Bilateria;Protostomia;Lophotrochozoa;Acanthocephala;Eoacanthocephala;Neoechinorhynchida;";"0.0";"0";"10";"10";"0";"10";"0";"430514";"5766"
"LOK1378_1mm";"SILVA (only NR);Eukaryota;Amorphea;Obazoa;Opisthokonta;Holozoa;Choanozoa;Metazoa;Animalia;BCP clade;Bilateria;Protostomia;Lophotrochozoa;Acanthocephala;Palaeacanthocephala;";"0.0";"0";"49";"47";"0";"47";"2";"430477";"5766"
"LOK1378_1mm";"SILVA (only NR);Eukaryota;Amorphea;Obazoa;Opisthokonta;Holozoa;Choanozoa;Metazoa;Animalia;BCP clade;Bilateria;Protostomia;Lophotrochozoa;Acanthocephala;Palaeacanthocephala;Echinorhynchida;";"0.0";"0";"24";"22";"0";"22";"2";"430502";"5766"
"LOK1378_1mm";"SILVA (only NR);Eukaryota;Amorphea;Obazoa;Opisthokonta;Holozoa;Choanozoa;Metazoa;Animalia;BCP clade;Bilateria;Protostomia;Lophotrochozoa;Acanthocephala;Palaeacanthocephala;Polymorphida;";"0.0";"0";"25";"25";"0";"25";"0";"430499";"5766"
"LOK1378_1mm";"SILVA (only NR);Eukaryota;Amorphea;Obazoa;Opisthokonta;Holozoa;Choanozoa;Metazoa;Animalia;BCP clade;Bilateria;Protostomia;Lophotrochozoa;Annelida;";"0.0";"0";"1328";"1295";"0";"1295";"33";"429229";"5766"
"LOK1378_1mm";"SILVA (only NR);Eukaryota;Amorphea;Obazoa;Opisthokonta;Holozoa;Choanozoa;Metazoa;Animalia;BCP clade;Bilateria;Protostomia;Lophotrochozoa;Annelida;Annelida Incertae Sedis;";"0.0";"0";"2";"2";"0";"2";"0";"430522";"5766"
"LOK1378_1mm";"SILVA (only NR);Eukaryota;Amorphea;Obazoa;Opisthokonta;Holozoa;Choanozoa;Metazoa;Animalia;BCP clade;Bilateria;Protostomia;Lophotrochozoa;Annelida;Annelida Incertae Sedis;Fauvelopsis;";"0.0";"0";"1";"1";"0";"1";"0";"430523";"5766"
"LOK1378_1mm";"SILVA (only NR);Eukaryota;Amorphea;Obazoa;Opisthokonta;Holozoa;Choanozoa;Metazoa;Animalia;BCP clade;Bilateria;Protostomia;Lophotrochozoa;Annelida;Annelida Incertae Sedis;Hrabeiella;";"0.0";"0";"1";"1";"0";"1";"0";"430523";"5766"
"LOK1378_1mm";"SILVA (only NR);Eukaryota;Amorphea;Obazoa;Opisthokonta;Holozoa;Choanozoa;Metazoa;Animalia;BCP clade;Bilateria;Protostomia;Lophotrochozoa;Annelida;Clitellata;";"0.0";"0";"290";"285";"0";"285";"5";"430239";"5766"
"LOK1378_1mm";"SILVA (only NR);Eukaryota;Amorphea;Obazoa;Opisthokonta;Holozoa;Choanozoa;Metazoa;Animalia;BCP clade;Bilateria;Protostomia;Lophotrochozoa;Annelida;Clitellata;Branchiobdellae;";"0.0";"0";"11";"11";"0";"11";"0";"430513";"5766"
"LOK1378_1mm";"SILVA (only NR);Eukaryota;Amorphea;Obazoa;Opisthokonta;Holozoa;Choanozoa;Metazoa;Animalia;BCP clade;Bilateria;Protostomia;Lophotrochozoa;Annelida;Clitellata;Branchiobdellae;Branchiobdellida;";"0.0";"0";"11";"11";"0";"11";"0";"430513";"5766"
"LOK1378_1mm";"SILVA (only NR);Eukaryota;Amorphea;Obazoa;Opisthokonta;Holozoa;Choanozoa;Metazoa;Animalia;BCP clade;Bilateria;Protostomia;Lophotrochozoa;Annelida;Clitellata;Hirudinida;";"0.0";"0";"106";"102";"0";"102";"4";"430422";"5766"
"LOK1378_1mm";"SILVA (only NR);Eukaryota;Amorphea;Obazoa;Opisthokonta;Holozoa;Choanozoa;Metazoa;Animalia;BCP clade;Bilateria;Protostomia;Lophotrochozoa;Annelida;Clitellata;Hirudinida;Arhynchobdellida;";"0.0";"0";"77";"73";"0";"73";"4";"430451";"5766"
"LOK1378_1mm";"SILVA (only NR);Eukaryota;Amorphea;Obazoa;Opisthokonta;Holozoa;Choanozoa;Metazoa;Animalia;BCP clade;Bilateria;Protostomia;Lophotrochozoa;Annelida;Clitellata;Hirudinida;Rhynchobdellida;";"0.0";"0";"28";"28";"0";"28";"0";"430496";"5766"
"LOK1378_1mm";"SILVA (only NR);Eukaryota;Amorphea;Obazoa;Opisthokonta;Holozoa;Choanozoa;Metazoa;Animalia;BCP clade;Bilateria;Protostomia;Lophotrochozoa;Annelida;Clitellata;Oligochaeta;";"0.0";"0";"173";"172";"0";"172";"1";"430352";"5766"
"LOK1378_1mm";"SILVA (only NR);Eukaryota;Amorphea;Obazoa;Opisthokonta;Holozoa;Choanozoa;Metazoa;Animalia;BCP clade;Bilateria;Protostomia;Lophotrochozoa;Annelida;Clitellata;Oligochaeta;Haplotaxida;";"0.0";"0";"165";"164";"0";"164";"1";"430360";"5766"
"LOK1378_1mm";"SILVA (only NR);Eukaryota;Amorphea;Obazoa;Opisthokonta;Holozoa;Choanozoa;Metazoa;Animalia;BCP clade;Bilateria;Protostomia;Lophotrochozoa;Annelida;Clitellata;Oligochaeta;Lumbriculida;";"0.0";"0";"3";"3";"0";"3";"0";"430521";"5766"
"LOK1378_1mm";"SILVA (only NR);Eukaryota;Amorphea;Obazoa;Opisthokonta;Holozoa;Choanozoa;Metazoa;Animalia;BCP clade;Bilateria;Protostomia;Lophotrochozoa;Annelida;Clitellata;Oligochaeta;Moniligastrida;";"0.0";"0";"4";"4";"0";"4";"0";"430520";"5766"
"LOK1378_1mm";"SILVA (only NR);Eukaryota;Amorphea;Obazoa;Opisthokonta;Holozoa;Choanozoa;Metazoa;Animalia;BCP clade;Bilateria;Protostomia;Lophotrochozoa;Annelida;Myzostomida;";"0.0";"0";"54";"53";"0";"53";"1";"430471";"5766"
"LOK1378_1mm";"SILVA (only NR);Eukaryota;Amorphea;Obazoa;Opisthokonta;Holozoa;Choanozoa;Metazoa;Animalia;BCP clade;Bilateria;Protostomia;Lophotrochozoa;Annelida;Myzostomida;Endomyzostomatidae;";"0.0";"0";"6";"6";"0";"6";"0";"430518";"5766"
"LOK1378_1mm";"SILVA (only NR);Eukaryota;Amorphea;Obazoa;Opisthokonta;Holozoa;Choanozoa;Metazoa;Animalia;BCP clade;Bilateria;Protostomia;Lophotrochozoa;Annelida;Myzostomida;Myzostomida Incertae Sedis;";"0.0";"0";"3";"3";"0";"3";"0";"430521";"5766"
"LOK1378_1mm";"SILVA (only NR);Eukaryota;Amorphea;Obazoa;Opisthokonta;Holozoa;Choanozoa;Metazoa;Animalia;BCP clade;Bilateria;Protostomia;Lophotrochozoa;Annelida;Myzostomida;Myzostomidae;";"0.0";"0";"43";"42";"0";"42";"1";"430482";"5766"
"LOK1378_1mm";"SILVA (only NR);Eukaryota;Amorphea;Obazoa;Opisthokonta;Holozoa;Choanozoa;Metazoa;Animalia;BCP clade;Bilateria;Protostomia;Lophotrochozoa;Annelida;Polychaeta;";"0.0";"0";"975";"949";"0";"949";"26";"429575";"5766"
"LOK1378_1mm";"SILVA (only NR);Eukaryota;Amorphea;Obazoa;Opisthokonta;Holozoa;Choanozoa;Metazoa;Animalia;BCP clade;Bilateria;Protostomia;Lophotrochozoa;Annelida;Polychaeta;Echiura;";"0.0";"0";"17";"17";"0";"17";"0";"430507";"5766"
"LOK1378_1mm";"SILVA (only NR);Eukaryota;Amorphea;Obazoa;Opisthokonta;Holozoa;Choanozoa;Metazoa;Animalia;BCP clade;Bilateria;Protostomia;Lophotrochozoa;Annelida;Polychaeta;Echiura;Echiuroinea;";"0.0";"0";"15";"15";"0";"15";"0";"430509";"5766"
"LOK1378_1mm";"SILVA (only NR);Eukaryota;Amorphea;Obazoa;Opisthokonta;Holozoa;Choanozoa;Metazoa;Animalia;BCP clade;Bilateria;Protostomia;Lophotrochozoa;Annelida;Polychaeta;Echiura;Xenopneusta;";"0.0";"0";"2";"2";"0";"2";"0";"430522";"5766"
"LOK1378_1mm";"SILVA (only NR);Eukaryota;Amorphea;Obazoa;Opisthokonta;Holozoa;Choanozoa;Metazoa;Animalia;BCP clade;Bilateria;Protostomia;Lophotrochozoa;Annelida;Polychaeta;Palpata;";"0.0";"0";"593";"573";"0";"573";"20";"429951";"5766"
"LOK1378_1mm";"SILVA (only NR);Eukaryota;Amorphea;Obazoa;Opisthokonta;Holozoa;Choanozoa;Metazoa;Animalia;BCP clade;Bilateria;Protostomia;Lophotrochozoa;Annelida;Polychaeta;Palpata;Eunicida;";"0.0";"0";"54";"54";"0";"54";"0";"430470";"5766"
"LOK1378_1mm";"SILVA (only NR);Eukaryota;Amorphea;Obazoa;Opisthokonta;Holozoa;Choanozoa;Metazoa;Animalia;BCP clade;Bilateria;Protostomia;Lophotrochozoa;Annelida;Polychaeta;Palpata;Flabelligerida;";"0.0";"0";"14";"14";"0";"14";"0";"430510";"5766"
"LOK1378_1mm";"SILVA (only NR);Eukaryota;Amorphea;Obazoa;Opisthokonta;Holozoa;Choanozoa;Metazoa;Animalia;BCP clade;Bilateria;Protostomia;Lophotrochozoa;Annelida;Polychaeta;Palpata;Palpata Incertae Sedis;";"0.0";"0";"27";"27";"0";"27";"0";"430497";"5766"
"LOK1378_1mm";"SILVA (only NR);Eukaryota;Amorphea;Obazoa;Opisthokonta;Holozoa;Choanozoa;Metazoa;Animalia;BCP clade;Bilateria;Protostomia;Lophotrochozoa;Annelida;Polychaeta;Palpata;Phyllodocida;";"0.0";"0";"353";"335";"0";"335";"18";"430189";"5766"
"LOK1378_1mm";"SILVA (only NR);Eukaryota;Amorphea;Obazoa;Opisthokonta;Holozoa;Choanozoa;Metazoa;Animalia;BCP clade;Bilateria;Protostomia;Lophotrochozoa;Annelida;Polychaeta;Palpata;Sabellida;";"0.0";"0";"144";"142";"0";"142";"2";"430382";"5766"
"LOK1378_1mm";"SILVA (only NR);Eukaryota;Amorphea;Obazoa;Opisthokonta;Holozoa;Choanozoa;Metazoa;Animalia;BCP clade;Bilateria;Protostomia;Lophotrochozoa;Annelida;Polychaeta;Protodrilidae;";"0.0";"0";"39";"39";"0";"39";"0";"430485";"5766"
"LOK1378_1mm";"SILVA (only NR);Eukaryota;Amorphea;Obazoa;Opisthokonta;Holozoa;Choanozoa;Metazoa;Animalia;BCP clade;Bilateria;Protostomia;Lophotrochozoa;Annelida;Polychaeta;Protodrilidae;Protodrilus;";"0.0";"0";"39";"39";"0";"39";"0";"430485";"5766"
"LOK1378_1mm";"SILVA (only NR);Eukaryota;Amorphea;Obazoa;Opisthokonta;Holozoa;Choanozoa;Metazoa;Animalia;BCP clade;Bilateria;Protostomia;Lophotrochozoa;Annelida;Polychaeta;Scolecida;";"0.0";"0";"290";"285";"0";"285";"5";"430239";"5766"
"LOK1378_1mm";"SILVA (only NR);Eukaryota;Amorphea;Obazoa;Opisthokonta;Holozoa;Choanozoa;Metazoa;Animalia;BCP clade;Bilateria;Protostomia;Lophotrochozoa;Annelida;Polychaeta;Scolecida;Capitellida;";"0.0";"0";"56";"54";"0";"54";"2";"430470";"5766"
"LOK1378_1mm";"SILVA (only NR);Eukaryota;Amorphea;Obazoa;Opisthokonta;Holozoa;Choanozoa;Metazoa;Animalia;BCP clade;Bilateria;Protostomia;Lophotrochozoa;Annelida;Polychaeta;Scolecida;Cossuridae;";"0.0";"0";"4";"4";"0";"4";"0";"430520";"5766"
"LOK1378_1mm";"SILVA (only NR);Eukaryota;Amorphea;Obazoa;Opisthokonta;Holozoa;Choanozoa;Metazoa;Animalia;BCP clade;Bilateria;Protostomia;Lophotrochozoa;Annelida;Polychaeta;Scolecida;Dinophilida;";"0.0";"0";"6";"6";"0";"6";"0";"430518";"5766"
"LOK1378_1mm";"SILVA (only NR);Eukaryota;Amorphea;Obazoa;Opisthokonta;Holozoa;Choanozoa;Metazoa;Animalia;BCP clade;Bilateria;Protostomia;Lophotrochozoa;Annelida;Polychaeta;Scolecida;Opheliidae;";"0.0";"0";"9";"9";"0";"9";"0";"430515";"5766"
"LOK1378_1mm";"SILVA (only NR);Eukaryota;Amorphea;Obazoa;Opisthokonta;Holozoa;Choanozoa;Metazoa;Animalia;BCP clade;Bilateria;Protostomia;Lophotrochozoa;Annelida;Polychaeta;Scolecida;Orbiniidae;";"0.0";"0";"25";"25";"0";"25";"0";"430499";"5766"
"LOK1378_1mm";"SILVA (only NR);Eukaryota;Amorphea;Obazoa;Opisthokonta;Holozoa;Choanozoa;Metazoa;Animalia;BCP clade;Bilateria;Protostomia;Lophotrochozoa;Annelida;Polychaeta;Scolecida;Paraonidae;";"0.0";"0";"6";"6";"0";"6";"0";"430518";"5766"
"LOK1378_1mm";"SILVA (only NR);Eukaryota;Amorphea;Obazoa;Opisthokonta;Holozoa;Choanozoa;Metazoa;Animalia;BCP clade;Bilateria;Protostomia;Lophotrochozoa;Annelida;Polychaeta;Scolecida;Parergodrilidae;";"0.0";"0";"4";"4";"0";"4";"0";"430520";"5766"
"LOK1378_1mm";"SILVA (only NR);Eukaryota;Amorphea;Obazoa;Opisthokonta;Holozoa;Choanozoa;Metazoa;Animalia;BCP clade;Bilateria;Protostomia;Lophotrochozoa;Annelida;Polychaeta;Scolecida;Questidae;";"0.0";"0";"2";"2";"0";"2";"0";"430522";"5766"
"LOK1378_1mm";"SILVA (only NR);Eukaryota;Amorphea;Obazoa;Opisthokonta;Holozoa;Choanozoa;Metazoa;Animalia;BCP clade;Bilateria;Protostomia;Lophotrochozoa;Annelida;Polychaeta;Scolecida;Spionida;";"0.0";"0";"93";"90";"0";"90";"3";"430434";"5766"
"LOK1378_1mm";"SILVA (only NR);Eukaryota;Amorphea;Obazoa;Opisthokonta;Holozoa;Choanozoa;Metazoa;Animalia;BCP clade;Bilateria;Protostomia;Lophotrochozoa;Annelida;Polychaeta;Scolecida;Terebellida;";"0.0";"0";"81";"81";"0";"81";"0";"430443";"5766"
"LOK1378_1mm";"SILVA (only NR);Eukaryota;Amorphea;Obazoa;Opisthokonta;Holozoa;Choanozoa;Metazoa;Animalia;BCP clade;Bilateria;Protostomia;Lophotrochozoa;Annelida;Polychaeta;Sipuncula;";"0.0";"0";"34";"33";"0";"33";"1";"430491";"5766"
"LOK1378_1mm";"SILVA (only NR);Eukaryota;Amorphea;Obazoa;Opisthokonta;Holozoa;Choanozoa;Metazoa;Animalia;BCP clade;Bilateria;Protostomia;Lophotrochozoa;Annelida;Polychaeta;Sipuncula;Aspidosiphonidormes;";"0.0";"0";"5";"5";"0";"5";"0";"430519";"5766"
"LOK1378_1mm";"SILVA (only NR);Eukaryota;Amorphea;Obazoa;Opisthokonta;Holozoa;Choanozoa;Metazoa;Animalia;BCP clade;Bilateria;Protostomia;Lophotrochozoa;Annelida;Polychaeta;Sipuncula;Golfingiida;";"0.0";"0";"20";"19";"0";"19";"1";"430505";"5766"
"LOK1378_1mm";"SILVA (only NR);Eukaryota;Amorphea;Obazoa;Opisthokonta;Holozoa;Choanozoa;Metazoa;Animalia;BCP clade;Bilateria;Protostomia;Lophotrochozoa;Annelida;Polychaeta;Sipuncula;Phascolosomatiformes;";"0.0";"0";"9";"9";"0";"9";"0";"430515";"5766"
"LOK1378_1mm";"SILVA (only NR);Eukaryota;Amorphea;Obazoa;Opisthokonta;Holozoa;Choanozoa;Metazoa;Animalia;BCP clade;Bilateria;Protostomia;Lophotrochozoa;Bryozoa;";"0.0";"0";"111";"110";"0";"110";"1";"430414";"5766"
"LOK1378_1mm";"SILVA (only NR);Eukaryota;Amorphea;Obazoa;Opisthokonta;Holozoa;Choanozoa;Metazoa;Animalia;BCP clade;Bilateria;Protostomia;Lophotrochozoa;Bryozoa;Gymnolaemata;";"0.0";"0";"71";"71";"0";"71";"0";"430453";"5766"
"LOK1378_1mm";"SILVA (only NR);Eukaryota;Amorphea;Obazoa;Opisthokonta;Holozoa;Choanozoa;Metazoa;Animalia;BCP clade;Bilateria;Protostomia;Lophotrochozoa;Bryozoa;Gymnolaemata;Cheilostomatida;";"0.0";"0";"54";"54";"0";"54";"0";"430470";"5766"
"LOK1378_1mm";"SILVA (only NR);Eukaryota;Amorphea;Obazoa;Opisthokonta;Holozoa;Choanozoa;Metazoa;Animalia;BCP clade;Bilateria;Protostomia;Lophotrochozoa;Bryozoa;Gymnolaemata;Ctenostomatida;";"0.0";"0";"17";"17";"0";"17";"0";"430507";"5766"
"LOK1378_1mm";"SILVA (only NR);Eukaryota;Amorphea;Obazoa;Opisthokonta;Holozoa;Choanozoa;Metazoa;Animalia;BCP clade;Bilateria;Protostomia;Lophotrochozoa;Bryozoa;Phylactolaemata;";"0.0";"0";"7";"7";"0";"7";"0";"430517";"5766"
"LOK1378_1mm";"SILVA (only NR);Eukaryota;Amorphea;Obazoa;Opisthokonta;Holozoa;Choanozoa;Metazoa;Animalia;BCP clade;Bilateria;Protostomia;Lophotrochozoa;Bryozoa;Phylactolaemata;Plumatellida;";"0.0";"0";"7";"7";"0";"7";"0";"430517";"5766"
"LOK1378_1mm";"SILVA (only NR);Eukaryota;Amorphea;Obazoa;Opisthokonta;Holozoa;Choanozoa;Metazoa;Animalia;BCP clade;Bilateria;Protostomia;Lophotrochozoa;Bryozoa;Phylactolaemata;Plumatellida;Plumatellidae;";"0.0";"0";"2";"2";"0";"2";"0";"430522";"5766"
"LOK1378_1mm";"SILVA (only NR);Eukaryota;Amorphea;Obazoa;Opisthokonta;Holozoa;Choanozoa;Metazoa;Animalia;BCP clade;Bilateria;Protostomia;Lophotrochozoa;Bryozoa;Stenolaemata;";"0.0";"0";"33";"32";"0";"32";"1";"430492";"5766"
"LOK1378_1mm";"SILVA (only NR);Eukaryota;Amorphea;Obazoa;Opisthokonta;Holozoa;Choanozoa;Metazoa;Animalia;BCP clade;Bilateria;Protostomia;Lophotrochozoa;Bryozoa;Stenolaemata;Cyclostomatida;";"0.0";"0";"28";"27";"0";"27";"1";"430497";"5766"
"LOK1378_1mm";"SILVA (only NR);Eukaryota;Amorphea;Obazoa;Opisthokonta;Holozoa;Choanozoa;Metazoa;Animalia;BCP clade;Bilateria;Protostomia;Lophotrochozoa;Bryozoa;Stenolaemata;Tubuliporida;";"0.0";"0";"4";"4";"0";"4";"0";"430520";"5766"
"LOK1378_1mm";"SILVA (only NR);Eukaryota;Amorphea;Obazoa;Opisthokonta;Holozoa;Choanozoa;Metazoa;Animalia;BCP clade;Bilateria;Protostomia;Lophotrochozoa;Entoprocta;";"0.0";"0";"19";"18";"0";"18";"1";"430506";"5766"
"LOK1378_1mm";"SILVA (only NR);Eukaryota;Amorphea;Obazoa;Opisthokonta;Holozoa;Choanozoa;Metazoa;Animalia;BCP clade;Bilateria;Protostomia;Lophotrochozoa;Entoprocta;Coloniales;";"0.0";"0";"4";"4";"0";"4";"0";"430520";"5766"
"LOK1378_1mm";"SILVA (only NR);Eukaryota;Amorphea;Obazoa;Opisthokonta;Holozoa;Choanozoa;Metazoa;Animalia;BCP clade;Bilateria;Protostomia;Lophotrochozoa;Entoprocta;Coloniales;Barentsiidae;";"0.0";"0";"4";"4";"0";"4";"0";"430520";"5766"
"LOK1378_1mm";"SILVA (only NR);Eukaryota;Amorphea;Obazoa;Opisthokonta;Holozoa;Choanozoa;Metazoa;Animalia;BCP clade;Bilateria;Protostomia;Lophotrochozoa;Entoprocta;Solitaria;";"0.0";"0";"13";"12";"0";"12";"1";"430512";"5766"
"LOK1378_1mm";"SILVA (only NR);Eukaryota;Amorphea;Obazoa;Opisthokonta;Holozoa;Choanozoa;Metazoa;Animalia;BCP clade;Bilateria;Protostomia;Lophotrochozoa;Entoprocta;Solitaria;Loxosomatidae;";"0.0";"0";"13";"12";"0";"12";"1";"430512";"5766"
"LOK1378_1mm";"SILVA (only NR);Eukaryota;Amorphea;Obazoa;Opisthokonta;Holozoa;Choanozoa;Metazoa;Animalia;BCP clade;Bilateria;Protostomia;Lophotrochozoa;Gastrotricha;";"0.0";"0";"149";"146";"0";"146";"3";"430378";"5766"
"LOK1378_1mm";"SILVA (only NR);Eukaryota;Amorphea;Obazoa;Opisthokonta;Holozoa;Choanozoa;Metazoa;Animalia;BCP clade;Bilateria;Protostomia;Lophotrochozoa;Gastrotricha;Chaetonotida;";"0.0";"0";"88";"86";"0";"86";"2";"430438";"5766"
"LOK1378_1mm";"SILVA (only NR);Eukaryota;Amorphea;Obazoa;Opisthokonta;Holozoa;Choanozoa;Metazoa;Animalia;BCP clade;Bilateria;Protostomia;Lophotrochozoa;Gastrotricha;Macrodasyida;";"0.0";"0";"61";"60";"0";"60";"1";"430464";"5766"
"LOK1378_1mm";"SILVA (only NR);Eukaryota;Amorphea;Obazoa;Opisthokonta;Holozoa;Choanozoa;Metazoa;Animalia;BCP clade;Bilateria;Protostomia;Lophotrochozoa;Gastrotricha;Macrodasyida;Dactylopodolidae;";"0.0";"0";"5";"5";"0";"5";"0";"430519";"5766"
"LOK1378_1mm";"SILVA (only NR);Eukaryota;Amorphea;Obazoa;Opisthokonta;Holozoa;Choanozoa;Metazoa;Animalia;BCP clade;Bilateria;Protostomia;Lophotrochozoa;Gnathostomulida;";"0.0";"0";"24";"24";"0";"24";"0";"430500";"5766"
"LOK1378_1mm";"SILVA (only NR);Eukaryota;Amorphea;Obazoa;Opisthokonta;Holozoa;Choanozoa;Metazoa;Animalia;BCP clade;Bilateria;Protostomia;Lophotrochozoa;Gnathostomulida;Bursovaginoidea;";"0.0";"0";"18";"18";"0";"18";"0";"430506";"5766"
"LOK1378_1mm";"SILVA (only NR);Eukaryota;Amorphea;Obazoa;Opisthokonta;Holozoa;Choanozoa;Metazoa;Animalia;BCP clade;Bilateria;Protostomia;Lophotrochozoa;Gnathostomulida;Filospermoidea;";"0.0";"0";"6";"6";"0";"6";"0";"430518";"5766"
"LOK1378_1mm";"SILVA (only NR);Eukaryota;Amorphea;Obazoa;Opisthokonta;Holozoa;Choanozoa;Metazoa;Animalia;BCP clade;Bilateria;Protostomia;Lophotrochozoa;Lophophorata;";"0.0";"0";"57";"57";"0";"57";"0";"430467";"5766"
"LOK1378_1mm";"SILVA (only NR);Eukaryota;Amorphea;Obazoa;Opisthokonta;Holozoa;Choanozoa;Metazoa;Animalia;BCP clade;Bilateria;Protostomia;Lophotrochozoa;Lophophorata;Brachiopoda;";"0.0";"0";"57";"57";"0";"57";"0";"430467";"5766"
"LOK1378_1mm";"SILVA (only NR);Eukaryota;Amorphea;Obazoa;Opisthokonta;Holozoa;Choanozoa;Metazoa;Animalia;BCP clade;Bilateria;Protostomia;Lophotrochozoa;Lophophorata;Brachiopoda;Linguliformea;";"0.0";"0";"6";"6";"0";"6";"0";"430518";"5766"
"LOK1378_1mm";"SILVA (only NR);Eukaryota;Amorphea;Obazoa;Opisthokonta;Holozoa;Choanozoa;Metazoa;Animalia;BCP clade;Bilateria;Protostomia;Lophotrochozoa;Lophophorata;Brachiopoda;Linguliformea;Lingulata;";"0.0";"0";"6";"6";"0";"6";"0";"430518";"5766"
"LOK1378_1mm";"SILVA (only NR);Eukaryota;Amorphea;Obazoa;Opisthokonta;Holozoa;Choanozoa;Metazoa;Animalia;BCP clade;Bilateria;Protostomia;Lophotrochozoa;Lophophorata;Brachiopoda;Linguliformea;Lingulata;Lingulida;";"0.0";"0";"6";"6";"0";"6";"0";"430518";"5766"
"LOK1378_1mm";"SILVA (only NR);Eukaryota;Amorphea;Obazoa;Opisthokonta;Holozoa;Choanozoa;Metazoa;Animalia;BCP clade;Bilateria;Protostomia;Lophotrochozoa;Lophophorata;Brachiopoda;Phoroniformea;";"0.0";"0";"12";"12";"0";"12";"0";"430512";"5766"
"LOK1378_1mm";"SILVA (only NR);Eukaryota;Amorphea;Obazoa;Opisthokonta;Holozoa;Choanozoa;Metazoa;Animalia;BCP clade;Bilateria;Protostomia;Lophotrochozoa;Lophophorata;Brachiopoda;Rhynchonelliformea;";"0.0";"0";"37";"37";"0";"37";"0";"430487";"5766"
"LOK1378_1mm";"SILVA (only NR);Eukaryota;Amorphea;Obazoa;Opisthokonta;Holozoa;Choanozoa;Metazoa;Animalia;BCP clade;Bilateria;Protostomia;Lophotrochozoa;Lophophorata;Brachiopoda;Rhynchonelliformea;Rhynchonellata;";"0.0";"0";"37";"37";"0";"37";"0";"430487";"5766"
"LOK1378_1mm";"SILVA (only NR);Eukaryota;Amorphea;Obazoa;Opisthokonta;Holozoa;Choanozoa;Metazoa;Animalia;BCP clade;Bilateria;Protostomia;Lophotrochozoa;Lophophorata;Brachiopoda;Rhynchonelliformea;Rhynchonellata;Rhynchonellida;";"0.0";"0";"9";"9";"0";"9";"0";"430515";"5766"
"LOK1378_1mm";"SILVA (only NR);Eukaryota;Amorphea;Obazoa;Opisthokonta;Holozoa;Choanozoa;Metazoa;Animalia;BCP clade;Bilateria;Protostomia;Lophotrochozoa;Lophophorata;Brachiopoda;Rhynchonelliformea;Rhynchonellata;Terebratulida;";"0.0";"0";"20";"20";"0";"20";"0";"430504";"5766"
"LOK1378_1mm";"SILVA (only NR);Eukaryota;Amorphea;Obazoa;Opisthokonta;Holozoa;Choanozoa;Metazoa;Animalia;BCP clade;Bilateria;Protostomia;Lophotrochozoa;Lophophorata;Brachiopoda;Rhynchonelliformea;Rhynchonellata;Thecideida;";"0.0";"0";"8";"8";"0";"8";"0";"430516";"5766"
"LOK1378_1mm";"SILVA (only NR);Eukaryota;Amorphea;Obazoa;Opisthokonta;Holozoa;Choanozoa;Metazoa;Animalia;BCP clade;Bilateria;Protostomia;Lophotrochozoa;Micrognathozoa;";"0.0";"0";"2";"2";"0";"2";"0";"430522";"5766"
"LOK1378_1mm";"SILVA (only NR);Eukaryota;Amorphea;Obazoa;Opisthokonta;Holozoa;Choanozoa;Metazoa;Animalia;BCP clade;Bilateria;Protostomia;Lophotrochozoa;Micrognathozoa;Limnognathia;";"0.0";"0";"2";"2";"0";"2";"0";"430522";"5766"
"LOK1378_1mm";"SILVA (only NR);Eukaryota;Amorphea;Obazoa;Opisthokonta;Holozoa;Choanozoa;Metazoa;Animalia;BCP clade;Bilateria;Protostomia;Lophotrochozoa;Mollusca;";"0.0";"0";"986";"951";"0";"951";"35";"429573";"5766"
"LOK1378_1mm";"SILVA (only NR);Eukaryota;Amorphea;Obazoa;Opisthokonta;Holozoa;Choanozoa;Metazoa;Animalia;BCP clade;Bilateria;Protostomia;Lophotrochozoa;Mollusca;Bivalvia;";"0.0";"0";"368";"352";"0";"352";"16";"430172";"5766"
"LOK1378_1mm";"SILVA (only NR);Eukaryota;Amorphea;Obazoa;Opisthokonta;Holozoa;Choanozoa;Metazoa;Animalia;BCP clade;Bilateria;Protostomia;Lophotrochozoa;Mollusca;Bivalvia;Anomalodesmata;";"0.0";"0";"43";"40";"0";"40";"3";"430484";"5766"
"LOK1378_1mm";"SILVA (only NR);Eukaryota;Amorphea;Obazoa;Opisthokonta;Holozoa;Choanozoa;Metazoa;Animalia;BCP clade;Bilateria;Protostomia;Lophotrochozoa;Mollusca;Bivalvia;Anomalodesmata;Pholadomyoida;";"0.0";"0";"43";"40";"0";"40";"3";"430484";"5766"
"LOK1378_1mm";"SILVA (only NR);Eukaryota;Amorphea;Obazoa;Opisthokonta;Holozoa;Choanozoa;Metazoa;Animalia;BCP clade;Bilateria;Protostomia;Lophotrochozoa;Mollusca;Bivalvia;Heteroconchia;";"0.0";"0";"176";"172";"0";"172";"4";"430352";"5766"
"LOK1378_1mm";"SILVA (only NR);Eukaryota;Amorphea;Obazoa;Opisthokonta;Holozoa;Choanozoa;Metazoa;Animalia;BCP clade;Bilateria;Protostomia;Lophotrochozoa;Mollusca;Bivalvia;Heteroconchia;Myoida;";"0.0";"0";"36";"35";"0";"35";"1";"430489";"5766"
"LOK1378_1mm";"SILVA (only NR);Eukaryota;Amorphea;Obazoa;Opisthokonta;Holozoa;Choanozoa;Metazoa;Animalia;BCP clade;Bilateria;Protostomia;Lophotrochozoa;Mollusca;Bivalvia;Heteroconchia;Veneroida;";"0.0";"0";"134";"132";"0";"132";"2";"430392";"5766"
"LOK1378_1mm";"SILVA (only NR);Eukaryota;Amorphea;Obazoa;Opisthokonta;Holozoa;Choanozoa;Metazoa;Animalia;BCP clade;Bilateria;Protostomia;Lophotrochozoa;Mollusca;Bivalvia;Palaeoheterodonta;";"0.0";"0";"15";"13";"0";"13";"2";"430511";"5766"
"LOK1378_1mm";"SILVA (only NR);Eukaryota;Amorphea;Obazoa;Opisthokonta;Holozoa;Choanozoa;Metazoa;Animalia;BCP clade;Bilateria;Protostomia;Lophotrochozoa;Mollusca;Bivalvia;Palaeoheterodonta;Unionoida;";"0.0";"0";"14";"12";"0";"12";"2";"430512";"5766"
"LOK1378_1mm";"SILVA (only NR);Eukaryota;Amorphea;Obazoa;Opisthokonta;Holozoa;Choanozoa;Metazoa;Animalia;BCP clade;Bilateria;Protostomia;Lophotrochozoa;Mollusca;Bivalvia;Protobranchia;";"0.0";"0";"26";"25";"0";"25";"1";"430499";"5766"
"LOK1378_1mm";"SILVA (only NR);Eukaryota;Amorphea;Obazoa;Opisthokonta;Holozoa;Choanozoa;Metazoa;Animalia;BCP clade;Bilateria;Protostomia;Lophotrochozoa;Mollusca;Bivalvia;Protobranchia;Nuculanoida;";"0.0";"0";"6";"6";"0";"6";"0";"430518";"5766"
"LOK1378_1mm";"SILVA (only NR);Eukaryota;Amorphea;Obazoa;Opisthokonta;Holozoa;Choanozoa;Metazoa;Animalia;BCP clade;Bilateria;Protostomia;Lophotrochozoa;Mollusca;Bivalvia;Protobranchia;Nuculoida;";"0.0";"0";"4";"4";"0";"4";"0";"430520";"5766"
"LOK1378_1mm";"SILVA (only NR);Eukaryota;Amorphea;Obazoa;Opisthokonta;Holozoa;Choanozoa;Metazoa;Animalia;BCP clade;Bilateria;Protostomia;Lophotrochozoa;Mollusca;Bivalvia;Protobranchia;Solemyoida;";"0.0";"0";"16";"15";"0";"15";"1";"430509";"5766"
"LOK1378_1mm";"SILVA (only NR);Eukaryota;Amorphea;Obazoa;Opisthokonta;Holozoa;Choanozoa;Metazoa;Animalia;BCP clade;Bilateria;Protostomia;Lophotrochozoa;Mollusca;Bivalvia;Pteriomorphia;";"0.0";"0";"108";"102";"0";"102";"6";"430422";"5766"
"LOK1378_1mm";"SILVA (only NR);Eukaryota;Amorphea;Obazoa;Opisthokonta;Holozoa;Choanozoa;Metazoa;Animalia;BCP clade;Bilateria;Protostomia;Lophotrochozoa;Mollusca;Bivalvia;Pteriomorphia;Arcoida;";"0.0";"0";"12";"12";"0";"12";"0";"430512";"5766"
"LOK1378_1mm";"SILVA (only NR);Eukaryota;Amorphea;Obazoa;Opisthokonta;Holozoa;Choanozoa;Metazoa;Animalia;BCP clade;Bilateria;Protostomia;Lophotrochozoa;Mollusca;Bivalvia;Pteriomorphia;Limoida;";"0.0";"0";"8";"8";"0";"8";"0";"430516";"5766"
"LOK1378_1mm";"SILVA (only NR);Eukaryota;Amorphea;Obazoa;Opisthokonta;Holozoa;Choanozoa;Metazoa;Animalia;BCP clade;Bilateria;Protostomia;Lophotrochozoa;Mollusca;Bivalvia;Pteriomorphia;Mytiloida;";"0.0";"0";"37";"36";"0";"36";"1";"430488";"5766"
"LOK1378_1mm";"SILVA (only NR);Eukaryota;Amorphea;Obazoa;Opisthokonta;Holozoa;Choanozoa;Metazoa;Animalia;BCP clade;Bilateria;Protostomia;Lophotrochozoa;Mollusca;Bivalvia;Pteriomorphia;Ostreoida;";"0.0";"0";"16";"13";"0";"13";"3";"430511";"5766"
"LOK1378_1mm";"SILVA (only NR);Eukaryota;Amorphea;Obazoa;Opisthokonta;Holozoa;Choanozoa;Metazoa;Animalia;BCP clade;Bilateria;Protostomia;Lophotrochozoa;Mollusca;Bivalvia;Pteriomorphia;Pectinoida;";"0.0";"0";"13";"12";"0";"12";"1";"430512";"5766"
"LOK1378_1mm";"SILVA (only NR);Eukaryota;Amorphea;Obazoa;Opisthokonta;Holozoa;Choanozoa;Metazoa;Animalia;BCP clade;Bilateria;Protostomia;Lophotrochozoa;Mollusca;Bivalvia;Pteriomorphia;Pterioida;";"0.0";"0";"22";"21";"0";"21";"1";"430503";"5766"
"LOK1378_1mm";"SILVA (only NR);Eukaryota;Amorphea;Obazoa;Opisthokonta;Holozoa;Choanozoa;Metazoa;Animalia;BCP clade;Bilateria;Protostomia;Lophotrochozoa;Mollusca;Caudofoveata;";"0.0";"0";"4";"4";"0";"4";"0";"430520";"5766"
"LOK1378_1mm";"SILVA (only NR);Eukaryota;Amorphea;Obazoa;Opisthokonta;Holozoa;Choanozoa;Metazoa;Animalia;BCP clade;Bilateria;Protostomia;Lophotrochozoa;Mollusca;Cephalopoda;";"0.0";"0";"53";"53";"0";"53";"0";"430471";"5766"
"LOK1378_1mm";"SILVA (only NR);Eukaryota;Amorphea;Obazoa;Opisthokonta;Holozoa;Choanozoa;Metazoa;Animalia;BCP clade;Bilateria;Protostomia;Lophotrochozoa;Mollusca;Cephalopoda;Coleoidea;";"0.0";"0";"53";"53";"0";"53";"0";"430471";"5766"
"LOK1378_1mm";"SILVA (only NR);Eukaryota;Amorphea;Obazoa;Opisthokonta;Holozoa;Choanozoa;Metazoa;Animalia;BCP clade;Bilateria;Protostomia;Lophotrochozoa;Mollusca;Cephalopoda;Coleoidea;Decapodiformes;";"0.0";"0";"50";"50";"0";"50";"0";"430474";"5766"
"LOK1378_1mm";"SILVA (only NR);Eukaryota;Amorphea;Obazoa;Opisthokonta;Holozoa;Choanozoa;Metazoa;Animalia;BCP clade;Bilateria;Protostomia;Lophotrochozoa;Mollusca;Cephalopoda;Coleoidea;Decapodiformes;Teuthida;";"0.0";"0";"46";"46";"0";"46";"0";"430478";"5766"
"LOK1378_1mm";"SILVA (only NR);Eukaryota;Amorphea;Obazoa;Opisthokonta;Holozoa;Choanozoa;Metazoa;Animalia;BCP clade;Bilateria;Protostomia;Lophotrochozoa;Mollusca;Gastropoda;";"0.0";"0";"496";"477";"0";"477";"19";"430047";"5766"
"LOK1378_1mm";"SILVA (only NR);Eukaryota;Amorphea;Obazoa;Opisthokonta;Holozoa;Choanozoa;Metazoa;Animalia;BCP clade;Bilateria;Protostomia;Lophotrochozoa;Mollusca;Gastropoda;Caenogastropoda;";"0.0";"0";"97";"96";"0";"96";"1";"430428";"5766"
"LOK1378_1mm";"SILVA (only NR);Eukaryota;Amorphea;Obazoa;Opisthokonta;Holozoa;Choanozoa;Metazoa;Animalia;BCP clade;Bilateria;Protostomia;Lophotrochozoa;Mollusca;Gastropoda;Cucculiniformia;";"0.0";"0";"6";"6";"0";"6";"0";"430518";"5766"
"LOK1378_1mm";"SILVA (only NR);Eukaryota;Amorphea;Obazoa;Opisthokonta;Holozoa;Choanozoa;Metazoa;Animalia;BCP clade;Bilateria;Protostomia;Lophotrochozoa;Mollusca;Gastropoda;Heterobranchia;";"0.0";"0";"314";"298";"0";"298";"16";"430226";"5766"
"LOK1378_1mm";"SILVA (only NR);Eukaryota;Amorphea;Obazoa;Opisthokonta;Holozoa;Choanozoa;Metazoa;Animalia;BCP clade;Bilateria;Protostomia;Lophotrochozoa;Mollusca;Gastropoda;Neritimorpha;";"0.0";"0";"6";"6";"0";"6";"0";"430518";"5766"
"LOK1378_1mm";"SILVA (only NR);Eukaryota;Amorphea;Obazoa;Opisthokonta;Holozoa;Choanozoa;Metazoa;Animalia;BCP clade;Bilateria;Protostomia;Lophotrochozoa;Mollusca;Gastropoda;Vetigastropoda;";"0.0";"0";"72";"70";"0";"70";"2";"430454";"5766"
"LOK1378_1mm";"SILVA (only NR);Eukaryota;Amorphea;Obazoa;Opisthokonta;Holozoa;Choanozoa;Metazoa;Animalia;BCP clade;Bilateria;Protostomia;Lophotrochozoa;Mollusca;Polyplacophora;";"0.0";"0";"45";"45";"0";"45";"0";"430479";"5766"
"LOK1378_1mm";"SILVA (only NR);Eukaryota;Amorphea;Obazoa;Opisthokonta;Holozoa;Choanozoa;Metazoa;Animalia;BCP clade;Bilateria;Protostomia;Lophotrochozoa;Mollusca;Polyplacophora;Neoloricata;";"0.0";"0";"45";"45";"0";"45";"0";"430479";"5766"
"LOK1378_1mm";"SILVA (only NR);Eukaryota;Amorphea;Obazoa;Opisthokonta;Holozoa;Choanozoa;Metazoa;Animalia;BCP clade;Bilateria;Protostomia;Lophotrochozoa;Mollusca;Scaphopoda;";"0.0";"0";"16";"16";"0";"16";"0";"430508";"5766"
"LOK1378_1mm";"SILVA (only NR);Eukaryota;Amorphea;Obazoa;Opisthokonta;Holozoa;Choanozoa;Metazoa;Animalia;BCP clade;Bilateria;Protostomia;Lophotrochozoa;Mollusca;Scaphopoda;Dentaliida;";"0.0";"0";"7";"7";"0";"7";"0";"430517";"5766"
"LOK1378_1mm";"SILVA (only NR);Eukaryota;Amorphea;Obazoa;Opisthokonta;Holozoa;Choanozoa;Metazoa;Animalia;BCP clade;Bilateria;Protostomia;Lophotrochozoa;Mollusca;Scaphopoda;Gadilida;";"0.0";"0";"9";"9";"0";"9";"0";"430515";"5766"
"LOK1378_1mm";"SILVA (only NR);Eukaryota;Amorphea;Obazoa;Opisthokonta;Holozoa;Choanozoa;Metazoa;Animalia;BCP clade;Bilateria;Protostomia;Lophotrochozoa;Nemertea;";"0.0";"0";"160";"156";"0";"156";"4";"430368";"5766"
"LOK1378_1mm";"SILVA (only NR);Eukaryota;Amorphea;Obazoa;Opisthokonta;Holozoa;Choanozoa;Metazoa;Animalia;BCP clade;Bilateria;Protostomia;Lophotrochozoa;Nemertea;Anopla;";"0.0";"0";"74";"73";"0";"73";"1";"430451";"5766"
"LOK1378_1mm";"SILVA (only NR);Eukaryota;Amorphea;Obazoa;Opisthokonta;Holozoa;Choanozoa;Metazoa;Animalia;BCP clade;Bilateria;Protostomia;Lophotrochozoa;Nemertea;Anopla;Heteronemertea;";"0.0";"0";"38";"38";"0";"38";"0";"430486";"5766"
"LOK1378_1mm";"SILVA (only NR);Eukaryota;Amorphea;Obazoa;Opisthokonta;Holozoa;Choanozoa;Metazoa;Animalia;BCP clade;Bilateria;Protostomia;Lophotrochozoa;Nemertea;Anopla;Palaeonemertea;";"0.0";"0";"34";"33";"0";"33";"1";"430491";"5766"
"LOK1378_1mm";"SILVA (only NR);Eukaryota;Amorphea;Obazoa;Opisthokonta;Holozoa;Choanozoa;Metazoa;Animalia;BCP clade;Bilateria;Protostomia;Lophotrochozoa;Nemertea;Enopla;";"0.0";"0";"86";"83";"0";"83";"3";"430441";"5766"
"LOK1378_1mm";"SILVA (only NR);Eukaryota;Amorphea;Obazoa;Opisthokonta;Holozoa;Choanozoa;Metazoa;Animalia;BCP clade;Bilateria;Protostomia;Lophotrochozoa;Nemertea;Enopla;Bdellonemertea;";"0.0";"0";"2";"2";"0";"2";"0";"430522";"5766"
"LOK1378_1mm";"SILVA (only NR);Eukaryota;Amorphea;Obazoa;Opisthokonta;Holozoa;Choanozoa;Metazoa;Animalia;BCP clade;Bilateria;Protostomia;Lophotrochozoa;Nemertea;Enopla;Monostilifera;";"0.0";"0";"79";"76";"0";"76";"3";"430448";"5766"
"LOK1378_1mm";"SILVA (only NR);Eukaryota;Amorphea;Obazoa;Opisthokonta;Holozoa;Choanozoa;Metazoa;Animalia;BCP clade;Bilateria;Protostomia;Lophotrochozoa;Nemertea;Enopla;Polystilifera;";"0.0";"0";"4";"4";"0";"4";"0";"430520";"5766"
"LOK1378_1mm";"SILVA (only NR);Eukaryota;Amorphea;Obazoa;Opisthokonta;Holozoa;Choanozoa;Metazoa;Animalia;BCP clade;Bilateria;Protostomia;Lophotrochozoa;Pauropoda;";"0.0";"0";"5";"5";"0";"5";"0";"430519";"5766"
"LOK1378_1mm";"SILVA (only NR);Eukaryota;Amorphea;Obazoa;Opisthokonta;Holozoa;Choanozoa;Metazoa;Animalia;BCP clade;Bilateria;Protostomia;Lophotrochozoa;Platyhelminthes;";"0.0";"0";"1993";"1923";"0";"1923";"70";"428601";"5766"
"LOK1378_1mm";"SILVA (only NR);Eukaryota;Amorphea;Obazoa;Opisthokonta;Holozoa;Choanozoa;Metazoa;Animalia;BCP clade;Bilateria;Protostomia;Lophotrochozoa;Platyhelminthes;Catenulida;";"0.0";"0";"43";"42";"0";"42";"1";"430482";"5766"
"LOK1378_1mm";"SILVA (only NR);Eukaryota;Amorphea;Obazoa;Opisthokonta;Holozoa;Choanozoa;Metazoa;Animalia;BCP clade;Bilateria;Protostomia;Lophotrochozoa;Platyhelminthes;Catenulida;Catenulidae;";"0.0";"0";"22";"22";"0";"22";"0";"430502";"5766"
"LOK1378_1mm";"SILVA (only NR);Eukaryota;Amorphea;Obazoa;Opisthokonta;Holozoa;Choanozoa;Metazoa;Animalia;BCP clade;Bilateria;Protostomia;Lophotrochozoa;Platyhelminthes;Catenulida;Stenostomidae;";"0.0";"0";"20";"19";"0";"19";"1";"430505";"5766"
"LOK1378_1mm";"SILVA (only NR);Eukaryota;Amorphea;Obazoa;Opisthokonta;Holozoa;Choanozoa;Metazoa;Animalia;BCP clade;Bilateria;Protostomia;Lophotrochozoa;Platyhelminthes;Cestoda;";"0.0";"0";"508";"499";"0";"499";"9";"430025";"5766"
"LOK1378_1mm";"SILVA (only NR);Eukaryota;Amorphea;Obazoa;Opisthokonta;Holozoa;Choanozoa;Metazoa;Animalia;BCP clade;Bilateria;Protostomia;Lophotrochozoa;Platyhelminthes;Cestoda;Cestodaria;";"0.0";"0";"4";"4";"0";"4";"0";"430520";"5766"
"LOK1378_1mm";"SILVA (only NR);Eukaryota;Amorphea;Obazoa;Opisthokonta;Holozoa;Choanozoa;Metazoa;Animalia;BCP clade;Bilateria;Protostomia;Lophotrochozoa;Platyhelminthes;Cestoda;Cestodaria;Amphilinidea;";"0.0";"0";"2";"2";"0";"2";"0";"430522";"5766"
"LOK1378_1mm";"SILVA (only NR);Eukaryota;Amorphea;Obazoa;Opisthokonta;Holozoa;Choanozoa;Metazoa;Animalia;BCP clade;Bilateria;Protostomia;Lophotrochozoa;Platyhelminthes;Cestoda;Cestodaria;Gyrocotylidea;";"0.0";"0";"2";"2";"0";"2";"0";"430522";"5766"
"LOK1378_1mm";"SILVA (only NR);Eukaryota;Amorphea;Obazoa;Opisthokonta;Holozoa;Choanozoa;Metazoa;Animalia;BCP clade;Bilateria;Protostomia;Lophotrochozoa;Platyhelminthes;Cestoda;Eucestoda;";"0.0";"0";"503";"494";"0";"494";"9";"430030";"5766"
"LOK1378_1mm";"SILVA (only NR);Eukaryota;Amorphea;Obazoa;Opisthokonta;Holozoa;Choanozoa;Metazoa;Animalia;BCP clade;Bilateria;Protostomia;Lophotrochozoa;Platyhelminthes;Cestoda;Eucestoda;Bothriocephalidea;";"0.0";"0";"43";"42";"0";"42";"1";"430482";"5766"
"LOK1378_1mm";"SILVA (only NR);Eukaryota;Amorphea;Obazoa;Opisthokonta;Holozoa;Choanozoa;Metazoa;Animalia;BCP clade;Bilateria;Protostomia;Lophotrochozoa;Platyhelminthes;Cestoda;Eucestoda;Caryophyllidea;";"0.0";"0";"31";"31";"0";"31";"0";"430493";"5766"
"LOK1378_1mm";"SILVA (only NR);Eukaryota;Amorphea;Obazoa;Opisthokonta;Holozoa;Choanozoa;Metazoa;Animalia;BCP clade;Bilateria;Protostomia;Lophotrochozoa;Platyhelminthes;Cestoda;Eucestoda;Cathetocephalidea;";"0.0";"0";"2";"2";"0";"2";"0";"430522";"5766"
"LOK1378_1mm";"SILVA (only NR);Eukaryota;Amorphea;Obazoa;Opisthokonta;Holozoa;Choanozoa;Metazoa;Animalia;BCP clade;Bilateria;Protostomia;Lophotrochozoa;Platyhelminthes;Cestoda;Eucestoda;Cyclophyllidea;";"0.0";"0";"90";"83";"0";"83";"7";"430441";"5766"
"LOK1378_1mm";"SILVA (only NR);Eukaryota;Amorphea;Obazoa;Opisthokonta;Holozoa;Choanozoa;Metazoa;Animalia;BCP clade;Bilateria;Protostomia;Lophotrochozoa;Platyhelminthes;Cestoda;Eucestoda;Diphyllidea;";"0.0";"0";"21";"20";"0";"20";"1";"430504";"5766"
"LOK1378_1mm";"SILVA (only NR);Eukaryota;Amorphea;Obazoa;Opisthokonta;Holozoa;Choanozoa;Metazoa;Animalia;BCP clade;Bilateria;Protostomia;Lophotrochozoa;Platyhelminthes;Cestoda;Eucestoda;Diphyllobothriidea;";"0.0";"0";"12";"12";"0";"12";"0";"430512";"5766"
"LOK1378_1mm";"SILVA (only NR);Eukaryota;Amorphea;Obazoa;Opisthokonta;Holozoa;Choanozoa;Metazoa;Animalia;BCP clade;Bilateria;Protostomia;Lophotrochozoa;Platyhelminthes;Cestoda;Eucestoda;Eucestoda Incertae Sedis;";"0.0";"0";"4";"4";"0";"4";"0";"430520";"5766"
"LOK1378_1mm";"SILVA (only NR);Eukaryota;Amorphea;Obazoa;Opisthokonta;Holozoa;Choanozoa;Metazoa;Animalia;BCP clade;Bilateria;Protostomia;Lophotrochozoa;Platyhelminthes;Cestoda;Eucestoda;Lecanicephalidea;";"0.0";"0";"36";"36";"0";"36";"0";"430488";"5766"
"LOK1378_1mm";"SILVA (only NR);Eukaryota;Amorphea;Obazoa;Opisthokonta;Holozoa;Choanozoa;Metazoa;Animalia;BCP clade;Bilateria;Protostomia;Lophotrochozoa;Platyhelminthes;Cestoda;Eucestoda;Litobothriidea;";"0.0";"0";"3";"3";"0";"3";"0";"430521";"5766"
"LOK1378_1mm";"SILVA (only NR);Eukaryota;Amorphea;Obazoa;Opisthokonta;Holozoa;Choanozoa;Metazoa;Animalia;BCP clade;Bilateria;Protostomia;Lophotrochozoa;Platyhelminthes;Cestoda;Eucestoda;Nippotaeniidea;";"0.0";"0";"4";"4";"0";"4";"0";"430520";"5766"
"LOK1378_1mm";"SILVA (only NR);Eukaryota;Amorphea;Obazoa;Opisthokonta;Holozoa;Choanozoa;Metazoa;Animalia;BCP clade;Bilateria;Protostomia;Lophotrochozoa;Platyhelminthes;Cestoda;Eucestoda;Proteocephalidea;";"0.0";"0";"28";"28";"0";"28";"0";"430496";"5766"
"LOK1378_1mm";"SILVA (only NR);Eukaryota;Amorphea;Obazoa;Opisthokonta;Holozoa;Choanozoa;Metazoa;Animalia;BCP clade;Bilateria;Protostomia;Lophotrochozoa;Platyhelminthes;Cestoda;Eucestoda;Pseudophyllidea;";"0.0";"0";"7";"7";"0";"7";"0";"430517";"5766"
"LOK1378_1mm";"SILVA (only NR);Eukaryota;Amorphea;Obazoa;Opisthokonta;Holozoa;Choanozoa;Metazoa;Animalia;BCP clade;Bilateria;Protostomia;Lophotrochozoa;Platyhelminthes;Cestoda;Eucestoda;Rhinebothriidea;";"0.0";"0";"50";"50";"0";"50";"0";"430474";"5766"
"LOK1378_1mm";"SILVA (only NR);Eukaryota;Amorphea;Obazoa;Opisthokonta;Holozoa;Choanozoa;Metazoa;Animalia;BCP clade;Bilateria;Protostomia;Lophotrochozoa;Platyhelminthes;Cestoda;Eucestoda;Spathebothriidea;";"0.0";"0";"4";"4";"0";"4";"0";"430520";"5766"
"LOK1378_1mm";"SILVA (only NR);Eukaryota;Amorphea;Obazoa;Opisthokonta;Holozoa;Choanozoa;Metazoa;Animalia;BCP clade;Bilateria;Protostomia;Lophotrochozoa;Platyhelminthes;Cestoda;Eucestoda;Tetrabothriidea;";"0.0";"0";"3";"3";"0";"3";"0";"430521";"5766"
"LOK1378_1mm";"SILVA (only NR);Eukaryota;Amorphea;Obazoa;Opisthokonta;Holozoa;Choanozoa;Metazoa;Animalia;BCP clade;Bilateria;Protostomia;Lophotrochozoa;Platyhelminthes;Cestoda;Eucestoda;Tetraphyllidea;";"0.0";"0";"52";"52";"0";"52";"0";"430472";"5766"
"LOK1378_1mm";"SILVA (only NR);Eukaryota;Amorphea;Obazoa;Opisthokonta;Holozoa;Choanozoa;Metazoa;Animalia;BCP clade;Bilateria;Protostomia;Lophotrochozoa;Platyhelminthes;Cestoda;Eucestoda;Trypanorhyncha;";"0.0";"0";"78";"78";"0";"78";"0";"430446";"5766"
"LOK1378_1mm";"SILVA (only NR);Eukaryota;Amorphea;Obazoa;Opisthokonta;Holozoa;Choanozoa;Metazoa;Animalia;BCP clade;Bilateria;Protostomia;Lophotrochozoa;Platyhelminthes;Monogenea;";"0.0";"0";"195";"191";"0";"191";"4";"430333";"5766"
"LOK1378_1mm";"SILVA (only NR);Eukaryota;Amorphea;Obazoa;Opisthokonta;Holozoa;Choanozoa;Metazoa;Animalia;BCP clade;Bilateria;Protostomia;Lophotrochozoa;Platyhelminthes;Monogenea;Monopisthocotylea;";"0.0";"0";"121";"118";"0";"118";"3";"430406";"5766"
"LOK1378_1mm";"SILVA (only NR);Eukaryota;Amorphea;Obazoa;Opisthokonta;Holozoa;Choanozoa;Metazoa;Animalia;BCP clade;Bilateria;Protostomia;Lophotrochozoa;Platyhelminthes;Monogenea;Monopisthocotylea;Ancylodiscoididae;";"0.0";"0";"17";"17";"0";"17";"0";"430507";"5766"
"LOK1378_1mm";"SILVA (only NR);Eukaryota;Amorphea;Obazoa;Opisthokonta;Holozoa;Choanozoa;Metazoa;Animalia;BCP clade;Bilateria;Protostomia;Lophotrochozoa;Platyhelminthes;Monogenea;Monopisthocotylea;Ancyrocephalidae;";"0.0";"0";"32";"31";"0";"31";"1";"430493";"5766"
"LOK1378_1mm";"SILVA (only NR);Eukaryota;Amorphea;Obazoa;Opisthokonta;Holozoa;Choanozoa;Metazoa;Animalia;BCP clade;Bilateria;Protostomia;Lophotrochozoa;Platyhelminthes;Monogenea;Monopisthocotylea;Capsalidae;";"0.0";"0";"5";"3";"0";"3";"2";"430521";"5766"
"LOK1378_1mm";"SILVA (only NR);Eukaryota;Amorphea;Obazoa;Opisthokonta;Holozoa;Choanozoa;Metazoa;Animalia;BCP clade;Bilateria;Protostomia;Lophotrochozoa;Platyhelminthes;Monogenea;Monopisthocotylea;Dactylogyridae;";"0.0";"0";"4";"4";"0";"4";"0";"430520";"5766"
"LOK1378_1mm";"SILVA (only NR);Eukaryota;Amorphea;Obazoa;Opisthokonta;Holozoa;Choanozoa;Metazoa;Animalia;BCP clade;Bilateria;Protostomia;Lophotrochozoa;Platyhelminthes;Monogenea;Monopisthocotylea;Diplectanidae;";"0.0";"0";"9";"9";"0";"9";"0";"430515";"5766"
"LOK1378_1mm";"SILVA (only NR);Eukaryota;Amorphea;Obazoa;Opisthokonta;Holozoa;Choanozoa;Metazoa;Animalia;BCP clade;Bilateria;Protostomia;Lophotrochozoa;Platyhelminthes;Monogenea;Monopisthocotylea;Gyrodactylidae;";"0.0";"0";"30";"30";"0";"30";"0";"430494";"5766"
"LOK1378_1mm";"SILVA (only NR);Eukaryota;Amorphea;Obazoa;Opisthokonta;Holozoa;Choanozoa;Metazoa;Animalia;BCP clade;Bilateria;Protostomia;Lophotrochozoa;Platyhelminthes;Monogenea;Monopisthocotylea;Monocotylidae;";"0.0";"0";"4";"4";"0";"4";"0";"430520";"5766"
"LOK1378_1mm";"SILVA (only NR);Eukaryota;Amorphea;Obazoa;Opisthokonta;Holozoa;Choanozoa;Metazoa;Animalia;BCP clade;Bilateria;Protostomia;Lophotrochozoa;Platyhelminthes;Monogenea;Monopisthocotylea;Ooegyrodactylidae;";"0.0";"0";"2";"2";"0";"2";"0";"430522";"5766"
"LOK1378_1mm";"SILVA (only NR);Eukaryota;Amorphea;Obazoa;Opisthokonta;Holozoa;Choanozoa;Metazoa;Animalia;BCP clade;Bilateria;Protostomia;Lophotrochozoa;Platyhelminthes;Monogenea;Monopisthocotylea;Pseudodactylogyridae;";"0.0";"0";"3";"3";"0";"3";"0";"430521";"5766"
"LOK1378_1mm";"SILVA (only NR);Eukaryota;Amorphea;Obazoa;Opisthokonta;Holozoa;Choanozoa;Metazoa;Animalia;BCP clade;Bilateria;Protostomia;Lophotrochozoa;Platyhelminthes;Monogenea;Monopisthocotylea;Udonellidae;";"0.0";"0";"4";"4";"0";"4";"0";"430520";"5766"
"LOK1378_1mm";"SILVA (only NR);Eukaryota;Amorphea;Obazoa;Opisthokonta;Holozoa;Choanozoa;Metazoa;Animalia;BCP clade;Bilateria;Protostomia;Lophotrochozoa;Platyhelminthes;Monogenea;Polyopisthocotylea;";"0.0";"0";"74";"73";"0";"73";"1";"430451";"5766"
"LOK1378_1mm";"SILVA (only NR);Eukaryota;Amorphea;Obazoa;Opisthokonta;Holozoa;Choanozoa;Metazoa;Animalia;BCP clade;Bilateria;Protostomia;Lophotrochozoa;Platyhelminthes;Monogenea;Polyopisthocotylea;Diclidophoridae;";"0.0";"0";"6";"6";"0";"6";"0";"430518";"5766"
"LOK1378_1mm";"SILVA (only NR);Eukaryota;Amorphea;Obazoa;Opisthokonta;Holozoa;Choanozoa;Metazoa;Animalia;BCP clade;Bilateria;Protostomia;Lophotrochozoa;Platyhelminthes;Monogenea;Polyopisthocotylea;Diclybothriidae;";"0.0";"0";"2";"2";"0";"2";"0";"430522";"5766"
"LOK1378_1mm";"SILVA (only NR);Eukaryota;Amorphea;Obazoa;Opisthokonta;Holozoa;Choanozoa;Metazoa;Animalia;BCP clade;Bilateria;Protostomia;Lophotrochozoa;Platyhelminthes;Monogenea;Polyopisthocotylea;Gotocotylidae;";"0.0";"0";"3";"3";"0";"3";"0";"430521";"5766"
"LOK1378_1mm";"SILVA (only NR);Eukaryota;Amorphea;Obazoa;Opisthokonta;Holozoa;Choanozoa;Metazoa;Animalia;BCP clade;Bilateria;Protostomia;Lophotrochozoa;Platyhelminthes;Monogenea;Polyopisthocotylea;Mazocraeidae;";"0.0";"0";"6";"6";"0";"6";"0";"430518";"5766"
"LOK1378_1mm";"SILVA (only NR);Eukaryota;Amorphea;Obazoa;Opisthokonta;Holozoa;Choanozoa;Metazoa;Animalia;BCP clade;Bilateria;Protostomia;Lophotrochozoa;Platyhelminthes;Monogenea;Polyopisthocotylea;Microcotylidae;";"0.0";"0";"5";"5";"0";"5";"0";"430519";"5766"
"LOK1378_1mm";"SILVA (only NR);Eukaryota;Amorphea;Obazoa;Opisthokonta;Holozoa;Choanozoa;Metazoa;Animalia;BCP clade;Bilateria;Protostomia;Lophotrochozoa;Platyhelminthes;Monogenea;Polyopisthocotylea;Neothoracocotylidae;";"0.0";"0";"2";"2";"0";"2";"0";"430522";"5766"
"LOK1378_1mm";"SILVA (only NR);Eukaryota;Amorphea;Obazoa;Opisthokonta;Holozoa;Choanozoa;Metazoa;Animalia;BCP clade;Bilateria;Protostomia;Lophotrochozoa;Platyhelminthes;Monogenea;Polyopisthocotylea;Polystomatidae;";"0.0";"0";"37";"37";"0";"37";"0";"430487";"5766"
"LOK1378_1mm";"SILVA (only NR);Eukaryota;Amorphea;Obazoa;Opisthokonta;Holozoa;Choanozoa;Metazoa;Animalia;BCP clade;Bilateria;Protostomia;Lophotrochozoa;Platyhelminthes;Rhabditophora;";"0.0";"0";"886";"858";"0";"858";"28";"429666";"5766"
"LOK1378_1mm";"SILVA (only NR);Eukaryota;Amorphea;Obazoa;Opisthokonta;Holozoa;Choanozoa;Metazoa;Animalia;BCP clade;Bilateria;Protostomia;Lophotrochozoa;Platyhelminthes;Rhabditophora;Haplopharyngida;";"0.0";"0";"3";"3";"0";"3";"0";"430521";"5766"
"LOK1378_1mm";"SILVA (only NR);Eukaryota;Amorphea;Obazoa;Opisthokonta;Holozoa;Choanozoa;Metazoa;Animalia;BCP clade;Bilateria;Protostomia;Lophotrochozoa;Platyhelminthes;Rhabditophora;Lecithoepitheliata;";"0.0";"0";"21";"21";"0";"21";"0";"430503";"5766"
"LOK1378_1mm";"SILVA (only NR);Eukaryota;Amorphea;Obazoa;Opisthokonta;Holozoa;Choanozoa;Metazoa;Animalia;BCP clade;Bilateria;Protostomia;Lophotrochozoa;Platyhelminthes;Rhabditophora;Macrostomida;";"0.0";"0";"198";"186";"0";"186";"12";"430338";"5766"
"LOK1378_1mm";"SILVA (only NR);Eukaryota;Amorphea;Obazoa;Opisthokonta;Holozoa;Choanozoa;Metazoa;Animalia;BCP clade;Bilateria;Protostomia;Lophotrochozoa;Platyhelminthes;Rhabditophora;Mediofusata;";"0.0";"0";"3";"3";"0";"3";"0";"430521";"5766"
"LOK1378_1mm";"SILVA (only NR);Eukaryota;Amorphea;Obazoa;Opisthokonta;Holozoa;Choanozoa;Metazoa;Animalia;BCP clade;Bilateria;Protostomia;Lophotrochozoa;Platyhelminthes;Rhabditophora;Mediofusata;Urastomidae;";"0.0";"0";"3";"3";"0";"3";"0";"430521";"5766"
"LOK1378_1mm";"SILVA (only NR);Eukaryota;Amorphea;Obazoa;Opisthokonta;Holozoa;Choanozoa;Metazoa;Animalia;BCP clade;Bilateria;Protostomia;Lophotrochozoa;Platyhelminthes;Rhabditophora;Polycladida;";"0.0";"0";"15";"14";"0";"14";"1";"430510";"5766"
"LOK1378_1mm";"SILVA (only NR);Eukaryota;Amorphea;Obazoa;Opisthokonta;Holozoa;Choanozoa;Metazoa;Animalia;BCP clade;Bilateria;Protostomia;Lophotrochozoa;Platyhelminthes;Rhabditophora;Prolecithophora;";"0.0";"0";"28";"28";"0";"28";"0";"430496";"5766"
"LOK1378_1mm";"SILVA (only NR);Eukaryota;Amorphea;Obazoa;Opisthokonta;Holozoa;Choanozoa;Metazoa;Animalia;BCP clade;Bilateria;Protostomia;Lophotrochozoa;Platyhelminthes;Rhabditophora;Rhabdocoela;";"0.0";"0";"287";"286";"0";"286";"1";"430238";"5766"
"LOK1378_1mm";"SILVA (only NR);Eukaryota;Amorphea;Obazoa;Opisthokonta;Holozoa;Choanozoa;Metazoa;Animalia;BCP clade;Bilateria;Protostomia;Lophotrochozoa;Platyhelminthes;Rhabditophora;Rhabdocoela;Dalyellioida;";"0.0";"0";"38";"38";"0";"38";"0";"430486";"5766"
"LOK1378_1mm";"SILVA (only NR);Eukaryota;Amorphea;Obazoa;Opisthokonta;Holozoa;Choanozoa;Metazoa;Animalia;BCP clade;Bilateria;Protostomia;Lophotrochozoa;Platyhelminthes;Rhabditophora;Rhabdocoela;Kalyptorhynchia;";"0.0";"0";"130";"129";"0";"129";"1";"430395";"5766"
"LOK1378_1mm";"SILVA (only NR);Eukaryota;Amorphea;Obazoa;Opisthokonta;Holozoa;Choanozoa;Metazoa;Animalia;BCP clade;Bilateria;Protostomia;Lophotrochozoa;Platyhelminthes;Rhabditophora;Rhabdocoela;Neodalyellida;";"0.0";"0";"114";"114";"0";"114";"0";"430410";"5766"
"LOK1378_1mm";"SILVA (only NR);Eukaryota;Amorphea;Obazoa;Opisthokonta;Holozoa;Choanozoa;Metazoa;Animalia;BCP clade;Bilateria;Protostomia;Lophotrochozoa;Platyhelminthes;Rhabditophora;Rhabdocoela;Typhloplanoida;";"0.0";"0";"5";"5";"0";"5";"0";"430519";"5766"
"LOK1378_1mm";"SILVA (only NR);Eukaryota;Amorphea;Obazoa;Opisthokonta;Holozoa;Choanozoa;Metazoa;Animalia;BCP clade;Bilateria;Protostomia;Lophotrochozoa;Platyhelminthes;Rhabditophora;Seriata;";"0.0";"0";"330";"316";"0";"316";"14";"430208";"5766"
"LOK1378_1mm";"SILVA (only NR);Eukaryota;Amorphea;Obazoa;Opisthokonta;Holozoa;Choanozoa;Metazoa;Animalia;BCP clade;Bilateria;Protostomia;Lophotrochozoa;Platyhelminthes;Rhabditophora;Seriata;Proseriata;";"0.0";"0";"99";"99";"0";"99";"0";"430425";"5766"
"LOK1378_1mm";"SILVA (only NR);Eukaryota;Amorphea;Obazoa;Opisthokonta;Holozoa;Choanozoa;Metazoa;Animalia;BCP clade;Bilateria;Protostomia;Lophotrochozoa;Platyhelminthes;Rhabditophora;Seriata;Tricladida;";"0.0";"0";"230";"216";"0";"216";"14";"430308";"5766"
"LOK1378_1mm";"SILVA (only NR);Eukaryota;Amorphea;Obazoa;Opisthokonta;Holozoa;Choanozoa;Metazoa;Animalia;BCP clade;Bilateria;Protostomia;Lophotrochozoa;Platyhelminthes;Rhabditophora;Seriata;Tricladida;Continenticola;";"0.0";"0";"213";"199";"0";"199";"14";"430325";"5766"
"LOK1378_1mm";"SILVA (only NR);Eukaryota;Amorphea;Obazoa;Opisthokonta;Holozoa;Choanozoa;Metazoa;Animalia;BCP clade;Bilateria;Protostomia;Lophotrochozoa;Platyhelminthes;Rhabditophora;Seriata;Tricladida;Maricola;";"0.0";"0";"15";"15";"0";"15";"0";"430509";"5766"
"LOK1378_1mm";"SILVA (only NR);Eukaryota;Amorphea;Obazoa;Opisthokonta;Holozoa;Choanozoa;Metazoa;Animalia;BCP clade;Bilateria;Protostomia;Lophotrochozoa;Platyhelminthes;Trematoda;";"0.0";"0";"360";"332";"0";"332";"28";"430192";"5766"
"LOK1378_1mm";"SILVA (only NR);Eukaryota;Amorphea;Obazoa;Opisthokonta;Holozoa;Choanozoa;Metazoa;Animalia;BCP clade;Bilateria;Protostomia;Lophotrochozoa;Platyhelminthes;Trematoda;Aspidogastrea;";"0.0";"0";"9";"9";"0";"9";"0";"430515";"5766"
"LOK1378_1mm";"SILVA (only NR);Eukaryota;Amorphea;Obazoa;Opisthokonta;Holozoa;Choanozoa;Metazoa;Animalia;BCP clade;Bilateria;Protostomia;Lophotrochozoa;Platyhelminthes;Trematoda;Aspidogastrea;Aspidogastridae;";"0.0";"0";"7";"7";"0";"7";"0";"430517";"5766"
"LOK1378_1mm";"SILVA (only NR);Eukaryota;Amorphea;Obazoa;Opisthokonta;Holozoa;Choanozoa;Metazoa;Animalia;BCP clade;Bilateria;Protostomia;Lophotrochozoa;Platyhelminthes;Trematoda;Digenea;";"0.0";"0";"351";"323";"0";"323";"28";"430201";"5766"
"LOK1378_1mm";"SILVA (only NR);Eukaryota;Amorphea;Obazoa;Opisthokonta;Holozoa;Choanozoa;Metazoa;Animalia;BCP clade;Bilateria;Protostomia;Lophotrochozoa;Platyhelminthes;Trematoda;Digenea;Azygiida;";"0.0";"0";"39";"36";"0";"36";"3";"430488";"5766"
"LOK1378_1mm";"SILVA (only NR);Eukaryota;Amorphea;Obazoa;Opisthokonta;Holozoa;Choanozoa;Metazoa;Animalia;BCP clade;Bilateria;Protostomia;Lophotrochozoa;Platyhelminthes;Trematoda;Digenea;Diplostomida;";"0.0";"0";"2";"2";"0";"2";"0";"430522";"5766"
"LOK1378_1mm";"SILVA (only NR);Eukaryota;Amorphea;Obazoa;Opisthokonta;Holozoa;Choanozoa;Metazoa;Animalia;BCP clade;Bilateria;Protostomia;Lophotrochozoa;Platyhelminthes;Trematoda;Digenea;Diplostomida;Brachylaimoidea;";"0.0";"0";"2";"2";"0";"2";"0";"430522";"5766"
"LOK1378_1mm";"SILVA (only NR);Eukaryota;Amorphea;Obazoa;Opisthokonta;Holozoa;Choanozoa;Metazoa;Animalia;BCP clade;Bilateria;Protostomia;Lophotrochozoa;Platyhelminthes;Trematoda;Digenea;Echinostomida;";"0.0";"0";"53";"50";"0";"50";"3";"430474";"5766"
"LOK1378_1mm";"SILVA (only NR);Eukaryota;Amorphea;Obazoa;Opisthokonta;Holozoa;Choanozoa;Metazoa;Animalia;BCP clade;Bilateria;Protostomia;Lophotrochozoa;Platyhelminthes;Trematoda;Digenea;Incertae Sedis;";"0.0";"0";"1";"1";"0";"1";"0";"430523";"5766"
"LOK1378_1mm";"SILVA (only NR);Eukaryota;Amorphea;Obazoa;Opisthokonta;Holozoa;Choanozoa;Metazoa;Animalia;BCP clade;Bilateria;Protostomia;Lophotrochozoa;Platyhelminthes;Trematoda;Digenea;Incertae Sedis;Prosorhynchoides;";"0.0";"0";"1";"1";"0";"1";"0";"430523";"5766"
"LOK1378_1mm";"SILVA (only NR);Eukaryota;Amorphea;Obazoa;Opisthokonta;Holozoa;Choanozoa;Metazoa;Animalia;BCP clade;Bilateria;Protostomia;Lophotrochozoa;Platyhelminthes;Trematoda;Digenea;Opisthorchiida;";"0.0";"0";"36";"35";"0";"35";"1";"430489";"5766"
"LOK1378_1mm";"SILVA (only NR);Eukaryota;Amorphea;Obazoa;Opisthokonta;Holozoa;Choanozoa;Metazoa;Animalia;BCP clade;Bilateria;Protostomia;Lophotrochozoa;Platyhelminthes;Trematoda;Digenea;Plagiorchiida;";"0.0";"0";"119";"115";"0";"115";"4";"430409";"5766"
"LOK1378_1mm";"SILVA (only NR);Eukaryota;Amorphea;Obazoa;Opisthokonta;Holozoa;Choanozoa;Metazoa;Animalia;BCP clade;Bilateria;Protostomia;Lophotrochozoa;Platyhelminthes;Trematoda;Digenea;Strigeidida;";"0.0";"0";"93";"78";"0";"78";"15";"430446";"5766"
"LOK1378_1mm";"SILVA (only NR);Eukaryota;Amorphea;Obazoa;Opisthokonta;Holozoa;Choanozoa;Metazoa;Animalia;BCP clade;Bilateria;Protostomia;Lophotrochozoa;Rotifera;";"0.0";"0";"122";"118";"0";"118";"4";"430406";"5766"
"LOK1378_1mm";"SILVA (only NR);Eukaryota;Amorphea;Obazoa;Opisthokonta;Holozoa;Choanozoa;Metazoa;Animalia;BCP clade;Bilateria;Protostomia;Lophotrochozoa;Rotifera;Bdelloidea;";"0.0";"0";"57";"54";"0";"54";"3";"430470";"5766"
"LOK1378_1mm";"SILVA (only NR);Eukaryota;Amorphea;Obazoa;Opisthokonta;Holozoa;Choanozoa;Metazoa;Animalia;BCP clade;Bilateria;Protostomia;Lophotrochozoa;Rotifera;Bdelloidea;Adinetida;";"0.0";"0";"28";"25";"0";"25";"3";"430499";"5766"
"LOK1378_1mm";"SILVA (only NR);Eukaryota;Amorphea;Obazoa;Opisthokonta;Holozoa;Choanozoa;Metazoa;Animalia;BCP clade;Bilateria;Protostomia;Lophotrochozoa;Rotifera;Bdelloidea;Philodinida;";"0.0";"0";"19";"19";"0";"19";"0";"430505";"5766"
"LOK1378_1mm";"SILVA (only NR);Eukaryota;Amorphea;Obazoa;Opisthokonta;Holozoa;Choanozoa;Metazoa;Animalia;BCP clade;Bilateria;Protostomia;Lophotrochozoa;Rotifera;Bdelloidea;Rotaria;";"0.0";"0";"9";"9";"0";"9";"0";"430515";"5766"
"LOK1378_1mm";"SILVA (only NR);Eukaryota;Amorphea;Obazoa;Opisthokonta;Holozoa;Choanozoa;Metazoa;Animalia;BCP clade;Bilateria;Protostomia;Lophotrochozoa;Rotifera;Monogononta;";"0.0";"0";"64";"63";"0";"63";"1";"430461";"5766"
"LOK1378_1mm";"SILVA (only NR);Eukaryota;Amorphea;Obazoa;Opisthokonta;Holozoa;Choanozoa;Metazoa;Animalia;BCP clade;Bilateria;Protostomia;Lophotrochozoa;Rotifera;Monogononta;Flosculariacea;";"0.0";"0";"16";"16";"0";"16";"0";"430508";"5766"
"LOK1378_1mm";"SILVA (only NR);Eukaryota;Amorphea;Obazoa;Opisthokonta;Holozoa;Choanozoa;Metazoa;Animalia;BCP clade;Bilateria;Protostomia;Lophotrochozoa;Rotifera;Monogononta;Ploimida;";"0.0";"0";"48";"47";"0";"47";"1";"430477";"5766"
"LOK1378_1mm";"SILVA (only NR);Eukaryota;Amorphea;Obazoa;Opisthokonta;Holozoa;Choanozoa;Metazoa;Animalia;BCP clade;Bilateria;Protostomia;Lophotrochozoa;Xenacoelomorpha;";"0.0";"0";"163";"160";"0";"160";"3";"430364";"5766"
"LOK1378_1mm";"SILVA (only NR);Eukaryota;Amorphea;Obazoa;Opisthokonta;Holozoa;Choanozoa;Metazoa;Animalia;BCP clade;Bilateria;Protostomia;Lophotrochozoa;Xenacoelomorpha;Acoelomorpha;";"0.0";"0";"163";"160";"0";"160";"3";"430364";"5766"
"LOK1378_1mm";"SILVA (only NR);Eukaryota;Amorphea;Obazoa;Opisthokonta;Holozoa;Choanozoa;Metazoa;Animalia;BCP clade;Bilateria;Protostomia;Lophotrochozoa;Xenacoelomorpha;Acoelomorpha;Acoela;";"0.0";"0";"135";"133";"0";"133";"2";"430391";"5766"
"LOK1378_1mm";"SILVA (only NR);Eukaryota;Amorphea;Obazoa;Opisthokonta;Holozoa;Choanozoa;Metazoa;Animalia;BCP clade;Bilateria;Protostomia;Lophotrochozoa;Xenacoelomorpha;Acoelomorpha;Nemertodermatida;";"0.0";"0";"28";"27";"0";"27";"1";"430497";"5766"
"LOK1378_1mm";"SILVA (only NR);Eukaryota;Amorphea;Obazoa;Opisthokonta;Holozoa;Choanozoa;Metazoa;Animalia;BCP clade;Bilateria;Protostomia;Lophotrochozoa;Xenacoelomorpha;Acoelomorpha;Nemertodermatida;Nemertodermatidae;";"0.0";"0";"28";"27";"0";"27";"1";"430497";"5766"
"LOK1378_1mm";"SILVA (only NR);Eukaryota;Amorphea;Obazoa;Opisthokonta;Holozoa;Choanozoa;Metazoa;Animalia;BCP clade;Bilateria;Protostomia;uncultured;";"0.0";"0";"12";"12";"0";"12";"0";"430512";"5766"
"LOK1378_1mm";"SILVA (only NR);Eukaryota;Amorphea;Obazoa;Opisthokonta;Holozoa;Choanozoa;Metazoa;Animalia;BCP clade;Cnidaria;";"0.0";"0";"1397";"1207";"0";"1207";"190";"429317";"5766"
"LOK1378_1mm";"SILVA (only NR);Eukaryota;Amorphea;Obazoa;Opisthokonta;Holozoa;Choanozoa;Metazoa;Animalia;BCP clade;Cnidaria;Anthozoa;";"0.0";"0";"313";"304";"0";"304";"9";"430220";"5766"
"LOK1378_1mm";"SILVA (only NR);Eukaryota;Amorphea;Obazoa;Opisthokonta;Holozoa;Choanozoa;Metazoa;Animalia;BCP clade;Cnidaria;Anthozoa;Hexacorallia;";"0.0";"0";"209";"204";"0";"204";"5";"430320";"5766"
"LOK1378_1mm";"SILVA (only NR);Eukaryota;Amorphea;Obazoa;Opisthokonta;Holozoa;Choanozoa;Metazoa;Animalia;BCP clade;Cnidaria;Anthozoa;Hexacorallia;Actiniaria;";"0.0";"0";"100";"96";"0";"96";"4";"430428";"5766"
"LOK1378_1mm";"SILVA (only NR);Eukaryota;Amorphea;Obazoa;Opisthokonta;Holozoa;Choanozoa;Metazoa;Animalia;BCP clade;Cnidaria;Anthozoa;Hexacorallia;Ceriantharia;";"0.0";"0";"6";"6";"0";"6";"0";"430518";"5766"
"LOK1378_1mm";"SILVA (only NR);Eukaryota;Amorphea;Obazoa;Opisthokonta;Holozoa;Choanozoa;Metazoa;Animalia;BCP clade;Cnidaria;Anthozoa;Hexacorallia;Corallimorpharia;";"0.0";"0";"9";"9";"0";"9";"0";"430515";"5766"
"LOK1378_1mm";"SILVA (only NR);Eukaryota;Amorphea;Obazoa;Opisthokonta;Holozoa;Choanozoa;Metazoa;Animalia;BCP clade;Cnidaria;Anthozoa;Hexacorallia;Scleractinia;";"0.0";"0";"61";"61";"0";"61";"0";"430463";"5766"
"LOK1378_1mm";"SILVA (only NR);Eukaryota;Amorphea;Obazoa;Opisthokonta;Holozoa;Choanozoa;Metazoa;Animalia;BCP clade;Cnidaria;Anthozoa;Hexacorallia;Zoantharia;";"0.0";"0";"7";"7";"0";"7";"0";"430517";"5766"
"LOK1378_1mm";"SILVA (only NR);Eukaryota;Amorphea;Obazoa;Opisthokonta;Holozoa;Choanozoa;Metazoa;Animalia;BCP clade;Cnidaria;Anthozoa;Octocorallia;";"0.0";"0";"104";"100";"0";"100";"4";"430424";"5766"
"LOK1378_1mm";"SILVA (only NR);Eukaryota;Amorphea;Obazoa;Opisthokonta;Holozoa;Choanozoa;Metazoa;Animalia;BCP clade;Cnidaria;Anthozoa;Octocorallia;Alcyonacea;";"0.0";"0";"88";"84";"0";"84";"4";"430440";"5766"
"LOK1378_1mm";"SILVA (only NR);Eukaryota;Amorphea;Obazoa;Opisthokonta;Holozoa;Choanozoa;Metazoa;Animalia;BCP clade;Cnidaria;Anthozoa;Octocorallia;Pennatulacea;";"0.0";"0";"8";"8";"0";"8";"0";"430516";"5766"
"LOK1378_1mm";"SILVA (only NR);Eukaryota;Amorphea;Obazoa;Opisthokonta;Holozoa;Choanozoa;Metazoa;Animalia;BCP clade;Cnidaria;Cubozoa;";"0.0";"0";"13";"13";"0";"13";"0";"430511";"5766"
"LOK1378_1mm";"SILVA (only NR);Eukaryota;Amorphea;Obazoa;Opisthokonta;Holozoa;Choanozoa;Metazoa;Animalia;BCP clade;Cnidaria;Cubozoa;Carybdeida;";"0.0";"0";"10";"10";"0";"10";"0";"430514";"5766"
"LOK1378_1mm";"SILVA (only NR);Eukaryota;Amorphea;Obazoa;Opisthokonta;Holozoa;Choanozoa;Metazoa;Animalia;BCP clade;Cnidaria;Cubozoa;Chirodropida;";"0.0";"0";"3";"3";"0";"3";"0";"430521";"5766"
"LOK1378_1mm";"SILVA (only NR);Eukaryota;Amorphea;Obazoa;Opisthokonta;Holozoa;Choanozoa;Metazoa;Animalia;BCP clade;Cnidaria;Hydrozoa;";"0.0";"0";"352";"346";"0";"346";"6";"430178";"5766"
"LOK1378_1mm";"SILVA (only NR);Eukaryota;Amorphea;Obazoa;Opisthokonta;Holozoa;Choanozoa;Metazoa;Animalia;BCP clade;Cnidaria;Hydrozoa;Hydroidolina;";"0.0";"0";"319";"314";"0";"314";"5";"430210";"5766"
"LOK1378_1mm";"SILVA (only NR);Eukaryota;Amorphea;Obazoa;Opisthokonta;Holozoa;Choanozoa;Metazoa;Animalia;BCP clade;Cnidaria;Hydrozoa;Hydroidolina;Anthoathecata;";"0.0";"0";"98";"94";"0";"94";"4";"430430";"5766"
"LOK1378_1mm";"SILVA (only NR);Eukaryota;Amorphea;Obazoa;Opisthokonta;Holozoa;Choanozoa;Metazoa;Animalia;BCP clade;Cnidaria;Hydrozoa;Hydroidolina;Leptothecata;";"0.0";"0";"158";"158";"0";"158";"0";"430366";"5766"
"LOK1378_1mm";"SILVA (only NR);Eukaryota;Amorphea;Obazoa;Opisthokonta;Holozoa;Choanozoa;Metazoa;Animalia;BCP clade;Cnidaria;Hydrozoa;Hydroidolina;Siphonophorae;";"0.0";"0";"58";"57";"0";"57";"1";"430467";"5766"
"LOK1378_1mm";"SILVA (only NR);Eukaryota;Amorphea;Obazoa;Opisthokonta;Holozoa;Choanozoa;Metazoa;Animalia;BCP clade;Cnidaria;Hydrozoa;Trachylinae;";"0.0";"0";"32";"31";"0";"31";"1";"430493";"5766"
"LOK1378_1mm";"SILVA (only NR);Eukaryota;Amorphea;Obazoa;Opisthokonta;Holozoa;Choanozoa;Metazoa;Animalia;BCP clade;Cnidaria;Hydrozoa;Trachylinae;Limnomedusae;";"0.0";"0";"9";"9";"0";"9";"0";"430515";"5766"
"LOK1378_1mm";"SILVA (only NR);Eukaryota;Amorphea;Obazoa;Opisthokonta;Holozoa;Choanozoa;Metazoa;Animalia;BCP clade;Cnidaria;Hydrozoa;Trachylinae;Narcomedusae;";"0.0";"0";"9";"9";"0";"9";"0";"430515";"5766"
"LOK1378_1mm";"SILVA (only NR);Eukaryota;Amorphea;Obazoa;Opisthokonta;Holozoa;Choanozoa;Metazoa;Animalia;BCP clade;Cnidaria;Hydrozoa;Trachylinae;Trachymedusae;";"0.0";"0";"9";"9";"0";"9";"0";"430515";"5766"
"LOK1378_1mm";"SILVA (only NR);Eukaryota;Amorphea;Obazoa;Opisthokonta;Holozoa;Choanozoa;Metazoa;Animalia;BCP clade;Cnidaria;Myxozoa;";"0.0";"0";"673";"499";"0";"499";"174";"430025";"5766"
"LOK1378_1mm";"SILVA (only NR);Eukaryota;Amorphea;Obazoa;Opisthokonta;Holozoa;Choanozoa;Metazoa;Animalia;BCP clade;Cnidaria;Myxozoa;Malacosporea;";"0.0";"0";"20";"14";"0";"14";"6";"430510";"5766"
"LOK1378_1mm";"SILVA (only NR);Eukaryota;Amorphea;Obazoa;Opisthokonta;Holozoa;Choanozoa;Metazoa;Animalia;BCP clade;Cnidaria;Myxozoa;Malacosporea;Malacovalvulida;";"0.0";"0";"20";"14";"0";"14";"6";"430510";"5766"
"LOK1378_1mm";"SILVA (only NR);Eukaryota;Amorphea;Obazoa;Opisthokonta;Holozoa;Choanozoa;Metazoa;Animalia;BCP clade;Cnidaria;Myxozoa;Myxosporea;";"0.0";"0";"653";"485";"0";"485";"168";"430039";"5766"
"LOK1378_1mm";"SILVA (only NR);Eukaryota;Amorphea;Obazoa;Opisthokonta;Holozoa;Choanozoa;Metazoa;Animalia;BCP clade;Cnidaria;Myxozoa;Myxosporea;Bivalvulida;";"0.0";"0";"587";"426";"0";"426";"161";"430098";"5766"
"LOK1378_1mm";"SILVA (only NR);Eukaryota;Amorphea;Obazoa;Opisthokonta;Holozoa;Choanozoa;Metazoa;Animalia;BCP clade;Cnidaria;Myxozoa;Myxosporea;Multivalvulida;";"0.0";"0";"65";"59";"0";"59";"6";"430465";"5766"
"LOK1378_1mm";"SILVA (only NR);Eukaryota;Amorphea;Obazoa;Opisthokonta;Holozoa;Choanozoa;Metazoa;Animalia;BCP clade;Cnidaria;Scyphozoa;";"0.0";"0";"46";"45";"0";"45";"1";"430479";"5766"
"LOK1378_1mm";"SILVA (only NR);Eukaryota;Amorphea;Obazoa;Opisthokonta;Holozoa;Choanozoa;Metazoa;Animalia;BCP clade;Cnidaria;Scyphozoa;Coronatae;";"0.0";"0";"2";"2";"0";"2";"0";"430522";"5766"
"LOK1378_1mm";"SILVA (only NR);Eukaryota;Amorphea;Obazoa;Opisthokonta;Holozoa;Choanozoa;Metazoa;Animalia;BCP clade;Cnidaria;Scyphozoa;Rhizostomeae;";"0.0";"0";"12";"12";"0";"12";"0";"430512";"5766"
"LOK1378_1mm";"SILVA (only NR);Eukaryota;Amorphea;Obazoa;Opisthokonta;Holozoa;Choanozoa;Metazoa;Animalia;BCP clade;Cnidaria;Scyphozoa;Semaeostomeae;";"0.0";"0";"19";"18";"0";"18";"1";"430506";"5766"
"LOK1378_1mm";"SILVA (only NR);Eukaryota;Amorphea;Obazoa;Opisthokonta;Holozoa;Choanozoa;Metazoa;Animalia;BCP clade;Cnidaria;Scyphozoa;Stauromedusae;";"0.0";"0";"10";"10";"0";"10";"0";"430514";"5766"
"LOK1378_1mm";"SILVA (only NR);Eukaryota;Amorphea;Obazoa;Opisthokonta;Holozoa;Choanozoa;Metazoa;Animalia;BCP clade;Ctenophora;";"0.0";"0";"27";"27";"0";"27";"0";"430497";"5766"
"LOK1378_1mm";"SILVA (only NR);Eukaryota;Amorphea;Obazoa;Opisthokonta;Holozoa;Choanozoa;Metazoa;Animalia;BCP clade;Ctenophora;Nuda;";"0.0";"0";"2";"2";"0";"2";"0";"430522";"5766"
"LOK1378_1mm";"SILVA (only NR);Eukaryota;Amorphea;Obazoa;Opisthokonta;Holozoa;Choanozoa;Metazoa;Animalia;BCP clade;Ctenophora;Nuda;Beroida;";"0.0";"0";"2";"2";"0";"2";"0";"430522";"5766"
"LOK1378_1mm";"SILVA (only NR);Eukaryota;Amorphea;Obazoa;Opisthokonta;Holozoa;Choanozoa;Metazoa;Animalia;BCP clade;Ctenophora;Tentaculata;";"0.0";"0";"18";"18";"0";"18";"0";"430506";"5766"
"LOK1378_1mm";"SILVA (only NR);Eukaryota;Amorphea;Obazoa;Opisthokonta;Holozoa;Choanozoa;Metazoa;Animalia;BCP clade;Ctenophora;Tentaculata;Cydippida;";"0.0";"0";"12";"12";"0";"12";"0";"430512";"5766"
"LOK1378_1mm";"SILVA (only NR);Eukaryota;Amorphea;Obazoa;Opisthokonta;Holozoa;Choanozoa;Metazoa;Animalia;BCP clade;Ctenophora;Tentaculata;Lobata;";"0.0";"0";"2";"2";"0";"2";"0";"430522";"5766"
"LOK1378_1mm";"SILVA (only NR);Eukaryota;Amorphea;Obazoa;Opisthokonta;Holozoa;Choanozoa;Metazoa;Animalia;BCP clade;Ctenophora;Tentaculata;Platyctenida;";"0.0";"0";"2";"2";"0";"2";"0";"430522";"5766"
"LOK1378_1mm";"SILVA (only NR);Eukaryota;Amorphea;Obazoa;Opisthokonta;Holozoa;Choanozoa;Metazoa;Animalia;BCP clade;Mesozoa;";"0.0";"0";"26";"17";"0";"17";"9";"430507";"5766"
"LOK1378_1mm";"SILVA (only NR);Eukaryota;Amorphea;Obazoa;Opisthokonta;Holozoa;Choanozoa;Metazoa;Animalia;BCP clade;Mesozoa;Orthonectida;";"0.0";"0";"3";"2";"0";"2";"1";"430522";"5766"
"LOK1378_1mm";"SILVA (only NR);Eukaryota;Amorphea;Obazoa;Opisthokonta;Holozoa;Choanozoa;Metazoa;Animalia;BCP clade;Mesozoa;Orthonectida;Rhopaluridae;";"0.0";"0";"3";"2";"0";"2";"1";"430522";"5766"
"LOK1378_1mm";"SILVA (only NR);Eukaryota;Amorphea;Obazoa;Opisthokonta;Holozoa;Choanozoa;Metazoa;Animalia;BCP clade;Mesozoa;Rhombozoa;";"0.0";"0";"20";"12";"0";"12";"8";"430512";"5766"
"LOK1378_1mm";"SILVA (only NR);Eukaryota;Amorphea;Obazoa;Opisthokonta;Holozoa;Choanozoa;Metazoa;Animalia;BCP clade;Mesozoa;Rhombozoa;Dicyemida;";"0.0";"0";"20";"12";"0";"12";"8";"430512";"5766"
"LOK1378_1mm";"SILVA (only NR);Eukaryota;Amorphea;Obazoa;Opisthokonta;Holozoa;Choanozoa;Metazoa;Animalia;BCP clade;Mesozoa;Rhombozoa;Dicyemida;Dicyema;";"0.0";"0";"8";"5";"0";"5";"3";"430519";"5766"
"LOK1378_1mm";"SILVA (only NR);Eukaryota;Amorphea;Obazoa;Opisthokonta;Holozoa;Choanozoa;Metazoa;Animalia;BCP clade;Mesozoa;Rhombozoa;Dicyemida;Dicyemennea;";"0.0";"0";"5";"3";"0";"3";"2";"430521";"5766"
"LOK1378_1mm";"SILVA (only NR);Eukaryota;Amorphea;Obazoa;Opisthokonta;Holozoa;Choanozoa;Metazoa;Animalia;BCP clade;Placozoa;";"0.0";"0";"4";"4";"0";"4";"0";"430520";"5766"
"LOK1378_1mm";"SILVA (only NR);Eukaryota;Amorphea;Obazoa;Opisthokonta;Holozoa;Choanozoa;Metazoa;Animalia;BCP clade;Placozoa;Trichoplax;";"0.0";"0";"4";"4";"0";"4";"0";"430520";"5766"
"LOK1378_1mm";"SILVA (only NR);Eukaryota;Amorphea;Obazoa;Opisthokonta;Holozoa;Choanozoa;Metazoa;Porifera;";"0.0";"0";"396";"386";"0";"386";"10";"430138";"5766"
"LOK1378_1mm";"SILVA (only NR);Eukaryota;Amorphea;Obazoa;Opisthokonta;Holozoa;Choanozoa;Metazoa;Porifera;Calcarea;";"0.0";"0";"34";"33";"0";"33";"1";"430491";"5766"
"LOK1378_1mm";"SILVA (only NR);Eukaryota;Amorphea;Obazoa;Opisthokonta;Holozoa;Choanozoa;Metazoa;Porifera;Calcarea;Calcaronea;";"0.0";"0";"14";"14";"0";"14";"0";"430510";"5766"
"LOK1378_1mm";"SILVA (only NR);Eukaryota;Amorphea;Obazoa;Opisthokonta;Holozoa;Choanozoa;Metazoa;Porifera;Calcarea;Calcaronea;Leucosolenida;";"0.0";"0";"9";"9";"0";"9";"0";"430515";"5766"
"LOK1378_1mm";"SILVA (only NR);Eukaryota;Amorphea;Obazoa;Opisthokonta;Holozoa;Choanozoa;Metazoa;Porifera;Calcarea;Calcinea;";"0.0";"0";"20";"19";"0";"19";"1";"430505";"5766"
"LOK1378_1mm";"SILVA (only NR);Eukaryota;Amorphea;Obazoa;Opisthokonta;Holozoa;Choanozoa;Metazoa;Porifera;Calcarea;Calcinea;Clathrinida;";"0.0";"0";"18";"17";"0";"17";"1";"430507";"5766"
"LOK1378_1mm";"SILVA (only NR);Eukaryota;Amorphea;Obazoa;Opisthokonta;Holozoa;Choanozoa;Metazoa;Porifera;Calcarea;Calcinea;Murrayonida;";"0.0";"0";"2";"2";"0";"2";"0";"430522";"5766"
"LOK1378_1mm";"SILVA (only NR);Eukaryota;Amorphea;Obazoa;Opisthokonta;Holozoa;Choanozoa;Metazoa;Porifera;DemHex clade;";"0.0";"0";"26";"25";"0";"25";"1";"430499";"5766"
"LOK1378_1mm";"SILVA (only NR);Eukaryota;Amorphea;Obazoa;Opisthokonta;Holozoa;Choanozoa;Metazoa;Porifera;DemHex clade;Hexactinellida;";"0.0";"0";"26";"25";"0";"25";"1";"430499";"5766"
"LOK1378_1mm";"SILVA (only NR);Eukaryota;Amorphea;Obazoa;Opisthokonta;Holozoa;Choanozoa;Metazoa;Porifera;DemHex clade;Hexactinellida;Amphidiscophora;";"0.0";"0";"3";"3";"0";"3";"0";"430521";"5766"
"LOK1378_1mm";"SILVA (only NR);Eukaryota;Amorphea;Obazoa;Opisthokonta;Holozoa;Choanozoa;Metazoa;Porifera;DemHex clade;Hexactinellida;Amphidiscophora;Amphidiscosida;";"0.0";"0";"3";"3";"0";"3";"0";"430521";"5766"
"LOK1378_1mm";"SILVA (only NR);Eukaryota;Amorphea;Obazoa;Opisthokonta;Holozoa;Choanozoa;Metazoa;Porifera;DemHex clade;Hexactinellida;Hexasterophora;";"0.0";"0";"23";"22";"0";"22";"1";"430502";"5766"
"LOK1378_1mm";"SILVA (only NR);Eukaryota;Amorphea;Obazoa;Opisthokonta;Holozoa;Choanozoa;Metazoa;Porifera;DemHex clade;Hexactinellida;Hexasterophora;Hexactinosida;";"0.0";"0";"14";"13";"0";"13";"1";"430511";"5766"
"LOK1378_1mm";"SILVA (only NR);Eukaryota;Amorphea;Obazoa;Opisthokonta;Holozoa;Choanozoa;Metazoa;Porifera;DemHex clade;Hexactinellida;Hexasterophora;Lyssacinosida;";"0.0";"0";"9";"9";"0";"9";"0";"430515";"5766"
"LOK1378_1mm";"SILVA (only NR);Eukaryota;Amorphea;Obazoa;Opisthokonta;Holozoa;Choanozoa;Metazoa;Porifera;Demospongiae;";"0.0";"0";"315";"308";"0";"308";"7";"430216";"5766"
"LOK1378_1mm";"SILVA (only NR);Eukaryota;Amorphea;Obazoa;Opisthokonta;Holozoa;Choanozoa;Metazoa;Porifera;Demospongiae;Axinellida;";"0.0";"0";"15";"14";"0";"14";"1";"430510";"5766"
"LOK1378_1mm";"SILVA (only NR);Eukaryota;Amorphea;Obazoa;Opisthokonta;Holozoa;Choanozoa;Metazoa;Porifera;Demospongiae;Biemnida;";"0.0";"0";"3";"3";"0";"3";"0";"430521";"5766"
"LOK1378_1mm";"SILVA (only NR);Eukaryota;Amorphea;Obazoa;Opisthokonta;Holozoa;Choanozoa;Metazoa;Porifera;Demospongiae;Bubarida;";"0.0";"0";"8";"8";"0";"8";"0";"430516";"5766"
"LOK1378_1mm";"SILVA (only NR);Eukaryota;Amorphea;Obazoa;Opisthokonta;Holozoa;Choanozoa;Metazoa;Porifera;Demospongiae;Clionaida;";"0.0";"0";"4";"4";"0";"4";"0";"430520";"5766"
"LOK1378_1mm";"SILVA (only NR);Eukaryota;Amorphea;Obazoa;Opisthokonta;Holozoa;Choanozoa;Metazoa;Porifera;Demospongiae;Dendroceratida;";"0.0";"0";"3";"3";"0";"3";"0";"430521";"5766"
"LOK1378_1mm";"SILVA (only NR);Eukaryota;Amorphea;Obazoa;Opisthokonta;Holozoa;Choanozoa;Metazoa;Porifera;Demospongiae;Dictyoceratida;";"0.0";"0";"27";"27";"0";"27";"0";"430497";"5766"
"LOK1378_1mm";"SILVA (only NR);Eukaryota;Amorphea;Obazoa;Opisthokonta;Holozoa;Choanozoa;Metazoa;Porifera;Demospongiae;Hadromerida;";"0.0";"0";"5";"5";"0";"5";"0";"430519";"5766"
"LOK1378_1mm";"SILVA (only NR);Eukaryota;Amorphea;Obazoa;Opisthokonta;Holozoa;Choanozoa;Metazoa;Porifera;Demospongiae;Halichondrida;";"0.0";"0";"3";"3";"0";"3";"0";"430521";"5766"
"LOK1378_1mm";"SILVA (only NR);Eukaryota;Amorphea;Obazoa;Opisthokonta;Holozoa;Choanozoa;Metazoa;Porifera;Demospongiae;Haplosclerida;";"0.0";"0";"69";"66";"0";"66";"3";"430458";"5766"
"LOK1378_1mm";"SILVA (only NR);Eukaryota;Amorphea;Obazoa;Opisthokonta;Holozoa;Choanozoa;Metazoa;Porifera;Demospongiae;Lithistida;";"0.0";"0";"2";"2";"0";"2";"0";"430522";"5766"
"LOK1378_1mm";"SILVA (only NR);Eukaryota;Amorphea;Obazoa;Opisthokonta;Holozoa;Choanozoa;Metazoa;Porifera;Demospongiae;Poecilosclerida;";"0.0";"0";"83";"82";"0";"82";"1";"430442";"5766"
"LOK1378_1mm";"SILVA (only NR);Eukaryota;Amorphea;Obazoa;Opisthokonta;Holozoa;Choanozoa;Metazoa;Porifera;Demospongiae;Polymastiida;";"0.0";"0";"4";"4";"0";"4";"0";"430520";"5766"
"LOK1378_1mm";"SILVA (only NR);Eukaryota;Amorphea;Obazoa;Opisthokonta;Holozoa;Choanozoa;Metazoa;Porifera;Demospongiae;Spongillida;";"0.0";"0";"5";"5";"0";"5";"0";"430519";"5766"
"LOK1378_1mm";"SILVA (only NR);Eukaryota;Amorphea;Obazoa;Opisthokonta;Holozoa;Choanozoa;Metazoa;Porifera;Demospongiae;Suberitida;";"0.0";"0";"19";"19";"0";"19";"0";"430505";"5766"
"LOK1378_1mm";"SILVA (only NR);Eukaryota;Amorphea;Obazoa;Opisthokonta;Holozoa;Choanozoa;Metazoa;Porifera;Demospongiae;Tetractinellida;";"0.0";"0";"23";"23";"0";"23";"0";"430501";"5766"
"LOK1378_1mm";"SILVA (only NR);Eukaryota;Amorphea;Obazoa;Opisthokonta;Holozoa;Choanozoa;Metazoa;Porifera;Demospongiae;Verongiida;";"0.0";"0";"12";"12";"0";"12";"0";"430512";"5766"
"LOK1378_1mm";"SILVA (only NR);Eukaryota;Amorphea;Obazoa;Opisthokonta;Holozoa;Choanozoa;Metazoa;Porifera;Homoscleromorpha;";"0.0";"0";"20";"19";"0";"19";"1";"430505";"5766"
"LOK1378_1mm";"SILVA (only NR);Eukaryota;Amorphea;Obazoa;Opisthokonta;Holozoa;Choanozoa;Metazoa;Porifera;Homoscleromorpha;Homosclerophorida;";"0.0";"0";"20";"19";"0";"19";"1";"430505";"5766"
"LOK1378_1mm";"SILVA (only NR);Eukaryota;Amorphea;Obazoa;Opisthokonta;Nucletmycea;";"0.0";"0";"9451";"8841";"0";"8841";"610";"421683";"5766"
"LOK1378_1mm";"SILVA (only NR);Eukaryota;Amorphea;Obazoa;Opisthokonta;Nucletmycea;Aphelidea;";"0.0";"0";"49";"48";"0";"48";"1";"430476";"5766"
"LOK1378_1mm";"SILVA (only NR);Eukaryota;Amorphea;Obazoa;Opisthokonta;Nucletmycea;Aphelidea;Aphelidium;";"0.0";"0";"9";"9";"0";"9";"0";"430515";"5766"
"LOK1378_1mm";"SILVA (only NR);Eukaryota;Amorphea;Obazoa;Opisthokonta;Nucletmycea;Aphelidea;Paraphelidium;";"0.0";"0";"11";"10";"0";"10";"1";"430514";"5766"
"LOK1378_1mm";"SILVA (only NR);Eukaryota;Amorphea;Obazoa;Opisthokonta;Nucletmycea;Aphelidea;uncultured;";"0.0";"0";"25";"25";"0";"25";"0";"430499";"5766"
"LOK1378_1mm";"SILVA (only NR);Eukaryota;Amorphea;Obazoa;Opisthokonta;Nucletmycea;Fungi;";"0.0";"0";"9373";"8766";"0";"8766";"607";"421758";"5766"
"LOK1378_1mm";"SILVA (only NR);Eukaryota;Amorphea;Obazoa;Opisthokonta;Nucletmycea;Fungi;Blastocladiomycota;";"0.0";"0";"33";"32";"0";"32";"1";"430492";"5766"
"LOK1378_1mm";"SILVA (only NR);Eukaryota;Amorphea;Obazoa;Opisthokonta;Nucletmycea;Fungi;Blastocladiomycota;Incertae Sedis;";"0.0";"0";"33";"32";"0";"32";"1";"430492";"5766"
"LOK1378_1mm";"SILVA (only NR);Eukaryota;Amorphea;Obazoa;Opisthokonta;Nucletmycea;Fungi;Blastocladiomycota;Incertae Sedis;Blastocladiomycetes;";"0.0";"0";"33";"32";"0";"32";"1";"430492";"5766"
"LOK1378_1mm";"SILVA (only NR);Eukaryota;Amorphea;Obazoa;Opisthokonta;Nucletmycea;Fungi;Blastocladiomycota;Incertae Sedis;Blastocladiomycetes;Blastocladiales;";"0.0";"0";"33";"32";"0";"32";"1";"430492";"5766"
"LOK1378_1mm";"SILVA (only NR);Eukaryota;Amorphea;Obazoa;Opisthokonta;Nucletmycea;Fungi;Blastocladiomycota;Incertae Sedis;Blastocladiomycetes;Blastocladiales;Blastocladiaceae;";"0.0";"0";"19";"18";"0";"18";"1";"430506";"5766"
"LOK1378_1mm";"SILVA (only NR);Eukaryota;Amorphea;Obazoa;Opisthokonta;Nucletmycea;Fungi;Blastocladiomycota;Incertae Sedis;Blastocladiomycetes;Blastocladiales;Blastocladiaceae;Allomyces;";"0.0";"0";"10";"9";"0";"9";"1";"430515";"5766"
"LOK1378_1mm";"SILVA (only NR);Eukaryota;Amorphea;Obazoa;Opisthokonta;Nucletmycea;Fungi;Blastocladiomycota;Incertae Sedis;Blastocladiomycetes;Blastocladiales;Blastocladiaceae;Blastocladia;";"0.0";"0";"4";"4";"0";"4";"0";"430520";"5766"
"LOK1378_1mm";"SILVA (only NR);Eukaryota;Amorphea;Obazoa;Opisthokonta;Nucletmycea;Fungi;Blastocladiomycota;Incertae Sedis;Blastocladiomycetes;Blastocladiales;Blastocladiaceae;Blastocladiella;";"0.0";"0";"4";"4";"0";"4";"0";"430520";"5766"
"LOK1378_1mm";"SILVA (only NR);Eukaryota;Amorphea;Obazoa;Opisthokonta;Nucletmycea;Fungi;Blastocladiomycota;Incertae Sedis;Blastocladiomycetes;Blastocladiales;Blastocladiaceae;Microallomyces;";"0.0";"0";"1";"1";"0";"1";"0";"430523";"5766"
"LOK1378_1mm";"SILVA (only NR);Eukaryota;Amorphea;Obazoa;Opisthokonta;Nucletmycea;Fungi;Blastocladiomycota;Incertae Sedis;Blastocladiomycetes;Blastocladiales;Catenaria;";"0.0";"0";"6";"6";"0";"6";"0";"430518";"5766"
"LOK1378_1mm";"SILVA (only NR);Eukaryota;Amorphea;Obazoa;Opisthokonta;Nucletmycea;Fungi;Blastocladiomycota;Incertae Sedis;Blastocladiomycetes;Blastocladiales;Coelomomyces;";"0.0";"0";"1";"1";"0";"1";"0";"430523";"5766"
"LOK1378_1mm";"SILVA (only NR);Eukaryota;Amorphea;Obazoa;Opisthokonta;Nucletmycea;Fungi;Blastocladiomycota;Incertae Sedis;Blastocladiomycetes;Blastocladiales;Physodermataceae;";"0.0";"0";"6";"6";"0";"6";"0";"430518";"5766"
"LOK1378_1mm";"SILVA (only NR);Eukaryota;Amorphea;Obazoa;Opisthokonta;Nucletmycea;Fungi;Blastocladiomycota;Incertae Sedis;Blastocladiomycetes;Blastocladiales;Physodermataceae;Paraphysoderma;";"0.0";"0";"1";"1";"0";"1";"0";"430523";"5766"
"LOK1378_1mm";"SILVA (only NR);Eukaryota;Amorphea;Obazoa;Opisthokonta;Nucletmycea;Fungi;Blastocladiomycota;Incertae Sedis;Blastocladiomycetes;Blastocladiales;Physodermataceae;Physoderma;";"0.0";"0";"3";"3";"0";"3";"0";"430521";"5766"
"LOK1378_1mm";"SILVA (only NR);Eukaryota;Amorphea;Obazoa;Opisthokonta;Nucletmycea;Fungi;Blastocladiomycota;Incertae Sedis;Blastocladiomycetes;Blastocladiales;Physodermataceae;Urophlyctis;";"0.0";"0";"1";"1";"0";"1";"0";"430523";"5766"
"LOK1378_1mm";"SILVA (only NR);Eukaryota;Amorphea;Obazoa;Opisthokonta;Nucletmycea;Fungi;Chytridiomycota;";"0.0";"0";"319";"301";"0";"301";"18";"430223";"5766"
"LOK1378_1mm";"SILVA (only NR);Eukaryota;Amorphea;Obazoa;Opisthokonta;Nucletmycea;Fungi;Chytridiomycota;Incertae Sedis;";"0.0";"0";"319";"301";"0";"301";"18";"430223";"5766"
"LOK1378_1mm";"SILVA (only NR);Eukaryota;Amorphea;Obazoa;Opisthokonta;Nucletmycea;Fungi;Chytridiomycota;Incertae Sedis;Chytridiomycetes;";"0.0";"0";"306";"288";"0";"288";"18";"430236";"5766"
"LOK1378_1mm";"SILVA (only NR);Eukaryota;Amorphea;Obazoa;Opisthokonta;Nucletmycea;Fungi;Chytridiomycota;Incertae Sedis;Chytridiomycetes;Chytridiales;";"0.0";"0";"30";"29";"0";"29";"1";"430495";"5766"
"LOK1378_1mm";"SILVA (only NR);Eukaryota;Amorphea;Obazoa;Opisthokonta;Nucletmycea;Fungi;Chytridiomycota;Incertae Sedis;Chytridiomycetes;Chytridiales;Chytridiaceae;";"0.0";"0";"10";"9";"0";"9";"1";"430515";"5766"
"LOK1378_1mm";"SILVA (only NR);Eukaryota;Amorphea;Obazoa;Opisthokonta;Nucletmycea;Fungi;Chytridiomycota;Incertae Sedis;Chytridiomycetes;Chytridiales;Chytridiaceae;Chytridium;";"0.0";"0";"1";"1";"0";"1";"0";"430523";"5766"
"LOK1378_1mm";"SILVA (only NR);Eukaryota;Amorphea;Obazoa;Opisthokonta;Nucletmycea;Fungi;Chytridiomycota;Incertae Sedis;Chytridiomycetes;Chytridiales;Chytridiaceae;Dendrochytridium;";"0.0";"0";"2";"2";"0";"2";"0";"430522";"5766"
"LOK1378_1mm";"SILVA (only NR);Eukaryota;Amorphea;Obazoa;Opisthokonta;Nucletmycea;Fungi;Chytridiomycota;Incertae Sedis;Chytridiomycetes;Chytridiales;Chytridiaceae;uncultured;";"0.0";"0";"7";"6";"0";"6";"1";"430518";"5766"
"LOK1378_1mm";"SILVA (only NR);Eukaryota;Amorphea;Obazoa;Opisthokonta;Nucletmycea;Fungi;Chytridiomycota;Incertae Sedis;Chytridiomycetes;Chytridiales;Chytriomycetaceae;";"0.0";"0";"12";"12";"0";"12";"0";"430512";"5766"
"LOK1378_1mm";"SILVA (only NR);Eukaryota;Amorphea;Obazoa;Opisthokonta;Nucletmycea;Fungi;Chytridiomycota;Incertae Sedis;Chytridiomycetes;Chytridiales;Chytriomycetaceae;Chytriomyces;";"0.0";"0";"2";"2";"0";"2";"0";"430522";"5766"
"LOK1378_1mm";"SILVA (only NR);Eukaryota;Amorphea;Obazoa;Opisthokonta;Nucletmycea;Fungi;Chytridiomycota;Incertae Sedis;Chytridiomycetes;Chytridiales;Chytriomycetaceae;Entophlyctis;";"0.0";"0";"1";"1";"0";"1";"0";"430523";"5766"
"LOK1378_1mm";"SILVA (only NR);Eukaryota;Amorphea;Obazoa;Opisthokonta;Nucletmycea;Fungi;Chytridiomycota;Incertae Sedis;Chytridiomycetes;Chytridiales;Chytriomycetaceae;Rhizoclosmatium;";"0.0";"0";"3";"3";"0";"3";"0";"430521";"5766"
"LOK1378_1mm";"SILVA (only NR);Eukaryota;Amorphea;Obazoa;Opisthokonta;Nucletmycea;Fungi;Chytridiomycota;Incertae Sedis;Chytridiomycetes;Chytridiales;Incertae Sedis;";"0.0";"0";"8";"8";"0";"8";"0";"430516";"5766"
"LOK1378_1mm";"SILVA (only NR);Eukaryota;Amorphea;Obazoa;Opisthokonta;Nucletmycea;Fungi;Chytridiomycota;Incertae Sedis;Chytridiomycetes;Chytridiales;Incertae Sedis;Pseudorhizidium;";"0.0";"0";"1";"1";"0";"1";"0";"430523";"5766"
"LOK1378_1mm";"SILVA (only NR);Eukaryota;Amorphea;Obazoa;Opisthokonta;Nucletmycea;Fungi;Chytridiomycota;Incertae Sedis;Chytridiomycetes;Chytridiales;Incertae Sedis;Zygorhizidium;";"0.0";"0";"2";"2";"0";"2";"0";"430522";"5766"
"LOK1378_1mm";"SILVA (only NR);Eukaryota;Amorphea;Obazoa;Opisthokonta;Nucletmycea;Fungi;Chytridiomycota;Incertae Sedis;Chytridiomycetes;Cladochytriales;";"0.0";"0";"10";"9";"0";"9";"1";"430515";"5766"
"LOK1378_1mm";"SILVA (only NR);Eukaryota;Amorphea;Obazoa;Opisthokonta;Nucletmycea;Fungi;Chytridiomycota;Incertae Sedis;Chytridiomycetes;Cladochytriales;Cladochytriaceae;";"0.0";"0";"3";"2";"0";"2";"1";"430522";"5766"
"LOK1378_1mm";"SILVA (only NR);Eukaryota;Amorphea;Obazoa;Opisthokonta;Nucletmycea;Fungi;Chytridiomycota;Incertae Sedis;Chytridiomycetes;Cladochytriales;Cladochytriaceae;Cladochytrium;";"0.0";"0";"3";"2";"0";"2";"1";"430522";"5766"
"LOK1378_1mm";"SILVA (only NR);Eukaryota;Amorphea;Obazoa;Opisthokonta;Nucletmycea;Fungi;Chytridiomycota;Incertae Sedis;Chytridiomycetes;Cladochytriales;Nowakowskiellaceae;";"0.0";"0";"7";"7";"0";"7";"0";"430517";"5766"
"LOK1378_1mm";"SILVA (only NR);Eukaryota;Amorphea;Obazoa;Opisthokonta;Nucletmycea;Fungi;Chytridiomycota;Incertae Sedis;Chytridiomycetes;Cladochytriales;Nowakowskiellaceae;Nowakowskiella;";"0.0";"0";"7";"7";"0";"7";"0";"430517";"5766"
"LOK1378_1mm";"SILVA (only NR);Eukaryota;Amorphea;Obazoa;Opisthokonta;Nucletmycea;Fungi;Chytridiomycota;Incertae Sedis;Chytridiomycetes;Gromochytriales;";"0.0";"0";"22";"22";"0";"22";"0";"430502";"5766"
"LOK1378_1mm";"SILVA (only NR);Eukaryota;Amorphea;Obazoa;Opisthokonta;Nucletmycea;Fungi;Chytridiomycota;Incertae Sedis;Chytridiomycetes;Gromochytriales;Gromochytriaceae;";"0.0";"0";"22";"22";"0";"22";"0";"430502";"5766"
"LOK1378_1mm";"SILVA (only NR);Eukaryota;Amorphea;Obazoa;Opisthokonta;Nucletmycea;Fungi;Chytridiomycota;Incertae Sedis;Chytridiomycetes;Gromochytriales;Gromochytriaceae;Gromochytrium;";"0.0";"0";"1";"1";"0";"1";"0";"430523";"5766"
"LOK1378_1mm";"SILVA (only NR);Eukaryota;Amorphea;Obazoa;Opisthokonta;Nucletmycea;Fungi;Chytridiomycota;Incertae Sedis;Chytridiomycetes;Gromochytriales;Gromochytriaceae;uncultured;";"0.0";"0";"19";"19";"0";"19";"0";"430505";"5766"
"LOK1378_1mm";"SILVA (only NR);Eukaryota;Amorphea;Obazoa;Opisthokonta;Nucletmycea;Fungi;Chytridiomycota;Incertae Sedis;Chytridiomycetes;Incertae Sedis;";"0.0";"0";"19";"18";"0";"18";"1";"430506";"5766"
"LOK1378_1mm";"SILVA (only NR);Eukaryota;Amorphea;Obazoa;Opisthokonta;Nucletmycea;Fungi;Chytridiomycota;Incertae Sedis;Chytridiomycetes;Incertae Sedis;Incertae Sedis;";"0.0";"0";"5";"5";"0";"5";"0";"430519";"5766"
"LOK1378_1mm";"SILVA (only NR);Eukaryota;Amorphea;Obazoa;Opisthokonta;Nucletmycea;Fungi;Chytridiomycota;Incertae Sedis;Chytridiomycetes;Incertae Sedis;Incertae Sedis;Blyttiomyces;";"0.0";"0";"1";"1";"0";"1";"0";"430523";"5766"
"LOK1378_1mm";"SILVA (only NR);Eukaryota;Amorphea;Obazoa;Opisthokonta;Nucletmycea;Fungi;Chytridiomycota;Incertae Sedis;Chytridiomycetes;Incertae Sedis;Incertae Sedis;Catenomyces;";"0.0";"0";"2";"2";"0";"2";"0";"430522";"5766"
"LOK1378_1mm";"SILVA (only NR);Eukaryota;Amorphea;Obazoa;Opisthokonta;Nucletmycea;Fungi;Chytridiomycota;Incertae Sedis;Chytridiomycetes;Incertae Sedis;Synchytriaceae;";"0.0";"0";"14";"13";"0";"13";"1";"430511";"5766"
"LOK1378_1mm";"SILVA (only NR);Eukaryota;Amorphea;Obazoa;Opisthokonta;Nucletmycea;Fungi;Chytridiomycota;Incertae Sedis;Chytridiomycetes;Incertae Sedis;Synchytriaceae;Synchytrium;";"0.0";"0";"14";"13";"0";"13";"1";"430511";"5766"
"LOK1378_1mm";"SILVA (only NR);Eukaryota;Amorphea;Obazoa;Opisthokonta;Nucletmycea;Fungi;Chytridiomycota;Incertae Sedis;Chytridiomycetes;Lobulomycetales;";"0.0";"0";"33";"33";"0";"33";"0";"430491";"5766"
"LOK1378_1mm";"SILVA (only NR);Eukaryota;Amorphea;Obazoa;Opisthokonta;Nucletmycea;Fungi;Chytridiomycota;Incertae Sedis;Chytridiomycetes;Lobulomycetales;Lobulomycetaceae;";"0.0";"0";"33";"33";"0";"33";"0";"430491";"5766"
"LOK1378_1mm";"SILVA (only NR);Eukaryota;Amorphea;Obazoa;Opisthokonta;Nucletmycea;Fungi;Chytridiomycota;Incertae Sedis;Chytridiomycetes;Lobulomycetales;Lobulomycetaceae;Clydaea;";"0.0";"0";"1";"1";"0";"1";"0";"430523";"5766"
"LOK1378_1mm";"SILVA (only NR);Eukaryota;Amorphea;Obazoa;Opisthokonta;Nucletmycea;Fungi;Chytridiomycota;Incertae Sedis;Chytridiomycetes;Lobulomycetales;Lobulomycetaceae;Lobulomyces;";"0.0";"0";"3";"3";"0";"3";"0";"430521";"5766"
"LOK1378_1mm";"SILVA (only NR);Eukaryota;Amorphea;Obazoa;Opisthokonta;Nucletmycea;Fungi;Chytridiomycota;Incertae Sedis;Chytridiomycetes;Lobulomycetales;Lobulomycetaceae;uncultured;";"0.0";"0";"24";"24";"0";"24";"0";"430500";"5766"
"LOK1378_1mm";"SILVA (only NR);Eukaryota;Amorphea;Obazoa;Opisthokonta;Nucletmycea;Fungi;Chytridiomycota;Incertae Sedis;Chytridiomycetes;Polychytriales;";"0.0";"0";"12";"12";"0";"12";"0";"430512";"5766"
"LOK1378_1mm";"SILVA (only NR);Eukaryota;Amorphea;Obazoa;Opisthokonta;Nucletmycea;Fungi;Chytridiomycota;Incertae Sedis;Chytridiomycetes;Polychytriales;Incertae Sedis;";"0.0";"0";"12";"12";"0";"12";"0";"430512";"5766"
"LOK1378_1mm";"SILVA (only NR);Eukaryota;Amorphea;Obazoa;Opisthokonta;Nucletmycea;Fungi;Chytridiomycota;Incertae Sedis;Chytridiomycetes;Polychytriales;Incertae Sedis;Arkaya;";"0.0";"0";"3";"3";"0";"3";"0";"430521";"5766"
"LOK1378_1mm";"SILVA (only NR);Eukaryota;Amorphea;Obazoa;Opisthokonta;Nucletmycea;Fungi;Chytridiomycota;Incertae Sedis;Chytridiomycetes;Polychytriales;Incertae Sedis;Karlingiomyces;";"0.0";"0";"2";"2";"0";"2";"0";"430522";"5766"
"LOK1378_1mm";"SILVA (only NR);Eukaryota;Amorphea;Obazoa;Opisthokonta;Nucletmycea;Fungi;Chytridiomycota;Incertae Sedis;Chytridiomycetes;Polychytriales;Incertae Sedis;Neokarlingia;";"0.0";"0";"1";"1";"0";"1";"0";"430523";"5766"
"LOK1378_1mm";"SILVA (only NR);Eukaryota;Amorphea;Obazoa;Opisthokonta;Nucletmycea;Fungi;Chytridiomycota;Incertae Sedis;Chytridiomycetes;Polychytriales;Incertae Sedis;Polychytrium;";"0.0";"0";"1";"1";"0";"1";"0";"430523";"5766"
"LOK1378_1mm";"SILVA (only NR);Eukaryota;Amorphea;Obazoa;Opisthokonta;Nucletmycea;Fungi;Chytridiomycota;Incertae Sedis;Chytridiomycetes;Polychytriales;Incertae Sedis;Polytrychium;";"0.0";"0";"2";"2";"0";"2";"0";"430522";"5766"
"LOK1378_1mm";"SILVA (only NR);Eukaryota;Amorphea;Obazoa;Opisthokonta;Nucletmycea;Fungi;Chytridiomycota;Incertae Sedis;Chytridiomycetes;Rhizophlyctidales;";"0.0";"0";"3";"3";"0";"3";"0";"430521";"5766"
"LOK1378_1mm";"SILVA (only NR);Eukaryota;Amorphea;Obazoa;Opisthokonta;Nucletmycea;Fungi;Chytridiomycota;Incertae Sedis;Chytridiomycetes;Rhizophlyctidales;Rhizophlyctidaceae;";"0.0";"0";"3";"3";"0";"3";"0";"430521";"5766"
"LOK1378_1mm";"SILVA (only NR);Eukaryota;Amorphea;Obazoa;Opisthokonta;Nucletmycea;Fungi;Chytridiomycota;Incertae Sedis;Chytridiomycetes;Rhizophlyctidales;Rhizophlyctidaceae;Rhizophlyctis;";"0.0";"0";"3";"3";"0";"3";"0";"430521";"5766"
"LOK1378_1mm";"SILVA (only NR);Eukaryota;Amorphea;Obazoa;Opisthokonta;Nucletmycea;Fungi;Chytridiomycota;Incertae Sedis;Chytridiomycetes;Rhizophydiales;";"0.0";"0";"95";"86";"0";"86";"9";"430438";"5766"
"LOK1378_1mm";"SILVA (only NR);Eukaryota;Amorphea;Obazoa;Opisthokonta;Nucletmycea;Fungi;Chytridiomycota;Incertae Sedis;Chytridiomycetes;Rhizophydiales;Boothiomyces;";"0.0";"0";"1";"1";"0";"1";"0";"430523";"5766"
"LOK1378_1mm";"SILVA (only NR);Eukaryota;Amorphea;Obazoa;Opisthokonta;Nucletmycea;Fungi;Chytridiomycota;Incertae Sedis;Chytridiomycetes;Rhizophydiales;Incertae Sedis;";"0.0";"0";"21";"19";"0";"19";"2";"430505";"5766"
"LOK1378_1mm";"SILVA (only NR);Eukaryota;Amorphea;Obazoa;Opisthokonta;Nucletmycea;Fungi;Chytridiomycota;Incertae Sedis;Chytridiomycetes;Rhizophydiales;Incertae Sedis;Batrachochytrium;";"0.0";"0";"20";"18";"0";"18";"2";"430506";"5766"
"LOK1378_1mm";"SILVA (only NR);Eukaryota;Amorphea;Obazoa;Opisthokonta;Nucletmycea;Fungi;Chytridiomycota;Incertae Sedis;Chytridiomycetes;Rhizophydiales;Kappamycetaceae;";"0.0";"0";"16";"13";"0";"13";"3";"430511";"5766"
"LOK1378_1mm";"SILVA (only NR);Eukaryota;Amorphea;Obazoa;Opisthokonta;Nucletmycea;Fungi;Chytridiomycota;Incertae Sedis;Chytridiomycetes;Rhizophydiales;Kappamycetaceae;Kappamyces;";"0.0";"0";"1";"1";"0";"1";"0";"430523";"5766"
"LOK1378_1mm";"SILVA (only NR);Eukaryota;Amorphea;Obazoa;Opisthokonta;Nucletmycea;Fungi;Chytridiomycota;Incertae Sedis;Chytridiomycetes;Rhizophydiales;Rhizophydiaceae;";"0.0";"0";"22";"22";"0";"22";"0";"430502";"5766"
"LOK1378_1mm";"SILVA (only NR);Eukaryota;Amorphea;Obazoa;Opisthokonta;Nucletmycea;Fungi;Chytridiomycota;Incertae Sedis;Chytridiomycetes;Rhizophydiales;Rhizophydiaceae;Rhizophydium;";"0.0";"0";"13";"13";"0";"13";"0";"430511";"5766"
"LOK1378_1mm";"SILVA (only NR);Eukaryota;Amorphea;Obazoa;Opisthokonta;Nucletmycea;Fungi;Chytridiomycota;Incertae Sedis;Chytridiomycetes;Rhizophydiales;uncultured;";"0.0";"0";"30";"26";"0";"26";"4";"430498";"5766"
"LOK1378_1mm";"SILVA (only NR);Eukaryota;Amorphea;Obazoa;Opisthokonta;Nucletmycea;Fungi;Chytridiomycota;Incertae Sedis;Chytridiomycetes;Spizellomycetales;";"0.0";"0";"41";"39";"0";"39";"2";"430485";"5766"
"LOK1378_1mm";"SILVA (only NR);Eukaryota;Amorphea;Obazoa;Opisthokonta;Nucletmycea;Fungi;Chytridiomycota;Incertae Sedis;Chytridiomycetes;Spizellomycetales;Olpidiaceae;";"0.0";"0";"6";"5";"0";"5";"1";"430519";"5766"
"LOK1378_1mm";"SILVA (only NR);Eukaryota;Amorphea;Obazoa;Opisthokonta;Nucletmycea;Fungi;Chytridiomycota;Incertae Sedis;Chytridiomycetes;Spizellomycetales;Olpidiaceae;Olpidium;";"0.0";"0";"6";"5";"0";"5";"1";"430519";"5766"
"LOK1378_1mm";"SILVA (only NR);Eukaryota;Amorphea;Obazoa;Opisthokonta;Nucletmycea;Fungi;Chytridiomycota;Incertae Sedis;Chytridiomycetes;Spizellomycetales;Powellomycetaceae;";"0.0";"0";"24";"24";"0";"24";"0";"430500";"5766"
"LOK1378_1mm";"SILVA (only NR);Eukaryota;Amorphea;Obazoa;Opisthokonta;Nucletmycea;Fungi;Chytridiomycota;Incertae Sedis;Chytridiomycetes;Spizellomycetales;Powellomycetaceae;Geranomyces;";"0.0";"0";"17";"17";"0";"17";"0";"430507";"5766"
"LOK1378_1mm";"SILVA (only NR);Eukaryota;Amorphea;Obazoa;Opisthokonta;Nucletmycea;Fungi;Chytridiomycota;Incertae Sedis;Chytridiomycetes;Spizellomycetales;Spizellomycetaceae;";"0.0";"0";"7";"7";"0";"7";"0";"430517";"5766"
"LOK1378_1mm";"SILVA (only NR);Eukaryota;Amorphea;Obazoa;Opisthokonta;Nucletmycea;Fungi;Chytridiomycota;Incertae Sedis;Chytridiomycetes;Spizellomycetales;Spizellomycetaceae;Gaertneriomyces;";"0.0";"0";"1";"1";"0";"1";"0";"430523";"5766"
"LOK1378_1mm";"SILVA (only NR);Eukaryota;Amorphea;Obazoa;Opisthokonta;Nucletmycea;Fungi;Chytridiomycota;Incertae Sedis;Chytridiomycetes;Spizellomycetales;Spizellomycetaceae;Phlyctochytrium;";"0.0";"0";"2";"2";"0";"2";"0";"430522";"5766"
"LOK1378_1mm";"SILVA (only NR);Eukaryota;Amorphea;Obazoa;Opisthokonta;Nucletmycea;Fungi;Chytridiomycota;Incertae Sedis;Chytridiomycetes;Spizellomycetales;Spizellomycetaceae;Spizellomyces;";"0.0";"0";"3";"3";"0";"3";"0";"430521";"5766"
"LOK1378_1mm";"SILVA (only NR);Eukaryota;Amorphea;Obazoa;Opisthokonta;Nucletmycea;Fungi;Chytridiomycota;Incertae Sedis;Chytridiomycetes;Spizellomycetales;uncultured;";"0.0";"0";"4";"3";"0";"3";"1";"430521";"5766"
"LOK1378_1mm";"SILVA (only NR);Eukaryota;Amorphea;Obazoa;Opisthokonta;Nucletmycea;Fungi;Chytridiomycota;Incertae Sedis;Chytridiomycetes;uncultured;";"0.0";"0";"27";"23";"0";"23";"4";"430501";"5766"
"LOK1378_1mm";"SILVA (only NR);Eukaryota;Amorphea;Obazoa;Opisthokonta;Nucletmycea;Fungi;Chytridiomycota;Incertae Sedis;Monoblepharidomycetes;";"0.0";"0";"13";"13";"0";"13";"0";"430511";"5766"
"LOK1378_1mm";"SILVA (only NR);Eukaryota;Amorphea;Obazoa;Opisthokonta;Nucletmycea;Fungi;Chytridiomycota;Incertae Sedis;Monoblepharidomycetes;Monoblepharidales;";"0.0";"0";"13";"13";"0";"13";"0";"430511";"5766"
"LOK1378_1mm";"SILVA (only NR);Eukaryota;Amorphea;Obazoa;Opisthokonta;Nucletmycea;Fungi;Chytridiomycota;Incertae Sedis;Monoblepharidomycetes;Monoblepharidales;Gonapodyaceae;";"0.0";"0";"4";"4";"0";"4";"0";"430520";"5766"
"LOK1378_1mm";"SILVA (only NR);Eukaryota;Amorphea;Obazoa;Opisthokonta;Nucletmycea;Fungi;Chytridiomycota;Incertae Sedis;Monoblepharidomycetes;Monoblepharidales;Gonapodyaceae;Gonapodya;";"0.0";"0";"4";"4";"0";"4";"0";"430520";"5766"
"LOK1378_1mm";"SILVA (only NR);Eukaryota;Amorphea;Obazoa;Opisthokonta;Nucletmycea;Fungi;Chytridiomycota;Incertae Sedis;Monoblepharidomycetes;Monoblepharidales;Harpochytriaceae;";"0.0";"0";"2";"2";"0";"2";"0";"430522";"5766"
"LOK1378_1mm";"SILVA (only NR);Eukaryota;Amorphea;Obazoa;Opisthokonta;Nucletmycea;Fungi;Chytridiomycota;Incertae Sedis;Monoblepharidomycetes;Monoblepharidales;Harpochytriaceae;Harpochytrium;";"0.0";"0";"2";"2";"0";"2";"0";"430522";"5766"
"LOK1378_1mm";"SILVA (only NR);Eukaryota;Amorphea;Obazoa;Opisthokonta;Nucletmycea;Fungi;Chytridiomycota;Incertae Sedis;Monoblepharidomycetes;Monoblepharidales;Hyaloraphidium;";"0.0";"0";"1";"1";"0";"1";"0";"430523";"5766"
"LOK1378_1mm";"SILVA (only NR);Eukaryota;Amorphea;Obazoa;Opisthokonta;Nucletmycea;Fungi;Chytridiomycota;Incertae Sedis;Monoblepharidomycetes;Monoblepharidales;Monoblepharidaceae;";"0.0";"0";"2";"2";"0";"2";"0";"430522";"5766"
"LOK1378_1mm";"SILVA (only NR);Eukaryota;Amorphea;Obazoa;Opisthokonta;Nucletmycea;Fungi;Chytridiomycota;Incertae Sedis;Monoblepharidomycetes;Monoblepharidales;Monoblepharidaceae;Monoblepharella;";"0.0";"0";"2";"2";"0";"2";"0";"430522";"5766"
"LOK1378_1mm";"SILVA (only NR);Eukaryota;Amorphea;Obazoa;Opisthokonta;Nucletmycea;Fungi;Cryptomycota;";"0.0";"0";"213";"191";"0";"191";"22";"430333";"5766"
"LOK1378_1mm";"SILVA (only NR);Eukaryota;Amorphea;Obazoa;Opisthokonta;Nucletmycea;Fungi;Cryptomycota;Incertae Sedis;";"0.0";"0";"49";"45";"0";"45";"4";"430479";"5766"
"LOK1378_1mm";"SILVA (only NR);Eukaryota;Amorphea;Obazoa;Opisthokonta;Nucletmycea;Fungi;Cryptomycota;Incertae Sedis;Incertae Sedis;";"0.0";"0";"49";"45";"0";"45";"4";"430479";"5766"
"LOK1378_1mm";"SILVA (only NR);Eukaryota;Amorphea;Obazoa;Opisthokonta;Nucletmycea;Fungi;Cryptomycota;Incertae Sedis;Incertae Sedis;Incertae Sedis;";"0.0";"0";"49";"45";"0";"45";"4";"430479";"5766"
"LOK1378_1mm";"SILVA (only NR);Eukaryota;Amorphea;Obazoa;Opisthokonta;Nucletmycea;Fungi;Cryptomycota;Incertae Sedis;Incertae Sedis;Incertae Sedis;Incertae Sedis;";"0.0";"0";"49";"45";"0";"45";"4";"430479";"5766"
"LOK1378_1mm";"SILVA (only NR);Eukaryota;Amorphea;Obazoa;Opisthokonta;Nucletmycea;Fungi;Cryptomycota;Incertae Sedis;Incertae Sedis;Incertae Sedis;Incertae Sedis;Nucleophaga;";"0.0";"0";"2";"2";"0";"2";"0";"430522";"5766"
"LOK1378_1mm";"SILVA (only NR);Eukaryota;Amorphea;Obazoa;Opisthokonta;Nucletmycea;Fungi;Cryptomycota;Incertae Sedis;Incertae Sedis;Incertae Sedis;Incertae Sedis;Paramicrosporidium;";"0.0";"0";"32";"31";"0";"31";"1";"430493";"5766"
"LOK1378_1mm";"SILVA (only NR);Eukaryota;Amorphea;Obazoa;Opisthokonta;Nucletmycea;Fungi;Cryptomycota;Incertae Sedis;Incertae Sedis;Incertae Sedis;Incertae Sedis;Rozella;";"0.0";"0";"15";"12";"0";"12";"3";"430512";"5766"
"LOK1378_1mm";"SILVA (only NR);Eukaryota;Amorphea;Obazoa;Opisthokonta;Nucletmycea;Fungi;Cryptomycota;LKM11;";"0.0";"0";"123";"111";"0";"111";"12";"430413";"5766"
"LOK1378_1mm";"SILVA (only NR);Eukaryota;Amorphea;Obazoa;Opisthokonta;Nucletmycea;Fungi;Cryptomycota;uncultured;";"0.0";"0";"39";"34";"0";"34";"5";"430490";"5766"
"LOK1378_1mm";"SILVA (only NR);Eukaryota;Amorphea;Obazoa;Opisthokonta;Nucletmycea;Fungi;Dikarya;";"0.0";"0";"7696";"7241";"0";"7241";"455";"423283";"5766"
"LOK1378_1mm";"SILVA (only NR);Eukaryota;Amorphea;Obazoa;Opisthokonta;Nucletmycea;Fungi;Dikarya;Ascomycota;";"0.0";"0";"5156";"4792";"0";"4792";"364";"425732";"5766"
"LOK1378_1mm";"SILVA (only NR);Eukaryota;Amorphea;Obazoa;Opisthokonta;Nucletmycea;Fungi;Dikarya;Ascomycota;Incertae Sedis;";"0.0";"0";"3";"3";"0";"3";"0";"430521";"5766"
"LOK1378_1mm";"SILVA (only NR);Eukaryota;Amorphea;Obazoa;Opisthokonta;Nucletmycea;Fungi;Dikarya;Ascomycota;Incertae Sedis;Incertae Sedis;";"0.0";"0";"3";"3";"0";"3";"0";"430521";"5766"
"LOK1378_1mm";"SILVA (only NR);Eukaryota;Amorphea;Obazoa;Opisthokonta;Nucletmycea;Fungi;Dikarya;Ascomycota;Incertae Sedis;Incertae Sedis;Incertae Sedis;";"0.0";"0";"3";"3";"0";"3";"0";"430521";"5766"
"LOK1378_1mm";"SILVA (only NR);Eukaryota;Amorphea;Obazoa;Opisthokonta;Nucletmycea;Fungi;Dikarya;Ascomycota;Incertae Sedis;Incertae Sedis;Incertae Sedis;Incertae Sedis;";"0.0";"0";"3";"3";"0";"3";"0";"430521";"5766"
"LOK1378_1mm";"SILVA (only NR);Eukaryota;Amorphea;Obazoa;Opisthokonta;Nucletmycea;Fungi;Dikarya;Ascomycota;Incertae Sedis;Incertae Sedis;Incertae Sedis;Incertae Sedis;Calcarisporiella;";"0.0";"0";"3";"3";"0";"3";"0";"430521";"5766"
"LOK1378_1mm";"SILVA (only NR);Eukaryota;Amorphea;Obazoa;Opisthokonta;Nucletmycea;Fungi;Dikarya;Ascomycota;Pezizomycotina;";"0.0";"0";"3667";"3332";"0";"3332";"335";"427192";"5766"
"LOK1378_1mm";"SILVA (only NR);Eukaryota;Amorphea;Obazoa;Opisthokonta;Nucletmycea;Fungi;Dikarya;Ascomycota;Pezizomycotina;Arthoniomycetes;";"0.0";"0";"13";"13";"0";"13";"0";"430511";"5766"
"LOK1378_1mm";"SILVA (only NR);Eukaryota;Amorphea;Obazoa;Opisthokonta;Nucletmycea;Fungi;Dikarya;Ascomycota;Pezizomycotina;Arthoniomycetes;Arthoniales;";"0.0";"0";"8";"8";"0";"8";"0";"430516";"5766"
"LOK1378_1mm";"SILVA (only NR);Eukaryota;Amorphea;Obazoa;Opisthokonta;Nucletmycea;Fungi;Dikarya;Ascomycota;Pezizomycotina;Arthoniomycetes;Arthoniales;Opegrapha;";"0.0";"0";"1";"1";"0";"1";"0";"430523";"5766"
"LOK1378_1mm";"SILVA (only NR);Eukaryota;Amorphea;Obazoa;Opisthokonta;Nucletmycea;Fungi;Dikarya;Ascomycota;Pezizomycotina;Arthoniomycetes;Arthoniales;Roccellaceae;";"0.0";"0";"4";"4";"0";"4";"0";"430520";"5766"
"LOK1378_1mm";"SILVA (only NR);Eukaryota;Amorphea;Obazoa;Opisthokonta;Nucletmycea;Fungi;Dikarya;Ascomycota;Pezizomycotina;Arthoniomycetes;Arthoniales;Roccellaceae;Combea;";"0.0";"0";"1";"1";"0";"1";"0";"430523";"5766"
"LOK1378_1mm";"SILVA (only NR);Eukaryota;Amorphea;Obazoa;Opisthokonta;Nucletmycea;Fungi;Dikarya;Ascomycota;Pezizomycotina;Arthoniomycetes;Arthoniales;Roccellaceae;Dendrographa;";"0.0";"0";"1";"1";"0";"1";"0";"430523";"5766"
"LOK1378_1mm";"SILVA (only NR);Eukaryota;Amorphea;Obazoa;Opisthokonta;Nucletmycea;Fungi;Dikarya;Ascomycota;Pezizomycotina;Arthoniomycetes;Arthoniales;Roccellaceae;Lecanactis;";"0.0";"0";"1";"1";"0";"1";"0";"430523";"5766"
"LOK1378_1mm";"SILVA (only NR);Eukaryota;Amorphea;Obazoa;Opisthokonta;Nucletmycea;Fungi;Dikarya;Ascomycota;Pezizomycotina;Arthoniomycetes;Arthoniales;Roccellaceae;Roccella;";"0.0";"0";"1";"1";"0";"1";"0";"430523";"5766"
"LOK1378_1mm";"SILVA (only NR);Eukaryota;Amorphea;Obazoa;Opisthokonta;Nucletmycea;Fungi;Dikarya;Ascomycota;Pezizomycotina;Arthoniomycetes;Arthoniales;Roccellographa;";"0.0";"0";"1";"1";"0";"1";"0";"430523";"5766"
"LOK1378_1mm";"SILVA (only NR);Eukaryota;Amorphea;Obazoa;Opisthokonta;Nucletmycea;Fungi;Dikarya;Ascomycota;Pezizomycotina;Arthoniomycetes;Arthoniales;Simonyella;";"0.0";"0";"1";"1";"0";"1";"0";"430523";"5766"
"LOK1378_1mm";"SILVA (only NR);Eukaryota;Amorphea;Obazoa;Opisthokonta;Nucletmycea;Fungi;Dikarya;Ascomycota;Pezizomycotina;Arthoniomycetes;uncultured;";"0.0";"0";"5";"5";"0";"5";"0";"430519";"5766"
"LOK1378_1mm";"SILVA (only NR);Eukaryota;Amorphea;Obazoa;Opisthokonta;Nucletmycea;Fungi;Dikarya;Ascomycota;Pezizomycotina;Dothideomycetes;";"0.0";"0";"1025";"965";"0";"965";"60";"429559";"5766"
"LOK1378_1mm";"SILVA (only NR);Eukaryota;Amorphea;Obazoa;Opisthokonta;Nucletmycea;Fungi;Dikarya;Ascomycota;Pezizomycotina;Dothideomycetes;Botryosphaeriales;";"0.0";"0";"21";"20";"0";"20";"1";"430504";"5766"
"LOK1378_1mm";"SILVA (only NR);Eukaryota;Amorphea;Obazoa;Opisthokonta;Nucletmycea;Fungi;Dikarya;Ascomycota;Pezizomycotina;Dothideomycetes;Botryosphaeriales;Bagnisiella;";"0.0";"0";"1";"1";"0";"1";"0";"430523";"5766"
"LOK1378_1mm";"SILVA (only NR);Eukaryota;Amorphea;Obazoa;Opisthokonta;Nucletmycea;Fungi;Dikarya;Ascomycota;Pezizomycotina;Dothideomycetes;Botryosphaeriales;Botryosphaeriaceae;";"0.0";"0";"6";"5";"0";"5";"1";"430519";"5766"
"LOK1378_1mm";"SILVA (only NR);Eukaryota;Amorphea;Obazoa;Opisthokonta;Nucletmycea;Fungi;Dikarya;Ascomycota;Pezizomycotina;Dothideomycetes;Botryosphaeriales;Botryosphaeriaceae;Botryosphaeria;";"0.0";"0";"1";"1";"0";"1";"0";"430523";"5766"
"LOK1378_1mm";"SILVA (only NR);Eukaryota;Amorphea;Obazoa;Opisthokonta;Nucletmycea;Fungi;Dikarya;Ascomycota;Pezizomycotina;Dothideomycetes;Botryosphaeriales;Botryosphaeriaceae;Diplodia;";"0.0";"0";"1";"1";"0";"1";"0";"430523";"5766"
"LOK1378_1mm";"SILVA (only NR);Eukaryota;Amorphea;Obazoa;Opisthokonta;Nucletmycea;Fungi;Dikarya;Ascomycota;Pezizomycotina;Dothideomycetes;Botryosphaeriales;Botryosphaeriaceae;Lasiodiplodia;";"0.0";"0";"1";"1";"0";"1";"0";"430523";"5766"
"LOK1378_1mm";"SILVA (only NR);Eukaryota;Amorphea;Obazoa;Opisthokonta;Nucletmycea;Fungi;Dikarya;Ascomycota;Pezizomycotina;Dothideomycetes;Botryosphaeriales;Botryosphaeriaceae;Macrophomina;";"0.0";"0";"1";"1";"0";"1";"0";"430523";"5766"
"LOK1378_1mm";"SILVA (only NR);Eukaryota;Amorphea;Obazoa;Opisthokonta;Nucletmycea;Fungi;Dikarya;Ascomycota;Pezizomycotina;Dothideomycetes;Botryosphaeriales;Botryosphaeriaceae;Neofusicoccum;";"0.0";"0";"1";"1";"0";"1";"0";"430523";"5766"
"LOK1378_1mm";"SILVA (only NR);Eukaryota;Amorphea;Obazoa;Opisthokonta;Nucletmycea;Fungi;Dikarya;Ascomycota;Pezizomycotina;Dothideomycetes;Botryosphaeriales;Botryosphaeriaceae;Neoscytalidium;";"0.0";"0";"1";"0";"0";"0";"1";"430524";"5766"
"LOK1378_1mm";"SILVA (only NR);Eukaryota;Amorphea;Obazoa;Opisthokonta;Nucletmycea;Fungi;Dikarya;Ascomycota;Pezizomycotina;Dothideomycetes;Botryosphaeriales;Phyllostictaceae;";"0.0";"0";"14";"14";"0";"14";"0";"430510";"5766"
"LOK1378_1mm";"SILVA (only NR);Eukaryota;Amorphea;Obazoa;Opisthokonta;Nucletmycea;Fungi;Dikarya;Ascomycota;Pezizomycotina;Dothideomycetes;Botryosphaeriales;Phyllostictaceae;Phyllosticta;";"0.0";"0";"14";"14";"0";"14";"0";"430510";"5766"
"LOK1378_1mm";"SILVA (only NR);Eukaryota;Amorphea;Obazoa;Opisthokonta;Nucletmycea;Fungi;Dikarya;Ascomycota;Pezizomycotina;Dothideomycetes;Capnodiales;";"0.0";"0";"351";"343";"0";"343";"8";"430181";"5766"
"LOK1378_1mm";"SILVA (only NR);Eukaryota;Amorphea;Obazoa;Opisthokonta;Nucletmycea;Fungi;Dikarya;Ascomycota;Pezizomycotina;Dothideomycetes;Capnodiales;Acrodontium;";"0.0";"0";"1";"1";"0";"1";"0";"430523";"5766"
"LOK1378_1mm";"SILVA (only NR);Eukaryota;Amorphea;Obazoa;Opisthokonta;Nucletmycea;Fungi;Dikarya;Ascomycota;Pezizomycotina;Dothideomycetes;Capnodiales;Capnodiaceae;";"0.0";"0";"5";"5";"0";"5";"0";"430519";"5766"
"LOK1378_1mm";"SILVA (only NR);Eukaryota;Amorphea;Obazoa;Opisthokonta;Nucletmycea;Fungi;Dikarya;Ascomycota;Pezizomycotina;Dothideomycetes;Capnodiales;Capnodiaceae;Conidiocarpus;";"0.0";"0";"1";"1";"0";"1";"0";"430523";"5766"
"LOK1378_1mm";"SILVA (only NR);Eukaryota;Amorphea;Obazoa;Opisthokonta;Nucletmycea;Fungi;Dikarya;Ascomycota;Pezizomycotina;Dothideomycetes;Capnodiales;Capnodiaceae;Leptoxyphium;";"0.0";"0";"2";"2";"0";"2";"0";"430522";"5766"
"LOK1378_1mm";"SILVA (only NR);Eukaryota;Amorphea;Obazoa;Opisthokonta;Nucletmycea;Fungi;Dikarya;Ascomycota;Pezizomycotina;Dothideomycetes;Capnodiales;Capnodiaceae;Scorias;";"0.0";"0";"2";"2";"0";"2";"0";"430522";"5766"
"LOK1378_1mm";"SILVA (only NR);Eukaryota;Amorphea;Obazoa;Opisthokonta;Nucletmycea;Fungi;Dikarya;Ascomycota;Pezizomycotina;Dothideomycetes;Capnodiales;Cladosporiaceae;";"0.0";"0";"91";"86";"0";"86";"5";"430438";"5766"
"LOK1378_1mm";"SILVA (only NR);Eukaryota;Amorphea;Obazoa;Opisthokonta;Nucletmycea;Fungi;Dikarya;Ascomycota;Pezizomycotina;Dothideomycetes;Capnodiales;Cladosporiaceae;Cladosporium;";"0.0";"0";"86";"81";"0";"81";"5";"430443";"5766"
"LOK1378_1mm";"SILVA (only NR);Eukaryota;Amorphea;Obazoa;Opisthokonta;Nucletmycea;Fungi;Dikarya;Ascomycota;Pezizomycotina;Dothideomycetes;Capnodiales;Cladosporiaceae;Rachicladosporium;";"0.0";"0";"2";"2";"0";"2";"0";"430522";"5766"
"LOK1378_1mm";"SILVA (only NR);Eukaryota;Amorphea;Obazoa;Opisthokonta;Nucletmycea;Fungi;Dikarya;Ascomycota;Pezizomycotina;Dothideomycetes;Capnodiales;Cladosporiaceae;Toxicocladosporium;";"0.0";"0";"3";"3";"0";"3";"0";"430521";"5766"
"LOK1378_1mm";"SILVA (only NR);Eukaryota;Amorphea;Obazoa;Opisthokonta;Nucletmycea;Fungi;Dikarya;Ascomycota;Pezizomycotina;Dothideomycetes;Capnodiales;Dissoconiaceae;";"0.0";"0";"8";"8";"0";"8";"0";"430516";"5766"
"LOK1378_1mm";"SILVA (only NR);Eukaryota;Amorphea;Obazoa;Opisthokonta;Nucletmycea;Fungi;Dikarya;Ascomycota;Pezizomycotina;Dothideomycetes;Capnodiales;Dissoconiaceae;Dissoconium;";"0.0";"0";"3";"3";"0";"3";"0";"430521";"5766"
"LOK1378_1mm";"SILVA (only NR);Eukaryota;Amorphea;Obazoa;Opisthokonta;Nucletmycea;Fungi;Dikarya;Ascomycota;Pezizomycotina;Dothideomycetes;Capnodiales;Dissoconiaceae;Ramichloridium;";"0.0";"0";"1";"1";"0";"1";"0";"430523";"5766"
"LOK1378_1mm";"SILVA (only NR);Eukaryota;Amorphea;Obazoa;Opisthokonta;Nucletmycea;Fungi;Dikarya;Ascomycota;Pezizomycotina;Dothideomycetes;Capnodiales;Dissoconiaceae;Uwebraunia;";"0.0";"0";"3";"3";"0";"3";"0";"430521";"5766"
"LOK1378_1mm";"SILVA (only NR);Eukaryota;Amorphea;Obazoa;Opisthokonta;Nucletmycea;Fungi;Dikarya;Ascomycota;Pezizomycotina;Dothideomycetes;Capnodiales;Extremaceae;";"0.0";"0";"9";"9";"0";"9";"0";"430515";"5766"
"LOK1378_1mm";"SILVA (only NR);Eukaryota;Amorphea;Obazoa;Opisthokonta;Nucletmycea;Fungi;Dikarya;Ascomycota;Pezizomycotina;Dothideomycetes;Capnodiales;Extremaceae;Vermiconia;";"0.0";"0";"3";"3";"0";"3";"0";"430521";"5766"
"LOK1378_1mm";"SILVA (only NR);Eukaryota;Amorphea;Obazoa;Opisthokonta;Nucletmycea;Fungi;Dikarya;Ascomycota;Pezizomycotina;Dothideomycetes;Capnodiales;Incertae Sedis;";"0.0";"0";"4";"4";"0";"4";"0";"430520";"5766"
"LOK1378_1mm";"SILVA (only NR);Eukaryota;Amorphea;Obazoa;Opisthokonta;Nucletmycea;Fungi;Dikarya;Ascomycota;Pezizomycotina;Dothideomycetes;Capnodiales;Incertae Sedis;Peltaster;";"0.0";"0";"4";"4";"0";"4";"0";"430520";"5766"
"LOK1378_1mm";"SILVA (only NR);Eukaryota;Amorphea;Obazoa;Opisthokonta;Nucletmycea;Fungi;Dikarya;Ascomycota;Pezizomycotina;Dothideomycetes;Capnodiales;Microcyclospora;";"0.0";"0";"1";"1";"0";"1";"0";"430523";"5766"
"LOK1378_1mm";"SILVA (only NR);Eukaryota;Amorphea;Obazoa;Opisthokonta;Nucletmycea;Fungi;Dikarya;Ascomycota;Pezizomycotina;Dothideomycetes;Capnodiales;Mucomycosphaerella;";"0.0";"0";"1";"0";"0";"0";"1";"430524";"5766"
"LOK1378_1mm";"SILVA (only NR);Eukaryota;Amorphea;Obazoa;Opisthokonta;Nucletmycea;Fungi;Dikarya;Ascomycota;Pezizomycotina;Dothideomycetes;Capnodiales;Mycosphaerellaceae;";"0.0";"0";"122";"121";"0";"121";"1";"430403";"5766"
"LOK1378_1mm";"SILVA (only NR);Eukaryota;Amorphea;Obazoa;Opisthokonta;Nucletmycea;Fungi;Dikarya;Ascomycota;Pezizomycotina;Dothideomycetes;Capnodiales;Mycosphaerellaceae;Cercospora;";"0.0";"0";"1";"1";"0";"1";"0";"430523";"5766"
"LOK1378_1mm";"SILVA (only NR);Eukaryota;Amorphea;Obazoa;Opisthokonta;Nucletmycea;Fungi;Dikarya;Ascomycota;Pezizomycotina;Dothideomycetes;Capnodiales;Mycosphaerellaceae;Cercosporella;";"0.0";"0";"1";"1";"0";"1";"0";"430523";"5766"
"LOK1378_1mm";"SILVA (only NR);Eukaryota;Amorphea;Obazoa;Opisthokonta;Nucletmycea;Fungi;Dikarya;Ascomycota;Pezizomycotina;Dothideomycetes;Capnodiales;Mycosphaerellaceae;Exopassalora;";"0.0";"0";"1";"1";"0";"1";"0";"430523";"5766"
"LOK1378_1mm";"SILVA (only NR);Eukaryota;Amorphea;Obazoa;Opisthokonta;Nucletmycea;Fungi;Dikarya;Ascomycota;Pezizomycotina;Dothideomycetes;Capnodiales;Mycosphaerellaceae;Exutisphaerella;";"0.0";"0";"1";"1";"0";"1";"0";"430523";"5766"
"LOK1378_1mm";"SILVA (only NR);Eukaryota;Amorphea;Obazoa;Opisthokonta;Nucletmycea;Fungi;Dikarya;Ascomycota;Pezizomycotina;Dothideomycetes;Capnodiales;Mycosphaerellaceae;Graminopassalora;";"0.0";"0";"1";"1";"0";"1";"0";"430523";"5766"
"LOK1378_1mm";"SILVA (only NR);Eukaryota;Amorphea;Obazoa;Opisthokonta;Nucletmycea;Fungi;Dikarya;Ascomycota;Pezizomycotina;Dothideomycetes;Capnodiales;Mycosphaerellaceae;Lecanosticta;";"0.0";"0";"1";"1";"0";"1";"0";"430523";"5766"
"LOK1378_1mm";"SILVA (only NR);Eukaryota;Amorphea;Obazoa;Opisthokonta;Nucletmycea;Fungi;Dikarya;Ascomycota;Pezizomycotina;Dothideomycetes;Capnodiales;Mycosphaerellaceae;Mycosphaerella;";"0.0";"0";"15";"15";"0";"15";"0";"430509";"5766"
"LOK1378_1mm";"SILVA (only NR);Eukaryota;Amorphea;Obazoa;Opisthokonta;Nucletmycea;Fungi;Dikarya;Ascomycota;Pezizomycotina;Dothideomycetes;Capnodiales;Mycosphaerellaceae;Neophloeospora;";"0.0";"0";"1";"1";"0";"1";"0";"430523";"5766"
"LOK1378_1mm";"SILVA (only NR);Eukaryota;Amorphea;Obazoa;Opisthokonta;Nucletmycea;Fungi;Dikarya;Ascomycota;Pezizomycotina;Dothideomycetes;Capnodiales;Mycosphaerellaceae;Neopseudocercosporella;";"0.0";"0";"1";"1";"0";"1";"0";"430523";"5766"
"LOK1378_1mm";"SILVA (only NR);Eukaryota;Amorphea;Obazoa;Opisthokonta;Nucletmycea;Fungi;Dikarya;Ascomycota;Pezizomycotina;Dothideomycetes;Capnodiales;Mycosphaerellaceae;Pallidocercospora;";"0.0";"0";"1";"1";"0";"1";"0";"430523";"5766"
"LOK1378_1mm";"SILVA (only NR);Eukaryota;Amorphea;Obazoa;Opisthokonta;Nucletmycea;Fungi;Dikarya;Ascomycota;Pezizomycotina;Dothideomycetes;Capnodiales;Mycosphaerellaceae;Paramycosphaerella;";"0.0";"0";"1";"1";"0";"1";"0";"430523";"5766"
"LOK1378_1mm";"SILVA (only NR);Eukaryota;Amorphea;Obazoa;Opisthokonta;Nucletmycea;Fungi;Dikarya;Ascomycota;Pezizomycotina;Dothideomycetes;Capnodiales;Mycosphaerellaceae;Passalora;";"0.0";"0";"3";"3";"0";"3";"0";"430521";"5766"
"LOK1378_1mm";"SILVA (only NR);Eukaryota;Amorphea;Obazoa;Opisthokonta;Nucletmycea;Fungi;Dikarya;Ascomycota;Pezizomycotina;Dothideomycetes;Capnodiales;Mycosphaerellaceae;Phaeoisariopsis;";"0.0";"0";"2";"2";"0";"2";"0";"430522";"5766"
"LOK1378_1mm";"SILVA (only NR);Eukaryota;Amorphea;Obazoa;Opisthokonta;Nucletmycea;Fungi;Dikarya;Ascomycota;Pezizomycotina;Dothideomycetes;Capnodiales;Mycosphaerellaceae;Phaeophleospora;";"0.0";"0";"1";"1";"0";"1";"0";"430523";"5766"
"LOK1378_1mm";"SILVA (only NR);Eukaryota;Amorphea;Obazoa;Opisthokonta;Nucletmycea;Fungi;Dikarya;Ascomycota;Pezizomycotina;Dothideomycetes;Capnodiales;Mycosphaerellaceae;Pseudocercospora;";"0.0";"0";"5";"5";"0";"5";"0";"430519";"5766"
"LOK1378_1mm";"SILVA (only NR);Eukaryota;Amorphea;Obazoa;Opisthokonta;Nucletmycea;Fungi;Dikarya;Ascomycota;Pezizomycotina;Dothideomycetes;Capnodiales;Mycosphaerellaceae;Ramularia;";"0.0";"0";"66";"66";"0";"66";"0";"430458";"5766"
"LOK1378_1mm";"SILVA (only NR);Eukaryota;Amorphea;Obazoa;Opisthokonta;Nucletmycea;Fungi;Dikarya;Ascomycota;Pezizomycotina;Dothideomycetes;Capnodiales;Mycosphaerellaceae;Septoria;";"0.0";"0";"3";"3";"0";"3";"0";"430521";"5766"
"LOK1378_1mm";"SILVA (only NR);Eukaryota;Amorphea;Obazoa;Opisthokonta;Nucletmycea;Fungi;Dikarya;Ascomycota;Pezizomycotina;Dothideomycetes;Capnodiales;Mycosphaerellaceae;Sphaerulina;";"0.0";"0";"4";"4";"0";"4";"0";"430520";"5766"
"LOK1378_1mm";"SILVA (only NR);Eukaryota;Amorphea;Obazoa;Opisthokonta;Nucletmycea;Fungi;Dikarya;Ascomycota;Pezizomycotina;Dothideomycetes;Capnodiales;Mycosphaerellaceae;Stigmina;";"0.0";"0";"1";"1";"0";"1";"0";"430523";"5766"
"LOK1378_1mm";"SILVA (only NR);Eukaryota;Amorphea;Obazoa;Opisthokonta;Nucletmycea;Fungi;Dikarya;Ascomycota;Pezizomycotina;Dothideomycetes;Capnodiales;Mycosphaerellaceae;Zasmidium;";"0.0";"0";"1";"1";"0";"1";"0";"430523";"5766"
"LOK1378_1mm";"SILVA (only NR);Eukaryota;Amorphea;Obazoa;Opisthokonta;Nucletmycea;Fungi;Dikarya;Ascomycota;Pezizomycotina;Dothideomycetes;Capnodiales;Mycosphaerellaceae;Zymoseptoria;";"0.0";"0";"7";"6";"0";"6";"1";"430518";"5766"
"LOK1378_1mm";"SILVA (only NR);Eukaryota;Amorphea;Obazoa;Opisthokonta;Nucletmycea;Fungi;Dikarya;Ascomycota;Pezizomycotina;Dothideomycetes;Capnodiales;Piedraia;";"0.0";"0";"1";"1";"0";"1";"0";"430523";"5766"
"LOK1378_1mm";"SILVA (only NR);Eukaryota;Amorphea;Obazoa;Opisthokonta;Nucletmycea;Fungi;Dikarya;Ascomycota;Pezizomycotina;Dothideomycetes;Capnodiales;Readeriella;";"0.0";"0";"1";"1";"0";"1";"0";"430523";"5766"
"LOK1378_1mm";"SILVA (only NR);Eukaryota;Amorphea;Obazoa;Opisthokonta;Nucletmycea;Fungi;Dikarya;Ascomycota;Pezizomycotina;Dothideomycetes;Capnodiales;Schizothyriaceae;";"0.0";"0";"3";"3";"0";"3";"0";"430521";"5766"
"LOK1378_1mm";"SILVA (only NR);Eukaryota;Amorphea;Obazoa;Opisthokonta;Nucletmycea;Fungi;Dikarya;Ascomycota;Pezizomycotina;Dothideomycetes;Capnodiales;Schizothyriaceae;Schizothyrium;";"0.0";"0";"3";"3";"0";"3";"0";"430521";"5766"
"LOK1378_1mm";"SILVA (only NR);Eukaryota;Amorphea;Obazoa;Opisthokonta;Nucletmycea;Fungi;Dikarya;Ascomycota;Pezizomycotina;Dothideomycetes;Capnodiales;Teratoramularia;";"0.0";"0";"1";"1";"0";"1";"0";"430523";"5766"
"LOK1378_1mm";"SILVA (only NR);Eukaryota;Amorphea;Obazoa;Opisthokonta;Nucletmycea;Fungi;Dikarya;Ascomycota;Pezizomycotina;Dothideomycetes;Capnodiales;Teratosphaeriaceae;";"0.0";"0";"99";"98";"0";"98";"1";"430426";"5766"
"LOK1378_1mm";"SILVA (only NR);Eukaryota;Amorphea;Obazoa;Opisthokonta;Nucletmycea;Fungi;Dikarya;Ascomycota;Pezizomycotina;Dothideomycetes;Capnodiales;Teratosphaeriaceae;Acidomyces;";"0.0";"0";"2";"2";"0";"2";"0";"430522";"5766"
"LOK1378_1mm";"SILVA (only NR);Eukaryota;Amorphea;Obazoa;Opisthokonta;Nucletmycea;Fungi;Dikarya;Ascomycota;Pezizomycotina;Dothideomycetes;Capnodiales;Teratosphaeriaceae;Baudoinia;";"0.0";"0";"2";"2";"0";"2";"0";"430522";"5766"
"LOK1378_1mm";"SILVA (only NR);Eukaryota;Amorphea;Obazoa;Opisthokonta;Nucletmycea;Fungi;Dikarya;Ascomycota;Pezizomycotina;Dothideomycetes;Capnodiales;Teratosphaeriaceae;Bryochiton;";"0.0";"0";"1";"1";"0";"1";"0";"430523";"5766"
"LOK1378_1mm";"SILVA (only NR);Eukaryota;Amorphea;Obazoa;Opisthokonta;Nucletmycea;Fungi;Dikarya;Ascomycota;Pezizomycotina;Dothideomycetes;Capnodiales;Teratosphaeriaceae;Capnobotryella;";"0.0";"0";"8";"8";"0";"8";"0";"430516";"5766"
"LOK1378_1mm";"SILVA (only NR);Eukaryota;Amorphea;Obazoa;Opisthokonta;Nucletmycea;Fungi;Dikarya;Ascomycota;Pezizomycotina;Dothideomycetes;Capnodiales;Teratosphaeriaceae;Catenulostroma;";"0.0";"0";"1";"1";"0";"1";"0";"430523";"5766"
"LOK1378_1mm";"SILVA (only NR);Eukaryota;Amorphea;Obazoa;Opisthokonta;Nucletmycea;Fungi;Dikarya;Ascomycota;Pezizomycotina;Dothideomycetes;Capnodiales;Teratosphaeriaceae;Devriesia;";"0.0";"0";"1";"1";"0";"1";"0";"430523";"5766"
"LOK1378_1mm";"SILVA (only NR);Eukaryota;Amorphea;Obazoa;Opisthokonta;Nucletmycea;Fungi;Dikarya;Ascomycota;Pezizomycotina;Dothideomycetes;Capnodiales;Teratosphaeriaceae;Elasticomyces;";"0.0";"0";"1";"1";"0";"1";"0";"430523";"5766"
"LOK1378_1mm";"SILVA (only NR);Eukaryota;Amorphea;Obazoa;Opisthokonta;Nucletmycea;Fungi;Dikarya;Ascomycota;Pezizomycotina;Dothideomycetes;Capnodiales;Teratosphaeriaceae;Friedmanniomyces;";"0.0";"0";"1";"1";"0";"1";"0";"430523";"5766"
"LOK1378_1mm";"SILVA (only NR);Eukaryota;Amorphea;Obazoa;Opisthokonta;Nucletmycea;Fungi;Dikarya;Ascomycota;Pezizomycotina;Dothideomycetes;Capnodiales;Teratosphaeriaceae;Hortaea;";"0.0";"0";"4";"4";"0";"4";"0";"430520";"5766"
"LOK1378_1mm";"SILVA (only NR);Eukaryota;Amorphea;Obazoa;Opisthokonta;Nucletmycea;Fungi;Dikarya;Ascomycota;Pezizomycotina;Dothideomycetes;Capnodiales;Teratosphaeriaceae;Monticola;";"0.0";"0";"1";"1";"0";"1";"0";"430523";"5766"
"LOK1378_1mm";"SILVA (only NR);Eukaryota;Amorphea;Obazoa;Opisthokonta;Nucletmycea;Fungi;Dikarya;Ascomycota;Pezizomycotina;Dothideomycetes;Capnodiales;Teratosphaeriaceae;Neocatenulostroma;";"0.0";"0";"62";"61";"0";"61";"1";"430463";"5766"
"LOK1378_1mm";"SILVA (only NR);Eukaryota;Amorphea;Obazoa;Opisthokonta;Nucletmycea;Fungi;Dikarya;Ascomycota;Pezizomycotina;Dothideomycetes;Capnodiales;Teratosphaeriaceae;Penidiella;";"0.0";"0";"1";"1";"0";"1";"0";"430523";"5766"
"LOK1378_1mm";"SILVA (only NR);Eukaryota;Amorphea;Obazoa;Opisthokonta;Nucletmycea;Fungi;Dikarya;Ascomycota;Pezizomycotina;Dothideomycetes;Capnodiales;Teratosphaeriaceae;Pseudotaeniolina;";"0.0";"0";"1";"1";"0";"1";"0";"430523";"5766"
"LOK1378_1mm";"SILVA (only NR);Eukaryota;Amorphea;Obazoa;Opisthokonta;Nucletmycea;Fungi;Dikarya;Ascomycota;Pezizomycotina;Dothideomycetes;Capnodiales;Teratosphaeriaceae;Recurvomyces;";"0.0";"0";"2";"2";"0";"2";"0";"430522";"5766"
"LOK1378_1mm";"SILVA (only NR);Eukaryota;Amorphea;Obazoa;Opisthokonta;Nucletmycea;Fungi;Dikarya;Ascomycota;Pezizomycotina;Dothideomycetes;Capnodiales;Teratosphaeriaceae;Suberoteratosphaeria;";"0.0";"0";"2";"2";"0";"2";"0";"430522";"5766"
"LOK1378_1mm";"SILVA (only NR);Eukaryota;Amorphea;Obazoa;Opisthokonta;Nucletmycea;Fungi;Dikarya;Ascomycota;Pezizomycotina;Dothideomycetes;Capnodiales;Teratosphaeriaceae;Teratosphaeria;";"0.0";"0";"6";"6";"0";"6";"0";"430518";"5766"
"LOK1378_1mm";"SILVA (only NR);Eukaryota;Amorphea;Obazoa;Opisthokonta;Nucletmycea;Fungi;Dikarya;Ascomycota;Pezizomycotina;Dothideomycetes;Cenococcum;";"0.0";"0";"2";"1";"0";"1";"1";"430523";"5766"
"LOK1378_1mm";"SILVA (only NR);Eukaryota;Amorphea;Obazoa;Opisthokonta;Nucletmycea;Fungi;Dikarya;Ascomycota;Pezizomycotina;Dothideomycetes;Dothideales;";"0.0";"0";"35";"33";"0";"33";"2";"430491";"5766"
"LOK1378_1mm";"SILVA (only NR);Eukaryota;Amorphea;Obazoa;Opisthokonta;Nucletmycea;Fungi;Dikarya;Ascomycota;Pezizomycotina;Dothideomycetes;Dothideales;Aureobasidiaceae;";"0.0";"0";"22";"22";"0";"22";"0";"430502";"5766"
"LOK1378_1mm";"SILVA (only NR);Eukaryota;Amorphea;Obazoa;Opisthokonta;Nucletmycea;Fungi;Dikarya;Ascomycota;Pezizomycotina;Dothideomycetes;Dothideales;Aureobasidiaceae;Aureobasidium;";"0.0";"0";"18";"18";"0";"18";"0";"430506";"5766"
"LOK1378_1mm";"SILVA (only NR);Eukaryota;Amorphea;Obazoa;Opisthokonta;Nucletmycea;Fungi;Dikarya;Ascomycota;Pezizomycotina;Dothideomycetes;Dothideales;Aureobasidiaceae;Columnosphaeria;";"0.0";"0";"1";"1";"0";"1";"0";"430523";"5766"
"LOK1378_1mm";"SILVA (only NR);Eukaryota;Amorphea;Obazoa;Opisthokonta;Nucletmycea;Fungi;Dikarya;Ascomycota;Pezizomycotina;Dothideomycetes;Dothideales;Aureobasidiaceae;Kabatiella;";"0.0";"0";"1";"1";"0";"1";"0";"430523";"5766"
"LOK1378_1mm";"SILVA (only NR);Eukaryota;Amorphea;Obazoa;Opisthokonta;Nucletmycea;Fungi;Dikarya;Ascomycota;Pezizomycotina;Dothideomycetes;Dothideales;Dothideaceae;";"0.0";"0";"6";"5";"0";"5";"1";"430519";"5766"
"LOK1378_1mm";"SILVA (only NR);Eukaryota;Amorphea;Obazoa;Opisthokonta;Nucletmycea;Fungi;Dikarya;Ascomycota;Pezizomycotina;Dothideomycetes;Dothideales;Dothideaceae;Dothidea;";"0.0";"0";"4";"3";"0";"3";"1";"430521";"5766"
"LOK1378_1mm";"SILVA (only NR);Eukaryota;Amorphea;Obazoa;Opisthokonta;Nucletmycea;Fungi;Dikarya;Ascomycota;Pezizomycotina;Dothideomycetes;Dothideales;Dothideaceae;Endoconidioma;";"0.0";"0";"1";"1";"0";"1";"0";"430523";"5766"
"LOK1378_1mm";"SILVA (only NR);Eukaryota;Amorphea;Obazoa;Opisthokonta;Nucletmycea;Fungi;Dikarya;Ascomycota;Pezizomycotina;Dothideomycetes;Dothideales;Dothideaceae;Stylodothis;";"0.0";"0";"1";"1";"0";"1";"0";"430523";"5766"
"LOK1378_1mm";"SILVA (only NR);Eukaryota;Amorphea;Obazoa;Opisthokonta;Nucletmycea;Fungi;Dikarya;Ascomycota;Pezizomycotina;Dothideomycetes;Dothideales;Dothioraceae;";"0.0";"0";"6";"5";"0";"5";"1";"430519";"5766"
"LOK1378_1mm";"SILVA (only NR);Eukaryota;Amorphea;Obazoa;Opisthokonta;Nucletmycea;Fungi;Dikarya;Ascomycota;Pezizomycotina;Dothideomycetes;Dothideales;Dothioraceae;Delphinella;";"0.0";"0";"2";"2";"0";"2";"0";"430522";"5766"
"LOK1378_1mm";"SILVA (only NR);Eukaryota;Amorphea;Obazoa;Opisthokonta;Nucletmycea;Fungi;Dikarya;Ascomycota;Pezizomycotina;Dothideomycetes;Dothideales;Dothioraceae;Dothiora;";"0.0";"0";"2";"2";"0";"2";"0";"430522";"5766"
"LOK1378_1mm";"SILVA (only NR);Eukaryota;Amorphea;Obazoa;Opisthokonta;Nucletmycea;Fungi;Dikarya;Ascomycota;Pezizomycotina;Dothideomycetes;Dothideales;Dothioraceae;Sydowia;";"0.0";"0";"1";"0";"0";"0";"1";"430524";"5766"
"LOK1378_1mm";"SILVA (only NR);Eukaryota;Amorphea;Obazoa;Opisthokonta;Nucletmycea;Fungi;Dikarya;Ascomycota;Pezizomycotina;Dothideomycetes;Dothideales;Scleroconidioma;";"0.0";"0";"1";"1";"0";"1";"0";"430523";"5766"
"LOK1378_1mm";"SILVA (only NR);Eukaryota;Amorphea;Obazoa;Opisthokonta;Nucletmycea;Fungi;Dikarya;Ascomycota;Pezizomycotina;Dothideomycetes;Hysteriales;";"0.0";"0";"2";"2";"0";"2";"0";"430522";"5766"
"LOK1378_1mm";"SILVA (only NR);Eukaryota;Amorphea;Obazoa;Opisthokonta;Nucletmycea;Fungi;Dikarya;Ascomycota;Pezizomycotina;Dothideomycetes;Hysteriales;Hysterographium;";"0.0";"0";"1";"1";"0";"1";"0";"430523";"5766"
"LOK1378_1mm";"SILVA (only NR);Eukaryota;Amorphea;Obazoa;Opisthokonta;Nucletmycea;Fungi;Dikarya;Ascomycota;Pezizomycotina;Dothideomycetes;Hysteriales;Rhytidhysteron;";"0.0";"0";"1";"1";"0";"1";"0";"430523";"5766"
"LOK1378_1mm";"SILVA (only NR);Eukaryota;Amorphea;Obazoa;Opisthokonta;Nucletmycea;Fungi;Dikarya;Ascomycota;Pezizomycotina;Dothideomycetes;Incertae Sedis;";"0.0";"0";"31";"27";"0";"27";"4";"430497";"5766"
"LOK1378_1mm";"SILVA (only NR);Eukaryota;Amorphea;Obazoa;Opisthokonta;Nucletmycea;Fungi;Dikarya;Ascomycota;Pezizomycotina;Dothideomycetes;Incertae Sedis;Eremomycetaceae;";"0.0";"0";"1";"1";"0";"1";"0";"430523";"5766"
"LOK1378_1mm";"SILVA (only NR);Eukaryota;Amorphea;Obazoa;Opisthokonta;Nucletmycea;Fungi;Dikarya;Ascomycota;Pezizomycotina;Dothideomycetes;Incertae Sedis;Eremomycetaceae;Arthrographis;";"0.0";"0";"1";"1";"0";"1";"0";"430523";"5766"
"LOK1378_1mm";"SILVA (only NR);Eukaryota;Amorphea;Obazoa;Opisthokonta;Nucletmycea;Fungi;Dikarya;Ascomycota;Pezizomycotina;Dothideomycetes;Incertae Sedis;Incertae Sedis;";"0.0";"0";"26";"22";"0";"22";"4";"430502";"5766"
"LOK1378_1mm";"SILVA (only NR);Eukaryota;Amorphea;Obazoa;Opisthokonta;Nucletmycea;Fungi;Dikarya;Ascomycota;Pezizomycotina;Dothideomycetes;Incertae Sedis;Incertae Sedis;Brachyconidiella;";"0.0";"0";"1";"0";"0";"0";"1";"430524";"5766"
"LOK1378_1mm";"SILVA (only NR);Eukaryota;Amorphea;Obazoa;Opisthokonta;Nucletmycea;Fungi;Dikarya;Ascomycota;Pezizomycotina;Dothideomycetes;Incertae Sedis;Incertae Sedis;Catinella;";"0.0";"0";"1";"1";"0";"1";"0";"430523";"5766"
"LOK1378_1mm";"SILVA (only NR);Eukaryota;Amorphea;Obazoa;Opisthokonta;Nucletmycea;Fungi;Dikarya;Ascomycota;Pezizomycotina;Dothideomycetes;Incertae Sedis;Incertae Sedis;Cryomyces;";"0.0";"0";"2";"2";"0";"2";"0";"430522";"5766"
"LOK1378_1mm";"SILVA (only NR);Eukaryota;Amorphea;Obazoa;Opisthokonta;Nucletmycea;Fungi;Dikarya;Ascomycota;Pezizomycotina;Dothideomycetes;Incertae Sedis;Incertae Sedis;Endosporium;";"0.0";"0";"1";"1";"0";"1";"0";"430523";"5766"
"LOK1378_1mm";"SILVA (only NR);Eukaryota;Amorphea;Obazoa;Opisthokonta;Nucletmycea;Fungi;Dikarya;Ascomycota;Pezizomycotina;Dothideomycetes;Incertae Sedis;Incertae Sedis;Heliocephala;";"0.0";"0";"3";"3";"0";"3";"0";"430521";"5766"
"LOK1378_1mm";"SILVA (only NR);Eukaryota;Amorphea;Obazoa;Opisthokonta;Nucletmycea;Fungi;Dikarya;Ascomycota;Pezizomycotina;Dothideomycetes;Incertae Sedis;Incertae Sedis;Phaeosclera;";"0.0";"0";"1";"1";"0";"1";"0";"430523";"5766"
"LOK1378_1mm";"SILVA (only NR);Eukaryota;Amorphea;Obazoa;Opisthokonta;Nucletmycea;Fungi;Dikarya;Ascomycota;Pezizomycotina;Dothideomycetes;Incertae Sedis;Incertae Sedis;Phaeotheca;";"0.0";"0";"1";"1";"0";"1";"0";"430523";"5766"
"LOK1378_1mm";"SILVA (only NR);Eukaryota;Amorphea;Obazoa;Opisthokonta;Nucletmycea;Fungi;Dikarya;Ascomycota;Pezizomycotina;Dothideomycetes;Incertae Sedis;Incertae Sedis;Pseudosigmoidea;";"0.0";"0";"1";"0";"0";"0";"1";"430524";"5766"
"LOK1378_1mm";"SILVA (only NR);Eukaryota;Amorphea;Obazoa;Opisthokonta;Nucletmycea;Fungi;Dikarya;Ascomycota;Pezizomycotina;Dothideomycetes;Incertae Sedis;Incertae Sedis;Rupestriomyces;";"0.0";"0";"1";"1";"0";"1";"0";"430523";"5766"
"LOK1378_1mm";"SILVA (only NR);Eukaryota;Amorphea;Obazoa;Opisthokonta;Nucletmycea;Fungi;Dikarya;Ascomycota;Pezizomycotina;Dothideomycetes;Incertae Sedis;Incertae Sedis;Saxomyces;";"0.0";"0";"2";"2";"0";"2";"0";"430522";"5766"
"LOK1378_1mm";"SILVA (only NR);Eukaryota;Amorphea;Obazoa;Opisthokonta;Nucletmycea;Fungi;Dikarya;Ascomycota;Pezizomycotina;Dothideomycetes;Incertae Sedis;Incertae Sedis;Scolecobasidium;";"0.0";"0";"1";"0";"0";"0";"1";"430524";"5766"
"LOK1378_1mm";"SILVA (only NR);Eukaryota;Amorphea;Obazoa;Opisthokonta;Nucletmycea;Fungi;Dikarya;Ascomycota;Pezizomycotina;Dothideomycetes;Incertae Sedis;Incertae Sedis;Spissiomyces;";"0.0";"0";"1";"1";"0";"1";"0";"430523";"5766"
"LOK1378_1mm";"SILVA (only NR);Eukaryota;Amorphea;Obazoa;Opisthokonta;Nucletmycea;Fungi;Dikarya;Ascomycota;Pezizomycotina;Dothideomycetes;Incertae Sedis;Incertae Sedis;Tyrannosorus;";"0.0";"0";"1";"1";"0";"1";"0";"430523";"5766"
"LOK1378_1mm";"SILVA (only NR);Eukaryota;Amorphea;Obazoa;Opisthokonta;Nucletmycea;Fungi;Dikarya;Ascomycota;Pezizomycotina;Dothideomycetes;Incertae Sedis;Kirschsteiniotheliaceae;";"0.0";"0";"2";"2";"0";"2";"0";"430522";"5766"
"LOK1378_1mm";"SILVA (only NR);Eukaryota;Amorphea;Obazoa;Opisthokonta;Nucletmycea;Fungi;Dikarya;Ascomycota;Pezizomycotina;Dothideomycetes;Incertae Sedis;Kirschsteiniotheliaceae;Kirschsteiniothelia;";"0.0";"0";"2";"2";"0";"2";"0";"430522";"5766"
"LOK1378_1mm";"SILVA (only NR);Eukaryota;Amorphea;Obazoa;Opisthokonta;Nucletmycea;Fungi;Dikarya;Ascomycota;Pezizomycotina;Dothideomycetes;Incertae Sedis;Micropeltidaceae;";"0.0";"0";"1";"1";"0";"1";"0";"430523";"5766"
"LOK1378_1mm";"SILVA (only NR);Eukaryota;Amorphea;Obazoa;Opisthokonta;Nucletmycea;Fungi;Dikarya;Ascomycota;Pezizomycotina;Dothideomycetes;Incertae Sedis;Micropeltidaceae;Stomiopeltis;";"0.0";"0";"1";"1";"0";"1";"0";"430523";"5766"
"LOK1378_1mm";"SILVA (only NR);Eukaryota;Amorphea;Obazoa;Opisthokonta;Nucletmycea;Fungi;Dikarya;Ascomycota;Pezizomycotina;Dothideomycetes;Jahnulales;";"0.0";"0";"7";"4";"0";"4";"3";"430520";"5766"
"LOK1378_1mm";"SILVA (only NR);Eukaryota;Amorphea;Obazoa;Opisthokonta;Nucletmycea;Fungi;Dikarya;Ascomycota;Pezizomycotina;Dothideomycetes;Jahnulales;Aliquandostipitaceae;";"0.0";"0";"6";"4";"0";"4";"2";"430520";"5766"
"LOK1378_1mm";"SILVA (only NR);Eukaryota;Amorphea;Obazoa;Opisthokonta;Nucletmycea;Fungi;Dikarya;Ascomycota;Pezizomycotina;Dothideomycetes;Jahnulales;Aliquandostipitaceae;Aliquandostipite;";"0.0";"0";"2";"2";"0";"2";"0";"430522";"5766"
"LOK1378_1mm";"SILVA (only NR);Eukaryota;Amorphea;Obazoa;Opisthokonta;Nucletmycea;Fungi;Dikarya;Ascomycota;Pezizomycotina;Dothideomycetes;Jahnulales;Aliquandostipitaceae;Jahnula;";"0.0";"0";"4";"2";"0";"2";"2";"430522";"5766"
"LOK1378_1mm";"SILVA (only NR);Eukaryota;Amorphea;Obazoa;Opisthokonta;Nucletmycea;Fungi;Dikarya;Ascomycota;Pezizomycotina;Dothideomycetes;Jahnulales;Manglicola;";"0.0";"0";"1";"0";"0";"0";"1";"430524";"5766"
"LOK1378_1mm";"SILVA (only NR);Eukaryota;Amorphea;Obazoa;Opisthokonta;Nucletmycea;Fungi;Dikarya;Ascomycota;Pezizomycotina;Dothideomycetes;Myriangiales;";"0.0";"0";"5";"5";"0";"5";"0";"430519";"5766"
"LOK1378_1mm";"SILVA (only NR);Eukaryota;Amorphea;Obazoa;Opisthokonta;Nucletmycea;Fungi;Dikarya;Ascomycota;Pezizomycotina;Dothideomycetes;Myriangiales;Elsinoaceae;";"0.0";"0";"3";"3";"0";"3";"0";"430521";"5766"
"LOK1378_1mm";"SILVA (only NR);Eukaryota;Amorphea;Obazoa;Opisthokonta;Nucletmycea;Fungi;Dikarya;Ascomycota;Pezizomycotina;Dothideomycetes;Myriangiales;Elsinoaceae;Elsinoe;";"0.0";"0";"3";"3";"0";"3";"0";"430521";"5766"
"LOK1378_1mm";"SILVA (only NR);Eukaryota;Amorphea;Obazoa;Opisthokonta;Nucletmycea;Fungi;Dikarya;Ascomycota;Pezizomycotina;Dothideomycetes;Myriangiales;Myriangiaceae;";"0.0";"0";"2";"2";"0";"2";"0";"430522";"5766"
"LOK1378_1mm";"SILVA (only NR);Eukaryota;Amorphea;Obazoa;Opisthokonta;Nucletmycea;Fungi;Dikarya;Ascomycota;Pezizomycotina;Dothideomycetes;Myriangiales;Myriangiaceae;Myriangium;";"0.0";"0";"2";"2";"0";"2";"0";"430522";"5766"
"LOK1378_1mm";"SILVA (only NR);Eukaryota;Amorphea;Obazoa;Opisthokonta;Nucletmycea;Fungi;Dikarya;Ascomycota;Pezizomycotina;Dothideomycetes;Mytilinidiales;";"0.0";"0";"3";"3";"0";"3";"0";"430521";"5766"
"LOK1378_1mm";"SILVA (only NR);Eukaryota;Amorphea;Obazoa;Opisthokonta;Nucletmycea;Fungi;Dikarya;Ascomycota;Pezizomycotina;Dothideomycetes;Mytilinidiales;Mytilinidiaceae;";"0.0";"0";"3";"3";"0";"3";"0";"430521";"5766"
"LOK1378_1mm";"SILVA (only NR);Eukaryota;Amorphea;Obazoa;Opisthokonta;Nucletmycea;Fungi;Dikarya;Ascomycota;Pezizomycotina;Dothideomycetes;Mytilinidiales;Mytilinidiaceae;Lophium;";"0.0";"0";"1";"1";"0";"1";"0";"430523";"5766"
"LOK1378_1mm";"SILVA (only NR);Eukaryota;Amorphea;Obazoa;Opisthokonta;Nucletmycea;Fungi;Dikarya;Ascomycota;Pezizomycotina;Dothideomycetes;Mytilinidiales;Mytilinidiaceae;Mytilinidion;";"0.0";"0";"1";"1";"0";"1";"0";"430523";"5766"
"LOK1378_1mm";"SILVA (only NR);Eukaryota;Amorphea;Obazoa;Opisthokonta;Nucletmycea;Fungi;Dikarya;Ascomycota;Pezizomycotina;Dothideomycetes;Mytilinidiales;Mytilinidiaceae;Slimacomyces;";"0.0";"0";"1";"1";"0";"1";"0";"430523";"5766"
"LOK1378_1mm";"SILVA (only NR);Eukaryota;Amorphea;Obazoa;Opisthokonta;Nucletmycea;Fungi;Dikarya;Ascomycota;Pezizomycotina;Dothideomycetes;Pleosporales;";"0.0";"0";"477";"449";"0";"449";"28";"430075";"5766"
"LOK1378_1mm";"SILVA (only NR);Eukaryota;Amorphea;Obazoa;Opisthokonta;Nucletmycea;Fungi;Dikarya;Ascomycota;Pezizomycotina;Dothideomycetes;Pleosporales;Acrocordiopsis;";"0.0";"0";"1";"0";"0";"0";"1";"430524";"5766"
"LOK1378_1mm";"SILVA (only NR);Eukaryota;Amorphea;Obazoa;Opisthokonta;Nucletmycea;Fungi;Dikarya;Ascomycota;Pezizomycotina;Dothideomycetes;Pleosporales;Aigialaceae;";"0.0";"0";"3";"3";"0";"3";"0";"430521";"5766"
"LOK1378_1mm";"SILVA (only NR);Eukaryota;Amorphea;Obazoa;Opisthokonta;Nucletmycea;Fungi;Dikarya;Ascomycota;Pezizomycotina;Dothideomycetes;Pleosporales;Aigialaceae;Aigialus;";"0.0";"0";"3";"3";"0";"3";"0";"430521";"5766"
"LOK1378_1mm";"SILVA (only NR);Eukaryota;Amorphea;Obazoa;Opisthokonta;Nucletmycea;Fungi;Dikarya;Ascomycota;Pezizomycotina;Dothideomycetes;Pleosporales;Amia;";"0.0";"0";"1";"1";"0";"1";"0";"430523";"5766"
"LOK1378_1mm";"SILVA (only NR);Eukaryota;Amorphea;Obazoa;Opisthokonta;Nucletmycea;Fungi;Dikarya;Ascomycota;Pezizomycotina;Dothideomycetes;Pleosporales;Amorosiaceae;";"0.0";"0";"3";"3";"0";"3";"0";"430521";"5766"
"LOK1378_1mm";"SILVA (only NR);Eukaryota;Amorphea;Obazoa;Opisthokonta;Nucletmycea;Fungi;Dikarya;Ascomycota;Pezizomycotina;Dothideomycetes;Pleosporales;Amorosiaceae;Amorosia;";"0.0";"0";"1";"1";"0";"1";"0";"430523";"5766"
"LOK1378_1mm";"SILVA (only NR);Eukaryota;Amorphea;Obazoa;Opisthokonta;Nucletmycea;Fungi;Dikarya;Ascomycota;Pezizomycotina;Dothideomycetes;Pleosporales;Anguillospora;";"0.0";"0";"1";"1";"0";"1";"0";"430523";"5766"
"LOK1378_1mm";"SILVA (only NR);Eukaryota;Amorphea;Obazoa;Opisthokonta;Nucletmycea;Fungi;Dikarya;Ascomycota;Pezizomycotina;Dothideomycetes;Pleosporales;Arthopyrenia;";"0.0";"0";"1";"1";"0";"1";"0";"430523";"5766"
"LOK1378_1mm";"SILVA (only NR);Eukaryota;Amorphea;Obazoa;Opisthokonta;Nucletmycea;Fungi;Dikarya;Ascomycota;Pezizomycotina;Dothideomycetes;Pleosporales;Biatriosporaceae;";"0.0";"0";"2";"2";"0";"2";"0";"430522";"5766"
"LOK1378_1mm";"SILVA (only NR);Eukaryota;Amorphea;Obazoa;Opisthokonta;Nucletmycea;Fungi;Dikarya;Ascomycota;Pezizomycotina;Dothideomycetes;Pleosporales;Biatriosporaceae;Biatriospora;";"0.0";"0";"2";"2";"0";"2";"0";"430522";"5766"
"LOK1378_1mm";"SILVA (only NR);Eukaryota;Amorphea;Obazoa;Opisthokonta;Nucletmycea;Fungi;Dikarya;Ascomycota;Pezizomycotina;Dothideomycetes;Pleosporales;Byssothecium;";"0.0";"0";"1";"1";"0";"1";"0";"430523";"5766"
"LOK1378_1mm";"SILVA (only NR);Eukaryota;Amorphea;Obazoa;Opisthokonta;Nucletmycea;Fungi;Dikarya;Ascomycota;Pezizomycotina;Dothideomycetes;Pleosporales;Coniothyriaceae;";"0.0";"0";"3";"3";"0";"3";"0";"430521";"5766"
"LOK1378_1mm";"SILVA (only NR);Eukaryota;Amorphea;Obazoa;Opisthokonta;Nucletmycea;Fungi;Dikarya;Ascomycota;Pezizomycotina;Dothideomycetes;Pleosporales;Coniothyriaceae;Coniothyrium;";"0.0";"0";"3";"3";"0";"3";"0";"430521";"5766"
"LOK1378_1mm";"SILVA (only NR);Eukaryota;Amorphea;Obazoa;Opisthokonta;Nucletmycea;Fungi;Dikarya;Ascomycota;Pezizomycotina;Dothideomycetes;Pleosporales;Corynespora;";"0.0";"0";"2";"2";"0";"2";"0";"430522";"5766"
"LOK1378_1mm";"SILVA (only NR);Eukaryota;Amorphea;Obazoa;Opisthokonta;Nucletmycea;Fungi;Dikarya;Ascomycota;Pezizomycotina;Dothideomycetes;Pleosporales;Cucurbitariaceae;";"0.0";"0";"10";"9";"0";"9";"1";"430515";"5766"
"LOK1378_1mm";"SILVA (only NR);Eukaryota;Amorphea;Obazoa;Opisthokonta;Nucletmycea;Fungi;Dikarya;Ascomycota;Pezizomycotina;Dothideomycetes;Pleosporales;Cucurbitariaceae;Cucurbitaria;";"0.0";"0";"1";"1";"0";"1";"0";"430523";"5766"
"LOK1378_1mm";"SILVA (only NR);Eukaryota;Amorphea;Obazoa;Opisthokonta;Nucletmycea;Fungi;Dikarya;Ascomycota;Pezizomycotina;Dothideomycetes;Pleosporales;Cucurbitariaceae;Pyrenochaeta;";"0.0";"0";"7";"6";"0";"6";"1";"430518";"5766"
"LOK1378_1mm";"SILVA (only NR);Eukaryota;Amorphea;Obazoa;Opisthokonta;Nucletmycea;Fungi;Dikarya;Ascomycota;Pezizomycotina;Dothideomycetes;Pleosporales;Cucurbitariaceae;uncultured;";"0.0";"0";"2";"2";"0";"2";"0";"430522";"5766"
"LOK1378_1mm";"SILVA (only NR);Eukaryota;Amorphea;Obazoa;Opisthokonta;Nucletmycea;Fungi;Dikarya;Ascomycota;Pezizomycotina;Dothideomycetes;Pleosporales;Curreya;";"0.0";"0";"1";"1";"0";"1";"0";"430523";"5766"
"LOK1378_1mm";"SILVA (only NR);Eukaryota;Amorphea;Obazoa;Opisthokonta;Nucletmycea;Fungi;Dikarya;Ascomycota;Pezizomycotina;Dothideomycetes;Pleosporales;Cyclothyriella;";"0.0";"0";"1";"1";"0";"1";"0";"430523";"5766"
"LOK1378_1mm";"SILVA (only NR);Eukaryota;Amorphea;Obazoa;Opisthokonta;Nucletmycea;Fungi;Dikarya;Ascomycota;Pezizomycotina;Dothideomycetes;Pleosporales;Decaisnella;";"0.0";"0";"1";"0";"0";"0";"1";"430524";"5766"
"LOK1378_1mm";"SILVA (only NR);Eukaryota;Amorphea;Obazoa;Opisthokonta;Nucletmycea;Fungi;Dikarya;Ascomycota;Pezizomycotina;Dothideomycetes;Pleosporales;Delitschia;";"0.0";"0";"2";"2";"0";"2";"0";"430522";"5766"
"LOK1378_1mm";"SILVA (only NR);Eukaryota;Amorphea;Obazoa;Opisthokonta;Nucletmycea;Fungi;Dikarya;Ascomycota;Pezizomycotina;Dothideomycetes;Pleosporales;Didymellaceae;";"0.0";"0";"86";"86";"0";"86";"0";"430438";"5766"
"LOK1378_1mm";"SILVA (only NR);Eukaryota;Amorphea;Obazoa;Opisthokonta;Nucletmycea;Fungi;Dikarya;Ascomycota;Pezizomycotina;Dothideomycetes;Pleosporales;Didymellaceae;Ascochyta;";"0.0";"0";"9";"9";"0";"9";"0";"430515";"5766"
"LOK1378_1mm";"SILVA (only NR);Eukaryota;Amorphea;Obazoa;Opisthokonta;Nucletmycea;Fungi;Dikarya;Ascomycota;Pezizomycotina;Dothideomycetes;Pleosporales;Didymellaceae;Boeremia;";"0.0";"0";"63";"63";"0";"63";"0";"430461";"5766"
"LOK1378_1mm";"SILVA (only NR);Eukaryota;Amorphea;Obazoa;Opisthokonta;Nucletmycea;Fungi;Dikarya;Ascomycota;Pezizomycotina;Dothideomycetes;Pleosporales;Didymellaceae;Didymella;";"0.0";"0";"6";"6";"0";"6";"0";"430518";"5766"
"LOK1378_1mm";"SILVA (only NR);Eukaryota;Amorphea;Obazoa;Opisthokonta;Nucletmycea;Fungi;Dikarya;Ascomycota;Pezizomycotina;Dothideomycetes;Pleosporales;Didymellaceae;Neoascochyta;";"0.0";"0";"1";"1";"0";"1";"0";"430523";"5766"
"LOK1378_1mm";"SILVA (only NR);Eukaryota;Amorphea;Obazoa;Opisthokonta;Nucletmycea;Fungi;Dikarya;Ascomycota;Pezizomycotina;Dothideomycetes;Pleosporales;Didymellaceae;Phoma;";"0.0";"0";"5";"5";"0";"5";"0";"430519";"5766"
"LOK1378_1mm";"SILVA (only NR);Eukaryota;Amorphea;Obazoa;Opisthokonta;Nucletmycea;Fungi;Dikarya;Ascomycota;Pezizomycotina;Dothideomycetes;Pleosporales;Didymellaceae;Stagonosporopsis;";"0.0";"0";"1";"1";"0";"1";"0";"430523";"5766"
"LOK1378_1mm";"SILVA (only NR);Eukaryota;Amorphea;Obazoa;Opisthokonta;Nucletmycea;Fungi;Dikarya;Ascomycota;Pezizomycotina;Dothideomycetes;Pleosporales;Didymocrea;";"0.0";"0";"2";"1";"0";"1";"1";"430523";"5766"
"LOK1378_1mm";"SILVA (only NR);Eukaryota;Amorphea;Obazoa;Opisthokonta;Nucletmycea;Fungi;Dikarya;Ascomycota;Pezizomycotina;Dothideomycetes;Pleosporales;Didymosphaeriaceae;";"0.0";"0";"15";"14";"0";"14";"1";"430510";"5766"
"LOK1378_1mm";"SILVA (only NR);Eukaryota;Amorphea;Obazoa;Opisthokonta;Nucletmycea;Fungi;Dikarya;Ascomycota;Pezizomycotina;Dothideomycetes;Pleosporales;Didymosphaeriaceae;Bimuria;";"0.0";"0";"3";"2";"0";"2";"1";"430522";"5766"
"LOK1378_1mm";"SILVA (only NR);Eukaryota;Amorphea;Obazoa;Opisthokonta;Nucletmycea;Fungi;Dikarya;Ascomycota;Pezizomycotina;Dothideomycetes;Pleosporales;Didymosphaeriaceae;Didymosphaeria;";"0.0";"0";"1";"1";"0";"1";"0";"430523";"5766"
"LOK1378_1mm";"SILVA (only NR);Eukaryota;Amorphea;Obazoa;Opisthokonta;Nucletmycea;Fungi;Dikarya;Ascomycota;Pezizomycotina;Dothideomycetes;Pleosporales;Didymosphaeriaceae;Letendraea;";"0.0";"0";"1";"1";"0";"1";"0";"430523";"5766"
"LOK1378_1mm";"SILVA (only NR);Eukaryota;Amorphea;Obazoa;Opisthokonta;Nucletmycea;Fungi;Dikarya;Ascomycota;Pezizomycotina;Dothideomycetes;Pleosporales;Didymosphaeriaceae;Paraconiothyrium;";"0.0";"0";"1";"1";"0";"1";"0";"430523";"5766"
"LOK1378_1mm";"SILVA (only NR);Eukaryota;Amorphea;Obazoa;Opisthokonta;Nucletmycea;Fungi;Dikarya;Ascomycota;Pezizomycotina;Dothideomycetes;Pleosporales;Didymosphaeriaceae;Paraphaeosphaeria;";"0.0";"0";"3";"3";"0";"3";"0";"430521";"5766"
"LOK1378_1mm";"SILVA (only NR);Eukaryota;Amorphea;Obazoa;Opisthokonta;Nucletmycea;Fungi;Dikarya;Ascomycota;Pezizomycotina;Dothideomycetes;Pleosporales;Didymosphaeriaceae;Pseudocamarosporium;";"0.0";"0";"2";"2";"0";"2";"0";"430522";"5766"
"LOK1378_1mm";"SILVA (only NR);Eukaryota;Amorphea;Obazoa;Opisthokonta;Nucletmycea;Fungi;Dikarya;Ascomycota;Pezizomycotina;Dothideomycetes;Pleosporales;Halojulellaceae;";"0.0";"0";"2";"2";"0";"2";"0";"430522";"5766"
"LOK1378_1mm";"SILVA (only NR);Eukaryota;Amorphea;Obazoa;Opisthokonta;Nucletmycea;Fungi;Dikarya;Ascomycota;Pezizomycotina;Dothideomycetes;Pleosporales;Halojulellaceae;Halojulella;";"0.0";"0";"1";"1";"0";"1";"0";"430523";"5766"
"LOK1378_1mm";"SILVA (only NR);Eukaryota;Amorphea;Obazoa;Opisthokonta;Nucletmycea;Fungi;Dikarya;Ascomycota;Pezizomycotina;Dothideomycetes;Pleosporales;Halokirschsteiniothelia;";"0.0";"0";"1";"1";"0";"1";"0";"430523";"5766"
"LOK1378_1mm";"SILVA (only NR);Eukaryota;Amorphea;Obazoa;Opisthokonta;Nucletmycea;Fungi;Dikarya;Ascomycota;Pezizomycotina;Dothideomycetes;Pleosporales;Herpotrichia;";"0.0";"0";"3";"3";"0";"3";"0";"430521";"5766"
"LOK1378_1mm";"SILVA (only NR);Eukaryota;Amorphea;Obazoa;Opisthokonta;Nucletmycea;Fungi;Dikarya;Ascomycota;Pezizomycotina;Dothideomycetes;Pleosporales;Hypoderma;";"0.0";"0";"1";"1";"0";"1";"0";"430523";"5766"
"LOK1378_1mm";"SILVA (only NR);Eukaryota;Amorphea;Obazoa;Opisthokonta;Nucletmycea;Fungi;Dikarya;Ascomycota;Pezizomycotina;Dothideomycetes;Pleosporales;Incertae Sedis;";"0.0";"0";"24";"20";"0";"20";"4";"430504";"5766"
"LOK1378_1mm";"SILVA (only NR);Eukaryota;Amorphea;Obazoa;Opisthokonta;Nucletmycea;Fungi;Dikarya;Ascomycota;Pezizomycotina;Dothideomycetes;Pleosporales;Incertae Sedis;Astrosphaeriella;";"0.0";"0";"1";"0";"0";"0";"1";"430524";"5766"
"LOK1378_1mm";"SILVA (only NR);Eukaryota;Amorphea;Obazoa;Opisthokonta;Nucletmycea;Fungi;Dikarya;Ascomycota;Pezizomycotina;Dothideomycetes;Pleosporales;Incertae Sedis;Camarosporium;";"0.0";"0";"2";"2";"0";"2";"0";"430522";"5766"
"LOK1378_1mm";"SILVA (only NR);Eukaryota;Amorphea;Obazoa;Opisthokonta;Nucletmycea;Fungi;Dikarya;Ascomycota;Pezizomycotina;Dothideomycetes;Pleosporales;Incertae Sedis;Dictyosporium;";"0.0";"0";"3";"3";"0";"3";"0";"430521";"5766"
"LOK1378_1mm";"SILVA (only NR);Eukaryota;Amorphea;Obazoa;Opisthokonta;Nucletmycea;Fungi;Dikarya;Ascomycota;Pezizomycotina;Dothideomycetes;Pleosporales;Incertae Sedis;Heleiosa;";"0.0";"0";"1";"1";"0";"1";"0";"430523";"5766"
"LOK1378_1mm";"SILVA (only NR);Eukaryota;Amorphea;Obazoa;Opisthokonta;Nucletmycea;Fungi;Dikarya;Ascomycota;Pezizomycotina;Dothideomycetes;Pleosporales;Incertae Sedis;Microsphaeropsis;";"0.0";"0";"3";"3";"0";"3";"0";"430521";"5766"
"LOK1378_1mm";"SILVA (only NR);Eukaryota;Amorphea;Obazoa;Opisthokonta;Nucletmycea;Fungi;Dikarya;Ascomycota;Pezizomycotina;Dothideomycetes;Pleosporales;Incertae Sedis;Pleiochaeta;";"0.0";"0";"2";"2";"0";"2";"0";"430522";"5766"
"LOK1378_1mm";"SILVA (only NR);Eukaryota;Amorphea;Obazoa;Opisthokonta;Nucletmycea;Fungi;Dikarya;Ascomycota;Pezizomycotina;Dothideomycetes;Pleosporales;Incertae Sedis;Pseudodictyosporium;";"0.0";"0";"2";"2";"0";"2";"0";"430522";"5766"
"LOK1378_1mm";"SILVA (only NR);Eukaryota;Amorphea;Obazoa;Opisthokonta;Nucletmycea;Fungi;Dikarya;Ascomycota;Pezizomycotina;Dothideomycetes;Pleosporales;Incertae Sedis;Pseudorobillarda;";"0.0";"0";"1";"0";"0";"0";"1";"430524";"5766"
"LOK1378_1mm";"SILVA (only NR);Eukaryota;Amorphea;Obazoa;Opisthokonta;Nucletmycea;Fungi;Dikarya;Ascomycota;Pezizomycotina;Dothideomycetes;Pleosporales;Incertae Sedis;Shiraia;";"0.0";"0";"4";"2";"0";"2";"2";"430522";"5766"
"LOK1378_1mm";"SILVA (only NR);Eukaryota;Amorphea;Obazoa;Opisthokonta;Nucletmycea;Fungi;Dikarya;Ascomycota;Pezizomycotina;Dothideomycetes;Pleosporales;Incertae Sedis;uncultured;";"0.0";"0";"3";"3";"0";"3";"0";"430521";"5766"
"LOK1378_1mm";"SILVA (only NR);Eukaryota;Amorphea;Obazoa;Opisthokonta;Nucletmycea;Fungi;Dikarya;Ascomycota;Pezizomycotina;Dothideomycetes;Pleosporales;Lentithecium;";"0.0";"0";"1";"1";"0";"1";"0";"430523";"5766"
"LOK1378_1mm";"SILVA (only NR);Eukaryota;Amorphea;Obazoa;Opisthokonta;Nucletmycea;Fungi;Dikarya;Ascomycota;Pezizomycotina;Dothideomycetes;Pleosporales;Leptosphaeriaceae;";"0.0";"0";"63";"59";"0";"59";"4";"430465";"5766"
"LOK1378_1mm";"SILVA (only NR);Eukaryota;Amorphea;Obazoa;Opisthokonta;Nucletmycea;Fungi;Dikarya;Ascomycota;Pezizomycotina;Dothideomycetes;Pleosporales;Leptosphaeriaceae;Leptosphaeria;";"0.0";"0";"36";"33";"0";"33";"3";"430491";"5766"
"LOK1378_1mm";"SILVA (only NR);Eukaryota;Amorphea;Obazoa;Opisthokonta;Nucletmycea;Fungi;Dikarya;Ascomycota;Pezizomycotina;Dothideomycetes;Pleosporales;Leptosphaeriaceae;Neophaeosphaeria;";"0.0";"0";"27";"26";"0";"26";"1";"430498";"5766"
"LOK1378_1mm";"SILVA (only NR);Eukaryota;Amorphea;Obazoa;Opisthokonta;Nucletmycea;Fungi;Dikarya;Ascomycota;Pezizomycotina;Dothideomycetes;Pleosporales;Lophiostomataceae;";"0.0";"0";"3";"3";"0";"3";"0";"430521";"5766"
"LOK1378_1mm";"SILVA (only NR);Eukaryota;Amorphea;Obazoa;Opisthokonta;Nucletmycea;Fungi;Dikarya;Ascomycota;Pezizomycotina;Dothideomycetes;Pleosporales;Lophiostomataceae;Lophiostoma;";"0.0";"0";"2";"2";"0";"2";"0";"430522";"5766"
"LOK1378_1mm";"SILVA (only NR);Eukaryota;Amorphea;Obazoa;Opisthokonta;Nucletmycea;Fungi;Dikarya;Ascomycota;Pezizomycotina;Dothideomycetes;Pleosporales;Lophiostomataceae;Sigarispora;";"0.0";"0";"1";"1";"0";"1";"0";"430523";"5766"
"LOK1378_1mm";"SILVA (only NR);Eukaryota;Amorphea;Obazoa;Opisthokonta;Nucletmycea;Fungi;Dikarya;Ascomycota;Pezizomycotina;Dothideomycetes;Pleosporales;Massariaceae;";"0.0";"0";"4";"4";"0";"4";"0";"430520";"5766"
"LOK1378_1mm";"SILVA (only NR);Eukaryota;Amorphea;Obazoa;Opisthokonta;Nucletmycea;Fungi;Dikarya;Ascomycota;Pezizomycotina;Dothideomycetes;Pleosporales;Massariaceae;Massaria;";"0.0";"0";"4";"4";"0";"4";"0";"430520";"5766"
"LOK1378_1mm";"SILVA (only NR);Eukaryota;Amorphea;Obazoa;Opisthokonta;Nucletmycea;Fungi;Dikarya;Ascomycota;Pezizomycotina;Dothideomycetes;Pleosporales;Massarinaceae;";"0.0";"0";"4";"4";"0";"4";"0";"430520";"5766"
"LOK1378_1mm";"SILVA (only NR);Eukaryota;Amorphea;Obazoa;Opisthokonta;Nucletmycea;Fungi;Dikarya;Ascomycota;Pezizomycotina;Dothideomycetes;Pleosporales;Massarinaceae;Helminthosporium;";"0.0";"0";"3";"3";"0";"3";"0";"430521";"5766"
"LOK1378_1mm";"SILVA (only NR);Eukaryota;Amorphea;Obazoa;Opisthokonta;Nucletmycea;Fungi;Dikarya;Ascomycota;Pezizomycotina;Dothideomycetes;Pleosporales;Massarinaceae;Stagonospora;";"0.0";"0";"1";"1";"0";"1";"0";"430523";"5766"
"LOK1378_1mm";"SILVA (only NR);Eukaryota;Amorphea;Obazoa;Opisthokonta;Nucletmycea;Fungi;Dikarya;Ascomycota;Pezizomycotina;Dothideomycetes;Pleosporales;Morosphaeriaceae;";"0.0";"0";"9";"9";"0";"9";"0";"430515";"5766"
"LOK1378_1mm";"SILVA (only NR);Eukaryota;Amorphea;Obazoa;Opisthokonta;Nucletmycea;Fungi;Dikarya;Ascomycota;Pezizomycotina;Dothideomycetes;Pleosporales;Morosphaeriaceae;Helicascus;";"0.0";"0";"4";"4";"0";"4";"0";"430520";"5766"
"LOK1378_1mm";"SILVA (only NR);Eukaryota;Amorphea;Obazoa;Opisthokonta;Nucletmycea;Fungi;Dikarya;Ascomycota;Pezizomycotina;Dothideomycetes;Pleosporales;Morosphaeriaceae;Helicoon;";"0.0";"0";"1";"1";"0";"1";"0";"430523";"5766"
"LOK1378_1mm";"SILVA (only NR);Eukaryota;Amorphea;Obazoa;Opisthokonta;Nucletmycea;Fungi;Dikarya;Ascomycota;Pezizomycotina;Dothideomycetes;Pleosporales;Morosphaeriaceae;Morosphaeria;";"0.0";"0";"1";"1";"0";"1";"0";"430523";"5766"
"LOK1378_1mm";"SILVA (only NR);Eukaryota;Amorphea;Obazoa;Opisthokonta;Nucletmycea;Fungi;Dikarya;Ascomycota;Pezizomycotina;Dothideomycetes;Pleosporales;Periconia;";"0.0";"0";"1";"1";"0";"1";"0";"430523";"5766"
"LOK1378_1mm";"SILVA (only NR);Eukaryota;Amorphea;Obazoa;Opisthokonta;Nucletmycea;Fungi;Dikarya;Ascomycota;Pezizomycotina;Dothideomycetes;Pleosporales;Phaeosphaeriaceae;";"0.0";"0";"34";"32";"0";"32";"2";"430492";"5766"
"LOK1378_1mm";"SILVA (only NR);Eukaryota;Amorphea;Obazoa;Opisthokonta;Nucletmycea;Fungi;Dikarya;Ascomycota;Pezizomycotina;Dothideomycetes;Pleosporales;Phaeosphaeriaceae;Ophiosphaerella;";"0.0";"0";"8";"8";"0";"8";"0";"430516";"5766"
"LOK1378_1mm";"SILVA (only NR);Eukaryota;Amorphea;Obazoa;Opisthokonta;Nucletmycea;Fungi;Dikarya;Ascomycota;Pezizomycotina;Dothideomycetes;Pleosporales;Phaeosphaeriaceae;Parastagonospora;";"0.0";"0";"13";"12";"0";"12";"1";"430512";"5766"
"LOK1378_1mm";"SILVA (only NR);Eukaryota;Amorphea;Obazoa;Opisthokonta;Nucletmycea;Fungi;Dikarya;Ascomycota;Pezizomycotina;Dothideomycetes;Pleosporales;Phaeosphaeriaceae;Phaeodothis;";"0.0";"0";"4";"4";"0";"4";"0";"430520";"5766"
"LOK1378_1mm";"SILVA (only NR);Eukaryota;Amorphea;Obazoa;Opisthokonta;Nucletmycea;Fungi;Dikarya;Ascomycota;Pezizomycotina;Dothideomycetes;Pleosporales;Phaeosphaeriaceae;Phaeosphaeria;";"0.0";"0";"4";"4";"0";"4";"0";"430520";"5766"
"LOK1378_1mm";"SILVA (only NR);Eukaryota;Amorphea;Obazoa;Opisthokonta;Nucletmycea;Fungi;Dikarya;Ascomycota;Pezizomycotina;Dothideomycetes;Pleosporales;Phaeosphaeriaceae;Phaeosphaeriopsis;";"0.0";"0";"1";"1";"0";"1";"0";"430523";"5766"
"LOK1378_1mm";"SILVA (only NR);Eukaryota;Amorphea;Obazoa;Opisthokonta;Nucletmycea;Fungi;Dikarya;Ascomycota;Pezizomycotina;Dothideomycetes;Pleosporales;Phaeosphaeriaceae;Setomelanomma;";"0.0";"0";"2";"1";"0";"1";"1";"430523";"5766"
"LOK1378_1mm";"SILVA (only NR);Eukaryota;Amorphea;Obazoa;Opisthokonta;Nucletmycea;Fungi;Dikarya;Ascomycota;Pezizomycotina;Dothideomycetes;Pleosporales;Phaeosphaeriaceae;uncultured;";"0.0";"0";"2";"2";"0";"2";"0";"430522";"5766"
"LOK1378_1mm";"SILVA (only NR);Eukaryota;Amorphea;Obazoa;Opisthokonta;Nucletmycea;Fungi;Dikarya;Ascomycota;Pezizomycotina;Dothideomycetes;Pleosporales;Pleomassaria;";"0.0";"0";"1";"1";"0";"1";"0";"430523";"5766"
"LOK1378_1mm";"SILVA (only NR);Eukaryota;Amorphea;Obazoa;Opisthokonta;Nucletmycea;Fungi;Dikarya;Ascomycota;Pezizomycotina;Dothideomycetes;Pleosporales;Pleosporaceae;";"0.0";"0";"110";"99";"0";"99";"11";"430425";"5766"
"LOK1378_1mm";"SILVA (only NR);Eukaryota;Amorphea;Obazoa;Opisthokonta;Nucletmycea;Fungi;Dikarya;Ascomycota;Pezizomycotina;Dothideomycetes;Pleosporales;Pleosporaceae;Alternaria;";"0.0";"0";"27";"24";"0";"24";"3";"430500";"5766"
"LOK1378_1mm";"SILVA (only NR);Eukaryota;Amorphea;Obazoa;Opisthokonta;Nucletmycea;Fungi;Dikarya;Ascomycota;Pezizomycotina;Dothideomycetes;Pleosporales;Pleosporaceae;Bipolaris;";"0.0";"0";"34";"28";"0";"28";"6";"430496";"5766"
"LOK1378_1mm";"SILVA (only NR);Eukaryota;Amorphea;Obazoa;Opisthokonta;Nucletmycea;Fungi;Dikarya;Ascomycota;Pezizomycotina;Dothideomycetes;Pleosporales;Pleosporaceae;Curvularia;";"0.0";"0";"30";"30";"0";"30";"0";"430494";"5766"
"LOK1378_1mm";"SILVA (only NR);Eukaryota;Amorphea;Obazoa;Opisthokonta;Nucletmycea;Fungi;Dikarya;Ascomycota;Pezizomycotina;Dothideomycetes;Pleosporales;Pleosporaceae;Decorospora;";"0.0";"0";"1";"1";"0";"1";"0";"430523";"5766"
"LOK1378_1mm";"SILVA (only NR);Eukaryota;Amorphea;Obazoa;Opisthokonta;Nucletmycea;Fungi;Dikarya;Ascomycota;Pezizomycotina;Dothideomycetes;Pleosporales;Pleosporaceae;Drechslera;";"0.0";"0";"1";"1";"0";"1";"0";"430523";"5766"
"LOK1378_1mm";"SILVA (only NR);Eukaryota;Amorphea;Obazoa;Opisthokonta;Nucletmycea;Fungi;Dikarya;Ascomycota;Pezizomycotina;Dothideomycetes;Pleosporales;Pleosporaceae;Pleospora;";"0.0";"0";"5";"4";"0";"4";"1";"430520";"5766"
"LOK1378_1mm";"SILVA (only NR);Eukaryota;Amorphea;Obazoa;Opisthokonta;Nucletmycea;Fungi;Dikarya;Ascomycota;Pezizomycotina;Dothideomycetes;Pleosporales;Pleosporaceae;Pyrenophora;";"0.0";"0";"6";"6";"0";"6";"0";"430518";"5766"
"LOK1378_1mm";"SILVA (only NR);Eukaryota;Amorphea;Obazoa;Opisthokonta;Nucletmycea;Fungi;Dikarya;Ascomycota;Pezizomycotina;Dothideomycetes;Pleosporales;Pleosporaceae;Setosphaeria;";"0.0";"0";"4";"4";"0";"4";"0";"430520";"5766"
"LOK1378_1mm";"SILVA (only NR);Eukaryota;Amorphea;Obazoa;Opisthokonta;Nucletmycea;Fungi;Dikarya;Ascomycota;Pezizomycotina;Dothideomycetes;Pleosporales;Pseudochaetosphaeronema;";"0.0";"0";"1";"1";"0";"1";"0";"430523";"5766"
"LOK1378_1mm";"SILVA (only NR);Eukaryota;Amorphea;Obazoa;Opisthokonta;Nucletmycea;Fungi;Dikarya;Ascomycota;Pezizomycotina;Dothideomycetes;Pleosporales;Roussoellaceae;";"0.0";"0";"6";"6";"0";"6";"0";"430518";"5766"
"LOK1378_1mm";"SILVA (only NR);Eukaryota;Amorphea;Obazoa;Opisthokonta;Nucletmycea;Fungi;Dikarya;Ascomycota;Pezizomycotina;Dothideomycetes;Pleosporales;Roussoellaceae;Roussoella;";"0.0";"0";"6";"6";"0";"6";"0";"430518";"5766"
"LOK1378_1mm";"SILVA (only NR);Eukaryota;Amorphea;Obazoa;Opisthokonta;Nucletmycea;Fungi;Dikarya;Ascomycota;Pezizomycotina;Dothideomycetes;Pleosporales;Sporormiaceae;";"0.0";"0";"10";"9";"0";"9";"1";"430515";"5766"
"LOK1378_1mm";"SILVA (only NR);Eukaryota;Amorphea;Obazoa;Opisthokonta;Nucletmycea;Fungi;Dikarya;Ascomycota;Pezizomycotina;Dothideomycetes;Pleosporales;Sporormiaceae;Preussia;";"0.0";"0";"7";"6";"0";"6";"1";"430518";"5766"
"LOK1378_1mm";"SILVA (only NR);Eukaryota;Amorphea;Obazoa;Opisthokonta;Nucletmycea;Fungi;Dikarya;Ascomycota;Pezizomycotina;Dothideomycetes;Pleosporales;Sporormiaceae;Westerdykella;";"0.0";"0";"3";"3";"0";"3";"0";"430521";"5766"
"LOK1378_1mm";"SILVA (only NR);Eukaryota;Amorphea;Obazoa;Opisthokonta;Nucletmycea;Fungi;Dikarya;Ascomycota;Pezizomycotina;Dothideomycetes;Pleosporales;Teichospora;";"0.0";"0";"1";"1";"0";"1";"0";"430523";"5766"
"LOK1378_1mm";"SILVA (only NR);Eukaryota;Amorphea;Obazoa;Opisthokonta;Nucletmycea;Fungi;Dikarya;Ascomycota;Pezizomycotina;Dothideomycetes;Pleosporales;Testudinaceae;";"0.0";"0";"5";"5";"0";"5";"0";"430519";"5766"
"LOK1378_1mm";"SILVA (only NR);Eukaryota;Amorphea;Obazoa;Opisthokonta;Nucletmycea;Fungi;Dikarya;Ascomycota;Pezizomycotina;Dothideomycetes;Pleosporales;Testudinaceae;Lepidosphaeria;";"0.0";"0";"1";"1";"0";"1";"0";"430523";"5766"
"LOK1378_1mm";"SILVA (only NR);Eukaryota;Amorphea;Obazoa;Opisthokonta;Nucletmycea;Fungi;Dikarya;Ascomycota;Pezizomycotina;Dothideomycetes;Pleosporales;Testudinaceae;Neotestudina;";"0.0";"0";"2";"2";"0";"2";"0";"430522";"5766"
"LOK1378_1mm";"SILVA (only NR);Eukaryota;Amorphea;Obazoa;Opisthokonta;Nucletmycea;Fungi;Dikarya;Ascomycota;Pezizomycotina;Dothideomycetes;Pleosporales;Testudinaceae;Ulospora;";"0.0";"0";"2";"2";"0";"2";"0";"430522";"5766"
"LOK1378_1mm";"SILVA (only NR);Eukaryota;Amorphea;Obazoa;Opisthokonta;Nucletmycea;Fungi;Dikarya;Ascomycota;Pezizomycotina;Dothideomycetes;Pleosporales;Torula;";"0.0";"0";"1";"1";"0";"1";"0";"430523";"5766"
"LOK1378_1mm";"SILVA (only NR);Eukaryota;Amorphea;Obazoa;Opisthokonta;Nucletmycea;Fungi;Dikarya;Ascomycota;Pezizomycotina;Dothideomycetes;Pleosporales;Trematosphaeria;";"0.0";"0";"2";"2";"0";"2";"0";"430522";"5766"
"LOK1378_1mm";"SILVA (only NR);Eukaryota;Amorphea;Obazoa;Opisthokonta;Nucletmycea;Fungi;Dikarya;Ascomycota;Pezizomycotina;Dothideomycetes;Pleosporales;Trematosphaeriaceae;";"0.0";"0";"2";"2";"0";"2";"0";"430522";"5766"
"LOK1378_1mm";"SILVA (only NR);Eukaryota;Amorphea;Obazoa;Opisthokonta;Nucletmycea;Fungi;Dikarya;Ascomycota;Pezizomycotina;Dothideomycetes;Pleosporales;Trematosphaeriaceae;Falciformispora;";"0.0";"0";"1";"1";"0";"1";"0";"430523";"5766"
"LOK1378_1mm";"SILVA (only NR);Eukaryota;Amorphea;Obazoa;Opisthokonta;Nucletmycea;Fungi;Dikarya;Ascomycota;Pezizomycotina;Dothideomycetes;Pleosporales;Zopfia;";"0.0";"0";"1";"1";"0";"1";"0";"430523";"5766"
"LOK1378_1mm";"SILVA (only NR);Eukaryota;Amorphea;Obazoa;Opisthokonta;Nucletmycea;Fungi;Dikarya;Ascomycota;Pezizomycotina;Dothideomycetes;Pleosporales;uncultured;";"0.0";"0";"31";"31";"0";"31";"0";"430493";"5766"
"LOK1378_1mm";"SILVA (only NR);Eukaryota;Amorphea;Obazoa;Opisthokonta;Nucletmycea;Fungi;Dikarya;Ascomycota;Pezizomycotina;Dothideomycetes;Stigmatodiscales;";"0.0";"0";"5";"5";"0";"5";"0";"430519";"5766"
"LOK1378_1mm";"SILVA (only NR);Eukaryota;Amorphea;Obazoa;Opisthokonta;Nucletmycea;Fungi;Dikarya;Ascomycota;Pezizomycotina;Dothideomycetes;Stigmatodiscales;Stigmatodiscaceae;";"0.0";"0";"5";"5";"0";"5";"0";"430519";"5766"
"LOK1378_1mm";"SILVA (only NR);Eukaryota;Amorphea;Obazoa;Opisthokonta;Nucletmycea;Fungi;Dikarya;Ascomycota;Pezizomycotina;Dothideomycetes;Stigmatodiscales;Stigmatodiscaceae;Asterodiscus;";"0.0";"0";"1";"1";"0";"1";"0";"430523";"5766"
"LOK1378_1mm";"SILVA (only NR);Eukaryota;Amorphea;Obazoa;Opisthokonta;Nucletmycea;Fungi;Dikarya;Ascomycota;Pezizomycotina;Dothideomycetes;Stigmatodiscales;Stigmatodiscaceae;Stigmatodiscus;";"0.0";"0";"2";"2";"0";"2";"0";"430522";"5766"
"LOK1378_1mm";"SILVA (only NR);Eukaryota;Amorphea;Obazoa;Opisthokonta;Nucletmycea;Fungi;Dikarya;Ascomycota;Pezizomycotina;Dothideomycetes;Stigmatodiscales;Stigmatodiscaceae;uncultured;";"0.0";"0";"2";"2";"0";"2";"0";"430522";"5766"
"LOK1378_1mm";"SILVA (only NR);Eukaryota;Amorphea;Obazoa;Opisthokonta;Nucletmycea;Fungi;Dikarya;Ascomycota;Pezizomycotina;Dothideomycetes;Tubeufiales;";"0.0";"0";"32";"30";"0";"30";"2";"430494";"5766"
"LOK1378_1mm";"SILVA (only NR);Eukaryota;Amorphea;Obazoa;Opisthokonta;Nucletmycea;Fungi;Dikarya;Ascomycota;Pezizomycotina;Dothideomycetes;Tubeufiales;Tubeufiaceae;";"0.0";"0";"31";"30";"0";"30";"1";"430494";"5766"
"LOK1378_1mm";"SILVA (only NR);Eukaryota;Amorphea;Obazoa;Opisthokonta;Nucletmycea;Fungi;Dikarya;Ascomycota;Pezizomycotina;Dothideomycetes;Tubeufiales;Tubeufiaceae;Acanthostigma;";"0.0";"0";"1";"1";"0";"1";"0";"430523";"5766"
"LOK1378_1mm";"SILVA (only NR);Eukaryota;Amorphea;Obazoa;Opisthokonta;Nucletmycea;Fungi;Dikarya;Ascomycota;Pezizomycotina;Dothideomycetes;Tubeufiales;Tubeufiaceae;Aquaphila;";"0.0";"0";"1";"1";"0";"1";"0";"430523";"5766"
"LOK1378_1mm";"SILVA (only NR);Eukaryota;Amorphea;Obazoa;Opisthokonta;Nucletmycea;Fungi;Dikarya;Ascomycota;Pezizomycotina;Dothideomycetes;Tubeufiales;Tubeufiaceae;Helicoma;";"0.0";"0";"11";"10";"0";"10";"1";"430514";"5766"
"LOK1378_1mm";"SILVA (only NR);Eukaryota;Amorphea;Obazoa;Opisthokonta;Nucletmycea;Fungi;Dikarya;Ascomycota;Pezizomycotina;Dothideomycetes;Tubeufiales;Tubeufiaceae;Helicomyces;";"0.0";"0";"4";"4";"0";"4";"0";"430520";"5766"
"LOK1378_1mm";"SILVA (only NR);Eukaryota;Amorphea;Obazoa;Opisthokonta;Nucletmycea;Fungi;Dikarya;Ascomycota;Pezizomycotina;Dothideomycetes;Tubeufiales;Tubeufiaceae;Helicosporium;";"0.0";"0";"7";"7";"0";"7";"0";"430517";"5766"
"LOK1378_1mm";"SILVA (only NR);Eukaryota;Amorphea;Obazoa;Opisthokonta;Nucletmycea;Fungi;Dikarya;Ascomycota;Pezizomycotina;Dothideomycetes;Tubeufiales;Tubeufiaceae;Tubeufia;";"0.0";"0";"7";"7";"0";"7";"0";"430517";"5766"
"LOK1378_1mm";"SILVA (only NR);Eukaryota;Amorphea;Obazoa;Opisthokonta;Nucletmycea;Fungi;Dikarya;Ascomycota;Pezizomycotina;Dothideomycetes;Tubeufiales;Wiesneriomyces;";"0.0";"0";"1";"0";"0";"0";"1";"430524";"5766"
"LOK1378_1mm";"SILVA (only NR);Eukaryota;Amorphea;Obazoa;Opisthokonta;Nucletmycea;Fungi;Dikarya;Ascomycota;Pezizomycotina;Dothideomycetes;Valsariales;";"0.0";"0";"4";"4";"0";"4";"0";"430520";"5766"
"LOK1378_1mm";"SILVA (only NR);Eukaryota;Amorphea;Obazoa;Opisthokonta;Nucletmycea;Fungi;Dikarya;Ascomycota;Pezizomycotina;Dothideomycetes;Valsariales;Valsariaceae;";"0.0";"0";"4";"4";"0";"4";"0";"430520";"5766"
"LOK1378_1mm";"SILVA (only NR);Eukaryota;Amorphea;Obazoa;Opisthokonta;Nucletmycea;Fungi;Dikarya;Ascomycota;Pezizomycotina;Dothideomycetes;Valsariales;Valsariaceae;Myrmaecium;";"0.0";"0";"1";"1";"0";"1";"0";"430523";"5766"
"LOK1378_1mm";"SILVA (only NR);Eukaryota;Amorphea;Obazoa;Opisthokonta;Nucletmycea;Fungi;Dikarya;Ascomycota;Pezizomycotina;Dothideomycetes;Valsariales;Valsariaceae;Valsaria;";"0.0";"0";"3";"3";"0";"3";"0";"430521";"5766"
"LOK1378_1mm";"SILVA (only NR);Eukaryota;Amorphea;Obazoa;Opisthokonta;Nucletmycea;Fungi;Dikarya;Ascomycota;Pezizomycotina;Dothideomycetes;Venturiales;";"0.0";"0";"33";"23";"0";"23";"10";"430501";"5766"
"LOK1378_1mm";"SILVA (only NR);Eukaryota;Amorphea;Obazoa;Opisthokonta;Nucletmycea;Fungi;Dikarya;Ascomycota;Pezizomycotina;Dothideomycetes;Venturiales;Sympoventuriaceae;";"0.0";"0";"28";"19";"0";"19";"9";"430505";"5766"
"LOK1378_1mm";"SILVA (only NR);Eukaryota;Amorphea;Obazoa;Opisthokonta;Nucletmycea;Fungi;Dikarya;Ascomycota;Pezizomycotina;Dothideomycetes;Venturiales;Sympoventuriaceae;Fusicladium;";"0.0";"0";"1";"1";"0";"1";"0";"430523";"5766"
"LOK1378_1mm";"SILVA (only NR);Eukaryota;Amorphea;Obazoa;Opisthokonta;Nucletmycea;Fungi;Dikarya;Ascomycota;Pezizomycotina;Dothideomycetes;Venturiales;Sympoventuriaceae;Mycosisymbrium;";"0.0";"0";"1";"1";"0";"1";"0";"430523";"5766"
"LOK1378_1mm";"SILVA (only NR);Eukaryota;Amorphea;Obazoa;Opisthokonta;Nucletmycea;Fungi;Dikarya;Ascomycota;Pezizomycotina;Dothideomycetes;Venturiales;Sympoventuriaceae;Ochroconis;";"0.0";"0";"20";"12";"0";"12";"8";"430512";"5766"
"LOK1378_1mm";"SILVA (only NR);Eukaryota;Amorphea;Obazoa;Opisthokonta;Nucletmycea;Fungi;Dikarya;Ascomycota;Pezizomycotina;Dothideomycetes;Venturiales;Sympoventuriaceae;Veronaeopsis;";"0.0";"0";"1";"0";"0";"0";"1";"430524";"5766"
"LOK1378_1mm";"SILVA (only NR);Eukaryota;Amorphea;Obazoa;Opisthokonta;Nucletmycea;Fungi;Dikarya;Ascomycota;Pezizomycotina;Dothideomycetes;Venturiales;Sympoventuriaceae;Verruconis;";"0.0";"0";"2";"2";"0";"2";"0";"430522";"5766"
"LOK1378_1mm";"SILVA (only NR);Eukaryota;Amorphea;Obazoa;Opisthokonta;Nucletmycea;Fungi;Dikarya;Ascomycota;Pezizomycotina;Dothideomycetes;Venturiales;Sympoventuriaceae;uncultured;";"0.0";"0";"2";"2";"0";"2";"0";"430522";"5766"
"LOK1378_1mm";"SILVA (only NR);Eukaryota;Amorphea;Obazoa;Opisthokonta;Nucletmycea;Fungi;Dikarya;Ascomycota;Pezizomycotina;Dothideomycetes;Venturiales;Venturiaceae;";"0.0";"0";"5";"4";"0";"4";"1";"430520";"5766"
"LOK1378_1mm";"SILVA (only NR);Eukaryota;Amorphea;Obazoa;Opisthokonta;Nucletmycea;Fungi;Dikarya;Ascomycota;Pezizomycotina;Dothideomycetes;Venturiales;Venturiaceae;Venturia;";"0.0";"0";"5";"4";"0";"4";"1";"430520";"5766"
"LOK1378_1mm";"SILVA (only NR);Eukaryota;Amorphea;Obazoa;Opisthokonta;Nucletmycea;Fungi;Dikarya;Ascomycota;Pezizomycotina;Dothideomycetes;uncultured;";"0.0";"0";"8";"8";"0";"8";"0";"430516";"5766"
"LOK1378_1mm";"SILVA (only NR);Eukaryota;Amorphea;Obazoa;Opisthokonta;Nucletmycea;Fungi;Dikarya;Ascomycota;Pezizomycotina;Eurotiomycetes;";"0.0";"0";"833";"759";"0";"759";"74";"429765";"5766"
"LOK1378_1mm";"SILVA (only NR);Eukaryota;Amorphea;Obazoa;Opisthokonta;Nucletmycea;Fungi;Dikarya;Ascomycota;Pezizomycotina;Eurotiomycetes;Chaetothyriales;";"0.0";"0";"176";"173";"0";"173";"3";"430351";"5766"
"LOK1378_1mm";"SILVA (only NR);Eukaryota;Amorphea;Obazoa;Opisthokonta;Nucletmycea;Fungi;Dikarya;Ascomycota;Pezizomycotina;Eurotiomycetes;Chaetothyriales;Chaetothyriaceae;";"0.0";"0";"4";"4";"0";"4";"0";"430520";"5766"
"LOK1378_1mm";"SILVA (only NR);Eukaryota;Amorphea;Obazoa;Opisthokonta;Nucletmycea;Fungi;Dikarya;Ascomycota;Pezizomycotina;Eurotiomycetes;Chaetothyriales;Chaetothyriaceae;Camptophora;";"0.0";"0";"2";"2";"0";"2";"0";"430522";"5766"
"LOK1378_1mm";"SILVA (only NR);Eukaryota;Amorphea;Obazoa;Opisthokonta;Nucletmycea;Fungi;Dikarya;Ascomycota;Pezizomycotina;Eurotiomycetes;Chaetothyriales;Chaetothyriaceae;Ceramothyrium;";"0.0";"0";"2";"2";"0";"2";"0";"430522";"5766"
"LOK1378_1mm";"SILVA (only NR);Eukaryota;Amorphea;Obazoa;Opisthokonta;Nucletmycea;Fungi;Dikarya;Ascomycota;Pezizomycotina;Eurotiomycetes;Chaetothyriales;Cyphellophoraceae;";"0.0";"0";"17";"17";"0";"17";"0";"430507";"5766"
"LOK1378_1mm";"SILVA (only NR);Eukaryota;Amorphea;Obazoa;Opisthokonta;Nucletmycea;Fungi;Dikarya;Ascomycota;Pezizomycotina;Eurotiomycetes;Chaetothyriales;Cyphellophoraceae;Cyphellophora;";"0.0";"0";"17";"17";"0";"17";"0";"430507";"5766"
"LOK1378_1mm";"SILVA (only NR);Eukaryota;Amorphea;Obazoa;Opisthokonta;Nucletmycea;Fungi;Dikarya;Ascomycota;Pezizomycotina;Eurotiomycetes;Chaetothyriales;Herpotrichiellaceae;";"0.0";"0";"109";"106";"0";"106";"3";"430418";"5766"
"LOK1378_1mm";"SILVA (only NR);Eukaryota;Amorphea;Obazoa;Opisthokonta;Nucletmycea;Fungi;Dikarya;Ascomycota;Pezizomycotina;Eurotiomycetes;Chaetothyriales;Herpotrichiellaceae;Berlesiella;";"0.0";"0";"1";"1";"0";"1";"0";"430523";"5766"
"LOK1378_1mm";"SILVA (only NR);Eukaryota;Amorphea;Obazoa;Opisthokonta;Nucletmycea;Fungi;Dikarya;Ascomycota;Pezizomycotina;Eurotiomycetes;Chaetothyriales;Herpotrichiellaceae;Capronia;";"0.0";"0";"15";"15";"0";"15";"0";"430509";"5766"
"LOK1378_1mm";"SILVA (only NR);Eukaryota;Amorphea;Obazoa;Opisthokonta;Nucletmycea;Fungi;Dikarya;Ascomycota;Pezizomycotina;Eurotiomycetes;Chaetothyriales;Herpotrichiellaceae;Cladophialophora;";"0.0";"0";"25";"25";"0";"25";"0";"430499";"5766"
"LOK1378_1mm";"SILVA (only NR);Eukaryota;Amorphea;Obazoa;Opisthokonta;Nucletmycea;Fungi;Dikarya;Ascomycota;Pezizomycotina;Eurotiomycetes;Chaetothyriales;Herpotrichiellaceae;Exophiala;";"0.0";"0";"44";"43";"0";"43";"1";"430481";"5766"
"LOK1378_1mm";"SILVA (only NR);Eukaryota;Amorphea;Obazoa;Opisthokonta;Nucletmycea;Fungi;Dikarya;Ascomycota;Pezizomycotina;Eurotiomycetes;Chaetothyriales;Herpotrichiellaceae;Fonsecaea;";"0.0";"0";"9";"9";"0";"9";"0";"430515";"5766"
"LOK1378_1mm";"SILVA (only NR);Eukaryota;Amorphea;Obazoa;Opisthokonta;Nucletmycea;Fungi;Dikarya;Ascomycota;Pezizomycotina;Eurotiomycetes;Chaetothyriales;Herpotrichiellaceae;Phialophora;";"0.0";"0";"5";"4";"0";"4";"1";"430520";"5766"
"LOK1378_1mm";"SILVA (only NR);Eukaryota;Amorphea;Obazoa;Opisthokonta;Nucletmycea;Fungi;Dikarya;Ascomycota;Pezizomycotina;Eurotiomycetes;Chaetothyriales;Herpotrichiellaceae;Rhinocladiella;";"0.0";"0";"5";"5";"0";"5";"0";"430519";"5766"
"LOK1378_1mm";"SILVA (only NR);Eukaryota;Amorphea;Obazoa;Opisthokonta;Nucletmycea;Fungi;Dikarya;Ascomycota;Pezizomycotina;Eurotiomycetes;Chaetothyriales;Herpotrichiellaceae;Veronaea;";"0.0";"0";"1";"1";"0";"1";"0";"430523";"5766"
"LOK1378_1mm";"SILVA (only NR);Eukaryota;Amorphea;Obazoa;Opisthokonta;Nucletmycea;Fungi;Dikarya;Ascomycota;Pezizomycotina;Eurotiomycetes;Chaetothyriales;Herpotrichiellaceae;uncultured;";"0.0";"0";"2";"2";"0";"2";"0";"430522";"5766"
"LOK1378_1mm";"SILVA (only NR);Eukaryota;Amorphea;Obazoa;Opisthokonta;Nucletmycea;Fungi;Dikarya;Ascomycota;Pezizomycotina;Eurotiomycetes;Chaetothyriales;Trichomeriaceae;";"0.0";"0";"34";"34";"0";"34";"0";"430490";"5766"
"LOK1378_1mm";"SILVA (only NR);Eukaryota;Amorphea;Obazoa;Opisthokonta;Nucletmycea;Fungi;Dikarya;Ascomycota;Pezizomycotina;Eurotiomycetes;Chaetothyriales;Trichomeriaceae;Bacillicladium;";"0.0";"0";"1";"1";"0";"1";"0";"430523";"5766"
"LOK1378_1mm";"SILVA (only NR);Eukaryota;Amorphea;Obazoa;Opisthokonta;Nucletmycea;Fungi;Dikarya;Ascomycota;Pezizomycotina;Eurotiomycetes;Chaetothyriales;Trichomeriaceae;Bradymyces;";"0.0";"0";"10";"10";"0";"10";"0";"430514";"5766"
"LOK1378_1mm";"SILVA (only NR);Eukaryota;Amorphea;Obazoa;Opisthokonta;Nucletmycea;Fungi;Dikarya;Ascomycota;Pezizomycotina;Eurotiomycetes;Chaetothyriales;Trichomeriaceae;Knufia;";"0.0";"0";"18";"18";"0";"18";"0";"430506";"5766"
"LOK1378_1mm";"SILVA (only NR);Eukaryota;Amorphea;Obazoa;Opisthokonta;Nucletmycea;Fungi;Dikarya;Ascomycota;Pezizomycotina;Eurotiomycetes;Chaetothyriales;Trichomeriaceae;Neophaeococcomyces;";"0.0";"0";"1";"1";"0";"1";"0";"430523";"5766"
"LOK1378_1mm";"SILVA (only NR);Eukaryota;Amorphea;Obazoa;Opisthokonta;Nucletmycea;Fungi;Dikarya;Ascomycota;Pezizomycotina;Eurotiomycetes;Chaetothyriales;Trichomeriaceae;uncultured;";"0.0";"0";"2";"2";"0";"2";"0";"430522";"5766"
"LOK1378_1mm";"SILVA (only NR);Eukaryota;Amorphea;Obazoa;Opisthokonta;Nucletmycea;Fungi;Dikarya;Ascomycota;Pezizomycotina;Eurotiomycetes;Chaetothyriales;uncultured;";"0.0";"0";"8";"8";"0";"8";"0";"430516";"5766"
"LOK1378_1mm";"SILVA (only NR);Eukaryota;Amorphea;Obazoa;Opisthokonta;Nucletmycea;Fungi;Dikarya;Ascomycota;Pezizomycotina;Eurotiomycetes;Coryneliales;";"0.0";"0";"5";"5";"0";"5";"0";"430519";"5766"
"LOK1378_1mm";"SILVA (only NR);Eukaryota;Amorphea;Obazoa;Opisthokonta;Nucletmycea;Fungi;Dikarya;Ascomycota;Pezizomycotina;Eurotiomycetes;Coryneliales;Coryneliaceae;";"0.0";"0";"5";"5";"0";"5";"0";"430519";"5766"
"LOK1378_1mm";"SILVA (only NR);Eukaryota;Amorphea;Obazoa;Opisthokonta;Nucletmycea;Fungi;Dikarya;Ascomycota;Pezizomycotina;Eurotiomycetes;Coryneliales;Coryneliaceae;Caliciopsis;";"0.0";"0";"2";"2";"0";"2";"0";"430522";"5766"
"LOK1378_1mm";"SILVA (only NR);Eukaryota;Amorphea;Obazoa;Opisthokonta;Nucletmycea;Fungi;Dikarya;Ascomycota;Pezizomycotina;Eurotiomycetes;Coryneliales;Coryneliaceae;Corynelia;";"0.0";"0";"2";"2";"0";"2";"0";"430522";"5766"
"LOK1378_1mm";"SILVA (only NR);Eukaryota;Amorphea;Obazoa;Opisthokonta;Nucletmycea;Fungi;Dikarya;Ascomycota;Pezizomycotina;Eurotiomycetes;Coryneliales;Coryneliaceae;Lagenulopsis;";"0.0";"0";"1";"1";"0";"1";"0";"430523";"5766"
"LOK1378_1mm";"SILVA (only NR);Eukaryota;Amorphea;Obazoa;Opisthokonta;Nucletmycea;Fungi;Dikarya;Ascomycota;Pezizomycotina;Eurotiomycetes;Eurotiales;";"0.0";"0";"440";"378";"0";"378";"62";"430146";"5766"
"LOK1378_1mm";"SILVA (only NR);Eukaryota;Amorphea;Obazoa;Opisthokonta;Nucletmycea;Fungi;Dikarya;Ascomycota;Pezizomycotina;Eurotiomycetes;Eurotiales;Aspergillaceae;";"0.0";"0";"304";"272";"0";"272";"32";"430252";"5766"
"LOK1378_1mm";"SILVA (only NR);Eukaryota;Amorphea;Obazoa;Opisthokonta;Nucletmycea;Fungi;Dikarya;Ascomycota;Pezizomycotina;Eurotiomycetes;Eurotiales;Aspergillaceae;Aspergillus;";"0.0";"0";"201";"179";"0";"179";"22";"430345";"5766"
"LOK1378_1mm";"SILVA (only NR);Eukaryota;Amorphea;Obazoa;Opisthokonta;Nucletmycea;Fungi;Dikarya;Ascomycota;Pezizomycotina;Eurotiomycetes;Eurotiales;Aspergillaceae;Chromocleista;";"0.0";"0";"2";"2";"0";"2";"0";"430522";"5766"
"LOK1378_1mm";"SILVA (only NR);Eukaryota;Amorphea;Obazoa;Opisthokonta;Nucletmycea;Fungi;Dikarya;Ascomycota;Pezizomycotina;Eurotiomycetes;Eurotiales;Aspergillaceae;Eurotium;";"0.0";"0";"1";"1";"0";"1";"0";"430523";"5766"
"LOK1378_1mm";"SILVA (only NR);Eukaryota;Amorphea;Obazoa;Opisthokonta;Nucletmycea;Fungi;Dikarya;Ascomycota;Pezizomycotina;Eurotiomycetes;Eurotiales;Aspergillaceae;Hamigera;";"0.0";"0";"3";"3";"0";"3";"0";"430521";"5766"
"LOK1378_1mm";"SILVA (only NR);Eukaryota;Amorphea;Obazoa;Opisthokonta;Nucletmycea;Fungi;Dikarya;Ascomycota;Pezizomycotina;Eurotiomycetes;Eurotiales;Aspergillaceae;Leiothecium;";"0.0";"0";"2";"2";"0";"2";"0";"430522";"5766"
"LOK1378_1mm";"SILVA (only NR);Eukaryota;Amorphea;Obazoa;Opisthokonta;Nucletmycea;Fungi;Dikarya;Ascomycota;Pezizomycotina;Eurotiomycetes;Eurotiales;Aspergillaceae;Merimbla;";"0.0";"0";"1";"1";"0";"1";"0";"430523";"5766"
"LOK1378_1mm";"SILVA (only NR);Eukaryota;Amorphea;Obazoa;Opisthokonta;Nucletmycea;Fungi;Dikarya;Ascomycota;Pezizomycotina;Eurotiomycetes;Eurotiales;Aspergillaceae;Monascus;";"0.0";"0";"8";"6";"0";"6";"2";"430518";"5766"
"LOK1378_1mm";"SILVA (only NR);Eukaryota;Amorphea;Obazoa;Opisthokonta;Nucletmycea;Fungi;Dikarya;Ascomycota;Pezizomycotina;Eurotiomycetes;Eurotiales;Aspergillaceae;Penicilliopsis;";"0.0";"0";"5";"5";"0";"5";"0";"430519";"5766"
"LOK1378_1mm";"SILVA (only NR);Eukaryota;Amorphea;Obazoa;Opisthokonta;Nucletmycea;Fungi;Dikarya;Ascomycota;Pezizomycotina;Eurotiomycetes;Eurotiales;Aspergillaceae;Penicillium;";"0.0";"0";"60";"52";"0";"52";"8";"430472";"5766"
"LOK1378_1mm";"SILVA (only NR);Eukaryota;Amorphea;Obazoa;Opisthokonta;Nucletmycea;Fungi;Dikarya;Ascomycota;Pezizomycotina;Eurotiomycetes;Eurotiales;Aspergillaceae;Sclerocleista;";"0.0";"0";"3";"3";"0";"3";"0";"430521";"5766"
"LOK1378_1mm";"SILVA (only NR);Eukaryota;Amorphea;Obazoa;Opisthokonta;Nucletmycea;Fungi;Dikarya;Ascomycota;Pezizomycotina;Eurotiomycetes;Eurotiales;Aspergillaceae;Thysanophora;";"0.0";"0";"10";"10";"0";"10";"0";"430514";"5766"
"LOK1378_1mm";"SILVA (only NR);Eukaryota;Amorphea;Obazoa;Opisthokonta;Nucletmycea;Fungi;Dikarya;Ascomycota;Pezizomycotina;Eurotiomycetes;Eurotiales;Aspergillaceae;Warcupiella;";"0.0";"0";"2";"2";"0";"2";"0";"430522";"5766"
"LOK1378_1mm";"SILVA (only NR);Eukaryota;Amorphea;Obazoa;Opisthokonta;Nucletmycea;Fungi;Dikarya;Ascomycota;Pezizomycotina;Eurotiomycetes;Eurotiales;Aspergillaceae;Xerochrysium;";"0.0";"0";"1";"1";"0";"1";"0";"430523";"5766"
"LOK1378_1mm";"SILVA (only NR);Eukaryota;Amorphea;Obazoa;Opisthokonta;Nucletmycea;Fungi;Dikarya;Ascomycota;Pezizomycotina;Eurotiomycetes;Eurotiales;Aspergillaceae;Xeromyces;";"0.0";"0";"3";"3";"0";"3";"0";"430521";"5766"
"LOK1378_1mm";"SILVA (only NR);Eukaryota;Amorphea;Obazoa;Opisthokonta;Nucletmycea;Fungi;Dikarya;Ascomycota;Pezizomycotina;Eurotiomycetes;Eurotiales;Elaphomycetaceae;";"0.0";"0";"4";"3";"0";"3";"1";"430521";"5766"
"LOK1378_1mm";"SILVA (only NR);Eukaryota;Amorphea;Obazoa;Opisthokonta;Nucletmycea;Fungi;Dikarya;Ascomycota;Pezizomycotina;Eurotiomycetes;Eurotiales;Elaphomycetaceae;Elaphomyces;";"0.0";"0";"2";"1";"0";"1";"1";"430523";"5766"
"LOK1378_1mm";"SILVA (only NR);Eukaryota;Amorphea;Obazoa;Opisthokonta;Nucletmycea;Fungi;Dikarya;Ascomycota;Pezizomycotina;Eurotiomycetes;Eurotiales;Elaphomycetaceae;Pseudotulostoma;";"0.0";"0";"2";"2";"0";"2";"0";"430522";"5766"
"LOK1378_1mm";"SILVA (only NR);Eukaryota;Amorphea;Obazoa;Opisthokonta;Nucletmycea;Fungi;Dikarya;Ascomycota;Pezizomycotina;Eurotiomycetes;Eurotiales;Incertae Sedis;";"0.0";"0";"2";"2";"0";"2";"0";"430522";"5766"
"LOK1378_1mm";"SILVA (only NR);Eukaryota;Amorphea;Obazoa;Opisthokonta;Nucletmycea;Fungi;Dikarya;Ascomycota;Pezizomycotina;Eurotiomycetes;Eurotiales;Incertae Sedis;Eladia;";"0.0";"0";"2";"2";"0";"2";"0";"430522";"5766"
"LOK1378_1mm";"SILVA (only NR);Eukaryota;Amorphea;Obazoa;Opisthokonta;Nucletmycea;Fungi;Dikarya;Ascomycota;Pezizomycotina;Eurotiomycetes;Eurotiales;Thermoascaceae;";"0.0";"0";"17";"16";"0";"16";"1";"430508";"5766"
"LOK1378_1mm";"SILVA (only NR);Eukaryota;Amorphea;Obazoa;Opisthokonta;Nucletmycea;Fungi;Dikarya;Ascomycota;Pezizomycotina;Eurotiomycetes;Eurotiales;Thermoascaceae;Byssochlamys;";"0.0";"0";"13";"12";"0";"12";"1";"430512";"5766"
"LOK1378_1mm";"SILVA (only NR);Eukaryota;Amorphea;Obazoa;Opisthokonta;Nucletmycea;Fungi;Dikarya;Ascomycota;Pezizomycotina;Eurotiomycetes;Eurotiales;Thermoascaceae;Thermoascus;";"0.0";"0";"4";"4";"0";"4";"0";"430520";"5766"
"LOK1378_1mm";"SILVA (only NR);Eukaryota;Amorphea;Obazoa;Opisthokonta;Nucletmycea;Fungi;Dikarya;Ascomycota;Pezizomycotina;Eurotiomycetes;Eurotiales;Trichocomaceae;";"0.0";"0";"110";"82";"0";"82";"28";"430442";"5766"
"LOK1378_1mm";"SILVA (only NR);Eukaryota;Amorphea;Obazoa;Opisthokonta;Nucletmycea;Fungi;Dikarya;Ascomycota;Pezizomycotina;Eurotiomycetes;Eurotiales;Trichocomaceae;Rasamsonia;";"0.0";"0";"6";"5";"0";"5";"1";"430519";"5766"
"LOK1378_1mm";"SILVA (only NR);Eukaryota;Amorphea;Obazoa;Opisthokonta;Nucletmycea;Fungi;Dikarya;Ascomycota;Pezizomycotina;Eurotiomycetes;Eurotiales;Trichocomaceae;Sagenomella;";"0.0";"0";"6";"6";"0";"6";"0";"430518";"5766"
"LOK1378_1mm";"SILVA (only NR);Eukaryota;Amorphea;Obazoa;Opisthokonta;Nucletmycea;Fungi;Dikarya;Ascomycota;Pezizomycotina;Eurotiomycetes;Eurotiales;Trichocomaceae;Talaromyces;";"0.0";"0";"91";"64";"0";"64";"27";"430460";"5766"
"LOK1378_1mm";"SILVA (only NR);Eukaryota;Amorphea;Obazoa;Opisthokonta;Nucletmycea;Fungi;Dikarya;Ascomycota;Pezizomycotina;Eurotiomycetes;Eurotiales;Trichocomaceae;Thermomyces;";"0.0";"0";"3";"3";"0";"3";"0";"430521";"5766"
"LOK1378_1mm";"SILVA (only NR);Eukaryota;Amorphea;Obazoa;Opisthokonta;Nucletmycea;Fungi;Dikarya;Ascomycota;Pezizomycotina;Eurotiomycetes;Eurotiales;Trichocomaceae;Trichocoma;";"0.0";"0";"3";"3";"0";"3";"0";"430521";"5766"
"LOK1378_1mm";"SILVA (only NR);Eukaryota;Amorphea;Obazoa;Opisthokonta;Nucletmycea;Fungi;Dikarya;Ascomycota;Pezizomycotina;Eurotiomycetes;Incertae Sedis;";"0.0";"0";"3";"3";"0";"3";"0";"430521";"5766"
"LOK1378_1mm";"SILVA (only NR);Eukaryota;Amorphea;Obazoa;Opisthokonta;Nucletmycea;Fungi;Dikarya;Ascomycota;Pezizomycotina;Eurotiomycetes;Incertae Sedis;Incertae Sedis;";"0.0";"0";"1";"1";"0";"1";"0";"430523";"5766"
"LOK1378_1mm";"SILVA (only NR);Eukaryota;Amorphea;Obazoa;Opisthokonta;Nucletmycea;Fungi;Dikarya;Ascomycota;Pezizomycotina;Eurotiomycetes;Incertae Sedis;Incertae Sedis;Pseudospiromastix;";"0.0";"0";"1";"1";"0";"1";"0";"430523";"5766"
"LOK1378_1mm";"SILVA (only NR);Eukaryota;Amorphea;Obazoa;Opisthokonta;Nucletmycea;Fungi;Dikarya;Ascomycota;Pezizomycotina;Eurotiomycetes;Incertae Sedis;Rhynchostomataceae;";"0.0";"0";"2";"2";"0";"2";"0";"430522";"5766"
"LOK1378_1mm";"SILVA (only NR);Eukaryota;Amorphea;Obazoa;Opisthokonta;Nucletmycea;Fungi;Dikarya;Ascomycota;Pezizomycotina;Eurotiomycetes;Incertae Sedis;Rhynchostomataceae;Rhynchostoma;";"0.0";"0";"2";"2";"0";"2";"0";"430522";"5766"
"LOK1378_1mm";"SILVA (only NR);Eukaryota;Amorphea;Obazoa;Opisthokonta;Nucletmycea;Fungi;Dikarya;Ascomycota;Pezizomycotina;Eurotiomycetes;Mycocaliciales;";"0.0";"0";"4";"4";"0";"4";"0";"430520";"5766"
"LOK1378_1mm";"SILVA (only NR);Eukaryota;Amorphea;Obazoa;Opisthokonta;Nucletmycea;Fungi;Dikarya;Ascomycota;Pezizomycotina;Eurotiomycetes;Mycocaliciales;Mycocaliciaceae;";"0.0";"0";"3";"3";"0";"3";"0";"430521";"5766"
"LOK1378_1mm";"SILVA (only NR);Eukaryota;Amorphea;Obazoa;Opisthokonta;Nucletmycea;Fungi;Dikarya;Ascomycota;Pezizomycotina;Eurotiomycetes;Mycocaliciales;Mycocaliciaceae;Chaenothecopsis;";"0.0";"0";"1";"1";"0";"1";"0";"430523";"5766"
"LOK1378_1mm";"SILVA (only NR);Eukaryota;Amorphea;Obazoa;Opisthokonta;Nucletmycea;Fungi;Dikarya;Ascomycota;Pezizomycotina;Eurotiomycetes;Mycocaliciales;Mycocaliciaceae;Mycocalicium;";"0.0";"0";"1";"1";"0";"1";"0";"430523";"5766"
"LOK1378_1mm";"SILVA (only NR);Eukaryota;Amorphea;Obazoa;Opisthokonta;Nucletmycea;Fungi;Dikarya;Ascomycota;Pezizomycotina;Eurotiomycetes;Mycocaliciales;Mycocaliciaceae;Stenocybe;";"0.0";"0";"1";"1";"0";"1";"0";"430523";"5766"
"LOK1378_1mm";"SILVA (only NR);Eukaryota;Amorphea;Obazoa;Opisthokonta;Nucletmycea;Fungi;Dikarya;Ascomycota;Pezizomycotina;Eurotiomycetes;Mycocaliciales;Sphinctrina;";"0.0";"0";"1";"1";"0";"1";"0";"430523";"5766"
"LOK1378_1mm";"SILVA (only NR);Eukaryota;Amorphea;Obazoa;Opisthokonta;Nucletmycea;Fungi;Dikarya;Ascomycota;Pezizomycotina;Eurotiomycetes;Onygenales;";"0.0";"0";"150";"142";"0";"142";"8";"430382";"5766"
"LOK1378_1mm";"SILVA (only NR);Eukaryota;Amorphea;Obazoa;Opisthokonta;Nucletmycea;Fungi;Dikarya;Ascomycota;Pezizomycotina;Eurotiomycetes;Onygenales;Ajellomycetaceae;";"0.0";"0";"19";"17";"0";"17";"2";"430507";"5766"
"LOK1378_1mm";"SILVA (only NR);Eukaryota;Amorphea;Obazoa;Opisthokonta;Nucletmycea;Fungi;Dikarya;Ascomycota;Pezizomycotina;Eurotiomycetes;Onygenales;Ajellomycetaceae;Blastomyces;";"0.0";"0";"6";"6";"0";"6";"0";"430518";"5766"
"LOK1378_1mm";"SILVA (only NR);Eukaryota;Amorphea;Obazoa;Opisthokonta;Nucletmycea;Fungi;Dikarya;Ascomycota;Pezizomycotina;Eurotiomycetes;Onygenales;Ajellomycetaceae;Helicocarpus;";"0.0";"0";"1";"1";"0";"1";"0";"430523";"5766"
"LOK1378_1mm";"SILVA (only NR);Eukaryota;Amorphea;Obazoa;Opisthokonta;Nucletmycea;Fungi;Dikarya;Ascomycota;Pezizomycotina;Eurotiomycetes;Onygenales;Ajellomycetaceae;Histoplasma;";"0.0";"0";"8";"7";"0";"7";"1";"430517";"5766"
"LOK1378_1mm";"SILVA (only NR);Eukaryota;Amorphea;Obazoa;Opisthokonta;Nucletmycea;Fungi;Dikarya;Ascomycota;Pezizomycotina;Eurotiomycetes;Onygenales;Ajellomycetaceae;Lacazia;";"0.0";"0";"2";"2";"0";"2";"0";"430522";"5766"
"LOK1378_1mm";"SILVA (only NR);Eukaryota;Amorphea;Obazoa;Opisthokonta;Nucletmycea;Fungi;Dikarya;Ascomycota;Pezizomycotina;Eurotiomycetes;Onygenales;Ajellomycetaceae;Paracoccidioides;";"0.0";"0";"2";"1";"0";"1";"1";"430523";"5766"
"LOK1378_1mm";"SILVA (only NR);Eukaryota;Amorphea;Obazoa;Opisthokonta;Nucletmycea;Fungi;Dikarya;Ascomycota;Pezizomycotina;Eurotiomycetes;Onygenales;Amaurascopsis;";"0.0";"0";"1";"1";"0";"1";"0";"430523";"5766"
"LOK1378_1mm";"SILVA (only NR);Eukaryota;Amorphea;Obazoa;Opisthokonta;Nucletmycea;Fungi;Dikarya;Ascomycota;Pezizomycotina;Eurotiomycetes;Onygenales;Arachnomycetaceae;";"0.0";"0";"8";"7";"0";"7";"1";"430517";"5766"
"LOK1378_1mm";"SILVA (only NR);Eukaryota;Amorphea;Obazoa;Opisthokonta;Nucletmycea;Fungi;Dikarya;Ascomycota;Pezizomycotina;Eurotiomycetes;Onygenales;Arachnomycetaceae;Arachnomyces;";"0.0";"0";"8";"7";"0";"7";"1";"430517";"5766"
"LOK1378_1mm";"SILVA (only NR);Eukaryota;Amorphea;Obazoa;Opisthokonta;Nucletmycea;Fungi;Dikarya;Ascomycota;Pezizomycotina;Eurotiomycetes;Onygenales;Arthrodermataceae;";"0.0";"0";"29";"28";"0";"28";"1";"430496";"5766"
"LOK1378_1mm";"SILVA (only NR);Eukaryota;Amorphea;Obazoa;Opisthokonta;Nucletmycea;Fungi;Dikarya;Ascomycota;Pezizomycotina;Eurotiomycetes;Onygenales;Arthrodermataceae;Arthroderma;";"0.0";"0";"10";"10";"0";"10";"0";"430514";"5766"
"LOK1378_1mm";"SILVA (only NR);Eukaryota;Amorphea;Obazoa;Opisthokonta;Nucletmycea;Fungi;Dikarya;Ascomycota;Pezizomycotina;Eurotiomycetes;Onygenales;Arthrodermataceae;Ctenomyces;";"0.0";"0";"3";"3";"0";"3";"0";"430521";"5766"
"LOK1378_1mm";"SILVA (only NR);Eukaryota;Amorphea;Obazoa;Opisthokonta;Nucletmycea;Fungi;Dikarya;Ascomycota;Pezizomycotina;Eurotiomycetes;Onygenales;Arthrodermataceae;Epidermophyton;";"0.0";"0";"1";"1";"0";"1";"0";"430523";"5766"
"LOK1378_1mm";"SILVA (only NR);Eukaryota;Amorphea;Obazoa;Opisthokonta;Nucletmycea;Fungi;Dikarya;Ascomycota;Pezizomycotina;Eurotiomycetes;Onygenales;Arthrodermataceae;Microsporum;";"0.0";"0";"4";"4";"0";"4";"0";"430520";"5766"
"LOK1378_1mm";"SILVA (only NR);Eukaryota;Amorphea;Obazoa;Opisthokonta;Nucletmycea;Fungi;Dikarya;Ascomycota;Pezizomycotina;Eurotiomycetes;Onygenales;Arthrodermataceae;Nannizzia;";"0.0";"0";"1";"1";"0";"1";"0";"430523";"5766"
"LOK1378_1mm";"SILVA (only NR);Eukaryota;Amorphea;Obazoa;Opisthokonta;Nucletmycea;Fungi;Dikarya;Ascomycota;Pezizomycotina;Eurotiomycetes;Onygenales;Arthrodermataceae;Trichophyton;";"0.0";"0";"10";"9";"0";"9";"1";"430515";"5766"
"LOK1378_1mm";"SILVA (only NR);Eukaryota;Amorphea;Obazoa;Opisthokonta;Nucletmycea;Fungi;Dikarya;Ascomycota;Pezizomycotina;Eurotiomycetes;Onygenales;Ascosphaeraceae;";"0.0";"0";"6";"6";"0";"6";"0";"430518";"5766"
"LOK1378_1mm";"SILVA (only NR);Eukaryota;Amorphea;Obazoa;Opisthokonta;Nucletmycea;Fungi;Dikarya;Ascomycota;Pezizomycotina;Eurotiomycetes;Onygenales;Ascosphaeraceae;Ascosphaera;";"0.0";"0";"6";"6";"0";"6";"0";"430518";"5766"
"LOK1378_1mm";"SILVA (only NR);Eukaryota;Amorphea;Obazoa;Opisthokonta;Nucletmycea;Fungi;Dikarya;Ascomycota;Pezizomycotina;Eurotiomycetes;Onygenales;Auxarthronopsis;";"0.0";"0";"1";"0";"0";"0";"1";"430524";"5766"
"LOK1378_1mm";"SILVA (only NR);Eukaryota;Amorphea;Obazoa;Opisthokonta;Nucletmycea;Fungi;Dikarya;Ascomycota;Pezizomycotina;Eurotiomycetes;Onygenales;Eremascaceae;";"0.0";"0";"2";"2";"0";"2";"0";"430522";"5766"
"LOK1378_1mm";"SILVA (only NR);Eukaryota;Amorphea;Obazoa;Opisthokonta;Nucletmycea;Fungi;Dikarya;Ascomycota;Pezizomycotina;Eurotiomycetes;Onygenales;Eremascaceae;Eremascus;";"0.0";"0";"2";"2";"0";"2";"0";"430522";"5766"
"LOK1378_1mm";"SILVA (only NR);Eukaryota;Amorphea;Obazoa;Opisthokonta;Nucletmycea;Fungi;Dikarya;Ascomycota;Pezizomycotina;Eurotiomycetes;Onygenales;Gymnoascaceae;";"0.0";"0";"12";"12";"0";"12";"0";"430512";"5766"
"LOK1378_1mm";"SILVA (only NR);Eukaryota;Amorphea;Obazoa;Opisthokonta;Nucletmycea;Fungi;Dikarya;Ascomycota;Pezizomycotina;Eurotiomycetes;Onygenales;Gymnoascaceae;Arachniotus;";"0.0";"0";"2";"2";"0";"2";"0";"430522";"5766"
"LOK1378_1mm";"SILVA (only NR);Eukaryota;Amorphea;Obazoa;Opisthokonta;Nucletmycea;Fungi;Dikarya;Ascomycota;Pezizomycotina;Eurotiomycetes;Onygenales;Gymnoascaceae;Gymnascella;";"0.0";"0";"3";"3";"0";"3";"0";"430521";"5766"
"LOK1378_1mm";"SILVA (only NR);Eukaryota;Amorphea;Obazoa;Opisthokonta;Nucletmycea;Fungi;Dikarya;Ascomycota;Pezizomycotina;Eurotiomycetes;Onygenales;Gymnoascaceae;Gymnoascus;";"0.0";"0";"6";"6";"0";"6";"0";"430518";"5766"
"LOK1378_1mm";"SILVA (only NR);Eukaryota;Amorphea;Obazoa;Opisthokonta;Nucletmycea;Fungi;Dikarya;Ascomycota;Pezizomycotina;Eurotiomycetes;Onygenales;Gymnoascaceae;Kraurogymnocarpa;";"0.0";"0";"1";"1";"0";"1";"0";"430523";"5766"
"LOK1378_1mm";"SILVA (only NR);Eukaryota;Amorphea;Obazoa;Opisthokonta;Nucletmycea;Fungi;Dikarya;Ascomycota;Pezizomycotina;Eurotiomycetes;Onygenales;Incertae Sedis;";"0.0";"0";"16";"14";"0";"14";"2";"430510";"5766"
"LOK1378_1mm";"SILVA (only NR);Eukaryota;Amorphea;Obazoa;Opisthokonta;Nucletmycea;Fungi;Dikarya;Ascomycota;Pezizomycotina;Eurotiomycetes;Onygenales;Incertae Sedis;Coccidioides;";"0.0";"0";"14";"12";"0";"12";"2";"430512";"5766"
"LOK1378_1mm";"SILVA (only NR);Eukaryota;Amorphea;Obazoa;Opisthokonta;Nucletmycea;Fungi;Dikarya;Ascomycota;Pezizomycotina;Eurotiomycetes;Onygenales;Incertae Sedis;Spiromastix;";"0.0";"0";"2";"2";"0";"2";"0";"430522";"5766"
"LOK1378_1mm";"SILVA (only NR);Eukaryota;Amorphea;Obazoa;Opisthokonta;Nucletmycea;Fungi;Dikarya;Ascomycota;Pezizomycotina;Eurotiomycetes;Onygenales;Leucothecium;";"0.0";"0";"1";"1";"0";"1";"0";"430523";"5766"
"LOK1378_1mm";"SILVA (only NR);Eukaryota;Amorphea;Obazoa;Opisthokonta;Nucletmycea;Fungi;Dikarya;Ascomycota;Pezizomycotina;Eurotiomycetes;Onygenales;Nannizziopsiaceae;";"0.0";"0";"4";"4";"0";"4";"0";"430520";"5766"
"LOK1378_1mm";"SILVA (only NR);Eukaryota;Amorphea;Obazoa;Opisthokonta;Nucletmycea;Fungi;Dikarya;Ascomycota;Pezizomycotina;Eurotiomycetes;Onygenales;Nannizziopsiaceae;Nannizziopsis;";"0.0";"0";"2";"2";"0";"2";"0";"430522";"5766"
"LOK1378_1mm";"SILVA (only NR);Eukaryota;Amorphea;Obazoa;Opisthokonta;Nucletmycea;Fungi;Dikarya;Ascomycota;Pezizomycotina;Eurotiomycetes;Onygenales;Nannizziopsiaceae;Paranannizziopsis;";"0.0";"0";"2";"2";"0";"2";"0";"430522";"5766"
"LOK1378_1mm";"SILVA (only NR);Eukaryota;Amorphea;Obazoa;Opisthokonta;Nucletmycea;Fungi;Dikarya;Ascomycota;Pezizomycotina;Eurotiomycetes;Onygenales;Onygenaceae;";"0.0";"0";"50";"49";"0";"49";"1";"430475";"5766"
"LOK1378_1mm";"SILVA (only NR);Eukaryota;Amorphea;Obazoa;Opisthokonta;Nucletmycea;Fungi;Dikarya;Ascomycota;Pezizomycotina;Eurotiomycetes;Onygenales;Onygenaceae;Aphanoascus;";"0.0";"0";"13";"13";"0";"13";"0";"430511";"5766"
"LOK1378_1mm";"SILVA (only NR);Eukaryota;Amorphea;Obazoa;Opisthokonta;Nucletmycea;Fungi;Dikarya;Ascomycota;Pezizomycotina;Eurotiomycetes;Onygenales;Onygenaceae;Apinisia;";"0.0";"0";"1";"1";"0";"1";"0";"430523";"5766"
"LOK1378_1mm";"SILVA (only NR);Eukaryota;Amorphea;Obazoa;Opisthokonta;Nucletmycea;Fungi;Dikarya;Ascomycota;Pezizomycotina;Eurotiomycetes;Onygenales;Onygenaceae;Ascocalvatia;";"0.0";"0";"1";"1";"0";"1";"0";"430523";"5766"
"LOK1378_1mm";"SILVA (only NR);Eukaryota;Amorphea;Obazoa;Opisthokonta;Nucletmycea;Fungi;Dikarya;Ascomycota;Pezizomycotina;Eurotiomycetes;Onygenales;Onygenaceae;Auxarthron;";"0.0";"0";"15";"15";"0";"15";"0";"430509";"5766"
"LOK1378_1mm";"SILVA (only NR);Eukaryota;Amorphea;Obazoa;Opisthokonta;Nucletmycea;Fungi;Dikarya;Ascomycota;Pezizomycotina;Eurotiomycetes;Onygenales;Onygenaceae;Chlamydosauromyces;";"0.0";"0";"1";"1";"0";"1";"0";"430523";"5766"
"LOK1378_1mm";"SILVA (only NR);Eukaryota;Amorphea;Obazoa;Opisthokonta;Nucletmycea;Fungi;Dikarya;Ascomycota;Pezizomycotina;Eurotiomycetes;Onygenales;Onygenaceae;Chrysosporium;";"0.0";"0";"3";"3";"0";"3";"0";"430521";"5766"
"LOK1378_1mm";"SILVA (only NR);Eukaryota;Amorphea;Obazoa;Opisthokonta;Nucletmycea;Fungi;Dikarya;Ascomycota;Pezizomycotina;Eurotiomycetes;Onygenales;Onygenaceae;Onygena;";"0.0";"0";"2";"2";"0";"2";"0";"430522";"5766"
"LOK1378_1mm";"SILVA (only NR);Eukaryota;Amorphea;Obazoa;Opisthokonta;Nucletmycea;Fungi;Dikarya;Ascomycota;Pezizomycotina;Eurotiomycetes;Onygenales;Onygenaceae;Ophidiomyces;";"0.0";"0";"1";"1";"0";"1";"0";"430523";"5766"
"LOK1378_1mm";"SILVA (only NR);Eukaryota;Amorphea;Obazoa;Opisthokonta;Nucletmycea;Fungi;Dikarya;Ascomycota;Pezizomycotina;Eurotiomycetes;Onygenales;Onygenaceae;Pectinotrichum;";"0.0";"0";"2";"2";"0";"2";"0";"430522";"5766"
"LOK1378_1mm";"SILVA (only NR);Eukaryota;Amorphea;Obazoa;Opisthokonta;Nucletmycea;Fungi;Dikarya;Ascomycota;Pezizomycotina;Eurotiomycetes;Onygenales;Onygenaceae;Pseudoamauroascus;";"0.0";"0";"1";"1";"0";"1";"0";"430523";"5766"
"LOK1378_1mm";"SILVA (only NR);Eukaryota;Amorphea;Obazoa;Opisthokonta;Nucletmycea;Fungi;Dikarya;Ascomycota;Pezizomycotina;Eurotiomycetes;Onygenales;Onygenaceae;Renispora;";"0.0";"0";"2";"2";"0";"2";"0";"430522";"5766"
"LOK1378_1mm";"SILVA (only NR);Eukaryota;Amorphea;Obazoa;Opisthokonta;Nucletmycea;Fungi;Dikarya;Ascomycota;Pezizomycotina;Eurotiomycetes;Onygenales;Onygenaceae;Shanorella;";"0.0";"0";"1";"1";"0";"1";"0";"430523";"5766"
"LOK1378_1mm";"SILVA (only NR);Eukaryota;Amorphea;Obazoa;Opisthokonta;Nucletmycea;Fungi;Dikarya;Ascomycota;Pezizomycotina;Eurotiomycetes;Onygenales;Onygenaceae;Uncinocarpus;";"0.0";"0";"7";"6";"0";"6";"1";"430518";"5766"
"LOK1378_1mm";"SILVA (only NR);Eukaryota;Amorphea;Obazoa;Opisthokonta;Nucletmycea;Fungi;Dikarya;Ascomycota;Pezizomycotina;Eurotiomycetes;Phaeomoniellales;";"0.0";"0";"3";"3";"0";"3";"0";"430521";"5766"
"LOK1378_1mm";"SILVA (only NR);Eukaryota;Amorphea;Obazoa;Opisthokonta;Nucletmycea;Fungi;Dikarya;Ascomycota;Pezizomycotina;Eurotiomycetes;Phaeomoniellales;Incertae Sedis;";"0.0";"0";"3";"3";"0";"3";"0";"430521";"5766"
"LOK1378_1mm";"SILVA (only NR);Eukaryota;Amorphea;Obazoa;Opisthokonta;Nucletmycea;Fungi;Dikarya;Ascomycota;Pezizomycotina;Eurotiomycetes;Phaeomoniellales;Incertae Sedis;Aequabiliella;";"0.0";"0";"1";"1";"0";"1";"0";"430523";"5766"
"LOK1378_1mm";"SILVA (only NR);Eukaryota;Amorphea;Obazoa;Opisthokonta;Nucletmycea;Fungi;Dikarya;Ascomycota;Pezizomycotina;Eurotiomycetes;Phaeomoniellales;Incertae Sedis;Neophaeomoniella;";"0.0";"0";"1";"1";"0";"1";"0";"430523";"5766"
"LOK1378_1mm";"SILVA (only NR);Eukaryota;Amorphea;Obazoa;Opisthokonta;Nucletmycea;Fungi;Dikarya;Ascomycota;Pezizomycotina;Eurotiomycetes;Phaeomoniellales;Incertae Sedis;Phaeomoniella;";"0.0";"0";"1";"1";"0";"1";"0";"430523";"5766"
"LOK1378_1mm";"SILVA (only NR);Eukaryota;Amorphea;Obazoa;Opisthokonta;Nucletmycea;Fungi;Dikarya;Ascomycota;Pezizomycotina;Eurotiomycetes;Pyrenulales;";"0.0";"0";"1";"1";"0";"1";"0";"430523";"5766"
"LOK1378_1mm";"SILVA (only NR);Eukaryota;Amorphea;Obazoa;Opisthokonta;Nucletmycea;Fungi;Dikarya;Ascomycota;Pezizomycotina;Eurotiomycetes;Pyrenulales;Pyrenulaceae;";"0.0";"0";"1";"1";"0";"1";"0";"430523";"5766"
"LOK1378_1mm";"SILVA (only NR);Eukaryota;Amorphea;Obazoa;Opisthokonta;Nucletmycea;Fungi;Dikarya;Ascomycota;Pezizomycotina;Eurotiomycetes;Pyrenulales;Pyrenulaceae;Pyrgillus;";"0.0";"0";"1";"1";"0";"1";"0";"430523";"5766"
"LOK1378_1mm";"SILVA (only NR);Eukaryota;Amorphea;Obazoa;Opisthokonta;Nucletmycea;Fungi;Dikarya;Ascomycota;Pezizomycotina;Eurotiomycetes;Verrucariales;";"0.0";"0";"47";"46";"0";"46";"1";"430478";"5766"
"LOK1378_1mm";"SILVA (only NR);Eukaryota;Amorphea;Obazoa;Opisthokonta;Nucletmycea;Fungi;Dikarya;Ascomycota;Pezizomycotina;Eurotiomycetes;Verrucariales;Verrucariaceae;";"0.0";"0";"47";"46";"0";"46";"1";"430478";"5766"
"LOK1378_1mm";"SILVA (only NR);Eukaryota;Amorphea;Obazoa;Opisthokonta;Nucletmycea;Fungi;Dikarya;Ascomycota;Pezizomycotina;Eurotiomycetes;Verrucariales;Verrucariaceae;Bagliettoa;";"0.0";"0";"2";"2";"0";"2";"0";"430522";"5766"
"LOK1378_1mm";"SILVA (only NR);Eukaryota;Amorphea;Obazoa;Opisthokonta;Nucletmycea;Fungi;Dikarya;Ascomycota;Pezizomycotina;Eurotiomycetes;Verrucariales;Verrucariaceae;Catapyrenium;";"0.0";"0";"2";"2";"0";"2";"0";"430522";"5766"
"LOK1378_1mm";"SILVA (only NR);Eukaryota;Amorphea;Obazoa;Opisthokonta;Nucletmycea;Fungi;Dikarya;Ascomycota;Pezizomycotina;Eurotiomycetes;Verrucariales;Verrucariaceae;Dermatocarpon;";"0.0";"0";"2";"2";"0";"2";"0";"430522";"5766"
"LOK1378_1mm";"SILVA (only NR);Eukaryota;Amorphea;Obazoa;Opisthokonta;Nucletmycea;Fungi;Dikarya;Ascomycota;Pezizomycotina;Eurotiomycetes;Verrucariales;Verrucariaceae;Endocarpon;";"0.0";"0";"1";"1";"0";"1";"0";"430523";"5766"
"LOK1378_1mm";"SILVA (only NR);Eukaryota;Amorphea;Obazoa;Opisthokonta;Nucletmycea;Fungi;Dikarya;Ascomycota;Pezizomycotina;Eurotiomycetes;Verrucariales;Verrucariaceae;Flakea;";"0.0";"0";"1";"1";"0";"1";"0";"430523";"5766"
"LOK1378_1mm";"SILVA (only NR);Eukaryota;Amorphea;Obazoa;Opisthokonta;Nucletmycea;Fungi;Dikarya;Ascomycota;Pezizomycotina;Eurotiomycetes;Verrucariales;Verrucariaceae;Heteroplacidium;";"0.0";"0";"3";"3";"0";"3";"0";"430521";"5766"
"LOK1378_1mm";"SILVA (only NR);Eukaryota;Amorphea;Obazoa;Opisthokonta;Nucletmycea;Fungi;Dikarya;Ascomycota;Pezizomycotina;Eurotiomycetes;Verrucariales;Verrucariaceae;Hydropunctaria;";"0.0";"0";"2";"2";"0";"2";"0";"430522";"5766"
"LOK1378_1mm";"SILVA (only NR);Eukaryota;Amorphea;Obazoa;Opisthokonta;Nucletmycea;Fungi;Dikarya;Ascomycota;Pezizomycotina;Eurotiomycetes;Verrucariales;Verrucariaceae;Normandina;";"0.0";"0";"2";"2";"0";"2";"0";"430522";"5766"
"LOK1378_1mm";"SILVA (only NR);Eukaryota;Amorphea;Obazoa;Opisthokonta;Nucletmycea;Fungi;Dikarya;Ascomycota;Pezizomycotina;Eurotiomycetes;Verrucariales;Verrucariaceae;Norrlinia;";"0.0";"0";"1";"1";"0";"1";"0";"430523";"5766"
"LOK1378_1mm";"SILVA (only NR);Eukaryota;Amorphea;Obazoa;Opisthokonta;Nucletmycea;Fungi;Dikarya;Ascomycota;Pezizomycotina;Eurotiomycetes;Verrucariales;Verrucariaceae;Parabagliettoa;";"0.0";"0";"2";"2";"0";"2";"0";"430522";"5766"
"LOK1378_1mm";"SILVA (only NR);Eukaryota;Amorphea;Obazoa;Opisthokonta;Nucletmycea;Fungi;Dikarya;Ascomycota;Pezizomycotina;Eurotiomycetes;Verrucariales;Verrucariaceae;Placidiopsis;";"0.0";"0";"2";"2";"0";"2";"0";"430522";"5766"
"LOK1378_1mm";"SILVA (only NR);Eukaryota;Amorphea;Obazoa;Opisthokonta;Nucletmycea;Fungi;Dikarya;Ascomycota;Pezizomycotina;Eurotiomycetes;Verrucariales;Verrucariaceae;Placidium;";"0.0";"0";"4";"4";"0";"4";"0";"430520";"5766"
"LOK1378_1mm";"SILVA (only NR);Eukaryota;Amorphea;Obazoa;Opisthokonta;Nucletmycea;Fungi;Dikarya;Ascomycota;Pezizomycotina;Eurotiomycetes;Verrucariales;Verrucariaceae;Placocarpus;";"0.0";"0";"1";"1";"0";"1";"0";"430523";"5766"
"LOK1378_1mm";"SILVA (only NR);Eukaryota;Amorphea;Obazoa;Opisthokonta;Nucletmycea;Fungi;Dikarya;Ascomycota;Pezizomycotina;Eurotiomycetes;Verrucariales;Verrucariaceae;Placopyrenium;";"0.0";"0";"2";"2";"0";"2";"0";"430522";"5766"
"LOK1378_1mm";"SILVA (only NR);Eukaryota;Amorphea;Obazoa;Opisthokonta;Nucletmycea;Fungi;Dikarya;Ascomycota;Pezizomycotina;Eurotiomycetes;Verrucariales;Verrucariaceae;Staurothele;";"0.0";"0";"2";"2";"0";"2";"0";"430522";"5766"
"LOK1378_1mm";"SILVA (only NR);Eukaryota;Amorphea;Obazoa;Opisthokonta;Nucletmycea;Fungi;Dikarya;Ascomycota;Pezizomycotina;Eurotiomycetes;Verrucariales;Verrucariaceae;Thelidium;";"0.0";"0";"2";"2";"0";"2";"0";"430522";"5766"
"LOK1378_1mm";"SILVA (only NR);Eukaryota;Amorphea;Obazoa;Opisthokonta;Nucletmycea;Fungi;Dikarya;Ascomycota;Pezizomycotina;Eurotiomycetes;Verrucariales;Verrucariaceae;Verrucaria;";"0.0";"0";"8";"8";"0";"8";"0";"430516";"5766"
"LOK1378_1mm";"SILVA (only NR);Eukaryota;Amorphea;Obazoa;Opisthokonta;Nucletmycea;Fungi;Dikarya;Ascomycota;Pezizomycotina;Eurotiomycetes;Verrucariales;Verrucariaceae;Verrucula;";"0.0";"0";"2";"1";"0";"1";"1";"430523";"5766"
"LOK1378_1mm";"SILVA (only NR);Eukaryota;Amorphea;Obazoa;Opisthokonta;Nucletmycea;Fungi;Dikarya;Ascomycota;Pezizomycotina;Eurotiomycetes;Verrucariales;Verrucariaceae;Verruculopsis;";"0.0";"0";"1";"1";"0";"1";"0";"430523";"5766"
"LOK1378_1mm";"SILVA (only NR);Eukaryota;Amorphea;Obazoa;Opisthokonta;Nucletmycea;Fungi;Dikarya;Ascomycota;Pezizomycotina;Eurotiomycetes;Verrucariales;Verrucariaceae;Wahlenbergiella;";"0.0";"0";"2";"2";"0";"2";"0";"430522";"5766"
"LOK1378_1mm";"SILVA (only NR);Eukaryota;Amorphea;Obazoa;Opisthokonta;Nucletmycea;Fungi;Dikarya;Ascomycota;Pezizomycotina;Eurotiomycetes;Verrucariales;Verrucariaceae;uncultured;";"0.0";"0";"2";"2";"0";"2";"0";"430522";"5766"
"LOK1378_1mm";"SILVA (only NR);Eukaryota;Amorphea;Obazoa;Opisthokonta;Nucletmycea;Fungi;Dikarya;Ascomycota;Pezizomycotina;Geoglossomycetes;";"0.0";"0";"2";"2";"0";"2";"0";"430522";"5766"
"LOK1378_1mm";"SILVA (only NR);Eukaryota;Amorphea;Obazoa;Opisthokonta;Nucletmycea;Fungi;Dikarya;Ascomycota;Pezizomycotina;Geoglossomycetes;Geoglossales;";"0.0";"0";"2";"2";"0";"2";"0";"430522";"5766"
"LOK1378_1mm";"SILVA (only NR);Eukaryota;Amorphea;Obazoa;Opisthokonta;Nucletmycea;Fungi;Dikarya;Ascomycota;Pezizomycotina;Geoglossomycetes;Geoglossales;Geoglossaceae;";"0.0";"0";"2";"2";"0";"2";"0";"430522";"5766"
"LOK1378_1mm";"SILVA (only NR);Eukaryota;Amorphea;Obazoa;Opisthokonta;Nucletmycea;Fungi;Dikarya;Ascomycota;Pezizomycotina;Geoglossomycetes;Geoglossales;Geoglossaceae;Geoglossum;";"0.0";"0";"1";"1";"0";"1";"0";"430523";"5766"
"LOK1378_1mm";"SILVA (only NR);Eukaryota;Amorphea;Obazoa;Opisthokonta;Nucletmycea;Fungi;Dikarya;Ascomycota;Pezizomycotina;Geoglossomycetes;Geoglossales;Geoglossaceae;Trichoglossum;";"0.0";"0";"1";"1";"0";"1";"0";"430523";"5766"
"LOK1378_1mm";"SILVA (only NR);Eukaryota;Amorphea;Obazoa;Opisthokonta;Nucletmycea;Fungi;Dikarya;Ascomycota;Pezizomycotina;Incertae Sedis;";"0.0";"0";"9";"9";"0";"9";"0";"430515";"5766"
"LOK1378_1mm";"SILVA (only NR);Eukaryota;Amorphea;Obazoa;Opisthokonta;Nucletmycea;Fungi;Dikarya;Ascomycota;Pezizomycotina;Incertae Sedis;Incertae Sedis;";"0.0";"0";"8";"8";"0";"8";"0";"430516";"5766"
"LOK1378_1mm";"SILVA (only NR);Eukaryota;Amorphea;Obazoa;Opisthokonta;Nucletmycea;Fungi;Dikarya;Ascomycota;Pezizomycotina;Incertae Sedis;Incertae Sedis;Incertae Sedis;";"0.0";"0";"8";"8";"0";"8";"0";"430516";"5766"
"LOK1378_1mm";"SILVA (only NR);Eukaryota;Amorphea;Obazoa;Opisthokonta;Nucletmycea;Fungi;Dikarya;Ascomycota;Pezizomycotina;Incertae Sedis;Incertae Sedis;Incertae Sedis;Dictyocatenulata;";"0.0";"0";"5";"5";"0";"5";"0";"430519";"5766"
"LOK1378_1mm";"SILVA (only NR);Eukaryota;Amorphea;Obazoa;Opisthokonta;Nucletmycea;Fungi;Dikarya;Ascomycota;Pezizomycotina;Incertae Sedis;Incertae Sedis;Incertae Sedis;Kendrickiella;";"0.0";"0";"1";"1";"0";"1";"0";"430523";"5766"
"LOK1378_1mm";"SILVA (only NR);Eukaryota;Amorphea;Obazoa;Opisthokonta;Nucletmycea;Fungi;Dikarya;Ascomycota;Pezizomycotina;Incertae Sedis;Incertae Sedis;Incertae Sedis;Lecophagus;";"0.0";"0";"2";"2";"0";"2";"0";"430522";"5766"
"LOK1378_1mm";"SILVA (only NR);Eukaryota;Amorphea;Obazoa;Opisthokonta;Nucletmycea;Fungi;Dikarya;Ascomycota;Pezizomycotina;Incertae Sedis;Medeolariales;";"0.0";"0";"1";"1";"0";"1";"0";"430523";"5766"
"LOK1378_1mm";"SILVA (only NR);Eukaryota;Amorphea;Obazoa;Opisthokonta;Nucletmycea;Fungi;Dikarya;Ascomycota;Pezizomycotina;Incertae Sedis;Medeolariales;Medeolariaceae;";"0.0";"0";"1";"1";"0";"1";"0";"430523";"5766"
"LOK1378_1mm";"SILVA (only NR);Eukaryota;Amorphea;Obazoa;Opisthokonta;Nucletmycea;Fungi;Dikarya;Ascomycota;Pezizomycotina;Incertae Sedis;Medeolariales;Medeolariaceae;Medeolaria;";"0.0";"0";"1";"1";"0";"1";"0";"430523";"5766"
"LOK1378_1mm";"SILVA (only NR);Eukaryota;Amorphea;Obazoa;Opisthokonta;Nucletmycea;Fungi;Dikarya;Ascomycota;Pezizomycotina;Laboulbeniomycetes;";"0.0";"0";"11";"9";"0";"9";"2";"430515";"5766"
"LOK1378_1mm";"SILVA (only NR);Eukaryota;Amorphea;Obazoa;Opisthokonta;Nucletmycea;Fungi;Dikarya;Ascomycota;Pezizomycotina;Laboulbeniomycetes;Laboulbeniales;";"0.0";"0";"6";"5";"0";"5";"1";"430519";"5766"
"LOK1378_1mm";"SILVA (only NR);Eukaryota;Amorphea;Obazoa;Opisthokonta;Nucletmycea;Fungi;Dikarya;Ascomycota;Pezizomycotina;Laboulbeniomycetes;Laboulbeniales;Laboulbeniaceae;";"0.0";"0";"6";"5";"0";"5";"1";"430519";"5766"
"LOK1378_1mm";"SILVA (only NR);Eukaryota;Amorphea;Obazoa;Opisthokonta;Nucletmycea;Fungi;Dikarya;Ascomycota;Pezizomycotina;Laboulbeniomycetes;Laboulbeniales;Laboulbeniaceae;Gloeandromyces;";"0.0";"0";"1";"1";"0";"1";"0";"430523";"5766"
"LOK1378_1mm";"SILVA (only NR);Eukaryota;Amorphea;Obazoa;Opisthokonta;Nucletmycea;Fungi;Dikarya;Ascomycota;Pezizomycotina;Laboulbeniomycetes;Laboulbeniales;Laboulbeniaceae;Hesperomyces;";"0.0";"0";"2";"1";"0";"1";"1";"430523";"5766"
"LOK1378_1mm";"SILVA (only NR);Eukaryota;Amorphea;Obazoa;Opisthokonta;Nucletmycea;Fungi;Dikarya;Ascomycota;Pezizomycotina;Laboulbeniomycetes;Laboulbeniales;Laboulbeniaceae;Laboulbenia;";"0.0";"0";"1";"1";"0";"1";"0";"430523";"5766"
"LOK1378_1mm";"SILVA (only NR);Eukaryota;Amorphea;Obazoa;Opisthokonta;Nucletmycea;Fungi;Dikarya;Ascomycota;Pezizomycotina;Laboulbeniomycetes;Laboulbeniales;Laboulbeniaceae;Monoicomyces;";"0.0";"0";"1";"1";"0";"1";"0";"430523";"5766"
"LOK1378_1mm";"SILVA (only NR);Eukaryota;Amorphea;Obazoa;Opisthokonta;Nucletmycea;Fungi;Dikarya;Ascomycota;Pezizomycotina;Laboulbeniomycetes;Laboulbeniales;Laboulbeniaceae;Stigmatomyces;";"0.0";"0";"1";"1";"0";"1";"0";"430523";"5766"
"LOK1378_1mm";"SILVA (only NR);Eukaryota;Amorphea;Obazoa;Opisthokonta;Nucletmycea;Fungi;Dikarya;Ascomycota;Pezizomycotina;Laboulbeniomycetes;Pyxidiophorales;";"0.0";"0";"1";"1";"0";"1";"0";"430523";"5766"
"LOK1378_1mm";"SILVA (only NR);Eukaryota;Amorphea;Obazoa;Opisthokonta;Nucletmycea;Fungi;Dikarya;Ascomycota;Pezizomycotina;Laboulbeniomycetes;Pyxidiophorales;Pyxidiophoraceae;";"0.0";"0";"1";"1";"0";"1";"0";"430523";"5766"
"LOK1378_1mm";"SILVA (only NR);Eukaryota;Amorphea;Obazoa;Opisthokonta;Nucletmycea;Fungi;Dikarya;Ascomycota;Pezizomycotina;Laboulbeniomycetes;Pyxidiophorales;Pyxidiophoraceae;Pyxidiophora;";"0.0";"0";"1";"1";"0";"1";"0";"430523";"5766"
"LOK1378_1mm";"SILVA (only NR);Eukaryota;Amorphea;Obazoa;Opisthokonta;Nucletmycea;Fungi;Dikarya;Ascomycota;Pezizomycotina;Lecanoromycetes;";"0.0";"0";"282";"270";"0";"270";"12";"430254";"5766"
"LOK1378_1mm";"SILVA (only NR);Eukaryota;Amorphea;Obazoa;Opisthokonta;Nucletmycea;Fungi;Dikarya;Ascomycota;Pezizomycotina;Lecanoromycetes;Acarosporales;";"0.0";"0";"7";"7";"0";"7";"0";"430517";"5766"
"LOK1378_1mm";"SILVA (only NR);Eukaryota;Amorphea;Obazoa;Opisthokonta;Nucletmycea;Fungi;Dikarya;Ascomycota;Pezizomycotina;Lecanoromycetes;Acarosporales;Acarosporaceae;";"0.0";"0";"7";"7";"0";"7";"0";"430517";"5766"
"LOK1378_1mm";"SILVA (only NR);Eukaryota;Amorphea;Obazoa;Opisthokonta;Nucletmycea;Fungi;Dikarya;Ascomycota;Pezizomycotina;Lecanoromycetes;Acarosporales;Acarosporaceae;Acarospora;";"0.0";"0";"4";"4";"0";"4";"0";"430520";"5766"
"LOK1378_1mm";"SILVA (only NR);Eukaryota;Amorphea;Obazoa;Opisthokonta;Nucletmycea;Fungi;Dikarya;Ascomycota;Pezizomycotina;Lecanoromycetes;Acarosporales;Acarosporaceae;Myriospora;";"0.0";"0";"1";"1";"0";"1";"0";"430523";"5766"
"LOK1378_1mm";"SILVA (only NR);Eukaryota;Amorphea;Obazoa;Opisthokonta;Nucletmycea;Fungi;Dikarya;Ascomycota;Pezizomycotina;Lecanoromycetes;Acarosporales;Acarosporaceae;Phacopsis;";"0.0";"0";"2";"2";"0";"2";"0";"430522";"5766"
"LOK1378_1mm";"SILVA (only NR);Eukaryota;Amorphea;Obazoa;Opisthokonta;Nucletmycea;Fungi;Dikarya;Ascomycota;Pezizomycotina;Lecanoromycetes;Arctomiales;";"0.0";"0";"1";"1";"0";"1";"0";"430523";"5766"
"LOK1378_1mm";"SILVA (only NR);Eukaryota;Amorphea;Obazoa;Opisthokonta;Nucletmycea;Fungi;Dikarya;Ascomycota;Pezizomycotina;Lecanoromycetes;Arctomiales;Arctomiaceae;";"0.0";"0";"1";"1";"0";"1";"0";"430523";"5766"
"LOK1378_1mm";"SILVA (only NR);Eukaryota;Amorphea;Obazoa;Opisthokonta;Nucletmycea;Fungi;Dikarya;Ascomycota;Pezizomycotina;Lecanoromycetes;Arctomiales;Arctomiaceae;Gregorella;";"0.0";"0";"1";"1";"0";"1";"0";"430523";"5766"
"LOK1378_1mm";"SILVA (only NR);Eukaryota;Amorphea;Obazoa;Opisthokonta;Nucletmycea;Fungi;Dikarya;Ascomycota;Pezizomycotina;Lecanoromycetes;Baeomycetales;";"0.0";"0";"4";"4";"0";"4";"0";"430520";"5766"
"LOK1378_1mm";"SILVA (only NR);Eukaryota;Amorphea;Obazoa;Opisthokonta;Nucletmycea;Fungi;Dikarya;Ascomycota;Pezizomycotina;Lecanoromycetes;Baeomycetales;Anamylopsora;";"0.0";"0";"1";"1";"0";"1";"0";"430523";"5766"
"LOK1378_1mm";"SILVA (only NR);Eukaryota;Amorphea;Obazoa;Opisthokonta;Nucletmycea;Fungi;Dikarya;Ascomycota;Pezizomycotina;Lecanoromycetes;Baeomycetales;Baeomyces;";"0.0";"0";"3";"3";"0";"3";"0";"430521";"5766"
"LOK1378_1mm";"SILVA (only NR);Eukaryota;Amorphea;Obazoa;Opisthokonta;Nucletmycea;Fungi;Dikarya;Ascomycota;Pezizomycotina;Lecanoromycetes;Caliciales;";"0.0";"0";"32";"30";"0";"30";"2";"430494";"5766"
"LOK1378_1mm";"SILVA (only NR);Eukaryota;Amorphea;Obazoa;Opisthokonta;Nucletmycea;Fungi;Dikarya;Ascomycota;Pezizomycotina;Lecanoromycetes;Caliciales;Caliciaceae;";"0.0";"0";"18";"17";"0";"17";"1";"430507";"5766"
"LOK1378_1mm";"SILVA (only NR);Eukaryota;Amorphea;Obazoa;Opisthokonta;Nucletmycea;Fungi;Dikarya;Ascomycota;Pezizomycotina;Lecanoromycetes;Caliciales;Caliciaceae;Buellia;";"0.0";"0";"9";"9";"0";"9";"0";"430515";"5766"
"LOK1378_1mm";"SILVA (only NR);Eukaryota;Amorphea;Obazoa;Opisthokonta;Nucletmycea;Fungi;Dikarya;Ascomycota;Pezizomycotina;Lecanoromycetes;Caliciales;Caliciaceae;Calicium;";"0.0";"0";"1";"0";"0";"0";"1";"430524";"5766"
"LOK1378_1mm";"SILVA (only NR);Eukaryota;Amorphea;Obazoa;Opisthokonta;Nucletmycea;Fungi;Dikarya;Ascomycota;Pezizomycotina;Lecanoromycetes;Caliciales;Caliciaceae;Cyphelium;";"0.0";"0";"3";"3";"0";"3";"0";"430521";"5766"
"LOK1378_1mm";"SILVA (only NR);Eukaryota;Amorphea;Obazoa;Opisthokonta;Nucletmycea;Fungi;Dikarya;Ascomycota;Pezizomycotina;Lecanoromycetes;Caliciales;Caliciaceae;Dimelaena;";"0.0";"0";"1";"1";"0";"1";"0";"430523";"5766"
"LOK1378_1mm";"SILVA (only NR);Eukaryota;Amorphea;Obazoa;Opisthokonta;Nucletmycea;Fungi;Dikarya;Ascomycota;Pezizomycotina;Lecanoromycetes;Caliciales;Caliciaceae;Diploicia;";"0.0";"0";"1";"1";"0";"1";"0";"430523";"5766"
"LOK1378_1mm";"SILVA (only NR);Eukaryota;Amorphea;Obazoa;Opisthokonta;Nucletmycea;Fungi;Dikarya;Ascomycota;Pezizomycotina;Lecanoromycetes;Caliciales;Caliciaceae;Pyxine;";"0.0";"0";"2";"2";"0";"2";"0";"430522";"5766"
"LOK1378_1mm";"SILVA (only NR);Eukaryota;Amorphea;Obazoa;Opisthokonta;Nucletmycea;Fungi;Dikarya;Ascomycota;Pezizomycotina;Lecanoromycetes;Caliciales;Caliciaceae;Texosporium;";"0.0";"0";"1";"1";"0";"1";"0";"430523";"5766"
"LOK1378_1mm";"SILVA (only NR);Eukaryota;Amorphea;Obazoa;Opisthokonta;Nucletmycea;Fungi;Dikarya;Ascomycota;Pezizomycotina;Lecanoromycetes;Caliciales;Physciaceae;";"0.0";"0";"14";"13";"0";"13";"1";"430511";"5766"
"LOK1378_1mm";"SILVA (only NR);Eukaryota;Amorphea;Obazoa;Opisthokonta;Nucletmycea;Fungi;Dikarya;Ascomycota;Pezizomycotina;Lecanoromycetes;Caliciales;Physciaceae;Anaptychia;";"0.0";"0";"1";"1";"0";"1";"0";"430523";"5766"
"LOK1378_1mm";"SILVA (only NR);Eukaryota;Amorphea;Obazoa;Opisthokonta;Nucletmycea;Fungi;Dikarya;Ascomycota;Pezizomycotina;Lecanoromycetes;Caliciales;Physciaceae;Heterodermia;";"0.0";"0";"2";"2";"0";"2";"0";"430522";"5766"
"LOK1378_1mm";"SILVA (only NR);Eukaryota;Amorphea;Obazoa;Opisthokonta;Nucletmycea;Fungi;Dikarya;Ascomycota;Pezizomycotina;Lecanoromycetes;Caliciales;Physciaceae;Phaeophyscia;";"0.0";"0";"1";"1";"0";"1";"0";"430523";"5766"
"LOK1378_1mm";"SILVA (only NR);Eukaryota;Amorphea;Obazoa;Opisthokonta;Nucletmycea;Fungi;Dikarya;Ascomycota;Pezizomycotina;Lecanoromycetes;Caliciales;Physciaceae;Physcia;";"0.0";"0";"5";"4";"0";"4";"1";"430520";"5766"
"LOK1378_1mm";"SILVA (only NR);Eukaryota;Amorphea;Obazoa;Opisthokonta;Nucletmycea;Fungi;Dikarya;Ascomycota;Pezizomycotina;Lecanoromycetes;Caliciales;Physciaceae;Physconia;";"0.0";"0";"1";"1";"0";"1";"0";"430523";"5766"
"LOK1378_1mm";"SILVA (only NR);Eukaryota;Amorphea;Obazoa;Opisthokonta;Nucletmycea;Fungi;Dikarya;Ascomycota;Pezizomycotina;Lecanoromycetes;Caliciales;Physciaceae;Rinodina;";"0.0";"0";"2";"2";"0";"2";"0";"430522";"5766"
"LOK1378_1mm";"SILVA (only NR);Eukaryota;Amorphea;Obazoa;Opisthokonta;Nucletmycea;Fungi;Dikarya;Ascomycota;Pezizomycotina;Lecanoromycetes;Caliciales;Physciaceae;Rinodinella;";"0.0";"0";"1";"1";"0";"1";"0";"430523";"5766"
"LOK1378_1mm";"SILVA (only NR);Eukaryota;Amorphea;Obazoa;Opisthokonta;Nucletmycea;Fungi;Dikarya;Ascomycota;Pezizomycotina;Lecanoromycetes;Lecanorales;";"0.0";"0";"98";"96";"0";"96";"2";"430428";"5766"
"LOK1378_1mm";"SILVA (only NR);Eukaryota;Amorphea;Obazoa;Opisthokonta;Nucletmycea;Fungi;Dikarya;Ascomycota;Pezizomycotina;Lecanoromycetes;Lecanorales;Allocetraria;";"0.0";"0";"1";"1";"0";"1";"0";"430523";"5766"
"LOK1378_1mm";"SILVA (only NR);Eukaryota;Amorphea;Obazoa;Opisthokonta;Nucletmycea;Fungi;Dikarya;Ascomycota;Pezizomycotina;Lecanoromycetes;Lecanorales;Austropeltum;";"0.0";"0";"1";"1";"0";"1";"0";"430523";"5766"
"LOK1378_1mm";"SILVA (only NR);Eukaryota;Amorphea;Obazoa;Opisthokonta;Nucletmycea;Fungi;Dikarya;Ascomycota;Pezizomycotina;Lecanoromycetes;Lecanorales;Bachmanniomyces;";"0.0";"0";"1";"1";"0";"1";"0";"430523";"5766"
"LOK1378_1mm";"SILVA (only NR);Eukaryota;Amorphea;Obazoa;Opisthokonta;Nucletmycea;Fungi;Dikarya;Ascomycota;Pezizomycotina;Lecanoromycetes;Lecanorales;Bunodophoron;";"0.0";"0";"2";"2";"0";"2";"0";"430522";"5766"
"LOK1378_1mm";"SILVA (only NR);Eukaryota;Amorphea;Obazoa;Opisthokonta;Nucletmycea;Fungi;Dikarya;Ascomycota;Pezizomycotina;Lecanoromycetes;Lecanorales;Byssoloma;";"0.0";"0";"1";"1";"0";"1";"0";"430523";"5766"
"LOK1378_1mm";"SILVA (only NR);Eukaryota;Amorphea;Obazoa;Opisthokonta;Nucletmycea;Fungi;Dikarya;Ascomycota;Pezizomycotina;Lecanoromycetes;Lecanorales;Cetradonia;";"0.0";"0";"1";"1";"0";"1";"0";"430523";"5766"
"LOK1378_1mm";"SILVA (only NR);Eukaryota;Amorphea;Obazoa;Opisthokonta;Nucletmycea;Fungi;Dikarya;Ascomycota;Pezizomycotina;Lecanoromycetes;Lecanorales;Cladoniaceae;";"0.0";"0";"7";"7";"0";"7";"0";"430517";"5766"
"LOK1378_1mm";"SILVA (only NR);Eukaryota;Amorphea;Obazoa;Opisthokonta;Nucletmycea;Fungi;Dikarya;Ascomycota;Pezizomycotina;Lecanoromycetes;Lecanorales;Cladoniaceae;Cladia;";"0.0";"0";"2";"2";"0";"2";"0";"430522";"5766"
"LOK1378_1mm";"SILVA (only NR);Eukaryota;Amorphea;Obazoa;Opisthokonta;Nucletmycea;Fungi;Dikarya;Ascomycota;Pezizomycotina;Lecanoromycetes;Lecanorales;Cladoniaceae;Cladonia;";"0.0";"0";"3";"3";"0";"3";"0";"430521";"5766"
"LOK1378_1mm";"SILVA (only NR);Eukaryota;Amorphea;Obazoa;Opisthokonta;Nucletmycea;Fungi;Dikarya;Ascomycota;Pezizomycotina;Lecanoromycetes;Lecanorales;Cladoniaceae;Gymnoderma;";"0.0";"0";"1";"1";"0";"1";"0";"430523";"5766"
"LOK1378_1mm";"SILVA (only NR);Eukaryota;Amorphea;Obazoa;Opisthokonta;Nucletmycea;Fungi;Dikarya;Ascomycota;Pezizomycotina;Lecanoromycetes;Lecanorales;Cladoniaceae;Pilophorus;";"0.0";"0";"1";"1";"0";"1";"0";"430523";"5766"
"LOK1378_1mm";"SILVA (only NR);Eukaryota;Amorphea;Obazoa;Opisthokonta;Nucletmycea;Fungi;Dikarya;Ascomycota;Pezizomycotina;Lecanoromycetes;Lecanorales;Crocynia;";"0.0";"0";"1";"1";"0";"1";"0";"430523";"5766"
"LOK1378_1mm";"SILVA (only NR);Eukaryota;Amorphea;Obazoa;Opisthokonta;Nucletmycea;Fungi;Dikarya;Ascomycota;Pezizomycotina;Lecanoromycetes;Lecanorales;Lecanoraceae;";"0.0";"0";"12";"12";"0";"12";"0";"430512";"5766"
"LOK1378_1mm";"SILVA (only NR);Eukaryota;Amorphea;Obazoa;Opisthokonta;Nucletmycea;Fungi;Dikarya;Ascomycota;Pezizomycotina;Lecanoromycetes;Lecanorales;Lecanoraceae;Lecanora;";"0.0";"0";"4";"4";"0";"4";"0";"430520";"5766"
"LOK1378_1mm";"SILVA (only NR);Eukaryota;Amorphea;Obazoa;Opisthokonta;Nucletmycea;Fungi;Dikarya;Ascomycota;Pezizomycotina;Lecanoromycetes;Lecanorales;Lecanoraceae;Lecidella;";"0.0";"0";"1";"1";"0";"1";"0";"430523";"5766"
"LOK1378_1mm";"SILVA (only NR);Eukaryota;Amorphea;Obazoa;Opisthokonta;Nucletmycea;Fungi;Dikarya;Ascomycota;Pezizomycotina;Lecanoromycetes;Lecanorales;Lecanoraceae;Miriquidica;";"0.0";"0";"1";"1";"0";"1";"0";"430523";"5766"
"LOK1378_1mm";"SILVA (only NR);Eukaryota;Amorphea;Obazoa;Opisthokonta;Nucletmycea;Fungi;Dikarya;Ascomycota;Pezizomycotina;Lecanoromycetes;Lecanorales;Lecanoraceae;Protoparmeliopsis;";"0.0";"0";"1";"1";"0";"1";"0";"430523";"5766"
"LOK1378_1mm";"SILVA (only NR);Eukaryota;Amorphea;Obazoa;Opisthokonta;Nucletmycea;Fungi;Dikarya;Ascomycota;Pezizomycotina;Lecanoromycetes;Lecanorales;Lecanoraceae;Pyrrhospora;";"0.0";"0";"1";"1";"0";"1";"0";"430523";"5766"
"LOK1378_1mm";"SILVA (only NR);Eukaryota;Amorphea;Obazoa;Opisthokonta;Nucletmycea;Fungi;Dikarya;Ascomycota;Pezizomycotina;Lecanoromycetes;Lecanorales;Lecanoraceae;Rhizoplaca;";"0.0";"0";"2";"2";"0";"2";"0";"430522";"5766"
"LOK1378_1mm";"SILVA (only NR);Eukaryota;Amorphea;Obazoa;Opisthokonta;Nucletmycea;Fungi;Dikarya;Ascomycota;Pezizomycotina;Lecanoromycetes;Lecanorales;Lecanoraceae;Scoliciosporum;";"0.0";"0";"2";"2";"0";"2";"0";"430522";"5766"
"LOK1378_1mm";"SILVA (only NR);Eukaryota;Amorphea;Obazoa;Opisthokonta;Nucletmycea;Fungi;Dikarya;Ascomycota;Pezizomycotina;Lecanoromycetes;Lecanorales;Micareaceae;";"0.0";"0";"2";"2";"0";"2";"0";"430522";"5766"
"LOK1378_1mm";"SILVA (only NR);Eukaryota;Amorphea;Obazoa;Opisthokonta;Nucletmycea;Fungi;Dikarya;Ascomycota;Pezizomycotina;Lecanoromycetes;Lecanorales;Micareaceae;Micarea;";"0.0";"0";"2";"2";"0";"2";"0";"430522";"5766"
"LOK1378_1mm";"SILVA (only NR);Eukaryota;Amorphea;Obazoa;Opisthokonta;Nucletmycea;Fungi;Dikarya;Ascomycota;Pezizomycotina;Lecanoromycetes;Lecanorales;Mycoblastaceae;";"0.0";"0";"1";"1";"0";"1";"0";"430523";"5766"
"LOK1378_1mm";"SILVA (only NR);Eukaryota;Amorphea;Obazoa;Opisthokonta;Nucletmycea;Fungi;Dikarya;Ascomycota;Pezizomycotina;Lecanoromycetes;Lecanorales;Mycoblastaceae;Mycoblastus;";"0.0";"0";"1";"1";"0";"1";"0";"430523";"5766"
"LOK1378_1mm";"SILVA (only NR);Eukaryota;Amorphea;Obazoa;Opisthokonta;Nucletmycea;Fungi;Dikarya;Ascomycota;Pezizomycotina;Lecanoromycetes;Lecanorales;Neophyllis;";"0.0";"0";"1";"1";"0";"1";"0";"430523";"5766"
"LOK1378_1mm";"SILVA (only NR);Eukaryota;Amorphea;Obazoa;Opisthokonta;Nucletmycea;Fungi;Dikarya;Ascomycota;Pezizomycotina;Lecanoromycetes;Lecanorales;Parmeliaceae;";"0.0";"0";"30";"30";"0";"30";"0";"430494";"5766"
"LOK1378_1mm";"SILVA (only NR);Eukaryota;Amorphea;Obazoa;Opisthokonta;Nucletmycea;Fungi;Dikarya;Ascomycota;Pezizomycotina;Lecanoromycetes;Lecanorales;Parmeliaceae;Anzia;";"0.0";"0";"2";"2";"0";"2";"0";"430522";"5766"
"LOK1378_1mm";"SILVA (only NR);Eukaryota;Amorphea;Obazoa;Opisthokonta;Nucletmycea;Fungi;Dikarya;Ascomycota;Pezizomycotina;Lecanoromycetes;Lecanorales;Parmeliaceae;Cetraria;";"0.0";"0";"1";"1";"0";"1";"0";"430523";"5766"
"LOK1378_1mm";"SILVA (only NR);Eukaryota;Amorphea;Obazoa;Opisthokonta;Nucletmycea;Fungi;Dikarya;Ascomycota;Pezizomycotina;Lecanoromycetes;Lecanorales;Parmeliaceae;Cornicularia;";"0.0";"0";"1";"1";"0";"1";"0";"430523";"5766"
"LOK1378_1mm";"SILVA (only NR);Eukaryota;Amorphea;Obazoa;Opisthokonta;Nucletmycea;Fungi;Dikarya;Ascomycota;Pezizomycotina;Lecanoromycetes;Lecanorales;Parmeliaceae;Evernia;";"0.0";"0";"1";"1";"0";"1";"0";"430523";"5766"
"LOK1378_1mm";"SILVA (only NR);Eukaryota;Amorphea;Obazoa;Opisthokonta;Nucletmycea;Fungi;Dikarya;Ascomycota;Pezizomycotina;Lecanoromycetes;Lecanorales;Parmeliaceae;Hypogymnia;";"0.0";"0";"5";"5";"0";"5";"0";"430519";"5766"
"LOK1378_1mm";"SILVA (only NR);Eukaryota;Amorphea;Obazoa;Opisthokonta;Nucletmycea;Fungi;Dikarya;Ascomycota;Pezizomycotina;Lecanoromycetes;Lecanorales;Parmeliaceae;Letharia;";"0.0";"0";"1";"1";"0";"1";"0";"430523";"5766"
"LOK1378_1mm";"SILVA (only NR);Eukaryota;Amorphea;Obazoa;Opisthokonta;Nucletmycea;Fungi;Dikarya;Ascomycota;Pezizomycotina;Lecanoromycetes;Lecanorales;Parmeliaceae;Menegazzia;";"0.0";"0";"2";"2";"0";"2";"0";"430522";"5766"
"LOK1378_1mm";"SILVA (only NR);Eukaryota;Amorphea;Obazoa;Opisthokonta;Nucletmycea;Fungi;Dikarya;Ascomycota;Pezizomycotina;Lecanoromycetes;Lecanorales;Parmeliaceae;Pannoparmelia;";"0.0";"0";"1";"1";"0";"1";"0";"430523";"5766"
"LOK1378_1mm";"SILVA (only NR);Eukaryota;Amorphea;Obazoa;Opisthokonta;Nucletmycea;Fungi;Dikarya;Ascomycota;Pezizomycotina;Lecanoromycetes;Lecanorales;Parmeliaceae;Parmelia;";"0.0";"0";"1";"1";"0";"1";"0";"430523";"5766"
"LOK1378_1mm";"SILVA (only NR);Eukaryota;Amorphea;Obazoa;Opisthokonta;Nucletmycea;Fungi;Dikarya;Ascomycota;Pezizomycotina;Lecanoromycetes;Lecanorales;Parmeliaceae;Parmeliopsis;";"0.0";"0";"1";"1";"0";"1";"0";"430523";"5766"
"LOK1378_1mm";"SILVA (only NR);Eukaryota;Amorphea;Obazoa;Opisthokonta;Nucletmycea;Fungi;Dikarya;Ascomycota;Pezizomycotina;Lecanoromycetes;Lecanorales;Parmeliaceae;Parmotrema;";"0.0";"0";"3";"3";"0";"3";"0";"430521";"5766"
"LOK1378_1mm";"SILVA (only NR);Eukaryota;Amorphea;Obazoa;Opisthokonta;Nucletmycea;Fungi;Dikarya;Ascomycota;Pezizomycotina;Lecanoromycetes;Lecanorales;Parmeliaceae;Pleurosticta;";"0.0";"0";"2";"2";"0";"2";"0";"430522";"5766"
"LOK1378_1mm";"SILVA (only NR);Eukaryota;Amorphea;Obazoa;Opisthokonta;Nucletmycea;Fungi;Dikarya;Ascomycota;Pezizomycotina;Lecanoromycetes;Lecanorales;Parmeliaceae;Punctelia;";"0.0";"0";"1";"1";"0";"1";"0";"430523";"5766"
"LOK1378_1mm";"SILVA (only NR);Eukaryota;Amorphea;Obazoa;Opisthokonta;Nucletmycea;Fungi;Dikarya;Ascomycota;Pezizomycotina;Lecanoromycetes;Lecanorales;Parmeliaceae;Usnea;";"0.0";"0";"3";"3";"0";"3";"0";"430521";"5766"
"LOK1378_1mm";"SILVA (only NR);Eukaryota;Amorphea;Obazoa;Opisthokonta;Nucletmycea;Fungi;Dikarya;Ascomycota;Pezizomycotina;Lecanoromycetes;Lecanorales;Parmeliaceae;Vulpicida;";"0.0";"0";"1";"1";"0";"1";"0";"430523";"5766"
"LOK1378_1mm";"SILVA (only NR);Eukaryota;Amorphea;Obazoa;Opisthokonta;Nucletmycea;Fungi;Dikarya;Ascomycota;Pezizomycotina;Lecanoromycetes;Lecanorales;Parmeliaceae;Xanthoparmelia;";"0.0";"0";"2";"2";"0";"2";"0";"430522";"5766"
"LOK1378_1mm";"SILVA (only NR);Eukaryota;Amorphea;Obazoa;Opisthokonta;Nucletmycea;Fungi;Dikarya;Ascomycota;Pezizomycotina;Lecanoromycetes;Lecanorales;Porpidiaceae;";"0.0";"0";"2";"2";"0";"2";"0";"430522";"5766"
"LOK1378_1mm";"SILVA (only NR);Eukaryota;Amorphea;Obazoa;Opisthokonta;Nucletmycea;Fungi;Dikarya;Ascomycota;Pezizomycotina;Lecanoromycetes;Lecanorales;Porpidiaceae;Porpidia;";"0.0";"0";"1";"1";"0";"1";"0";"430523";"5766"
"LOK1378_1mm";"SILVA (only NR);Eukaryota;Amorphea;Obazoa;Opisthokonta;Nucletmycea;Fungi;Dikarya;Ascomycota;Pezizomycotina;Lecanoromycetes;Lecanorales;Porpidiaceae;Romjularia;";"0.0";"0";"1";"1";"0";"1";"0";"430523";"5766"
"LOK1378_1mm";"SILVA (only NR);Eukaryota;Amorphea;Obazoa;Opisthokonta;Nucletmycea;Fungi;Dikarya;Ascomycota;Pezizomycotina;Lecanoromycetes;Lecanorales;Psilolechia;";"0.0";"0";"1";"1";"0";"1";"0";"430523";"5766"
"LOK1378_1mm";"SILVA (only NR);Eukaryota;Amorphea;Obazoa;Opisthokonta;Nucletmycea;Fungi;Dikarya;Ascomycota;Pezizomycotina;Lecanoromycetes;Lecanorales;Psoraceae;";"0.0";"0";"5";"5";"0";"5";"0";"430519";"5766"
"LOK1378_1mm";"SILVA (only NR);Eukaryota;Amorphea;Obazoa;Opisthokonta;Nucletmycea;Fungi;Dikarya;Ascomycota;Pezizomycotina;Lecanoromycetes;Lecanorales;Psoraceae;Protoblastenia;";"0.0";"0";"3";"3";"0";"3";"0";"430521";"5766"
"LOK1378_1mm";"SILVA (only NR);Eukaryota;Amorphea;Obazoa;Opisthokonta;Nucletmycea;Fungi;Dikarya;Ascomycota;Pezizomycotina;Lecanoromycetes;Lecanorales;Psoraceae;Psora;";"0.0";"0";"2";"2";"0";"2";"0";"430522";"5766"
"LOK1378_1mm";"SILVA (only NR);Eukaryota;Amorphea;Obazoa;Opisthokonta;Nucletmycea;Fungi;Dikarya;Ascomycota;Pezizomycotina;Lecanoromycetes;Lecanorales;Ramalinaceae;";"0.0";"0";"16";"14";"0";"14";"2";"430510";"5766"
"LOK1378_1mm";"SILVA (only NR);Eukaryota;Amorphea;Obazoa;Opisthokonta;Nucletmycea;Fungi;Dikarya;Ascomycota;Pezizomycotina;Lecanoromycetes;Lecanorales;Ramalinaceae;Bacidia;";"0.0";"0";"1";"1";"0";"1";"0";"430523";"5766"
"LOK1378_1mm";"SILVA (only NR);Eukaryota;Amorphea;Obazoa;Opisthokonta;Nucletmycea;Fungi;Dikarya;Ascomycota;Pezizomycotina;Lecanoromycetes;Lecanorales;Ramalinaceae;Bacidina;";"0.0";"0";"3";"1";"0";"1";"2";"430523";"5766"
"LOK1378_1mm";"SILVA (only NR);Eukaryota;Amorphea;Obazoa;Opisthokonta;Nucletmycea;Fungi;Dikarya;Ascomycota;Pezizomycotina;Lecanoromycetes;Lecanorales;Ramalinaceae;Biatora;";"0.0";"0";"1";"1";"0";"1";"0";"430523";"5766"
"LOK1378_1mm";"SILVA (only NR);Eukaryota;Amorphea;Obazoa;Opisthokonta;Nucletmycea;Fungi;Dikarya;Ascomycota;Pezizomycotina;Lecanoromycetes;Lecanorales;Ramalinaceae;Bilimbia;";"0.0";"0";"1";"1";"0";"1";"0";"430523";"5766"
"LOK1378_1mm";"SILVA (only NR);Eukaryota;Amorphea;Obazoa;Opisthokonta;Nucletmycea;Fungi;Dikarya;Ascomycota;Pezizomycotina;Lecanoromycetes;Lecanorales;Ramalinaceae;Cliostomum;";"0.0";"0";"1";"1";"0";"1";"0";"430523";"5766"
"LOK1378_1mm";"SILVA (only NR);Eukaryota;Amorphea;Obazoa;Opisthokonta;Nucletmycea;Fungi;Dikarya;Ascomycota;Pezizomycotina;Lecanoromycetes;Lecanorales;Ramalinaceae;Lecania;";"0.0";"0";"3";"3";"0";"3";"0";"430521";"5766"
"LOK1378_1mm";"SILVA (only NR);Eukaryota;Amorphea;Obazoa;Opisthokonta;Nucletmycea;Fungi;Dikarya;Ascomycota;Pezizomycotina;Lecanoromycetes;Lecanorales;Ramalinaceae;Lopezaria;";"0.0";"0";"1";"1";"0";"1";"0";"430523";"5766"
"LOK1378_1mm";"SILVA (only NR);Eukaryota;Amorphea;Obazoa;Opisthokonta;Nucletmycea;Fungi;Dikarya;Ascomycota;Pezizomycotina;Lecanoromycetes;Lecanorales;Ramalinaceae;Ramalina;";"0.0";"0";"1";"1";"0";"1";"0";"430523";"5766"
"LOK1378_1mm";"SILVA (only NR);Eukaryota;Amorphea;Obazoa;Opisthokonta;Nucletmycea;Fungi;Dikarya;Ascomycota;Pezizomycotina;Lecanoromycetes;Lecanorales;Ramalinaceae;Toninia;";"0.0";"0";"2";"2";"0";"2";"0";"430522";"5766"
"LOK1378_1mm";"SILVA (only NR);Eukaryota;Amorphea;Obazoa;Opisthokonta;Nucletmycea;Fungi;Dikarya;Ascomycota;Pezizomycotina;Lecanoromycetes;Lecanorales;Ramalinaceae;[Epicladonia];";"0.0";"0";"1";"1";"0";"1";"0";"430523";"5766"
"LOK1378_1mm";"SILVA (only NR);Eukaryota;Amorphea;Obazoa;Opisthokonta;Nucletmycea;Fungi;Dikarya;Ascomycota;Pezizomycotina;Lecanoromycetes;Lecanorales;Ramboldiaceae;";"0.0";"0";"2";"2";"0";"2";"0";"430522";"5766"
"LOK1378_1mm";"SILVA (only NR);Eukaryota;Amorphea;Obazoa;Opisthokonta;Nucletmycea;Fungi;Dikarya;Ascomycota;Pezizomycotina;Lecanoromycetes;Lecanorales;Ramboldiaceae;Ramboldia;";"0.0";"0";"2";"2";"0";"2";"0";"430522";"5766"
"LOK1378_1mm";"SILVA (only NR);Eukaryota;Amorphea;Obazoa;Opisthokonta;Nucletmycea;Fungi;Dikarya;Ascomycota;Pezizomycotina;Lecanoromycetes;Lecanorales;Sphaerophorus;";"0.0";"0";"1";"1";"0";"1";"0";"430523";"5766"
"LOK1378_1mm";"SILVA (only NR);Eukaryota;Amorphea;Obazoa;Opisthokonta;Nucletmycea;Fungi;Dikarya;Ascomycota;Pezizomycotina;Lecanoromycetes;Lecanorales;Squamarinaceae;";"0.0";"0";"2";"2";"0";"2";"0";"430522";"5766"
"LOK1378_1mm";"SILVA (only NR);Eukaryota;Amorphea;Obazoa;Opisthokonta;Nucletmycea;Fungi;Dikarya;Ascomycota;Pezizomycotina;Lecanoromycetes;Lecanorales;Squamarinaceae;Squamarina;";"0.0";"0";"2";"2";"0";"2";"0";"430522";"5766"
"LOK1378_1mm";"SILVA (only NR);Eukaryota;Amorphea;Obazoa;Opisthokonta;Nucletmycea;Fungi;Dikarya;Ascomycota;Pezizomycotina;Lecanoromycetes;Lecanorales;Stereocaulaceae;";"0.0";"0";"6";"6";"0";"6";"0";"430518";"5766"
"LOK1378_1mm";"SILVA (only NR);Eukaryota;Amorphea;Obazoa;Opisthokonta;Nucletmycea;Fungi;Dikarya;Ascomycota;Pezizomycotina;Lecanoromycetes;Lecanorales;Stereocaulaceae;Lepraria;";"0.0";"0";"1";"1";"0";"1";"0";"430523";"5766"
"LOK1378_1mm";"SILVA (only NR);Eukaryota;Amorphea;Obazoa;Opisthokonta;Nucletmycea;Fungi;Dikarya;Ascomycota;Pezizomycotina;Lecanoromycetes;Lecanorales;Stereocaulaceae;Stereocaulon;";"0.0";"0";"5";"5";"0";"5";"0";"430519";"5766"
"LOK1378_1mm";"SILVA (only NR);Eukaryota;Amorphea;Obazoa;Opisthokonta;Nucletmycea;Fungi;Dikarya;Ascomycota;Pezizomycotina;Lecanoromycetes;Lecanorales;Tephromela;";"0.0";"0";"1";"1";"0";"1";"0";"430523";"5766"
"LOK1378_1mm";"SILVA (only NR);Eukaryota;Amorphea;Obazoa;Opisthokonta;Nucletmycea;Fungi;Dikarya;Ascomycota;Pezizomycotina;Lecanoromycetes;Lecideales;";"0.0";"0";"2";"2";"0";"2";"0";"430522";"5766"
"LOK1378_1mm";"SILVA (only NR);Eukaryota;Amorphea;Obazoa;Opisthokonta;Nucletmycea;Fungi;Dikarya;Ascomycota;Pezizomycotina;Lecanoromycetes;Lecideales;Lecideaceae;";"0.0";"0";"2";"2";"0";"2";"0";"430522";"5766"
"LOK1378_1mm";"SILVA (only NR);Eukaryota;Amorphea;Obazoa;Opisthokonta;Nucletmycea;Fungi;Dikarya;Ascomycota;Pezizomycotina;Lecanoromycetes;Lecideales;Lecideaceae;Lecidea;";"0.0";"0";"2";"2";"0";"2";"0";"430522";"5766"
"LOK1378_1mm";"SILVA (only NR);Eukaryota;Amorphea;Obazoa;Opisthokonta;Nucletmycea;Fungi;Dikarya;Ascomycota;Pezizomycotina;Lecanoromycetes;Ostropales;";"0.0";"0";"12";"11";"0";"11";"1";"430513";"5766"
"LOK1378_1mm";"SILVA (only NR);Eukaryota;Amorphea;Obazoa;Opisthokonta;Nucletmycea;Fungi;Dikarya;Ascomycota;Pezizomycotina;Lecanoromycetes;Ostropales;Gomphillaceae;";"0.0";"0";"1";"1";"0";"1";"0";"430523";"5766"
"LOK1378_1mm";"SILVA (only NR);Eukaryota;Amorphea;Obazoa;Opisthokonta;Nucletmycea;Fungi;Dikarya;Ascomycota;Pezizomycotina;Lecanoromycetes;Ostropales;Gomphillaceae;Gyalideopsis;";"0.0";"0";"1";"1";"0";"1";"0";"430523";"5766"
"LOK1378_1mm";"SILVA (only NR);Eukaryota;Amorphea;Obazoa;Opisthokonta;Nucletmycea;Fungi;Dikarya;Ascomycota;Pezizomycotina;Lecanoromycetes;Ostropales;Graphidaceae;";"0.0";"0";"6";"5";"0";"5";"1";"430519";"5766"
"LOK1378_1mm";"SILVA (only NR);Eukaryota;Amorphea;Obazoa;Opisthokonta;Nucletmycea;Fungi;Dikarya;Ascomycota;Pezizomycotina;Lecanoromycetes;Ostropales;Graphidaceae;Diploschistes;";"0.0";"0";"1";"1";"0";"1";"0";"430523";"5766"
"LOK1378_1mm";"SILVA (only NR);Eukaryota;Amorphea;Obazoa;Opisthokonta;Nucletmycea;Fungi;Dikarya;Ascomycota;Pezizomycotina;Lecanoromycetes;Ostropales;Graphidaceae;Gomphillus;";"0.0";"0";"1";"1";"0";"1";"0";"430523";"5766"
"LOK1378_1mm";"SILVA (only NR);Eukaryota;Amorphea;Obazoa;Opisthokonta;Nucletmycea;Fungi;Dikarya;Ascomycota;Pezizomycotina;Lecanoromycetes;Ostropales;Graphidaceae;Graphis;";"0.0";"0";"3";"2";"0";"2";"1";"430522";"5766"
"LOK1378_1mm";"SILVA (only NR);Eukaryota;Amorphea;Obazoa;Opisthokonta;Nucletmycea;Fungi;Dikarya;Ascomycota;Pezizomycotina;Lecanoromycetes;Ostropales;Graphidaceae;Xalocoa;";"0.0";"0";"1";"1";"0";"1";"0";"430523";"5766"
"LOK1378_1mm";"SILVA (only NR);Eukaryota;Amorphea;Obazoa;Opisthokonta;Nucletmycea;Fungi;Dikarya;Ascomycota;Pezizomycotina;Lecanoromycetes;Ostropales;Gyalecta;";"0.0";"0";"1";"1";"0";"1";"0";"430523";"5766"
"LOK1378_1mm";"SILVA (only NR);Eukaryota;Amorphea;Obazoa;Opisthokonta;Nucletmycea;Fungi;Dikarya;Ascomycota;Pezizomycotina;Lecanoromycetes;Ostropales;Petractis;";"0.0";"0";"1";"1";"0";"1";"0";"430523";"5766"
"LOK1378_1mm";"SILVA (only NR);Eukaryota;Amorphea;Obazoa;Opisthokonta;Nucletmycea;Fungi;Dikarya;Ascomycota;Pezizomycotina;Lecanoromycetes;Ostropales;Stictidaceae;";"0.0";"0";"3";"3";"0";"3";"0";"430521";"5766"
"LOK1378_1mm";"SILVA (only NR);Eukaryota;Amorphea;Obazoa;Opisthokonta;Nucletmycea;Fungi;Dikarya;Ascomycota;Pezizomycotina;Lecanoromycetes;Ostropales;Stictidaceae;Acarosporina;";"0.0";"0";"1";"1";"0";"1";"0";"430523";"5766"
"LOK1378_1mm";"SILVA (only NR);Eukaryota;Amorphea;Obazoa;Opisthokonta;Nucletmycea;Fungi;Dikarya;Ascomycota;Pezizomycotina;Lecanoromycetes;Ostropales;Stictidaceae;Cyanodermella;";"0.0";"0";"1";"1";"0";"1";"0";"430523";"5766"
"LOK1378_1mm";"SILVA (only NR);Eukaryota;Amorphea;Obazoa;Opisthokonta;Nucletmycea;Fungi;Dikarya;Ascomycota;Pezizomycotina;Lecanoromycetes;Ostropales;Stictidaceae;Stictis;";"0.0";"0";"1";"1";"0";"1";"0";"430523";"5766"
"LOK1378_1mm";"SILVA (only NR);Eukaryota;Amorphea;Obazoa;Opisthokonta;Nucletmycea;Fungi;Dikarya;Ascomycota;Pezizomycotina;Lecanoromycetes;Peltigerales;";"0.0";"0";"23";"20";"0";"20";"3";"430504";"5766"
"LOK1378_1mm";"SILVA (only NR);Eukaryota;Amorphea;Obazoa;Opisthokonta;Nucletmycea;Fungi;Dikarya;Ascomycota;Pezizomycotina;Lecanoromycetes;Peltigerales;Coccocarpiaceae;";"0.0";"0";"3";"3";"0";"3";"0";"430521";"5766"
"LOK1378_1mm";"SILVA (only NR);Eukaryota;Amorphea;Obazoa;Opisthokonta;Nucletmycea;Fungi;Dikarya;Ascomycota;Pezizomycotina;Lecanoromycetes;Peltigerales;Coccocarpiaceae;Coccocarpia;";"0.0";"0";"3";"3";"0";"3";"0";"430521";"5766"
"LOK1378_1mm";"SILVA (only NR);Eukaryota;Amorphea;Obazoa;Opisthokonta;Nucletmycea;Fungi;Dikarya;Ascomycota;Pezizomycotina;Lecanoromycetes;Peltigerales;Collemataceae;";"0.0";"0";"5";"5";"0";"5";"0";"430519";"5766"
"LOK1378_1mm";"SILVA (only NR);Eukaryota;Amorphea;Obazoa;Opisthokonta;Nucletmycea;Fungi;Dikarya;Ascomycota;Pezizomycotina;Lecanoromycetes;Peltigerales;Collemataceae;Collema;";"0.0";"0";"2";"2";"0";"2";"0";"430522";"5766"
"LOK1378_1mm";"SILVA (only NR);Eukaryota;Amorphea;Obazoa;Opisthokonta;Nucletmycea;Fungi;Dikarya;Ascomycota;Pezizomycotina;Lecanoromycetes;Peltigerales;Collemataceae;Leptogium;";"0.0";"0";"3";"3";"0";"3";"0";"430521";"5766"
"LOK1378_1mm";"SILVA (only NR);Eukaryota;Amorphea;Obazoa;Opisthokonta;Nucletmycea;Fungi;Dikarya;Ascomycota;Pezizomycotina;Lecanoromycetes;Peltigerales;Fuscopannaria;";"0.0";"0";"1";"1";"0";"1";"0";"430523";"5766"
"LOK1378_1mm";"SILVA (only NR);Eukaryota;Amorphea;Obazoa;Opisthokonta;Nucletmycea;Fungi;Dikarya;Ascomycota;Pezizomycotina;Lecanoromycetes;Peltigerales;Koerberiaceae;";"0.0";"0";"1";"1";"0";"1";"0";"430523";"5766"
"LOK1378_1mm";"SILVA (only NR);Eukaryota;Amorphea;Obazoa;Opisthokonta;Nucletmycea;Fungi;Dikarya;Ascomycota;Pezizomycotina;Lecanoromycetes;Peltigerales;Koerberiaceae;Koerberia;";"0.0";"0";"1";"1";"0";"1";"0";"430523";"5766"
"LOK1378_1mm";"SILVA (only NR);Eukaryota;Amorphea;Obazoa;Opisthokonta;Nucletmycea;Fungi;Dikarya;Ascomycota;Pezizomycotina;Lecanoromycetes;Peltigerales;Leciophysma;";"0.0";"0";"1";"1";"0";"1";"0";"430523";"5766"
"LOK1378_1mm";"SILVA (only NR);Eukaryota;Amorphea;Obazoa;Opisthokonta;Nucletmycea;Fungi;Dikarya;Ascomycota;Pezizomycotina;Lecanoromycetes;Peltigerales;Leptochidium;";"0.0";"0";"1";"1";"0";"1";"0";"430523";"5766"
"LOK1378_1mm";"SILVA (only NR);Eukaryota;Amorphea;Obazoa;Opisthokonta;Nucletmycea;Fungi;Dikarya;Ascomycota;Pezizomycotina;Lecanoromycetes;Peltigerales;Lobaria;";"0.0";"0";"1";"1";"0";"1";"0";"430523";"5766"
"LOK1378_1mm";"SILVA (only NR);Eukaryota;Amorphea;Obazoa;Opisthokonta;Nucletmycea;Fungi;Dikarya;Ascomycota;Pezizomycotina;Lecanoromycetes;Peltigerales;Massalongia;";"0.0";"0";"1";"1";"0";"1";"0";"430523";"5766"
"LOK1378_1mm";"SILVA (only NR);Eukaryota;Amorphea;Obazoa;Opisthokonta;Nucletmycea;Fungi;Dikarya;Ascomycota;Pezizomycotina;Lecanoromycetes;Peltigerales;Nephroma;";"0.0";"0";"1";"1";"0";"1";"0";"430523";"5766"
"LOK1378_1mm";"SILVA (only NR);Eukaryota;Amorphea;Obazoa;Opisthokonta;Nucletmycea;Fungi;Dikarya;Ascomycota;Pezizomycotina;Lecanoromycetes;Peltigerales;Parmeliella;";"0.0";"0";"1";"1";"0";"1";"0";"430523";"5766"
"LOK1378_1mm";"SILVA (only NR);Eukaryota;Amorphea;Obazoa;Opisthokonta;Nucletmycea;Fungi;Dikarya;Ascomycota;Pezizomycotina;Lecanoromycetes;Peltigerales;Peltigeraceae;";"0.0";"0";"4";"2";"0";"2";"2";"430522";"5766"
"LOK1378_1mm";"SILVA (only NR);Eukaryota;Amorphea;Obazoa;Opisthokonta;Nucletmycea;Fungi;Dikarya;Ascomycota;Pezizomycotina;Lecanoromycetes;Peltigerales;Peltigeraceae;Peltigera;";"0.0";"0";"2";"1";"0";"1";"1";"430523";"5766"
"LOK1378_1mm";"SILVA (only NR);Eukaryota;Amorphea;Obazoa;Opisthokonta;Nucletmycea;Fungi;Dikarya;Ascomycota;Pezizomycotina;Lecanoromycetes;Peltigerales;Peltigeraceae;Solorina;";"0.0";"0";"2";"1";"0";"1";"1";"430523";"5766"
"LOK1378_1mm";"SILVA (only NR);Eukaryota;Amorphea;Obazoa;Opisthokonta;Nucletmycea;Fungi;Dikarya;Ascomycota;Pezizomycotina;Lecanoromycetes;Peltigerales;Placynthium;";"0.0";"0";"1";"0";"0";"0";"1";"430524";"5766"
"LOK1378_1mm";"SILVA (only NR);Eukaryota;Amorphea;Obazoa;Opisthokonta;Nucletmycea;Fungi;Dikarya;Ascomycota;Pezizomycotina;Lecanoromycetes;Peltigerales;Pseudocyphellaria;";"0.0";"0";"1";"1";"0";"1";"0";"430523";"5766"
"LOK1378_1mm";"SILVA (only NR);Eukaryota;Amorphea;Obazoa;Opisthokonta;Nucletmycea;Fungi;Dikarya;Ascomycota;Pezizomycotina;Lecanoromycetes;Peltigerales;Vahliella;";"0.0";"0";"1";"1";"0";"1";"0";"430523";"5766"
"LOK1378_1mm";"SILVA (only NR);Eukaryota;Amorphea;Obazoa;Opisthokonta;Nucletmycea;Fungi;Dikarya;Ascomycota;Pezizomycotina;Lecanoromycetes;Pertusariales;";"0.0";"0";"24";"21";"0";"21";"3";"430503";"5766"
"LOK1378_1mm";"SILVA (only NR);Eukaryota;Amorphea;Obazoa;Opisthokonta;Nucletmycea;Fungi;Dikarya;Ascomycota;Pezizomycotina;Lecanoromycetes;Pertusariales;Coccotrema;";"0.0";"0";"1";"1";"0";"1";"0";"430523";"5766"
"LOK1378_1mm";"SILVA (only NR);Eukaryota;Amorphea;Obazoa;Opisthokonta;Nucletmycea;Fungi;Dikarya;Ascomycota;Pezizomycotina;Lecanoromycetes;Pertusariales;Icmadophilaceae;";"0.0";"0";"8";"8";"0";"8";"0";"430516";"5766"
"LOK1378_1mm";"SILVA (only NR);Eukaryota;Amorphea;Obazoa;Opisthokonta;Nucletmycea;Fungi;Dikarya;Ascomycota;Pezizomycotina;Lecanoromycetes;Pertusariales;Icmadophilaceae;Dibaeis;";"0.0";"0";"2";"2";"0";"2";"0";"430522";"5766"
"LOK1378_1mm";"SILVA (only NR);Eukaryota;Amorphea;Obazoa;Opisthokonta;Nucletmycea;Fungi;Dikarya;Ascomycota;Pezizomycotina;Lecanoromycetes;Pertusariales;Icmadophilaceae;Icmadophila;";"0.0";"0";"1";"1";"0";"1";"0";"430523";"5766"
"LOK1378_1mm";"SILVA (only NR);Eukaryota;Amorphea;Obazoa;Opisthokonta;Nucletmycea;Fungi;Dikarya;Ascomycota;Pezizomycotina;Lecanoromycetes;Pertusariales;Icmadophilaceae;Siphula;";"0.0";"0";"4";"4";"0";"4";"0";"430520";"5766"
"LOK1378_1mm";"SILVA (only NR);Eukaryota;Amorphea;Obazoa;Opisthokonta;Nucletmycea;Fungi;Dikarya;Ascomycota;Pezizomycotina;Lecanoromycetes;Pertusariales;Icmadophilaceae;Thamnolia;";"0.0";"0";"1";"1";"0";"1";"0";"430523";"5766"
"LOK1378_1mm";"SILVA (only NR);Eukaryota;Amorphea;Obazoa;Opisthokonta;Nucletmycea;Fungi;Dikarya;Ascomycota;Pezizomycotina;Lecanoromycetes;Pertusariales;Ochrolechiaceae;";"0.0";"0";"4";"3";"0";"3";"1";"430521";"5766"
"LOK1378_1mm";"SILVA (only NR);Eukaryota;Amorphea;Obazoa;Opisthokonta;Nucletmycea;Fungi;Dikarya;Ascomycota;Pezizomycotina;Lecanoromycetes;Pertusariales;Ochrolechiaceae;Ochrolechia;";"0.0";"0";"4";"3";"0";"3";"1";"430521";"5766"
"LOK1378_1mm";"SILVA (only NR);Eukaryota;Amorphea;Obazoa;Opisthokonta;Nucletmycea;Fungi;Dikarya;Ascomycota;Pezizomycotina;Lecanoromycetes;Pertusariales;Pertusariaceae;";"0.0";"0";"10";"8";"0";"8";"2";"430516";"5766"
"LOK1378_1mm";"SILVA (only NR);Eukaryota;Amorphea;Obazoa;Opisthokonta;Nucletmycea;Fungi;Dikarya;Ascomycota;Pezizomycotina;Lecanoromycetes;Pertusariales;Pertusariaceae;Loxosporopsis;";"0.0";"0";"1";"1";"0";"1";"0";"430523";"5766"
"LOK1378_1mm";"SILVA (only NR);Eukaryota;Amorphea;Obazoa;Opisthokonta;Nucletmycea;Fungi;Dikarya;Ascomycota;Pezizomycotina;Lecanoromycetes;Pertusariales;Pertusariaceae;Pertusaria;";"0.0";"0";"8";"6";"0";"6";"2";"430518";"5766"
"LOK1378_1mm";"SILVA (only NR);Eukaryota;Amorphea;Obazoa;Opisthokonta;Nucletmycea;Fungi;Dikarya;Ascomycota;Pezizomycotina;Lecanoromycetes;Rhizocarpales;";"0.0";"0";"2";"2";"0";"2";"0";"430522";"5766"
"LOK1378_1mm";"SILVA (only NR);Eukaryota;Amorphea;Obazoa;Opisthokonta;Nucletmycea;Fungi;Dikarya;Ascomycota;Pezizomycotina;Lecanoromycetes;Rhizocarpales;Rhizocarpaceae;";"0.0";"0";"2";"2";"0";"2";"0";"430522";"5766"
"LOK1378_1mm";"SILVA (only NR);Eukaryota;Amorphea;Obazoa;Opisthokonta;Nucletmycea;Fungi;Dikarya;Ascomycota;Pezizomycotina;Lecanoromycetes;Rhizocarpales;Rhizocarpaceae;Rhizocarpon;";"0.0";"0";"2";"2";"0";"2";"0";"430522";"5766"
"LOK1378_1mm";"SILVA (only NR);Eukaryota;Amorphea;Obazoa;Opisthokonta;Nucletmycea;Fungi;Dikarya;Ascomycota;Pezizomycotina;Lecanoromycetes;Teloschistales;";"0.0";"0";"48";"48";"0";"48";"0";"430476";"5766"
"LOK1378_1mm";"SILVA (only NR);Eukaryota;Amorphea;Obazoa;Opisthokonta;Nucletmycea;Fungi;Dikarya;Ascomycota;Pezizomycotina;Lecanoromycetes;Teloschistales;Brigantiaeaceae;";"0.0";"0";"2";"2";"0";"2";"0";"430522";"5766"
"LOK1378_1mm";"SILVA (only NR);Eukaryota;Amorphea;Obazoa;Opisthokonta;Nucletmycea;Fungi;Dikarya;Ascomycota;Pezizomycotina;Lecanoromycetes;Teloschistales;Brigantiaeaceae;Brigantiaea;";"0.0";"0";"2";"2";"0";"2";"0";"430522";"5766"
"LOK1378_1mm";"SILVA (only NR);Eukaryota;Amorphea;Obazoa;Opisthokonta;Nucletmycea;Fungi;Dikarya;Ascomycota;Pezizomycotina;Lecanoromycetes;Teloschistales;Letrouitiaceae;";"0.0";"0";"4";"4";"0";"4";"0";"430520";"5766"
"LOK1378_1mm";"SILVA (only NR);Eukaryota;Amorphea;Obazoa;Opisthokonta;Nucletmycea;Fungi;Dikarya;Ascomycota;Pezizomycotina;Lecanoromycetes;Teloschistales;Letrouitiaceae;Letrouitia;";"0.0";"0";"4";"4";"0";"4";"0";"430520";"5766"
"LOK1378_1mm";"SILVA (only NR);Eukaryota;Amorphea;Obazoa;Opisthokonta;Nucletmycea;Fungi;Dikarya;Ascomycota;Pezizomycotina;Lecanoromycetes;Teloschistales;Megalosporaceae;";"0.0";"0";"3";"3";"0";"3";"0";"430521";"5766"
"LOK1378_1mm";"SILVA (only NR);Eukaryota;Amorphea;Obazoa;Opisthokonta;Nucletmycea;Fungi;Dikarya;Ascomycota;Pezizomycotina;Lecanoromycetes;Teloschistales;Megalosporaceae;Megalospora;";"0.0";"0";"2";"2";"0";"2";"0";"430522";"5766"
"LOK1378_1mm";"SILVA (only NR);Eukaryota;Amorphea;Obazoa;Opisthokonta;Nucletmycea;Fungi;Dikarya;Ascomycota;Pezizomycotina;Lecanoromycetes;Teloschistales;Megalosporaceae;Sipmaniella;";"0.0";"0";"1";"1";"0";"1";"0";"430523";"5766"
"LOK1378_1mm";"SILVA (only NR);Eukaryota;Amorphea;Obazoa;Opisthokonta;Nucletmycea;Fungi;Dikarya;Ascomycota;Pezizomycotina;Lecanoromycetes;Teloschistales;Teloschistaceae;";"0.0";"0";"39";"39";"0";"39";"0";"430485";"5766"
"LOK1378_1mm";"SILVA (only NR);Eukaryota;Amorphea;Obazoa;Opisthokonta;Nucletmycea;Fungi;Dikarya;Ascomycota;Pezizomycotina;Lecanoromycetes;Teloschistales;Teloschistaceae;Caloplaca;";"0.0";"0";"3";"3";"0";"3";"0";"430521";"5766"
"LOK1378_1mm";"SILVA (only NR);Eukaryota;Amorphea;Obazoa;Opisthokonta;Nucletmycea;Fungi;Dikarya;Ascomycota;Pezizomycotina;Lecanoromycetes;Teloschistales;Teloschistaceae;Dufourea;";"0.0";"0";"2";"2";"0";"2";"0";"430522";"5766"
"LOK1378_1mm";"SILVA (only NR);Eukaryota;Amorphea;Obazoa;Opisthokonta;Nucletmycea;Fungi;Dikarya;Ascomycota;Pezizomycotina;Lecanoromycetes;Teloschistales;Teloschistaceae;Flavoplaca;";"0.0";"0";"1";"1";"0";"1";"0";"430523";"5766"
"LOK1378_1mm";"SILVA (only NR);Eukaryota;Amorphea;Obazoa;Opisthokonta;Nucletmycea;Fungi;Dikarya;Ascomycota;Pezizomycotina;Lecanoromycetes;Teloschistales;Teloschistaceae;Gyalolechia;";"0.0";"0";"1";"1";"0";"1";"0";"430523";"5766"
"LOK1378_1mm";"SILVA (only NR);Eukaryota;Amorphea;Obazoa;Opisthokonta;Nucletmycea;Fungi;Dikarya;Ascomycota;Pezizomycotina;Lecanoromycetes;Teloschistales;Teloschistaceae;Hosseusiella;";"0.0";"0";"1";"1";"0";"1";"0";"430523";"5766"
"LOK1378_1mm";"SILVA (only NR);Eukaryota;Amorphea;Obazoa;Opisthokonta;Nucletmycea;Fungi;Dikarya;Ascomycota;Pezizomycotina;Lecanoromycetes;Teloschistales;Teloschistaceae;Josefpoeltia;";"0.0";"0";"1";"1";"0";"1";"0";"430523";"5766"
"LOK1378_1mm";"SILVA (only NR);Eukaryota;Amorphea;Obazoa;Opisthokonta;Nucletmycea;Fungi;Dikarya;Ascomycota;Pezizomycotina;Lecanoromycetes;Teloschistales;Teloschistaceae;Niorma;";"0.0";"0";"3";"3";"0";"3";"0";"430521";"5766"
"LOK1378_1mm";"SILVA (only NR);Eukaryota;Amorphea;Obazoa;Opisthokonta;Nucletmycea;Fungi;Dikarya;Ascomycota;Pezizomycotina;Lecanoromycetes;Teloschistales;Teloschistaceae;Olegblumia;";"0.0";"0";"1";"1";"0";"1";"0";"430523";"5766"
"LOK1378_1mm";"SILVA (only NR);Eukaryota;Amorphea;Obazoa;Opisthokonta;Nucletmycea;Fungi;Dikarya;Ascomycota;Pezizomycotina;Lecanoromycetes;Teloschistales;Teloschistaceae;Polycauliona;";"0.0";"0";"1";"1";"0";"1";"0";"430523";"5766"
"LOK1378_1mm";"SILVA (only NR);Eukaryota;Amorphea;Obazoa;Opisthokonta;Nucletmycea;Fungi;Dikarya;Ascomycota;Pezizomycotina;Lecanoromycetes;Teloschistales;Teloschistaceae;Pyrenodesmia;";"0.0";"0";"1";"1";"0";"1";"0";"430523";"5766"
"LOK1378_1mm";"SILVA (only NR);Eukaryota;Amorphea;Obazoa;Opisthokonta;Nucletmycea;Fungi;Dikarya;Ascomycota;Pezizomycotina;Lecanoromycetes;Teloschistales;Teloschistaceae;Rusavskia;";"0.0";"0";"4";"4";"0";"4";"0";"430520";"5766"
"LOK1378_1mm";"SILVA (only NR);Eukaryota;Amorphea;Obazoa;Opisthokonta;Nucletmycea;Fungi;Dikarya;Ascomycota;Pezizomycotina;Lecanoromycetes;Teloschistales;Teloschistaceae;Teloschistes;";"0.0";"0";"3";"3";"0";"3";"0";"430521";"5766"
"LOK1378_1mm";"SILVA (only NR);Eukaryota;Amorphea;Obazoa;Opisthokonta;Nucletmycea;Fungi;Dikarya;Ascomycota;Pezizomycotina;Lecanoromycetes;Teloschistales;Teloschistaceae;Usnochroma;";"0.0";"0";"1";"1";"0";"1";"0";"430523";"5766"
"LOK1378_1mm";"SILVA (only NR);Eukaryota;Amorphea;Obazoa;Opisthokonta;Nucletmycea;Fungi;Dikarya;Ascomycota;Pezizomycotina;Lecanoromycetes;Teloschistales;Teloschistaceae;Xanthocarpia;";"0.0";"0";"1";"1";"0";"1";"0";"430523";"5766"
"LOK1378_1mm";"SILVA (only NR);Eukaryota;Amorphea;Obazoa;Opisthokonta;Nucletmycea;Fungi;Dikarya;Ascomycota;Pezizomycotina;Lecanoromycetes;Teloschistales;Teloschistaceae;Xanthomendoza;";"0.0";"0";"9";"9";"0";"9";"0";"430515";"5766"
"LOK1378_1mm";"SILVA (only NR);Eukaryota;Amorphea;Obazoa;Opisthokonta;Nucletmycea;Fungi;Dikarya;Ascomycota;Pezizomycotina;Lecanoromycetes;Teloschistales;Teloschistaceae;Xanthoria;";"0.0";"0";"4";"4";"0";"4";"0";"430520";"5766"
"LOK1378_1mm";"SILVA (only NR);Eukaryota;Amorphea;Obazoa;Opisthokonta;Nucletmycea;Fungi;Dikarya;Ascomycota;Pezizomycotina;Lecanoromycetes;Trapeliales;";"0.0";"0";"4";"4";"0";"4";"0";"430520";"5766"
"LOK1378_1mm";"SILVA (only NR);Eukaryota;Amorphea;Obazoa;Opisthokonta;Nucletmycea;Fungi;Dikarya;Ascomycota;Pezizomycotina;Lecanoromycetes;Trapeliales;Trapeliaceae;";"0.0";"0";"4";"4";"0";"4";"0";"430520";"5766"
"LOK1378_1mm";"SILVA (only NR);Eukaryota;Amorphea;Obazoa;Opisthokonta;Nucletmycea;Fungi;Dikarya;Ascomycota;Pezizomycotina;Lecanoromycetes;Trapeliales;Trapeliaceae;Placopsis;";"0.0";"0";"1";"1";"0";"1";"0";"430523";"5766"
"LOK1378_1mm";"SILVA (only NR);Eukaryota;Amorphea;Obazoa;Opisthokonta;Nucletmycea;Fungi;Dikarya;Ascomycota;Pezizomycotina;Lecanoromycetes;Trapeliales;Trapeliaceae;Trapelia;";"0.0";"0";"1";"1";"0";"1";"0";"430523";"5766"
"LOK1378_1mm";"SILVA (only NR);Eukaryota;Amorphea;Obazoa;Opisthokonta;Nucletmycea;Fungi;Dikarya;Ascomycota;Pezizomycotina;Lecanoromycetes;Trapeliales;Trapeliaceae;Trapeliopsis;";"0.0";"0";"1";"1";"0";"1";"0";"430523";"5766"
"LOK1378_1mm";"SILVA (only NR);Eukaryota;Amorphea;Obazoa;Opisthokonta;Nucletmycea;Fungi;Dikarya;Ascomycota;Pezizomycotina;Lecanoromycetes;Trapeliales;Trapeliaceae;Xylographa;";"0.0";"0";"1";"1";"0";"1";"0";"430523";"5766"
"LOK1378_1mm";"SILVA (only NR);Eukaryota;Amorphea;Obazoa;Opisthokonta;Nucletmycea;Fungi;Dikarya;Ascomycota;Pezizomycotina;Lecanoromycetes;Umbilicariales;";"0.0";"0";"13";"13";"0";"13";"0";"430511";"5766"
"LOK1378_1mm";"SILVA (only NR);Eukaryota;Amorphea;Obazoa;Opisthokonta;Nucletmycea;Fungi;Dikarya;Ascomycota;Pezizomycotina;Lecanoromycetes;Umbilicariales;Umbilicariaceae;";"0.0";"0";"13";"13";"0";"13";"0";"430511";"5766"
"LOK1378_1mm";"SILVA (only NR);Eukaryota;Amorphea;Obazoa;Opisthokonta;Nucletmycea;Fungi;Dikarya;Ascomycota;Pezizomycotina;Lecanoromycetes;Umbilicariales;Umbilicariaceae;Umbilicaria;";"0.0";"0";"13";"13";"0";"13";"0";"430511";"5766"
"LOK1378_1mm";"SILVA (only NR);Eukaryota;Amorphea;Obazoa;Opisthokonta;Nucletmycea;Fungi;Dikarya;Ascomycota;Pezizomycotina;Leotiomyceta Incertae Sedis;";"0.0";"0";"2";"1";"0";"1";"1";"430523";"5766"
"LOK1378_1mm";"SILVA (only NR);Eukaryota;Amorphea;Obazoa;Opisthokonta;Nucletmycea;Fungi;Dikarya;Ascomycota;Pezizomycotina;Leotiomyceta Incertae Sedis;Candelariales;";"0.0";"0";"2";"1";"0";"1";"1";"430523";"5766"
"LOK1378_1mm";"SILVA (only NR);Eukaryota;Amorphea;Obazoa;Opisthokonta;Nucletmycea;Fungi;Dikarya;Ascomycota;Pezizomycotina;Leotiomyceta Incertae Sedis;Candelariales;Pycnoraceae;";"0.0";"0";"2";"1";"0";"1";"1";"430523";"5766"
"LOK1378_1mm";"SILVA (only NR);Eukaryota;Amorphea;Obazoa;Opisthokonta;Nucletmycea;Fungi;Dikarya;Ascomycota;Pezizomycotina;Leotiomyceta Incertae Sedis;Candelariales;Pycnoraceae;Pycnora;";"0.0";"0";"1";"1";"0";"1";"0";"430523";"5766"
"LOK1378_1mm";"SILVA (only NR);Eukaryota;Amorphea;Obazoa;Opisthokonta;Nucletmycea;Fungi;Dikarya;Ascomycota;Pezizomycotina;Leotiomycetes;";"0.0";"0";"226";"199";"0";"199";"27";"430325";"5766"
"LOK1378_1mm";"SILVA (only NR);Eukaryota;Amorphea;Obazoa;Opisthokonta;Nucletmycea;Fungi;Dikarya;Ascomycota;Pezizomycotina;Leotiomycetes;Cyttariales;";"0.0";"0";"6";"6";"0";"6";"0";"430518";"5766"
"LOK1378_1mm";"SILVA (only NR);Eukaryota;Amorphea;Obazoa;Opisthokonta;Nucletmycea;Fungi;Dikarya;Ascomycota;Pezizomycotina;Leotiomycetes;Cyttariales;Cyttariaceae;";"0.0";"0";"6";"6";"0";"6";"0";"430518";"5766"
"LOK1378_1mm";"SILVA (only NR);Eukaryota;Amorphea;Obazoa;Opisthokonta;Nucletmycea;Fungi;Dikarya;Ascomycota;Pezizomycotina;Leotiomycetes;Cyttariales;Cyttariaceae;Cyttaria;";"0.0";"0";"6";"6";"0";"6";"0";"430518";"5766"
"LOK1378_1mm";"SILVA (only NR);Eukaryota;Amorphea;Obazoa;Opisthokonta;Nucletmycea;Fungi;Dikarya;Ascomycota;Pezizomycotina;Leotiomycetes;Erysiphales;";"0.0";"0";"17";"16";"0";"16";"1";"430508";"5766"
"LOK1378_1mm";"SILVA (only NR);Eukaryota;Amorphea;Obazoa;Opisthokonta;Nucletmycea;Fungi;Dikarya;Ascomycota;Pezizomycotina;Leotiomycetes;Erysiphales;Erysiphaceae;";"0.0";"0";"17";"16";"0";"16";"1";"430508";"5766"
"LOK1378_1mm";"SILVA (only NR);Eukaryota;Amorphea;Obazoa;Opisthokonta;Nucletmycea;Fungi;Dikarya;Ascomycota;Pezizomycotina;Leotiomycetes;Erysiphales;Erysiphaceae;Arthrocladiella;";"0.0";"0";"1";"1";"0";"1";"0";"430523";"5766"
"LOK1378_1mm";"SILVA (only NR);Eukaryota;Amorphea;Obazoa;Opisthokonta;Nucletmycea;Fungi;Dikarya;Ascomycota;Pezizomycotina;Leotiomycetes;Erysiphales;Erysiphaceae;Blumeria;";"0.0";"0";"1";"1";"0";"1";"0";"430523";"5766"
"LOK1378_1mm";"SILVA (only NR);Eukaryota;Amorphea;Obazoa;Opisthokonta;Nucletmycea;Fungi;Dikarya;Ascomycota;Pezizomycotina;Leotiomycetes;Erysiphales;Erysiphaceae;Brasiliomyces;";"0.0";"0";"1";"1";"0";"1";"0";"430523";"5766"
"LOK1378_1mm";"SILVA (only NR);Eukaryota;Amorphea;Obazoa;Opisthokonta;Nucletmycea;Fungi;Dikarya;Ascomycota;Pezizomycotina;Leotiomycetes;Erysiphales;Erysiphaceae;Caespitotheca;";"0.0";"0";"1";"1";"0";"1";"0";"430523";"5766"
"LOK1378_1mm";"SILVA (only NR);Eukaryota;Amorphea;Obazoa;Opisthokonta;Nucletmycea;Fungi;Dikarya;Ascomycota;Pezizomycotina;Leotiomycetes;Erysiphales;Erysiphaceae;Erysiphe;";"0.0";"0";"5";"4";"0";"4";"1";"430520";"5766"
"LOK1378_1mm";"SILVA (only NR);Eukaryota;Amorphea;Obazoa;Opisthokonta;Nucletmycea;Fungi;Dikarya;Ascomycota;Pezizomycotina;Leotiomycetes;Erysiphales;Erysiphaceae;Golovinomyces;";"0.0";"0";"1";"1";"0";"1";"0";"430523";"5766"
"LOK1378_1mm";"SILVA (only NR);Eukaryota;Amorphea;Obazoa;Opisthokonta;Nucletmycea;Fungi;Dikarya;Ascomycota;Pezizomycotina;Leotiomycetes;Erysiphales;Erysiphaceae;Microidium;";"0.0";"0";"1";"1";"0";"1";"0";"430523";"5766"
"LOK1378_1mm";"SILVA (only NR);Eukaryota;Amorphea;Obazoa;Opisthokonta;Nucletmycea;Fungi;Dikarya;Ascomycota;Pezizomycotina;Leotiomycetes;Erysiphales;Erysiphaceae;Neoerysiphe;";"0.0";"0";"1";"1";"0";"1";"0";"430523";"5766"
"LOK1378_1mm";"SILVA (only NR);Eukaryota;Amorphea;Obazoa;Opisthokonta;Nucletmycea;Fungi;Dikarya;Ascomycota;Pezizomycotina;Leotiomycetes;Erysiphales;Erysiphaceae;Parauncinula;";"0.0";"0";"1";"1";"0";"1";"0";"430523";"5766"
"LOK1378_1mm";"SILVA (only NR);Eukaryota;Amorphea;Obazoa;Opisthokonta;Nucletmycea;Fungi;Dikarya;Ascomycota;Pezizomycotina;Leotiomycetes;Erysiphales;Erysiphaceae;Phyllactinia;";"0.0";"0";"1";"1";"0";"1";"0";"430523";"5766"
"LOK1378_1mm";"SILVA (only NR);Eukaryota;Amorphea;Obazoa;Opisthokonta;Nucletmycea;Fungi;Dikarya;Ascomycota;Pezizomycotina;Leotiomycetes;Erysiphales;Erysiphaceae;Pleochaeta;";"0.0";"0";"2";"2";"0";"2";"0";"430522";"5766"
"LOK1378_1mm";"SILVA (only NR);Eukaryota;Amorphea;Obazoa;Opisthokonta;Nucletmycea;Fungi;Dikarya;Ascomycota;Pezizomycotina;Leotiomycetes;Erysiphales;Erysiphaceae;Podosphaera;";"0.0";"0";"1";"1";"0";"1";"0";"430523";"5766"
"LOK1378_1mm";"SILVA (only NR);Eukaryota;Amorphea;Obazoa;Opisthokonta;Nucletmycea;Fungi;Dikarya;Ascomycota;Pezizomycotina;Leotiomycetes;Helotiales;";"0.0";"0";"147";"127";"0";"127";"20";"430397";"5766"
"LOK1378_1mm";"SILVA (only NR);Eukaryota;Amorphea;Obazoa;Opisthokonta;Nucletmycea;Fungi;Dikarya;Ascomycota;Pezizomycotina;Leotiomycetes;Helotiales;Bambusicola;";"0.0";"0";"1";"0";"0";"0";"1";"430524";"5766"
"LOK1378_1mm";"SILVA (only NR);Eukaryota;Amorphea;Obazoa;Opisthokonta;Nucletmycea;Fungi;Dikarya;Ascomycota;Pezizomycotina;Leotiomycetes;Helotiales;Bisporella;";"0.0";"0";"1";"1";"0";"1";"0";"430523";"5766"
"LOK1378_1mm";"SILVA (only NR);Eukaryota;Amorphea;Obazoa;Opisthokonta;Nucletmycea;Fungi;Dikarya;Ascomycota;Pezizomycotina;Leotiomycetes;Helotiales;Calycellinopsis;";"0.0";"0";"1";"1";"0";"1";"0";"430523";"5766"
"LOK1378_1mm";"SILVA (only NR);Eukaryota;Amorphea;Obazoa;Opisthokonta;Nucletmycea;Fungi;Dikarya;Ascomycota;Pezizomycotina;Leotiomycetes;Helotiales;Calycina;";"0.0";"0";"2";"2";"0";"2";"0";"430522";"5766"
"LOK1378_1mm";"SILVA (only NR);Eukaryota;Amorphea;Obazoa;Opisthokonta;Nucletmycea;Fungi;Dikarya;Ascomycota;Pezizomycotina;Leotiomycetes;Helotiales;Cashiella;";"0.0";"0";"1";"0";"0";"0";"1";"430524";"5766"
"LOK1378_1mm";"SILVA (only NR);Eukaryota;Amorphea;Obazoa;Opisthokonta;Nucletmycea;Fungi;Dikarya;Ascomycota;Pezizomycotina;Leotiomycetes;Helotiales;Cenangiaceae;";"0.0";"0";"5";"3";"0";"3";"2";"430521";"5766"
"LOK1378_1mm";"SILVA (only NR);Eukaryota;Amorphea;Obazoa;Opisthokonta;Nucletmycea;Fungi;Dikarya;Ascomycota;Pezizomycotina;Leotiomycetes;Helotiales;Cenangiaceae;Cenangium;";"0.0";"0";"2";"0";"0";"0";"2";"430524";"5766"
"LOK1378_1mm";"SILVA (only NR);Eukaryota;Amorphea;Obazoa;Opisthokonta;Nucletmycea;Fungi;Dikarya;Ascomycota;Pezizomycotina;Leotiomycetes;Helotiales;Cenangiaceae;Chlorencoelia;";"0.0";"0";"1";"1";"0";"1";"0";"430523";"5766"
"LOK1378_1mm";"SILVA (only NR);Eukaryota;Amorphea;Obazoa;Opisthokonta;Nucletmycea;Fungi;Dikarya;Ascomycota;Pezizomycotina;Leotiomycetes;Helotiales;Cenangiaceae;Heyderia;";"0.0";"0";"1";"1";"0";"1";"0";"430523";"5766"
"LOK1378_1mm";"SILVA (only NR);Eukaryota;Amorphea;Obazoa;Opisthokonta;Nucletmycea;Fungi;Dikarya;Ascomycota;Pezizomycotina;Leotiomycetes;Helotiales;Cenangiaceae;Sarcotrochila;";"0.0";"0";"1";"1";"0";"1";"0";"430523";"5766"
"LOK1378_1mm";"SILVA (only NR);Eukaryota;Amorphea;Obazoa;Opisthokonta;Nucletmycea;Fungi;Dikarya;Ascomycota;Pezizomycotina;Leotiomycetes;Helotiales;Chaetomellaceae;";"0.0";"0";"9";"8";"0";"8";"1";"430516";"5766"
"LOK1378_1mm";"SILVA (only NR);Eukaryota;Amorphea;Obazoa;Opisthokonta;Nucletmycea;Fungi;Dikarya;Ascomycota;Pezizomycotina;Leotiomycetes;Helotiales;Chaetomellaceae;Chaetomella;";"0.0";"0";"5";"4";"0";"4";"1";"430520";"5766"
"LOK1378_1mm";"SILVA (only NR);Eukaryota;Amorphea;Obazoa;Opisthokonta;Nucletmycea;Fungi;Dikarya;Ascomycota;Pezizomycotina;Leotiomycetes;Helotiales;Chaetomellaceae;Pilidium;";"0.0";"0";"2";"2";"0";"2";"0";"430522";"5766"
"LOK1378_1mm";"SILVA (only NR);Eukaryota;Amorphea;Obazoa;Opisthokonta;Nucletmycea;Fungi;Dikarya;Ascomycota;Pezizomycotina;Leotiomycetes;Helotiales;Chaetomellaceae;Sphaerographium;";"0.0";"0";"1";"1";"0";"1";"0";"430523";"5766"
"LOK1378_1mm";"SILVA (only NR);Eukaryota;Amorphea;Obazoa;Opisthokonta;Nucletmycea;Fungi;Dikarya;Ascomycota;Pezizomycotina;Leotiomycetes;Helotiales;Chaetomellaceae;Synchaetomella;";"0.0";"0";"1";"1";"0";"1";"0";"430523";"5766"
"LOK1378_1mm";"SILVA (only NR);Eukaryota;Amorphea;Obazoa;Opisthokonta;Nucletmycea;Fungi;Dikarya;Ascomycota;Pezizomycotina;Leotiomycetes;Helotiales;Chlorociboriaceae;";"0.0";"0";"4";"2";"0";"2";"2";"430522";"5766"
"LOK1378_1mm";"SILVA (only NR);Eukaryota;Amorphea;Obazoa;Opisthokonta;Nucletmycea;Fungi;Dikarya;Ascomycota;Pezizomycotina;Leotiomycetes;Helotiales;Chlorociboriaceae;Chlorociboria;";"0.0";"0";"4";"2";"0";"2";"2";"430522";"5766"
"LOK1378_1mm";"SILVA (only NR);Eukaryota;Amorphea;Obazoa;Opisthokonta;Nucletmycea;Fungi;Dikarya;Ascomycota;Pezizomycotina;Leotiomycetes;Helotiales;Chlorovibrissea;";"0.0";"0";"1";"0";"0";"0";"1";"430524";"5766"
"LOK1378_1mm";"SILVA (only NR);Eukaryota;Amorphea;Obazoa;Opisthokonta;Nucletmycea;Fungi;Dikarya;Ascomycota;Pezizomycotina;Leotiomycetes;Helotiales;Claussenomyces;";"0.0";"0";"1";"1";"0";"1";"0";"430523";"5766"
"LOK1378_1mm";"SILVA (only NR);Eukaryota;Amorphea;Obazoa;Opisthokonta;Nucletmycea;Fungi;Dikarya;Ascomycota;Pezizomycotina;Leotiomycetes;Helotiales;Cordieritidaceae;";"0.0";"0";"2";"2";"0";"2";"0";"430522";"5766"
"LOK1378_1mm";"SILVA (only NR);Eukaryota;Amorphea;Obazoa;Opisthokonta;Nucletmycea;Fungi;Dikarya;Ascomycota;Pezizomycotina;Leotiomycetes;Helotiales;Cordieritidaceae;Cordierites;";"0.0";"0";"1";"1";"0";"1";"0";"430523";"5766"
"LOK1378_1mm";"SILVA (only NR);Eukaryota;Amorphea;Obazoa;Opisthokonta;Nucletmycea;Fungi;Dikarya;Ascomycota;Pezizomycotina;Leotiomycetes;Helotiales;Cordieritidaceae;Thamnogalla;";"0.0";"0";"1";"1";"0";"1";"0";"430523";"5766"
"LOK1378_1mm";"SILVA (only NR);Eukaryota;Amorphea;Obazoa;Opisthokonta;Nucletmycea;Fungi;Dikarya;Ascomycota;Pezizomycotina;Leotiomycetes;Helotiales;Cyclaneusma;";"0.0";"0";"1";"0";"0";"0";"1";"430524";"5766"
"LOK1378_1mm";"SILVA (only NR);Eukaryota;Amorphea;Obazoa;Opisthokonta;Nucletmycea;Fungi;Dikarya;Ascomycota;Pezizomycotina;Leotiomycetes;Helotiales;Dermateaceae;";"0.0";"0";"2";"1";"0";"1";"1";"430523";"5766"
"LOK1378_1mm";"SILVA (only NR);Eukaryota;Amorphea;Obazoa;Opisthokonta;Nucletmycea;Fungi;Dikarya;Ascomycota;Pezizomycotina;Leotiomycetes;Helotiales;Dermateaceae;Dermea;";"0.0";"0";"1";"1";"0";"1";"0";"430523";"5766"
"LOK1378_1mm";"SILVA (only NR);Eukaryota;Amorphea;Obazoa;Opisthokonta;Nucletmycea;Fungi;Dikarya;Ascomycota;Pezizomycotina;Leotiomycetes;Helotiales;Dermateaceae;Pezicula;";"0.0";"0";"1";"0";"0";"0";"1";"430524";"5766"
"LOK1378_1mm";"SILVA (only NR);Eukaryota;Amorphea;Obazoa;Opisthokonta;Nucletmycea;Fungi;Dikarya;Ascomycota;Pezizomycotina;Leotiomycetes;Helotiales;Discohainesia;";"0.0";"0";"1";"1";"0";"1";"0";"430523";"5766"
"LOK1378_1mm";"SILVA (only NR);Eukaryota;Amorphea;Obazoa;Opisthokonta;Nucletmycea;Fungi;Dikarya;Ascomycota;Pezizomycotina;Leotiomycetes;Helotiales;Encoelia;";"0.0";"0";"1";"1";"0";"1";"0";"430523";"5766"
"LOK1378_1mm";"SILVA (only NR);Eukaryota;Amorphea;Obazoa;Opisthokonta;Nucletmycea;Fungi;Dikarya;Ascomycota;Pezizomycotina;Leotiomycetes;Helotiales;Glarea;";"0.0";"0";"1";"1";"0";"1";"0";"430523";"5766"
"LOK1378_1mm";"SILVA (only NR);Eukaryota;Amorphea;Obazoa;Opisthokonta;Nucletmycea;Fungi;Dikarya;Ascomycota;Pezizomycotina;Leotiomycetes;Helotiales;Helotiaceae;";"0.0";"0";"25";"23";"0";"23";"2";"430501";"5766"
"LOK1378_1mm";"SILVA (only NR);Eukaryota;Amorphea;Obazoa;Opisthokonta;Nucletmycea;Fungi;Dikarya;Ascomycota;Pezizomycotina;Leotiomycetes;Helotiales;Helotiaceae;Acidea;";"0.0";"0";"2";"2";"0";"2";"0";"430522";"5766"
"LOK1378_1mm";"SILVA (only NR);Eukaryota;Amorphea;Obazoa;Opisthokonta;Nucletmycea;Fungi;Dikarya;Ascomycota;Pezizomycotina;Leotiomycetes;Helotiales;Helotiaceae;Ascocoryne;";"0.0";"0";"1";"1";"0";"1";"0";"430523";"5766"
"LOK1378_1mm";"SILVA (only NR);Eukaryota;Amorphea;Obazoa;Opisthokonta;Nucletmycea;Fungi;Dikarya;Ascomycota;Pezizomycotina;Leotiomycetes;Helotiales;Helotiaceae;Chloroscypha;";"0.0";"0";"1";"1";"0";"1";"0";"430523";"5766"
"LOK1378_1mm";"SILVA (only NR);Eukaryota;Amorphea;Obazoa;Opisthokonta;Nucletmycea;Fungi;Dikarya;Ascomycota;Pezizomycotina;Leotiomycetes;Helotiales;Helotiaceae;Epiglia;";"0.0";"0";"1";"1";"0";"1";"0";"430523";"5766"
"LOK1378_1mm";"SILVA (only NR);Eukaryota;Amorphea;Obazoa;Opisthokonta;Nucletmycea;Fungi;Dikarya;Ascomycota;Pezizomycotina;Leotiomycetes;Helotiales;Helotiaceae;Epithamnolia;";"0.0";"0";"1";"0";"0";"0";"1";"430524";"5766"
"LOK1378_1mm";"SILVA (only NR);Eukaryota;Amorphea;Obazoa;Opisthokonta;Nucletmycea;Fungi;Dikarya;Ascomycota;Pezizomycotina;Leotiomycetes;Helotiales;Helotiaceae;Gremmeniella;";"0.0";"0";"1";"1";"0";"1";"0";"430523";"5766"
"LOK1378_1mm";"SILVA (only NR);Eukaryota;Amorphea;Obazoa;Opisthokonta;Nucletmycea;Fungi;Dikarya;Ascomycota;Pezizomycotina;Leotiomycetes;Helotiales;Helotiaceae;Helicodendron;";"0.0";"0";"2";"2";"0";"2";"0";"430522";"5766"
"LOK1378_1mm";"SILVA (only NR);Eukaryota;Amorphea;Obazoa;Opisthokonta;Nucletmycea;Fungi;Dikarya;Ascomycota;Pezizomycotina;Leotiomycetes;Helotiales;Helotiaceae;Holwaya;";"0.0";"0";"1";"1";"0";"1";"0";"430523";"5766"
"LOK1378_1mm";"SILVA (only NR);Eukaryota;Amorphea;Obazoa;Opisthokonta;Nucletmycea;Fungi;Dikarya;Ascomycota;Pezizomycotina;Leotiomycetes;Helotiales;Helotiaceae;Meliniomyces;";"0.0";"0";"4";"4";"0";"4";"0";"430520";"5766"
"LOK1378_1mm";"SILVA (only NR);Eukaryota;Amorphea;Obazoa;Opisthokonta;Nucletmycea;Fungi;Dikarya;Ascomycota;Pezizomycotina;Leotiomycetes;Helotiales;Helotiaceae;Mniaecia;";"0.0";"0";"1";"0";"0";"0";"1";"430524";"5766"
"LOK1378_1mm";"SILVA (only NR);Eukaryota;Amorphea;Obazoa;Opisthokonta;Nucletmycea;Fungi;Dikarya;Ascomycota;Pezizomycotina;Leotiomycetes;Helotiales;Helotiaceae;Tetrachaetum;";"0.0";"0";"1";"1";"0";"1";"0";"430523";"5766"
"LOK1378_1mm";"SILVA (only NR);Eukaryota;Amorphea;Obazoa;Opisthokonta;Nucletmycea;Fungi;Dikarya;Ascomycota;Pezizomycotina;Leotiomycetes;Helotiales;Helotiaceae;Varicosporium;";"0.0";"0";"1";"1";"0";"1";"0";"430523";"5766"
"LOK1378_1mm";"SILVA (only NR);Eukaryota;Amorphea;Obazoa;Opisthokonta;Nucletmycea;Fungi;Dikarya;Ascomycota;Pezizomycotina;Leotiomycetes;Helotiales;Hyaloscypha;";"0.0";"0";"1";"1";"0";"1";"0";"430523";"5766"
"LOK1378_1mm";"SILVA (only NR);Eukaryota;Amorphea;Obazoa;Opisthokonta;Nucletmycea;Fungi;Dikarya;Ascomycota;Pezizomycotina;Leotiomycetes;Helotiales;Hymenoscyphus;";"0.0";"0";"2";"2";"0";"2";"0";"430522";"5766"
"LOK1378_1mm";"SILVA (only NR);Eukaryota;Amorphea;Obazoa;Opisthokonta;Nucletmycea;Fungi;Dikarya;Ascomycota;Pezizomycotina;Leotiomycetes;Helotiales;Incertae Sedis;";"0.0";"0";"26";"25";"0";"25";"1";"430499";"5766"
"LOK1378_1mm";"SILVA (only NR);Eukaryota;Amorphea;Obazoa;Opisthokonta;Nucletmycea;Fungi;Dikarya;Ascomycota;Pezizomycotina;Leotiomycetes;Helotiales;Incertae Sedis;Brachyalara;";"0.0";"0";"2";"2";"0";"2";"0";"430522";"5766"
"LOK1378_1mm";"SILVA (only NR);Eukaryota;Amorphea;Obazoa;Opisthokonta;Nucletmycea;Fungi;Dikarya;Ascomycota;Pezizomycotina;Leotiomycetes;Helotiales;Incertae Sedis;Cadophora;";"0.0";"0";"1";"1";"0";"1";"0";"430523";"5766"
"LOK1378_1mm";"SILVA (only NR);Eukaryota;Amorphea;Obazoa;Opisthokonta;Nucletmycea;Fungi;Dikarya;Ascomycota;Pezizomycotina;Leotiomycetes;Helotiales;Incertae Sedis;Exochalara;";"0.0";"0";"2";"2";"0";"2";"0";"430522";"5766"
"LOK1378_1mm";"SILVA (only NR);Eukaryota;Amorphea;Obazoa;Opisthokonta;Nucletmycea;Fungi;Dikarya;Ascomycota;Pezizomycotina;Leotiomycetes;Helotiales;Incertae Sedis;Infundichalara;";"0.0";"0";"2";"2";"0";"2";"0";"430522";"5766"
"LOK1378_1mm";"SILVA (only NR);Eukaryota;Amorphea;Obazoa;Opisthokonta;Nucletmycea;Fungi;Dikarya;Ascomycota;Pezizomycotina;Leotiomycetes;Helotiales;Incertae Sedis;Lemonniera;";"0.0";"0";"3";"3";"0";"3";"0";"430521";"5766"
"LOK1378_1mm";"SILVA (only NR);Eukaryota;Amorphea;Obazoa;Opisthokonta;Nucletmycea;Fungi;Dikarya;Ascomycota;Pezizomycotina;Leotiomycetes;Helotiales;Incertae Sedis;Phialocephala;";"0.0";"0";"4";"4";"0";"4";"0";"430520";"5766"
"LOK1378_1mm";"SILVA (only NR);Eukaryota;Amorphea;Obazoa;Opisthokonta;Nucletmycea;Fungi;Dikarya;Ascomycota;Pezizomycotina;Leotiomycetes;Helotiales;Incertae Sedis;Rhexocercosporidium;";"0.0";"0";"1";"0";"0";"0";"1";"430524";"5766"
"LOK1378_1mm";"SILVA (only NR);Eukaryota;Amorphea;Obazoa;Opisthokonta;Nucletmycea;Fungi;Dikarya;Ascomycota;Pezizomycotina;Leotiomycetes;Helotiales;Incertae Sedis;Skyttea;";"0.0";"0";"2";"2";"0";"2";"0";"430522";"5766"
"LOK1378_1mm";"SILVA (only NR);Eukaryota;Amorphea;Obazoa;Opisthokonta;Nucletmycea;Fungi;Dikarya;Ascomycota;Pezizomycotina;Leotiomycetes;Helotiales;Incertae Sedis;Tetracladium;";"0.0";"0";"9";"9";"0";"9";"0";"430515";"5766"
"LOK1378_1mm";"SILVA (only NR);Eukaryota;Amorphea;Obazoa;Opisthokonta;Nucletmycea;Fungi;Dikarya;Ascomycota;Pezizomycotina;Leotiomycetes;Helotiales;Ionomidotis;";"0.0";"0";"1";"0";"0";"0";"1";"430524";"5766"
"LOK1378_1mm";"SILVA (only NR);Eukaryota;Amorphea;Obazoa;Opisthokonta;Nucletmycea;Fungi;Dikarya;Ascomycota;Pezizomycotina;Leotiomycetes;Helotiales;Lachnellula;";"0.0";"0";"1";"1";"0";"1";"0";"430523";"5766"
"LOK1378_1mm";"SILVA (only NR);Eukaryota;Amorphea;Obazoa;Opisthokonta;Nucletmycea;Fungi;Dikarya;Ascomycota;Pezizomycotina;Leotiomycetes;Helotiales;Lachnum;";"0.0";"0";"2";"2";"0";"2";"0";"430522";"5766"
"LOK1378_1mm";"SILVA (only NR);Eukaryota;Amorphea;Obazoa;Opisthokonta;Nucletmycea;Fungi;Dikarya;Ascomycota;Pezizomycotina;Leotiomycetes;Helotiales;Lambertella;";"0.0";"0";"1";"1";"0";"1";"0";"430523";"5766"
"LOK1378_1mm";"SILVA (only NR);Eukaryota;Amorphea;Obazoa;Opisthokonta;Nucletmycea;Fungi;Dikarya;Ascomycota;Pezizomycotina;Leotiomycetes;Helotiales;Leotiaceae;";"0.0";"0";"9";"9";"0";"9";"0";"430515";"5766"
"LOK1378_1mm";"SILVA (only NR);Eukaryota;Amorphea;Obazoa;Opisthokonta;Nucletmycea;Fungi;Dikarya;Ascomycota;Pezizomycotina;Leotiomycetes;Helotiales;Leotiaceae;Alatospora;";"0.0";"0";"3";"3";"0";"3";"0";"430521";"5766"
"LOK1378_1mm";"SILVA (only NR);Eukaryota;Amorphea;Obazoa;Opisthokonta;Nucletmycea;Fungi;Dikarya;Ascomycota;Pezizomycotina;Leotiomycetes;Helotiales;Leotiaceae;Leotia;";"0.0";"0";"3";"3";"0";"3";"0";"430521";"5766"
"LOK1378_1mm";"SILVA (only NR);Eukaryota;Amorphea;Obazoa;Opisthokonta;Nucletmycea;Fungi;Dikarya;Ascomycota;Pezizomycotina;Leotiomycetes;Helotiales;Leotiaceae;Pezoloma;";"0.0";"0";"3";"3";"0";"3";"0";"430521";"5766"
"LOK1378_1mm";"SILVA (only NR);Eukaryota;Amorphea;Obazoa;Opisthokonta;Nucletmycea;Fungi;Dikarya;Ascomycota;Pezizomycotina;Leotiomycetes;Helotiales;Loramyces;";"0.0";"0";"1";"1";"0";"1";"0";"430523";"5766"
"LOK1378_1mm";"SILVA (only NR);Eukaryota;Amorphea;Obazoa;Opisthokonta;Nucletmycea;Fungi;Dikarya;Ascomycota;Pezizomycotina;Leotiomycetes;Helotiales;Microglossum;";"0.0";"0";"1";"1";"0";"1";"0";"430523";"5766"
"LOK1378_1mm";"SILVA (only NR);Eukaryota;Amorphea;Obazoa;Opisthokonta;Nucletmycea;Fungi;Dikarya;Ascomycota;Pezizomycotina;Leotiomycetes;Helotiales;Neobulgaria;";"0.0";"0";"1";"1";"0";"1";"0";"430523";"5766"
"LOK1378_1mm";"SILVA (only NR);Eukaryota;Amorphea;Obazoa;Opisthokonta;Nucletmycea;Fungi;Dikarya;Ascomycota;Pezizomycotina;Leotiomycetes;Helotiales;Neocudoniella;";"0.0";"0";"1";"1";"0";"1";"0";"430523";"5766"
"LOK1378_1mm";"SILVA (only NR);Eukaryota;Amorphea;Obazoa;Opisthokonta;Nucletmycea;Fungi;Dikarya;Ascomycota;Pezizomycotina;Leotiomycetes;Helotiales;Rhymbocarpus;";"0.0";"0";"1";"1";"0";"1";"0";"430523";"5766"
"LOK1378_1mm";"SILVA (only NR);Eukaryota;Amorphea;Obazoa;Opisthokonta;Nucletmycea;Fungi;Dikarya;Ascomycota;Pezizomycotina;Leotiomycetes;Helotiales;Rhynchosporium;";"0.0";"0";"1";"1";"0";"1";"0";"430523";"5766"
"LOK1378_1mm";"SILVA (only NR);Eukaryota;Amorphea;Obazoa;Opisthokonta;Nucletmycea;Fungi;Dikarya;Ascomycota;Pezizomycotina;Leotiomycetes;Helotiales;Rutstroemia;";"0.0";"0";"1";"0";"0";"0";"1";"430524";"5766"
"LOK1378_1mm";"SILVA (only NR);Eukaryota;Amorphea;Obazoa;Opisthokonta;Nucletmycea;Fungi;Dikarya;Ascomycota;Pezizomycotina;Leotiomycetes;Helotiales;Sclerotiniaceae;";"0.0";"0";"10";"10";"0";"10";"0";"430514";"5766"
"LOK1378_1mm";"SILVA (only NR);Eukaryota;Amorphea;Obazoa;Opisthokonta;Nucletmycea;Fungi;Dikarya;Ascomycota;Pezizomycotina;Leotiomycetes;Helotiales;Sclerotiniaceae;Botrytis;";"0.0";"0";"2";"2";"0";"2";"0";"430522";"5766"
"LOK1378_1mm";"SILVA (only NR);Eukaryota;Amorphea;Obazoa;Opisthokonta;Nucletmycea;Fungi;Dikarya;Ascomycota;Pezizomycotina;Leotiomycetes;Helotiales;Sclerotiniaceae;Scleromitrula;";"0.0";"0";"1";"1";"0";"1";"0";"430523";"5766"
"LOK1378_1mm";"SILVA (only NR);Eukaryota;Amorphea;Obazoa;Opisthokonta;Nucletmycea;Fungi;Dikarya;Ascomycota;Pezizomycotina;Leotiomycetes;Helotiales;Sclerotiniaceae;Sclerotinia;";"0.0";"0";"5";"5";"0";"5";"0";"430519";"5766"
"LOK1378_1mm";"SILVA (only NR);Eukaryota;Amorphea;Obazoa;Opisthokonta;Nucletmycea;Fungi;Dikarya;Ascomycota;Pezizomycotina;Leotiomycetes;Helotiales;Tornabea;";"0.0";"0";"1";"1";"0";"1";"0";"430523";"5766"
"LOK1378_1mm";"SILVA (only NR);Eukaryota;Amorphea;Obazoa;Opisthokonta;Nucletmycea;Fungi;Dikarya;Ascomycota;Pezizomycotina;Leotiomycetes;Helotiales;Tricladium;";"0.0";"0";"1";"1";"0";"1";"0";"430523";"5766"
"LOK1378_1mm";"SILVA (only NR);Eukaryota;Amorphea;Obazoa;Opisthokonta;Nucletmycea;Fungi;Dikarya;Ascomycota;Pezizomycotina;Leotiomycetes;Helotiales;uncultured;";"0.0";"0";"4";"3";"0";"3";"1";"430521";"5766"
"LOK1378_1mm";"SILVA (only NR);Eukaryota;Amorphea;Obazoa;Opisthokonta;Nucletmycea;Fungi;Dikarya;Ascomycota;Pezizomycotina;Leotiomycetes;Incertae Sedis;";"0.0";"0";"16";"15";"0";"15";"1";"430509";"5766"
"LOK1378_1mm";"SILVA (only NR);Eukaryota;Amorphea;Obazoa;Opisthokonta;Nucletmycea;Fungi;Dikarya;Ascomycota;Pezizomycotina;Leotiomycetes;Incertae Sedis;Incertae Sedis;";"0.0";"0";"12";"11";"0";"11";"1";"430513";"5766"
"LOK1378_1mm";"SILVA (only NR);Eukaryota;Amorphea;Obazoa;Opisthokonta;Nucletmycea;Fungi;Dikarya;Ascomycota;Pezizomycotina;Leotiomycetes;Incertae Sedis;Incertae Sedis;Collophora;";"0.0";"0";"1";"1";"0";"1";"0";"430523";"5766"
"LOK1378_1mm";"SILVA (only NR);Eukaryota;Amorphea;Obazoa;Opisthokonta;Nucletmycea;Fungi;Dikarya;Ascomycota;Pezizomycotina;Leotiomycetes;Incertae Sedis;Incertae Sedis;Gelatinomyces;";"0.0";"0";"1";"1";"0";"1";"0";"430523";"5766"
"LOK1378_1mm";"SILVA (only NR);Eukaryota;Amorphea;Obazoa;Opisthokonta;Nucletmycea;Fungi;Dikarya;Ascomycota;Pezizomycotina;Leotiomycetes;Incertae Sedis;Incertae Sedis;Leohumicola;";"0.0";"0";"2";"2";"0";"2";"0";"430522";"5766"
"LOK1378_1mm";"SILVA (only NR);Eukaryota;Amorphea;Obazoa;Opisthokonta;Nucletmycea;Fungi;Dikarya;Ascomycota;Pezizomycotina;Leotiomycetes;Incertae Sedis;Incertae Sedis;Scytalidium;";"0.0";"0";"5";"5";"0";"5";"0";"430519";"5766"
"LOK1378_1mm";"SILVA (only NR);Eukaryota;Amorphea;Obazoa;Opisthokonta;Nucletmycea;Fungi;Dikarya;Ascomycota;Pezizomycotina;Leotiomycetes;Incertae Sedis;Incertae Sedis;Soosiella;";"0.0";"0";"1";"1";"0";"1";"0";"430523";"5766"
"LOK1378_1mm";"SILVA (only NR);Eukaryota;Amorphea;Obazoa;Opisthokonta;Nucletmycea;Fungi;Dikarya;Ascomycota;Pezizomycotina;Leotiomycetes;Incertae Sedis;Incertae Sedis;Xylogone;";"0.0";"0";"2";"1";"0";"1";"1";"430523";"5766"
"LOK1378_1mm";"SILVA (only NR);Eukaryota;Amorphea;Obazoa;Opisthokonta;Nucletmycea;Fungi;Dikarya;Ascomycota;Pezizomycotina;Leotiomycetes;Incertae Sedis;Myxotrichaceae;";"0.0";"0";"4";"4";"0";"4";"0";"430520";"5766"
"LOK1378_1mm";"SILVA (only NR);Eukaryota;Amorphea;Obazoa;Opisthokonta;Nucletmycea;Fungi;Dikarya;Ascomycota;Pezizomycotina;Leotiomycetes;Incertae Sedis;Myxotrichaceae;Byssoascus;";"0.0";"0";"1";"1";"0";"1";"0";"430523";"5766"
"LOK1378_1mm";"SILVA (only NR);Eukaryota;Amorphea;Obazoa;Opisthokonta;Nucletmycea;Fungi;Dikarya;Ascomycota;Pezizomycotina;Leotiomycetes;Incertae Sedis;Myxotrichaceae;Myxotrichum;";"0.0";"0";"1";"1";"0";"1";"0";"430523";"5766"
"LOK1378_1mm";"SILVA (only NR);Eukaryota;Amorphea;Obazoa;Opisthokonta;Nucletmycea;Fungi;Dikarya;Ascomycota;Pezizomycotina;Leotiomycetes;Incertae Sedis;Myxotrichaceae;Oidiodendron;";"0.0";"0";"1";"1";"0";"1";"0";"430523";"5766"
"LOK1378_1mm";"SILVA (only NR);Eukaryota;Amorphea;Obazoa;Opisthokonta;Nucletmycea;Fungi;Dikarya;Ascomycota;Pezizomycotina;Leotiomycetes;Phacidiales;";"0.0";"0";"2";"2";"0";"2";"0";"430522";"5766"
"LOK1378_1mm";"SILVA (only NR);Eukaryota;Amorphea;Obazoa;Opisthokonta;Nucletmycea;Fungi;Dikarya;Ascomycota;Pezizomycotina;Leotiomycetes;Phacidiales;Bulgariaceae;";"0.0";"0";"2";"2";"0";"2";"0";"430522";"5766"
"LOK1378_1mm";"SILVA (only NR);Eukaryota;Amorphea;Obazoa;Opisthokonta;Nucletmycea;Fungi;Dikarya;Ascomycota;Pezizomycotina;Leotiomycetes;Phacidiales;Bulgariaceae;Bulgaria;";"0.0";"0";"1";"1";"0";"1";"0";"430523";"5766"
"LOK1378_1mm";"SILVA (only NR);Eukaryota;Amorphea;Obazoa;Opisthokonta;Nucletmycea;Fungi;Dikarya;Ascomycota;Pezizomycotina;Leotiomycetes;Phacidiales;Bulgariaceae;Bulgariella;";"0.0";"0";"1";"1";"0";"1";"0";"430523";"5766"
"LOK1378_1mm";"SILVA (only NR);Eukaryota;Amorphea;Obazoa;Opisthokonta;Nucletmycea;Fungi;Dikarya;Ascomycota;Pezizomycotina;Leotiomycetes;Pseudogymnoascus;";"0.0";"0";"4";"4";"0";"4";"0";"430520";"5766"
"LOK1378_1mm";"SILVA (only NR);Eukaryota;Amorphea;Obazoa;Opisthokonta;Nucletmycea;Fungi;Dikarya;Ascomycota;Pezizomycotina;Leotiomycetes;Rhytismatales;";"0.0";"0";"7";"5";"0";"5";"2";"430519";"5766"
"LOK1378_1mm";"SILVA (only NR);Eukaryota;Amorphea;Obazoa;Opisthokonta;Nucletmycea;Fungi;Dikarya;Ascomycota;Pezizomycotina;Leotiomycetes;Rhytismatales;Cudoniaceae;";"0.0";"0";"2";"2";"0";"2";"0";"430522";"5766"
"LOK1378_1mm";"SILVA (only NR);Eukaryota;Amorphea;Obazoa;Opisthokonta;Nucletmycea;Fungi;Dikarya;Ascomycota;Pezizomycotina;Leotiomycetes;Rhytismatales;Cudoniaceae;Spathularia;";"0.0";"0";"2";"2";"0";"2";"0";"430522";"5766"
"LOK1378_1mm";"SILVA (only NR);Eukaryota;Amorphea;Obazoa;Opisthokonta;Nucletmycea;Fungi;Dikarya;Ascomycota;Pezizomycotina;Leotiomycetes;Rhytismatales;Darkera;";"0.0";"0";"1";"0";"0";"0";"1";"430524";"5766"
"LOK1378_1mm";"SILVA (only NR);Eukaryota;Amorphea;Obazoa;Opisthokonta;Nucletmycea;Fungi;Dikarya;Ascomycota;Pezizomycotina;Leotiomycetes;Rhytismatales;Rhytismataceae;";"0.0";"0";"4";"3";"0";"3";"1";"430521";"5766"
"LOK1378_1mm";"SILVA (only NR);Eukaryota;Amorphea;Obazoa;Opisthokonta;Nucletmycea;Fungi;Dikarya;Ascomycota;Pezizomycotina;Leotiomycetes;Rhytismatales;Rhytismataceae;Coccomyces;";"0.0";"0";"1";"1";"0";"1";"0";"430523";"5766"
"LOK1378_1mm";"SILVA (only NR);Eukaryota;Amorphea;Obazoa;Opisthokonta;Nucletmycea;Fungi;Dikarya;Ascomycota;Pezizomycotina;Leotiomycetes;Rhytismatales;Rhytismataceae;Meria;";"0.0";"0";"1";"1";"0";"1";"0";"430523";"5766"
"LOK1378_1mm";"SILVA (only NR);Eukaryota;Amorphea;Obazoa;Opisthokonta;Nucletmycea;Fungi;Dikarya;Ascomycota;Pezizomycotina;Leotiomycetes;Rhytismatales;Rhytismataceae;Propolis;";"0.0";"0";"1";"0";"0";"0";"1";"430524";"5766"
"LOK1378_1mm";"SILVA (only NR);Eukaryota;Amorphea;Obazoa;Opisthokonta;Nucletmycea;Fungi;Dikarya;Ascomycota;Pezizomycotina;Leotiomycetes;Rhytismatales;Rhytismataceae;Rhytisma;";"0.0";"0";"1";"1";"0";"1";"0";"430523";"5766"
"LOK1378_1mm";"SILVA (only NR);Eukaryota;Amorphea;Obazoa;Opisthokonta;Nucletmycea;Fungi;Dikarya;Ascomycota;Pezizomycotina;Leotiomycetes;Satchmopsis;";"0.0";"0";"1";"0";"0";"0";"1";"430524";"5766"
"LOK1378_1mm";"SILVA (only NR);Eukaryota;Amorphea;Obazoa;Opisthokonta;Nucletmycea;Fungi;Dikarya;Ascomycota;Pezizomycotina;Leotiomycetes;Thelebolales;";"0.0";"0";"19";"18";"0";"18";"1";"430506";"5766"
"LOK1378_1mm";"SILVA (only NR);Eukaryota;Amorphea;Obazoa;Opisthokonta;Nucletmycea;Fungi;Dikarya;Ascomycota;Pezizomycotina;Leotiomycetes;Thelebolales;Thelebolaceae;";"0.0";"0";"19";"18";"0";"18";"1";"430506";"5766"
"LOK1378_1mm";"SILVA (only NR);Eukaryota;Amorphea;Obazoa;Opisthokonta;Nucletmycea;Fungi;Dikarya;Ascomycota;Pezizomycotina;Leotiomycetes;Thelebolales;Thelebolaceae;Ascozonus;";"0.0";"0";"1";"1";"0";"1";"0";"430523";"5766"
"LOK1378_1mm";"SILVA (only NR);Eukaryota;Amorphea;Obazoa;Opisthokonta;Nucletmycea;Fungi;Dikarya;Ascomycota;Pezizomycotina;Leotiomycetes;Thelebolales;Thelebolaceae;Hyphozyma;";"0.0";"0";"2";"2";"0";"2";"0";"430522";"5766"
"LOK1378_1mm";"SILVA (only NR);Eukaryota;Amorphea;Obazoa;Opisthokonta;Nucletmycea;Fungi;Dikarya;Ascomycota;Pezizomycotina;Leotiomycetes;Thelebolales;Thelebolaceae;Thelebolus;";"0.0";"0";"16";"15";"0";"15";"1";"430509";"5766"
"LOK1378_1mm";"SILVA (only NR);Eukaryota;Amorphea;Obazoa;Opisthokonta;Nucletmycea;Fungi;Dikarya;Ascomycota;Pezizomycotina;Leotiomycetes;uncultured;";"0.0";"0";"2";"2";"0";"2";"0";"430522";"5766"
"LOK1378_1mm";"SILVA (only NR);Eukaryota;Amorphea;Obazoa;Opisthokonta;Nucletmycea;Fungi;Dikarya;Ascomycota;Pezizomycotina;Lichinomycetes;";"0.0";"0";"45";"43";"0";"43";"2";"430481";"5766"
"LOK1378_1mm";"SILVA (only NR);Eukaryota;Amorphea;Obazoa;Opisthokonta;Nucletmycea;Fungi;Dikarya;Ascomycota;Pezizomycotina;Lichinomycetes;Lichinales;";"0.0";"0";"45";"43";"0";"43";"2";"430481";"5766"
"LOK1378_1mm";"SILVA (only NR);Eukaryota;Amorphea;Obazoa;Opisthokonta;Nucletmycea;Fungi;Dikarya;Ascomycota;Pezizomycotina;Lichinomycetes;Lichinales;Heppiaceae;";"0.0";"0";"2";"1";"0";"1";"1";"430523";"5766"
"LOK1378_1mm";"SILVA (only NR);Eukaryota;Amorphea;Obazoa;Opisthokonta;Nucletmycea;Fungi;Dikarya;Ascomycota;Pezizomycotina;Lichinomycetes;Lichinales;Heppiaceae;Heppia;";"0.0";"0";"2";"1";"0";"1";"1";"430523";"5766"
"LOK1378_1mm";"SILVA (only NR);Eukaryota;Amorphea;Obazoa;Opisthokonta;Nucletmycea;Fungi;Dikarya;Ascomycota;Pezizomycotina;Lichinomycetes;Lichinales;Lichinaceae;";"0.0";"0";"28";"27";"0";"27";"1";"430497";"5766"
"LOK1378_1mm";"SILVA (only NR);Eukaryota;Amorphea;Obazoa;Opisthokonta;Nucletmycea;Fungi;Dikarya;Ascomycota;Pezizomycotina;Lichinomycetes;Lichinales;Lichinaceae;Anema;";"0.0";"0";"1";"1";"0";"1";"0";"430523";"5766"
"LOK1378_1mm";"SILVA (only NR);Eukaryota;Amorphea;Obazoa;Opisthokonta;Nucletmycea;Fungi;Dikarya;Ascomycota;Pezizomycotina;Lichinomycetes;Lichinales;Lichinaceae;Digitothyrea;";"0.0";"0";"1";"1";"0";"1";"0";"430523";"5766"
"LOK1378_1mm";"SILVA (only NR);Eukaryota;Amorphea;Obazoa;Opisthokonta;Nucletmycea;Fungi;Dikarya;Ascomycota;Pezizomycotina;Lichinomycetes;Lichinales;Lichinaceae;Ephebe;";"0.0";"0";"1";"1";"0";"1";"0";"430523";"5766"
"LOK1378_1mm";"SILVA (only NR);Eukaryota;Amorphea;Obazoa;Opisthokonta;Nucletmycea;Fungi;Dikarya;Ascomycota;Pezizomycotina;Lichinomycetes;Lichinales;Lichinaceae;Euopsis;";"0.0";"0";"1";"1";"0";"1";"0";"430523";"5766"
"LOK1378_1mm";"SILVA (only NR);Eukaryota;Amorphea;Obazoa;Opisthokonta;Nucletmycea;Fungi;Dikarya;Ascomycota;Pezizomycotina;Lichinomycetes;Lichinales;Lichinaceae;Harpidium;";"0.0";"0";"1";"1";"0";"1";"0";"430523";"5766"
"LOK1378_1mm";"SILVA (only NR);Eukaryota;Amorphea;Obazoa;Opisthokonta;Nucletmycea;Fungi;Dikarya;Ascomycota;Pezizomycotina;Lichinomycetes;Lichinales;Lichinaceae;Jenmania;";"0.0";"0";"1";"1";"0";"1";"0";"430523";"5766"
"LOK1378_1mm";"SILVA (only NR);Eukaryota;Amorphea;Obazoa;Opisthokonta;Nucletmycea;Fungi;Dikarya;Ascomycota;Pezizomycotina;Lichinomycetes;Lichinales;Lichinaceae;Lichina;";"0.0";"0";"2";"2";"0";"2";"0";"430522";"5766"
"LOK1378_1mm";"SILVA (only NR);Eukaryota;Amorphea;Obazoa;Opisthokonta;Nucletmycea;Fungi;Dikarya;Ascomycota;Pezizomycotina;Lichinomycetes;Lichinales;Lichinaceae;Lichinella;";"0.0";"0";"1";"1";"0";"1";"0";"430523";"5766"
"LOK1378_1mm";"SILVA (only NR);Eukaryota;Amorphea;Obazoa;Opisthokonta;Nucletmycea;Fungi;Dikarya;Ascomycota;Pezizomycotina;Lichinomycetes;Lichinales;Lichinaceae;Paulia;";"0.0";"0";"4";"4";"0";"4";"0";"430520";"5766"
"LOK1378_1mm";"SILVA (only NR);Eukaryota;Amorphea;Obazoa;Opisthokonta;Nucletmycea;Fungi;Dikarya;Ascomycota;Pezizomycotina;Lichinomycetes;Lichinales;Lichinaceae;Peccania;";"0.0";"0";"4";"4";"0";"4";"0";"430520";"5766"
"LOK1378_1mm";"SILVA (only NR);Eukaryota;Amorphea;Obazoa;Opisthokonta;Nucletmycea;Fungi;Dikarya;Ascomycota;Pezizomycotina;Lichinomycetes;Lichinales;Lichinaceae;Phloeopeccania;";"0.0";"0";"1";"0";"0";"0";"1";"430524";"5766"
"LOK1378_1mm";"SILVA (only NR);Eukaryota;Amorphea;Obazoa;Opisthokonta;Nucletmycea;Fungi;Dikarya;Ascomycota;Pezizomycotina;Lichinomycetes;Lichinales;Lichinaceae;Porocyphus;";"0.0";"0";"1";"1";"0";"1";"0";"430523";"5766"
"LOK1378_1mm";"SILVA (only NR);Eukaryota;Amorphea;Obazoa;Opisthokonta;Nucletmycea;Fungi;Dikarya;Ascomycota;Pezizomycotina;Lichinomycetes;Lichinales;Lichinaceae;Psorotichia;";"0.0";"0";"3";"3";"0";"3";"0";"430521";"5766"
"LOK1378_1mm";"SILVA (only NR);Eukaryota;Amorphea;Obazoa;Opisthokonta;Nucletmycea;Fungi;Dikarya;Ascomycota;Pezizomycotina;Lichinomycetes;Lichinales;Lichinaceae;Pterygiopsis;";"0.0";"0";"1";"1";"0";"1";"0";"430523";"5766"
"LOK1378_1mm";"SILVA (only NR);Eukaryota;Amorphea;Obazoa;Opisthokonta;Nucletmycea;Fungi;Dikarya;Ascomycota;Pezizomycotina;Lichinomycetes;Lichinales;Lichinaceae;Stromatella;";"0.0";"0";"1";"1";"0";"1";"0";"430523";"5766"
"LOK1378_1mm";"SILVA (only NR);Eukaryota;Amorphea;Obazoa;Opisthokonta;Nucletmycea;Fungi;Dikarya;Ascomycota;Pezizomycotina;Lichinomycetes;Lichinales;Lichinaceae;Thyrea;";"0.0";"0";"2";"2";"0";"2";"0";"430522";"5766"
"LOK1378_1mm";"SILVA (only NR);Eukaryota;Amorphea;Obazoa;Opisthokonta;Nucletmycea;Fungi;Dikarya;Ascomycota;Pezizomycotina;Lichinomycetes;Lichinales;Peltulaceae;";"0.0";"0";"14";"14";"0";"14";"0";"430510";"5766"
"LOK1378_1mm";"SILVA (only NR);Eukaryota;Amorphea;Obazoa;Opisthokonta;Nucletmycea;Fungi;Dikarya;Ascomycota;Pezizomycotina;Lichinomycetes;Lichinales;Peltulaceae;Peltula;";"0.0";"0";"14";"14";"0";"14";"0";"430510";"5766"
"LOK1378_1mm";"SILVA (only NR);Eukaryota;Amorphea;Obazoa;Opisthokonta;Nucletmycea;Fungi;Dikarya;Ascomycota;Pezizomycotina;Orbiliomycetes;";"0.0";"0";"17";"16";"0";"16";"1";"430508";"5766"
"LOK1378_1mm";"SILVA (only NR);Eukaryota;Amorphea;Obazoa;Opisthokonta;Nucletmycea;Fungi;Dikarya;Ascomycota;Pezizomycotina;Orbiliomycetes;Orbiliales;";"0.0";"0";"17";"16";"0";"16";"1";"430508";"5766"
"LOK1378_1mm";"SILVA (only NR);Eukaryota;Amorphea;Obazoa;Opisthokonta;Nucletmycea;Fungi;Dikarya;Ascomycota;Pezizomycotina;Orbiliomycetes;Orbiliales;Orbiliaceae;";"0.0";"0";"17";"16";"0";"16";"1";"430508";"5766"
"LOK1378_1mm";"SILVA (only NR);Eukaryota;Amorphea;Obazoa;Opisthokonta;Nucletmycea;Fungi;Dikarya;Ascomycota;Pezizomycotina;Orbiliomycetes;Orbiliales;Orbiliaceae;Arthrobotrys;";"0.0";"0";"8";"8";"0";"8";"0";"430516";"5766"
"LOK1378_1mm";"SILVA (only NR);Eukaryota;Amorphea;Obazoa;Opisthokonta;Nucletmycea;Fungi;Dikarya;Ascomycota;Pezizomycotina;Orbiliomycetes;Orbiliales;Orbiliaceae;Dactylella;";"0.0";"0";"2";"2";"0";"2";"0";"430522";"5766"
"LOK1378_1mm";"SILVA (only NR);Eukaryota;Amorphea;Obazoa;Opisthokonta;Nucletmycea;Fungi;Dikarya;Ascomycota;Pezizomycotina;Orbiliomycetes;Orbiliales;Orbiliaceae;Dactylellina;";"0.0";"0";"2";"2";"0";"2";"0";"430522";"5766"
"LOK1378_1mm";"SILVA (only NR);Eukaryota;Amorphea;Obazoa;Opisthokonta;Nucletmycea;Fungi;Dikarya;Ascomycota;Pezizomycotina;Orbiliomycetes;Orbiliales;Orbiliaceae;Drechslerella;";"0.0";"0";"1";"1";"0";"1";"0";"430523";"5766"
"LOK1378_1mm";"SILVA (only NR);Eukaryota;Amorphea;Obazoa;Opisthokonta;Nucletmycea;Fungi;Dikarya;Ascomycota;Pezizomycotina;Orbiliomycetes;Orbiliales;Orbiliaceae;Duddingtonia;";"0.0";"0";"1";"1";"0";"1";"0";"430523";"5766"
"LOK1378_1mm";"SILVA (only NR);Eukaryota;Amorphea;Obazoa;Opisthokonta;Nucletmycea;Fungi;Dikarya;Ascomycota;Pezizomycotina;Orbiliomycetes;Orbiliales;Orbiliaceae;Monacrosporium;";"0.0";"0";"1";"1";"0";"1";"0";"430523";"5766"
"LOK1378_1mm";"SILVA (only NR);Eukaryota;Amorphea;Obazoa;Opisthokonta;Nucletmycea;Fungi;Dikarya;Ascomycota;Pezizomycotina;Orbiliomycetes;Orbiliales;Orbiliaceae;Orbilia;";"0.0";"0";"2";"1";"0";"1";"1";"430523";"5766"
"LOK1378_1mm";"SILVA (only NR);Eukaryota;Amorphea;Obazoa;Opisthokonta;Nucletmycea;Fungi;Dikarya;Ascomycota;Pezizomycotina;Pezizomycetes;";"0.0";"0";"189";"183";"0";"183";"6";"430341";"5766"
"LOK1378_1mm";"SILVA (only NR);Eukaryota;Amorphea;Obazoa;Opisthokonta;Nucletmycea;Fungi;Dikarya;Ascomycota;Pezizomycotina;Pezizomycetes;Pezizales;";"0.0";"0";"189";"183";"0";"183";"6";"430341";"5766"
"LOK1378_1mm";"SILVA (only NR);Eukaryota;Amorphea;Obazoa;Opisthokonta;Nucletmycea;Fungi;Dikarya;Ascomycota;Pezizomycotina;Pezizomycetes;Pezizales;Ascobolaceae;";"0.0";"0";"7";"7";"0";"7";"0";"430517";"5766"
"LOK1378_1mm";"SILVA (only NR);Eukaryota;Amorphea;Obazoa;Opisthokonta;Nucletmycea;Fungi;Dikarya;Ascomycota;Pezizomycotina;Pezizomycetes;Pezizales;Ascobolaceae;Ascobolus;";"0.0";"0";"2";"2";"0";"2";"0";"430522";"5766"
"LOK1378_1mm";"SILVA (only NR);Eukaryota;Amorphea;Obazoa;Opisthokonta;Nucletmycea;Fungi;Dikarya;Ascomycota;Pezizomycotina;Pezizomycetes;Pezizales;Ascobolaceae;Saccobolus;";"0.0";"0";"1";"1";"0";"1";"0";"430523";"5766"
"LOK1378_1mm";"SILVA (only NR);Eukaryota;Amorphea;Obazoa;Opisthokonta;Nucletmycea;Fungi;Dikarya;Ascomycota;Pezizomycotina;Pezizomycetes;Pezizales;Ascobolaceae;Thecotheus;";"0.0";"0";"1";"1";"0";"1";"0";"430523";"5766"
"LOK1378_1mm";"SILVA (only NR);Eukaryota;Amorphea;Obazoa;Opisthokonta;Nucletmycea;Fungi;Dikarya;Ascomycota;Pezizomycotina;Pezizomycetes;Pezizales;Ascobolaceae;uncultured;";"0.0";"0";"3";"3";"0";"3";"0";"430521";"5766"
"LOK1378_1mm";"SILVA (only NR);Eukaryota;Amorphea;Obazoa;Opisthokonta;Nucletmycea;Fungi;Dikarya;Ascomycota;Pezizomycotina;Pezizomycetes;Pezizales;Ascodesmidaceae;";"0.0";"0";"9";"9";"0";"9";"0";"430515";"5766"
"LOK1378_1mm";"SILVA (only NR);Eukaryota;Amorphea;Obazoa;Opisthokonta;Nucletmycea;Fungi;Dikarya;Ascomycota;Pezizomycotina;Pezizomycetes;Pezizales;Ascodesmidaceae;Cephaliophora;";"0.0";"0";"5";"5";"0";"5";"0";"430519";"5766"
"LOK1378_1mm";"SILVA (only NR);Eukaryota;Amorphea;Obazoa;Opisthokonta;Nucletmycea;Fungi;Dikarya;Ascomycota;Pezizomycotina;Pezizomycetes;Pezizales;Ascodesmidaceae;Eleutherascus;";"0.0";"0";"2";"2";"0";"2";"0";"430522";"5766"
"LOK1378_1mm";"SILVA (only NR);Eukaryota;Amorphea;Obazoa;Opisthokonta;Nucletmycea;Fungi;Dikarya;Ascomycota;Pezizomycotina;Pezizomycetes;Pezizales;Ascodesmidaceae;Lasiobolus;";"0.0";"0";"1";"1";"0";"1";"0";"430523";"5766"
"LOK1378_1mm";"SILVA (only NR);Eukaryota;Amorphea;Obazoa;Opisthokonta;Nucletmycea;Fungi;Dikarya;Ascomycota;Pezizomycotina;Pezizomycetes;Pezizales;Caloscypha;";"0.0";"0";"2";"2";"0";"2";"0";"430522";"5766"
"LOK1378_1mm";"SILVA (only NR);Eukaryota;Amorphea;Obazoa;Opisthokonta;Nucletmycea;Fungi;Dikarya;Ascomycota;Pezizomycotina;Pezizomycetes;Pezizales;Chalazion;";"0.0";"0";"1";"1";"0";"1";"0";"430523";"5766"
"LOK1378_1mm";"SILVA (only NR);Eukaryota;Amorphea;Obazoa;Opisthokonta;Nucletmycea;Fungi;Dikarya;Ascomycota;Pezizomycotina;Pezizomycetes;Pezizales;Chorioactidaceae;";"0.0";"0";"3";"3";"0";"3";"0";"430521";"5766"
"LOK1378_1mm";"SILVA (only NR);Eukaryota;Amorphea;Obazoa;Opisthokonta;Nucletmycea;Fungi;Dikarya;Ascomycota;Pezizomycotina;Pezizomycetes;Pezizales;Chorioactidaceae;Chorioactis;";"0.0";"0";"1";"1";"0";"1";"0";"430523";"5766"
"LOK1378_1mm";"SILVA (only NR);Eukaryota;Amorphea;Obazoa;Opisthokonta;Nucletmycea;Fungi;Dikarya;Ascomycota;Pezizomycotina;Pezizomycetes;Pezizales;Chorioactidaceae;Neournula;";"0.0";"0";"1";"1";"0";"1";"0";"430523";"5766"
"LOK1378_1mm";"SILVA (only NR);Eukaryota;Amorphea;Obazoa;Opisthokonta;Nucletmycea;Fungi;Dikarya;Ascomycota;Pezizomycotina;Pezizomycetes;Pezizales;Chorioactidaceae;Pseudosarcosoma;";"0.0";"0";"1";"1";"0";"1";"0";"430523";"5766"
"LOK1378_1mm";"SILVA (only NR);Eukaryota;Amorphea;Obazoa;Opisthokonta;Nucletmycea;Fungi;Dikarya;Ascomycota;Pezizomycotina;Pezizomycetes;Pezizales;Desmazierella;";"0.0";"0";"1";"1";"0";"1";"0";"430523";"5766"
"LOK1378_1mm";"SILVA (only NR);Eukaryota;Amorphea;Obazoa;Opisthokonta;Nucletmycea;Fungi;Dikarya;Ascomycota;Pezizomycotina;Pezizomycetes;Pezizales;Glaziella;";"0.0";"0";"1";"1";"0";"1";"0";"430523";"5766"
"LOK1378_1mm";"SILVA (only NR);Eukaryota;Amorphea;Obazoa;Opisthokonta;Nucletmycea;Fungi;Dikarya;Ascomycota;Pezizomycotina;Pezizomycetes;Pezizales;Gyromitra;";"0.0";"0";"4";"4";"0";"4";"0";"430520";"5766"
"LOK1378_1mm";"SILVA (only NR);Eukaryota;Amorphea;Obazoa;Opisthokonta;Nucletmycea;Fungi;Dikarya;Ascomycota;Pezizomycotina;Pezizomycetes;Pezizales;Helvellaceae;";"0.0";"0";"15";"13";"0";"13";"2";"430511";"5766"
"LOK1378_1mm";"SILVA (only NR);Eukaryota;Amorphea;Obazoa;Opisthokonta;Nucletmycea;Fungi;Dikarya;Ascomycota;Pezizomycotina;Pezizomycetes;Pezizales;Helvellaceae;Balsamia;";"0.0";"0";"1";"1";"0";"1";"0";"430523";"5766"
"LOK1378_1mm";"SILVA (only NR);Eukaryota;Amorphea;Obazoa;Opisthokonta;Nucletmycea;Fungi;Dikarya;Ascomycota;Pezizomycotina;Pezizomycetes;Pezizales;Helvellaceae;Barssia;";"0.0";"0";"1";"1";"0";"1";"0";"430523";"5766"
"LOK1378_1mm";"SILVA (only NR);Eukaryota;Amorphea;Obazoa;Opisthokonta;Nucletmycea;Fungi;Dikarya;Ascomycota;Pezizomycotina;Pezizomycetes;Pezizales;Helvellaceae;Fischerula;";"0.0";"0";"1";"1";"0";"1";"0";"430523";"5766"
"LOK1378_1mm";"SILVA (only NR);Eukaryota;Amorphea;Obazoa;Opisthokonta;Nucletmycea;Fungi;Dikarya;Ascomycota;Pezizomycotina;Pezizomycetes;Pezizales;Helvellaceae;Helvella;";"0.0";"0";"10";"8";"0";"8";"2";"430516";"5766"
"LOK1378_1mm";"SILVA (only NR);Eukaryota;Amorphea;Obazoa;Opisthokonta;Nucletmycea;Fungi;Dikarya;Ascomycota;Pezizomycotina;Pezizomycetes;Pezizales;Helvellaceae;Imaia;";"0.0";"0";"1";"1";"0";"1";"0";"430523";"5766"
"LOK1378_1mm";"SILVA (only NR);Eukaryota;Amorphea;Obazoa;Opisthokonta;Nucletmycea;Fungi;Dikarya;Ascomycota;Pezizomycotina;Pezizomycetes;Pezizales;Helvellaceae;Leucangium;";"0.0";"0";"1";"1";"0";"1";"0";"430523";"5766"
"LOK1378_1mm";"SILVA (only NR);Eukaryota;Amorphea;Obazoa;Opisthokonta;Nucletmycea;Fungi;Dikarya;Ascomycota;Pezizomycotina;Pezizomycetes;Pezizales;Hydnotrya;";"0.0";"0";"1";"1";"0";"1";"0";"430523";"5766"
"LOK1378_1mm";"SILVA (only NR);Eukaryota;Amorphea;Obazoa;Opisthokonta;Nucletmycea;Fungi;Dikarya;Ascomycota;Pezizomycotina;Pezizomycetes;Pezizales;Incertae Sedis;";"0.0";"0";"2";"2";"0";"2";"0";"430522";"5766"
"LOK1378_1mm";"SILVA (only NR);Eukaryota;Amorphea;Obazoa;Opisthokonta;Nucletmycea;Fungi;Dikarya;Ascomycota;Pezizomycotina;Pezizomycetes;Pezizales;Incertae Sedis;Pulchromyces;";"0.0";"0";"2";"2";"0";"2";"0";"430522";"5766"
"LOK1378_1mm";"SILVA (only NR);Eukaryota;Amorphea;Obazoa;Opisthokonta;Nucletmycea;Fungi;Dikarya;Ascomycota;Pezizomycotina;Pezizomycetes;Pezizales;Karstenella;";"0.0";"0";"1";"1";"0";"1";"0";"430523";"5766"
"LOK1378_1mm";"SILVA (only NR);Eukaryota;Amorphea;Obazoa;Opisthokonta;Nucletmycea;Fungi;Dikarya;Ascomycota;Pezizomycotina;Pezizomycetes;Pezizales;Morchellaceae;";"0.0";"0";"4";"4";"0";"4";"0";"430520";"5766"
"LOK1378_1mm";"SILVA (only NR);Eukaryota;Amorphea;Obazoa;Opisthokonta;Nucletmycea;Fungi;Dikarya;Ascomycota;Pezizomycotina;Pezizomycetes;Pezizales;Morchellaceae;Morchella;";"0.0";"0";"1";"1";"0";"1";"0";"430523";"5766"
"LOK1378_1mm";"SILVA (only NR);Eukaryota;Amorphea;Obazoa;Opisthokonta;Nucletmycea;Fungi;Dikarya;Ascomycota;Pezizomycotina;Pezizomycetes;Pezizales;Morchellaceae;Verpa;";"0.0";"0";"3";"3";"0";"3";"0";"430521";"5766"
"LOK1378_1mm";"SILVA (only NR);Eukaryota;Amorphea;Obazoa;Opisthokonta;Nucletmycea;Fungi;Dikarya;Ascomycota;Pezizomycotina;Pezizomycetes;Pezizales;Pezizaceae;";"0.0";"0";"34";"33";"0";"33";"1";"430491";"5766"
"LOK1378_1mm";"SILVA (only NR);Eukaryota;Amorphea;Obazoa;Opisthokonta;Nucletmycea;Fungi;Dikarya;Ascomycota;Pezizomycotina;Pezizomycetes;Pezizales;Pezizaceae;Boudiera;";"0.0";"0";"1";"1";"0";"1";"0";"430523";"5766"
"LOK1378_1mm";"SILVA (only NR);Eukaryota;Amorphea;Obazoa;Opisthokonta;Nucletmycea;Fungi;Dikarya;Ascomycota;Pezizomycotina;Pezizomycetes;Pezizales;Pezizaceae;Cazia;";"0.0";"0";"1";"1";"0";"1";"0";"430523";"5766"
"LOK1378_1mm";"SILVA (only NR);Eukaryota;Amorphea;Obazoa;Opisthokonta;Nucletmycea;Fungi;Dikarya;Ascomycota;Pezizomycotina;Pezizomycetes;Pezizales;Pezizaceae;Iodowynnea;";"0.0";"0";"1";"1";"0";"1";"0";"430523";"5766"
"LOK1378_1mm";"SILVA (only NR);Eukaryota;Amorphea;Obazoa;Opisthokonta;Nucletmycea;Fungi;Dikarya;Ascomycota;Pezizomycotina;Pezizomycetes;Pezizales;Pezizaceae;Mattirolomyces;";"0.0";"0";"1";"1";"0";"1";"0";"430523";"5766"
"LOK1378_1mm";"SILVA (only NR);Eukaryota;Amorphea;Obazoa;Opisthokonta;Nucletmycea;Fungi;Dikarya;Ascomycota;Pezizomycotina;Pezizomycetes;Pezizales;Pezizaceae;Pachyella;";"0.0";"0";"3";"3";"0";"3";"0";"430521";"5766"
"LOK1378_1mm";"SILVA (only NR);Eukaryota;Amorphea;Obazoa;Opisthokonta;Nucletmycea;Fungi;Dikarya;Ascomycota;Pezizomycotina;Pezizomycetes;Pezizales;Pezizaceae;Peziza;";"0.0";"0";"15";"14";"0";"14";"1";"430510";"5766"
"LOK1378_1mm";"SILVA (only NR);Eukaryota;Amorphea;Obazoa;Opisthokonta;Nucletmycea;Fungi;Dikarya;Ascomycota;Pezizomycotina;Pezizomycetes;Pezizales;Pezizaceae;Plicaria;";"0.0";"0";"2";"2";"0";"2";"0";"430522";"5766"
"LOK1378_1mm";"SILVA (only NR);Eukaryota;Amorphea;Obazoa;Opisthokonta;Nucletmycea;Fungi;Dikarya;Ascomycota;Pezizomycotina;Pezizomycetes;Pezizales;Pezizaceae;Sarcosphaera;";"0.0";"0";"2";"2";"0";"2";"0";"430522";"5766"
"LOK1378_1mm";"SILVA (only NR);Eukaryota;Amorphea;Obazoa;Opisthokonta;Nucletmycea;Fungi;Dikarya;Ascomycota;Pezizomycotina;Pezizomycetes;Pezizales;Pezizaceae;uncultured;";"0.0";"0";"3";"3";"0";"3";"0";"430521";"5766"
"LOK1378_1mm";"SILVA (only NR);Eukaryota;Amorphea;Obazoa;Opisthokonta;Nucletmycea;Fungi;Dikarya;Ascomycota;Pezizomycotina;Pezizomycetes;Pezizales;Pyronemataceae;";"0.0";"0";"57";"56";"0";"56";"1";"430468";"5766"
"LOK1378_1mm";"SILVA (only NR);Eukaryota;Amorphea;Obazoa;Opisthokonta;Nucletmycea;Fungi;Dikarya;Ascomycota;Pezizomycotina;Pezizomycetes;Pezizales;Pyronemataceae;Acervus;";"0.0";"0";"2";"2";"0";"2";"0";"430522";"5766"
"LOK1378_1mm";"SILVA (only NR);Eukaryota;Amorphea;Obazoa;Opisthokonta;Nucletmycea;Fungi;Dikarya;Ascomycota;Pezizomycotina;Pezizomycetes;Pezizales;Pyronemataceae;Anthracobia;";"0.0";"0";"1";"1";"0";"1";"0";"430523";"5766"
"LOK1378_1mm";"SILVA (only NR);Eukaryota;Amorphea;Obazoa;Opisthokonta;Nucletmycea;Fungi;Dikarya;Ascomycota;Pezizomycotina;Pezizomycetes;Pezizales;Pyronemataceae;Byssonectria;";"0.0";"0";"1";"1";"0";"1";"0";"430523";"5766"
"LOK1378_1mm";"SILVA (only NR);Eukaryota;Amorphea;Obazoa;Opisthokonta;Nucletmycea;Fungi;Dikarya;Ascomycota;Pezizomycotina;Pezizomycetes;Pezizales;Pyronemataceae;Cheilymenia;";"0.0";"0";"3";"3";"0";"3";"0";"430521";"5766"
"LOK1378_1mm";"SILVA (only NR);Eukaryota;Amorphea;Obazoa;Opisthokonta;Nucletmycea;Fungi;Dikarya;Ascomycota;Pezizomycotina;Pezizomycetes;Pezizales;Pyronemataceae;Diehliomyces;";"0.0";"0";"1";"1";"0";"1";"0";"430523";"5766"
"LOK1378_1mm";"SILVA (only NR);Eukaryota;Amorphea;Obazoa;Opisthokonta;Nucletmycea;Fungi;Dikarya;Ascomycota;Pezizomycotina;Pezizomycetes;Pezizales;Pyronemataceae;Geopora;";"0.0";"0";"3";"3";"0";"3";"0";"430521";"5766"
"LOK1378_1mm";"SILVA (only NR);Eukaryota;Amorphea;Obazoa;Opisthokonta;Nucletmycea;Fungi;Dikarya;Ascomycota;Pezizomycotina;Pezizomycetes;Pezizales;Pyronemataceae;Geopyxis;";"0.0";"0";"3";"2";"0";"2";"1";"430522";"5766"
"LOK1378_1mm";"SILVA (only NR);Eukaryota;Amorphea;Obazoa;Opisthokonta;Nucletmycea;Fungi;Dikarya;Ascomycota;Pezizomycotina;Pezizomycetes;Pezizales;Pyronemataceae;Humaria;";"0.0";"0";"1";"1";"0";"1";"0";"430523";"5766"
"LOK1378_1mm";"SILVA (only NR);Eukaryota;Amorphea;Obazoa;Opisthokonta;Nucletmycea;Fungi;Dikarya;Ascomycota;Pezizomycotina;Pezizomycetes;Pezizales;Pyronemataceae;Inermisia;";"0.0";"0";"1";"1";"0";"1";"0";"430523";"5766"
"LOK1378_1mm";"SILVA (only NR);Eukaryota;Amorphea;Obazoa;Opisthokonta;Nucletmycea;Fungi;Dikarya;Ascomycota;Pezizomycotina;Pezizomycetes;Pezizales;Pyronemataceae;Lamprospora;";"0.0";"0";"2";"2";"0";"2";"0";"430522";"5766"
"LOK1378_1mm";"SILVA (only NR);Eukaryota;Amorphea;Obazoa;Opisthokonta;Nucletmycea;Fungi;Dikarya;Ascomycota;Pezizomycotina;Pezizomycetes;Pezizales;Pyronemataceae;Lasiobolidium;";"0.0";"0";"2";"2";"0";"2";"0";"430522";"5766"
"LOK1378_1mm";"SILVA (only NR);Eukaryota;Amorphea;Obazoa;Opisthokonta;Nucletmycea;Fungi;Dikarya;Ascomycota;Pezizomycotina;Pezizomycetes;Pezizales;Pyronemataceae;Leucoscypha;";"0.0";"0";"1";"1";"0";"1";"0";"430523";"5766"
"LOK1378_1mm";"SILVA (only NR);Eukaryota;Amorphea;Obazoa;Opisthokonta;Nucletmycea;Fungi;Dikarya;Ascomycota;Pezizomycotina;Pezizomycetes;Pezizales;Pyronemataceae;Marcelleina;";"0.0";"0";"2";"2";"0";"2";"0";"430522";"5766"
"LOK1378_1mm";"SILVA (only NR);Eukaryota;Amorphea;Obazoa;Opisthokonta;Nucletmycea;Fungi;Dikarya;Ascomycota;Pezizomycotina;Pezizomycetes;Pezizales;Pyronemataceae;Melastiza;";"0.0";"0";"1";"1";"0";"1";"0";"430523";"5766"
"LOK1378_1mm";"SILVA (only NR);Eukaryota;Amorphea;Obazoa;Opisthokonta;Nucletmycea;Fungi;Dikarya;Ascomycota;Pezizomycotina;Pezizomycetes;Pezizales;Pyronemataceae;Miladina;";"0.0";"0";"1";"1";"0";"1";"0";"430523";"5766"
"LOK1378_1mm";"SILVA (only NR);Eukaryota;Amorphea;Obazoa;Opisthokonta;Nucletmycea;Fungi;Dikarya;Ascomycota;Pezizomycotina;Pezizomycetes;Pezizales;Pyronemataceae;Octospora;";"0.0";"0";"2";"2";"0";"2";"0";"430522";"5766"
"LOK1378_1mm";"SILVA (only NR);Eukaryota;Amorphea;Obazoa;Opisthokonta;Nucletmycea;Fungi;Dikarya;Ascomycota;Pezizomycotina;Pezizomycetes;Pezizales;Pyronemataceae;Octosporella;";"0.0";"0";"2";"2";"0";"2";"0";"430522";"5766"
"LOK1378_1mm";"SILVA (only NR);Eukaryota;Amorphea;Obazoa;Opisthokonta;Nucletmycea;Fungi;Dikarya;Ascomycota;Pezizomycotina;Pezizomycetes;Pezizales;Pyronemataceae;Otidea;";"0.0";"0";"3";"3";"0";"3";"0";"430521";"5766"
"LOK1378_1mm";"SILVA (only NR);Eukaryota;Amorphea;Obazoa;Opisthokonta;Nucletmycea;Fungi;Dikarya;Ascomycota;Pezizomycotina;Pezizomycetes;Pezizales;Pyronemataceae;Parascutellinia;";"0.0";"0";"1";"1";"0";"1";"0";"430523";"5766"
"LOK1378_1mm";"SILVA (only NR);Eukaryota;Amorphea;Obazoa;Opisthokonta;Nucletmycea;Fungi;Dikarya;Ascomycota;Pezizomycotina;Pezizomycetes;Pezizales;Pyronemataceae;Pseudombrophila;";"0.0";"0";"1";"1";"0";"1";"0";"430523";"5766"
"LOK1378_1mm";"SILVA (only NR);Eukaryota;Amorphea;Obazoa;Opisthokonta;Nucletmycea;Fungi;Dikarya;Ascomycota;Pezizomycotina;Pezizomycetes;Pezizales;Pyronemataceae;Pulvinula;";"0.0";"0";"2";"2";"0";"2";"0";"430522";"5766"
"LOK1378_1mm";"SILVA (only NR);Eukaryota;Amorphea;Obazoa;Opisthokonta;Nucletmycea;Fungi;Dikarya;Ascomycota;Pezizomycotina;Pezizomycetes;Pezizales;Pyronemataceae;Pyronema;";"0.0";"0";"1";"1";"0";"1";"0";"430523";"5766"
"LOK1378_1mm";"SILVA (only NR);Eukaryota;Amorphea;Obazoa;Opisthokonta;Nucletmycea;Fungi;Dikarya;Ascomycota;Pezizomycotina;Pezizomycetes;Pezizales;Pyronemataceae;Rhodoscypha;";"0.0";"0";"1";"1";"0";"1";"0";"430523";"5766"
"LOK1378_1mm";"SILVA (only NR);Eukaryota;Amorphea;Obazoa;Opisthokonta;Nucletmycea;Fungi;Dikarya;Ascomycota;Pezizomycotina;Pezizomycetes;Pezizales;Pyronemataceae;Rhodotarzetta;";"0.0";"0";"1";"1";"0";"1";"0";"430523";"5766"
"LOK1378_1mm";"SILVA (only NR);Eukaryota;Amorphea;Obazoa;Opisthokonta;Nucletmycea;Fungi;Dikarya;Ascomycota;Pezizomycotina;Pezizomycetes;Pezizales;Pyronemataceae;Scutellinia;";"0.0";"0";"1";"1";"0";"1";"0";"430523";"5766"
"LOK1378_1mm";"SILVA (only NR);Eukaryota;Amorphea;Obazoa;Opisthokonta;Nucletmycea;Fungi;Dikarya;Ascomycota;Pezizomycotina;Pezizomycetes;Pezizales;Pyronemataceae;Selenaspora;";"0.0";"0";"1";"1";"0";"1";"0";"430523";"5766"
"LOK1378_1mm";"SILVA (only NR);Eukaryota;Amorphea;Obazoa;Opisthokonta;Nucletmycea;Fungi;Dikarya;Ascomycota;Pezizomycotina;Pezizomycetes;Pezizales;Pyronemataceae;Sowerbyella;";"0.0";"0";"3";"3";"0";"3";"0";"430521";"5766"
"LOK1378_1mm";"SILVA (only NR);Eukaryota;Amorphea;Obazoa;Opisthokonta;Nucletmycea;Fungi;Dikarya;Ascomycota;Pezizomycotina;Pezizomycetes;Pezizales;Pyronemataceae;Sporendonema;";"0.0";"0";"1";"1";"0";"1";"0";"430523";"5766"
"LOK1378_1mm";"SILVA (only NR);Eukaryota;Amorphea;Obazoa;Opisthokonta;Nucletmycea;Fungi;Dikarya;Ascomycota;Pezizomycotina;Pezizomycetes;Pezizales;Pyronemataceae;Tarzetta;";"0.0";"0";"2";"2";"0";"2";"0";"430522";"5766"
"LOK1378_1mm";"SILVA (only NR);Eukaryota;Amorphea;Obazoa;Opisthokonta;Nucletmycea;Fungi;Dikarya;Ascomycota;Pezizomycotina;Pezizomycetes;Pezizales;Pyronemataceae;Tricharina;";"0.0";"0";"1";"1";"0";"1";"0";"430523";"5766"
"LOK1378_1mm";"SILVA (only NR);Eukaryota;Amorphea;Obazoa;Opisthokonta;Nucletmycea;Fungi;Dikarya;Ascomycota;Pezizomycotina;Pezizomycetes;Pezizales;Pyronemataceae;Trichophaea;";"0.0";"0";"1";"1";"0";"1";"0";"430523";"5766"
"LOK1378_1mm";"SILVA (only NR);Eukaryota;Amorphea;Obazoa;Opisthokonta;Nucletmycea;Fungi;Dikarya;Ascomycota;Pezizomycotina;Pezizomycetes;Pezizales;Pyronemataceae;Wilcoxina;";"0.0";"0";"1";"1";"0";"1";"0";"430523";"5766"
"LOK1378_1mm";"SILVA (only NR);Eukaryota;Amorphea;Obazoa;Opisthokonta;Nucletmycea;Fungi;Dikarya;Ascomycota;Pezizomycotina;Pezizomycetes;Pezizales;Pyronemataceae;uncultured;";"0.0";"0";"5";"5";"0";"5";"0";"430519";"5766"
"LOK1378_1mm";"SILVA (only NR);Eukaryota;Amorphea;Obazoa;Opisthokonta;Nucletmycea;Fungi;Dikarya;Ascomycota;Pezizomycotina;Pezizomycetes;Pezizales;Reddellomyces;";"0.0";"0";"1";"1";"0";"1";"0";"430523";"5766"
"LOK1378_1mm";"SILVA (only NR);Eukaryota;Amorphea;Obazoa;Opisthokonta;Nucletmycea;Fungi;Dikarya;Ascomycota;Pezizomycotina;Pezizomycetes;Pezizales;Rhizinaceae;";"0.0";"0";"14";"14";"0";"14";"0";"430510";"5766"
"LOK1378_1mm";"SILVA (only NR);Eukaryota;Amorphea;Obazoa;Opisthokonta;Nucletmycea;Fungi;Dikarya;Ascomycota;Pezizomycotina;Pezizomycetes;Pezizales;Rhizinaceae;Phymatotrichopsis;";"0.0";"0";"9";"9";"0";"9";"0";"430515";"5766"
"LOK1378_1mm";"SILVA (only NR);Eukaryota;Amorphea;Obazoa;Opisthokonta;Nucletmycea;Fungi;Dikarya;Ascomycota;Pezizomycotina;Pezizomycetes;Pezizales;Rhizinaceae;Psilopezia;";"0.0";"0";"3";"3";"0";"3";"0";"430521";"5766"
"LOK1378_1mm";"SILVA (only NR);Eukaryota;Amorphea;Obazoa;Opisthokonta;Nucletmycea;Fungi;Dikarya;Ascomycota;Pezizomycotina;Pezizomycetes;Pezizales;Rhizinaceae;Rhizina;";"0.0";"0";"2";"2";"0";"2";"0";"430522";"5766"
"LOK1378_1mm";"SILVA (only NR);Eukaryota;Amorphea;Obazoa;Opisthokonta;Nucletmycea;Fungi;Dikarya;Ascomycota;Pezizomycotina;Pezizomycetes;Pezizales;Sarcoscyphaceae;";"0.0";"0";"13";"12";"0";"12";"1";"430512";"5766"
"LOK1378_1mm";"SILVA (only NR);Eukaryota;Amorphea;Obazoa;Opisthokonta;Nucletmycea;Fungi;Dikarya;Ascomycota;Pezizomycotina;Pezizomycetes;Pezizales;Sarcoscyphaceae;Cookeina;";"0.0";"0";"2";"1";"0";"1";"1";"430523";"5766"
"LOK1378_1mm";"SILVA (only NR);Eukaryota;Amorphea;Obazoa;Opisthokonta;Nucletmycea;Fungi;Dikarya;Ascomycota;Pezizomycotina;Pezizomycetes;Pezizales;Sarcoscyphaceae;Microstoma;";"0.0";"0";"2";"2";"0";"2";"0";"430522";"5766"
"LOK1378_1mm";"SILVA (only NR);Eukaryota;Amorphea;Obazoa;Opisthokonta;Nucletmycea;Fungi;Dikarya;Ascomycota;Pezizomycotina;Pezizomycetes;Pezizales;Sarcoscyphaceae;Nanoscypha;";"0.0";"0";"1";"1";"0";"1";"0";"430523";"5766"
"LOK1378_1mm";"SILVA (only NR);Eukaryota;Amorphea;Obazoa;Opisthokonta;Nucletmycea;Fungi;Dikarya;Ascomycota;Pezizomycotina;Pezizomycetes;Pezizales;Sarcoscyphaceae;Phillipsia;";"0.0";"0";"2";"2";"0";"2";"0";"430522";"5766"
"LOK1378_1mm";"SILVA (only NR);Eukaryota;Amorphea;Obazoa;Opisthokonta;Nucletmycea;Fungi;Dikarya;Ascomycota;Pezizomycotina;Pezizomycetes;Pezizales;Sarcoscyphaceae;Pithya;";"0.0";"0";"1";"1";"0";"1";"0";"430523";"5766"
"LOK1378_1mm";"SILVA (only NR);Eukaryota;Amorphea;Obazoa;Opisthokonta;Nucletmycea;Fungi;Dikarya;Ascomycota;Pezizomycotina;Pezizomycetes;Pezizales;Sarcoscyphaceae;Pseudopithyella;";"0.0";"0";"1";"1";"0";"1";"0";"430523";"5766"
"LOK1378_1mm";"SILVA (only NR);Eukaryota;Amorphea;Obazoa;Opisthokonta;Nucletmycea;Fungi;Dikarya;Ascomycota;Pezizomycotina;Pezizomycetes;Pezizales;Sarcoscyphaceae;Rickiella;";"0.0";"0";"1";"1";"0";"1";"0";"430523";"5766"
"LOK1378_1mm";"SILVA (only NR);Eukaryota;Amorphea;Obazoa;Opisthokonta;Nucletmycea;Fungi;Dikarya;Ascomycota;Pezizomycotina;Pezizomycetes;Pezizales;Sarcoscyphaceae;Sarcoscypha;";"0.0";"0";"2";"2";"0";"2";"0";"430522";"5766"
"LOK1378_1mm";"SILVA (only NR);Eukaryota;Amorphea;Obazoa;Opisthokonta;Nucletmycea;Fungi;Dikarya;Ascomycota;Pezizomycotina;Pezizomycetes;Pezizales;Sarcosomataceae;";"0.0";"0";"3";"3";"0";"3";"0";"430521";"5766"
"LOK1378_1mm";"SILVA (only NR);Eukaryota;Amorphea;Obazoa;Opisthokonta;Nucletmycea;Fungi;Dikarya;Ascomycota;Pezizomycotina;Pezizomycetes;Pezizales;Sarcosomataceae;Plectania;";"0.0";"0";"1";"1";"0";"1";"0";"430523";"5766"
"LOK1378_1mm";"SILVA (only NR);Eukaryota;Amorphea;Obazoa;Opisthokonta;Nucletmycea;Fungi;Dikarya;Ascomycota;Pezizomycotina;Pezizomycetes;Pezizales;Sarcosomataceae;Pseudoplectania;";"0.0";"0";"1";"1";"0";"1";"0";"430523";"5766"
"LOK1378_1mm";"SILVA (only NR);Eukaryota;Amorphea;Obazoa;Opisthokonta;Nucletmycea;Fungi;Dikarya;Ascomycota;Pezizomycotina;Pezizomycetes;Pezizales;Sarcosomataceae;Sarcosoma;";"0.0";"0";"1";"1";"0";"1";"0";"430523";"5766"
"LOK1378_1mm";"SILVA (only NR);Eukaryota;Amorphea;Obazoa;Opisthokonta;Nucletmycea;Fungi;Dikarya;Ascomycota;Pezizomycotina;Pezizomycetes;Pezizales;Strobiloscypha;";"0.0";"0";"1";"1";"0";"1";"0";"430523";"5766"
"LOK1378_1mm";"SILVA (only NR);Eukaryota;Amorphea;Obazoa;Opisthokonta;Nucletmycea;Fungi;Dikarya;Ascomycota;Pezizomycotina;Pezizomycetes;Pezizales;Tuberaceae;";"0.0";"0";"10";"10";"0";"10";"0";"430514";"5766"
"LOK1378_1mm";"SILVA (only NR);Eukaryota;Amorphea;Obazoa;Opisthokonta;Nucletmycea;Fungi;Dikarya;Ascomycota;Pezizomycotina;Pezizomycetes;Pezizales;Tuberaceae;Choiromyces;";"0.0";"0";"1";"1";"0";"1";"0";"430523";"5766"
"LOK1378_1mm";"SILVA (only NR);Eukaryota;Amorphea;Obazoa;Opisthokonta;Nucletmycea;Fungi;Dikarya;Ascomycota;Pezizomycotina;Pezizomycetes;Pezizales;Tuberaceae;Tuber;";"0.0";"0";"9";"9";"0";"9";"0";"430515";"5766"
"LOK1378_1mm";"SILVA (only NR);Eukaryota;Amorphea;Obazoa;Opisthokonta;Nucletmycea;Fungi;Dikarya;Ascomycota;Pezizomycotina;Pezizomycetes;Pezizales;Wolfina;";"0.0";"0";"1";"1";"0";"1";"0";"430523";"5766"
"LOK1378_1mm";"SILVA (only NR);Eukaryota;Amorphea;Obazoa;Opisthokonta;Nucletmycea;Fungi;Dikarya;Ascomycota;Pezizomycotina;Rhopalophora;";"0.0";"0";"2";"2";"0";"2";"0";"430522";"5766"
"LOK1378_1mm";"SILVA (only NR);Eukaryota;Amorphea;Obazoa;Opisthokonta;Nucletmycea;Fungi;Dikarya;Ascomycota;Pezizomycotina;Sordariomycetes;";"0.0";"0";"989";"839";"0";"839";"150";"429685";"5766"
"LOK1378_1mm";"SILVA (only NR);Eukaryota;Amorphea;Obazoa;Opisthokonta;Nucletmycea;Fungi;Dikarya;Ascomycota;Pezizomycotina;Sordariomycetes;Annulatascales;";"0.0";"0";"1";"1";"0";"1";"0";"430523";"5766"
"LOK1378_1mm";"SILVA (only NR);Eukaryota;Amorphea;Obazoa;Opisthokonta;Nucletmycea;Fungi;Dikarya;Ascomycota;Pezizomycotina;Sordariomycetes;Annulatascales;Annulatascaceae;";"0.0";"0";"1";"1";"0";"1";"0";"430523";"5766"
"LOK1378_1mm";"SILVA (only NR);Eukaryota;Amorphea;Obazoa;Opisthokonta;Nucletmycea;Fungi;Dikarya;Ascomycota;Pezizomycotina;Sordariomycetes;Annulatascales;Annulatascaceae;Ascitendus;";"0.0";"0";"1";"1";"0";"1";"0";"430523";"5766"
"LOK1378_1mm";"SILVA (only NR);Eukaryota;Amorphea;Obazoa;Opisthokonta;Nucletmycea;Fungi;Dikarya;Ascomycota;Pezizomycotina;Sordariomycetes;Boliniales;";"0.0";"0";"1";"1";"0";"1";"0";"430523";"5766"
"LOK1378_1mm";"SILVA (only NR);Eukaryota;Amorphea;Obazoa;Opisthokonta;Nucletmycea;Fungi;Dikarya;Ascomycota;Pezizomycotina;Sordariomycetes;Boliniales;Boliniaceae;";"0.0";"0";"1";"1";"0";"1";"0";"430523";"5766"
"LOK1378_1mm";"SILVA (only NR);Eukaryota;Amorphea;Obazoa;Opisthokonta;Nucletmycea;Fungi;Dikarya;Ascomycota;Pezizomycotina;Sordariomycetes;Boliniales;Boliniaceae;Camarops;";"0.0";"0";"1";"1";"0";"1";"0";"430523";"5766"
"LOK1378_1mm";"SILVA (only NR);Eukaryota;Amorphea;Obazoa;Opisthokonta;Nucletmycea;Fungi;Dikarya;Ascomycota;Pezizomycotina;Sordariomycetes;Calosphaeriales;";"0.0";"0";"6";"6";"0";"6";"0";"430518";"5766"
"LOK1378_1mm";"SILVA (only NR);Eukaryota;Amorphea;Obazoa;Opisthokonta;Nucletmycea;Fungi;Dikarya;Ascomycota;Pezizomycotina;Sordariomycetes;Calosphaeriales;Calosphaeriaceae;";"0.0";"0";"4";"4";"0";"4";"0";"430520";"5766"
"LOK1378_1mm";"SILVA (only NR);Eukaryota;Amorphea;Obazoa;Opisthokonta;Nucletmycea;Fungi;Dikarya;Ascomycota;Pezizomycotina;Sordariomycetes;Calosphaeriales;Calosphaeriaceae;Calosphaeria;";"0.0";"0";"1";"1";"0";"1";"0";"430523";"5766"
"LOK1378_1mm";"SILVA (only NR);Eukaryota;Amorphea;Obazoa;Opisthokonta;Nucletmycea;Fungi;Dikarya;Ascomycota;Pezizomycotina;Sordariomycetes;Calosphaeriales;Calosphaeriaceae;Jattaea;";"0.0";"0";"2";"2";"0";"2";"0";"430522";"5766"
"LOK1378_1mm";"SILVA (only NR);Eukaryota;Amorphea;Obazoa;Opisthokonta;Nucletmycea;Fungi;Dikarya;Ascomycota;Pezizomycotina;Sordariomycetes;Calosphaeriales;Calosphaeriaceae;Togniniella;";"0.0";"0";"1";"1";"0";"1";"0";"430523";"5766"
"LOK1378_1mm";"SILVA (only NR);Eukaryota;Amorphea;Obazoa;Opisthokonta;Nucletmycea;Fungi;Dikarya;Ascomycota;Pezizomycotina;Sordariomycetes;Calosphaeriales;Pleurostomataceae;";"0.0";"0";"2";"2";"0";"2";"0";"430522";"5766"
"LOK1378_1mm";"SILVA (only NR);Eukaryota;Amorphea;Obazoa;Opisthokonta;Nucletmycea;Fungi;Dikarya;Ascomycota;Pezizomycotina;Sordariomycetes;Calosphaeriales;Pleurostomataceae;Pleurostoma;";"0.0";"0";"2";"2";"0";"2";"0";"430522";"5766"
"LOK1378_1mm";"SILVA (only NR);Eukaryota;Amorphea;Obazoa;Opisthokonta;Nucletmycea;Fungi;Dikarya;Ascomycota;Pezizomycotina;Sordariomycetes;Coniochaetales;";"0.0";"0";"6";"6";"0";"6";"0";"430518";"5766"
"LOK1378_1mm";"SILVA (only NR);Eukaryota;Amorphea;Obazoa;Opisthokonta;Nucletmycea;Fungi;Dikarya;Ascomycota;Pezizomycotina;Sordariomycetes;Coniochaetales;Coniochaetaceae;";"0.0";"0";"6";"6";"0";"6";"0";"430518";"5766"
"LOK1378_1mm";"SILVA (only NR);Eukaryota;Amorphea;Obazoa;Opisthokonta;Nucletmycea;Fungi;Dikarya;Ascomycota;Pezizomycotina;Sordariomycetes;Coniochaetales;Coniochaetaceae;Coniochaeta;";"0.0";"0";"6";"6";"0";"6";"0";"430518";"5766"
"LOK1378_1mm";"SILVA (only NR);Eukaryota;Amorphea;Obazoa;Opisthokonta;Nucletmycea;Fungi;Dikarya;Ascomycota;Pezizomycotina;Sordariomycetes;Conioscyphales;";"0.0";"0";"3";"3";"0";"3";"0";"430521";"5766"
"LOK1378_1mm";"SILVA (only NR);Eukaryota;Amorphea;Obazoa;Opisthokonta;Nucletmycea;Fungi;Dikarya;Ascomycota;Pezizomycotina;Sordariomycetes;Conioscyphales;Conioscyphaceae;";"0.0";"0";"3";"3";"0";"3";"0";"430521";"5766"
"LOK1378_1mm";"SILVA (only NR);Eukaryota;Amorphea;Obazoa;Opisthokonta;Nucletmycea;Fungi;Dikarya;Ascomycota;Pezizomycotina;Sordariomycetes;Conioscyphales;Conioscyphaceae;Conioscypha;";"0.0";"0";"3";"3";"0";"3";"0";"430521";"5766"
"LOK1378_1mm";"SILVA (only NR);Eukaryota;Amorphea;Obazoa;Opisthokonta;Nucletmycea;Fungi;Dikarya;Ascomycota;Pezizomycotina;Sordariomycetes;Diaporthales;";"0.0";"0";"23";"18";"0";"18";"5";"430506";"5766"
"LOK1378_1mm";"SILVA (only NR);Eukaryota;Amorphea;Obazoa;Opisthokonta;Nucletmycea;Fungi;Dikarya;Ascomycota;Pezizomycotina;Sordariomycetes;Diaporthales;Cryphonectriaceae;";"0.0";"0";"9";"9";"0";"9";"0";"430515";"5766"
"LOK1378_1mm";"SILVA (only NR);Eukaryota;Amorphea;Obazoa;Opisthokonta;Nucletmycea;Fungi;Dikarya;Ascomycota;Pezizomycotina;Sordariomycetes;Diaporthales;Cryphonectriaceae;Cryphonectria-Endothia complex;";"0.0";"0";"9";"9";"0";"9";"0";"430515";"5766"
"LOK1378_1mm";"SILVA (only NR);Eukaryota;Amorphea;Obazoa;Opisthokonta;Nucletmycea;Fungi;Dikarya;Ascomycota;Pezizomycotina;Sordariomycetes;Diaporthales;Diaporthe;";"0.0";"0";"1";"0";"0";"0";"1";"430524";"5766"
"LOK1378_1mm";"SILVA (only NR);Eukaryota;Amorphea;Obazoa;Opisthokonta;Nucletmycea;Fungi;Dikarya;Ascomycota;Pezizomycotina;Sordariomycetes;Diaporthales;Gnomoniaceae;";"0.0";"0";"4";"3";"0";"3";"1";"430521";"5766"
"LOK1378_1mm";"SILVA (only NR);Eukaryota;Amorphea;Obazoa;Opisthokonta;Nucletmycea;Fungi;Dikarya;Ascomycota;Pezizomycotina;Sordariomycetes;Diaporthales;Gnomoniaceae;Cryptosporella;";"0.0";"0";"1";"1";"0";"1";"0";"430523";"5766"
"LOK1378_1mm";"SILVA (only NR);Eukaryota;Amorphea;Obazoa;Opisthokonta;Nucletmycea;Fungi;Dikarya;Ascomycota;Pezizomycotina;Sordariomycetes;Diaporthales;Gnomoniaceae;Gnomonia;";"0.0";"0";"1";"0";"0";"0";"1";"430524";"5766"
"LOK1378_1mm";"SILVA (only NR);Eukaryota;Amorphea;Obazoa;Opisthokonta;Nucletmycea;Fungi;Dikarya;Ascomycota;Pezizomycotina;Sordariomycetes;Diaporthales;Gnomoniaceae;Ophiognomonia;";"0.0";"0";"1";"1";"0";"1";"0";"430523";"5766"
"LOK1378_1mm";"SILVA (only NR);Eukaryota;Amorphea;Obazoa;Opisthokonta;Nucletmycea;Fungi;Dikarya;Ascomycota;Pezizomycotina;Sordariomycetes;Diaporthales;Gnomoniaceae;Plagiostoma;";"0.0";"0";"1";"1";"0";"1";"0";"430523";"5766"
"LOK1378_1mm";"SILVA (only NR);Eukaryota;Amorphea;Obazoa;Opisthokonta;Nucletmycea;Fungi;Dikarya;Ascomycota;Pezizomycotina;Sordariomycetes;Diaporthales;Melanconidaceae;";"0.0";"0";"2";"2";"0";"2";"0";"430522";"5766"
"LOK1378_1mm";"SILVA (only NR);Eukaryota;Amorphea;Obazoa;Opisthokonta;Nucletmycea;Fungi;Dikarya;Ascomycota;Pezizomycotina;Sordariomycetes;Diaporthales;Melanconidaceae;Melanconis;";"0.0";"0";"2";"2";"0";"2";"0";"430522";"5766"
"LOK1378_1mm";"SILVA (only NR);Eukaryota;Amorphea;Obazoa;Opisthokonta;Nucletmycea;Fungi;Dikarya;Ascomycota;Pezizomycotina;Sordariomycetes;Diaporthales;Phomopsis;";"0.0";"0";"1";"1";"0";"1";"0";"430523";"5766"
"LOK1378_1mm";"SILVA (only NR);Eukaryota;Amorphea;Obazoa;Opisthokonta;Nucletmycea;Fungi;Dikarya;Ascomycota;Pezizomycotina;Sordariomycetes;Diaporthales;Sirococcus;";"0.0";"0";"1";"1";"0";"1";"0";"430523";"5766"
"LOK1378_1mm";"SILVA (only NR);Eukaryota;Amorphea;Obazoa;Opisthokonta;Nucletmycea;Fungi;Dikarya;Ascomycota;Pezizomycotina;Sordariomycetes;Diaporthales;Valsa;";"0.0";"0";"1";"1";"0";"1";"0";"430523";"5766"
"LOK1378_1mm";"SILVA (only NR);Eukaryota;Amorphea;Obazoa;Opisthokonta;Nucletmycea;Fungi;Dikarya;Ascomycota;Pezizomycotina;Sordariomycetes;Diaporthales;Valsaceae;";"0.0";"0";"3";"0";"0";"0";"3";"430524";"5766"
"LOK1378_1mm";"SILVA (only NR);Eukaryota;Amorphea;Obazoa;Opisthokonta;Nucletmycea;Fungi;Dikarya;Ascomycota;Pezizomycotina;Sordariomycetes;Diaporthales;Valsaceae;Phruensis;";"0.0";"0";"2";"0";"0";"0";"2";"430524";"5766"
"LOK1378_1mm";"SILVA (only NR);Eukaryota;Amorphea;Obazoa;Opisthokonta;Nucletmycea;Fungi;Dikarya;Ascomycota;Pezizomycotina;Sordariomycetes;Glomerellales;";"0.0";"0";"92";"85";"0";"85";"7";"430439";"5766"
"LOK1378_1mm";"SILVA (only NR);Eukaryota;Amorphea;Obazoa;Opisthokonta;Nucletmycea;Fungi;Dikarya;Ascomycota;Pezizomycotina;Sordariomycetes;Glomerellales;Australiascaceae;";"0.0";"0";"5";"5";"0";"5";"0";"430519";"5766"
"LOK1378_1mm";"SILVA (only NR);Eukaryota;Amorphea;Obazoa;Opisthokonta;Nucletmycea;Fungi;Dikarya;Ascomycota;Pezizomycotina;Sordariomycetes;Glomerellales;Australiascaceae;Australiasca;";"0.0";"0";"1";"1";"0";"1";"0";"430523";"5766"
"LOK1378_1mm";"SILVA (only NR);Eukaryota;Amorphea;Obazoa;Opisthokonta;Nucletmycea;Fungi;Dikarya;Ascomycota;Pezizomycotina;Sordariomycetes;Glomerellales;Australiascaceae;Monilochaetes;";"0.0";"0";"4";"4";"0";"4";"0";"430520";"5766"
"LOK1378_1mm";"SILVA (only NR);Eukaryota;Amorphea;Obazoa;Opisthokonta;Nucletmycea;Fungi;Dikarya;Ascomycota;Pezizomycotina;Sordariomycetes;Glomerellales;Glomerellaceae;";"0.0";"0";"64";"58";"0";"58";"6";"430466";"5766"
"LOK1378_1mm";"SILVA (only NR);Eukaryota;Amorphea;Obazoa;Opisthokonta;Nucletmycea;Fungi;Dikarya;Ascomycota;Pezizomycotina;Sordariomycetes;Glomerellales;Glomerellaceae;Colletotrichum;";"0.0";"0";"64";"58";"0";"58";"6";"430466";"5766"
"LOK1378_1mm";"SILVA (only NR);Eukaryota;Amorphea;Obazoa;Opisthokonta;Nucletmycea;Fungi;Dikarya;Ascomycota;Pezizomycotina;Sordariomycetes;Glomerellales;Plectosphaerellaceae;";"0.0";"0";"18";"17";"0";"17";"1";"430507";"5766"
"LOK1378_1mm";"SILVA (only NR);Eukaryota;Amorphea;Obazoa;Opisthokonta;Nucletmycea;Fungi;Dikarya;Ascomycota;Pezizomycotina;Sordariomycetes;Glomerellales;Plectosphaerellaceae;Acrostalagmus;";"0.0";"0";"1";"1";"0";"1";"0";"430523";"5766"
"LOK1378_1mm";"SILVA (only NR);Eukaryota;Amorphea;Obazoa;Opisthokonta;Nucletmycea;Fungi;Dikarya;Ascomycota;Pezizomycotina;Sordariomycetes;Glomerellales;Plectosphaerellaceae;Gibellulopsis;";"0.0";"0";"1";"1";"0";"1";"0";"430523";"5766"
"LOK1378_1mm";"SILVA (only NR);Eukaryota;Amorphea;Obazoa;Opisthokonta;Nucletmycea;Fungi;Dikarya;Ascomycota;Pezizomycotina;Sordariomycetes;Glomerellales;Plectosphaerellaceae;Plectosphaerella;";"0.0";"0";"2";"2";"0";"2";"0";"430522";"5766"
"LOK1378_1mm";"SILVA (only NR);Eukaryota;Amorphea;Obazoa;Opisthokonta;Nucletmycea;Fungi;Dikarya;Ascomycota;Pezizomycotina;Sordariomycetes;Glomerellales;Plectosphaerellaceae;Verticillium;";"0.0";"0";"12";"11";"0";"11";"1";"430513";"5766"
"LOK1378_1mm";"SILVA (only NR);Eukaryota;Amorphea;Obazoa;Opisthokonta;Nucletmycea;Fungi;Dikarya;Ascomycota;Pezizomycotina;Sordariomycetes;Glomerellales;Reticulascaceae;";"0.0";"0";"5";"5";"0";"5";"0";"430519";"5766"
"LOK1378_1mm";"SILVA (only NR);Eukaryota;Amorphea;Obazoa;Opisthokonta;Nucletmycea;Fungi;Dikarya;Ascomycota;Pezizomycotina;Sordariomycetes;Glomerellales;Reticulascaceae;Kylindria;";"0.0";"0";"1";"1";"0";"1";"0";"430523";"5766"
"LOK1378_1mm";"SILVA (only NR);Eukaryota;Amorphea;Obazoa;Opisthokonta;Nucletmycea;Fungi;Dikarya;Ascomycota;Pezizomycotina;Sordariomycetes;Glomerellales;Reticulascaceae;Reticulascus;";"0.0";"0";"3";"3";"0";"3";"0";"430521";"5766"
"LOK1378_1mm";"SILVA (only NR);Eukaryota;Amorphea;Obazoa;Opisthokonta;Nucletmycea;Fungi;Dikarya;Ascomycota;Pezizomycotina;Sordariomycetes;Glomerellales;Reticulascaceae;Sporoschismopsis;";"0.0";"0";"1";"1";"0";"1";"0";"430523";"5766"
"LOK1378_1mm";"SILVA (only NR);Eukaryota;Amorphea;Obazoa;Opisthokonta;Nucletmycea;Fungi;Dikarya;Ascomycota;Pezizomycotina;Sordariomycetes;Hypocreales;";"0.0";"0";"435";"357";"0";"357";"78";"430167";"5766"
"LOK1378_1mm";"SILVA (only NR);Eukaryota;Amorphea;Obazoa;Opisthokonta;Nucletmycea;Fungi;Dikarya;Ascomycota;Pezizomycotina;Sordariomycetes;Hypocreales;Bionectriaceae;";"0.0";"0";"19";"16";"0";"16";"3";"430508";"5766"
"LOK1378_1mm";"SILVA (only NR);Eukaryota;Amorphea;Obazoa;Opisthokonta;Nucletmycea;Fungi;Dikarya;Ascomycota;Pezizomycotina;Sordariomycetes;Hypocreales;Bionectriaceae;Bryocentria;";"0.0";"0";"1";"1";"0";"1";"0";"430523";"5766"
"LOK1378_1mm";"SILVA (only NR);Eukaryota;Amorphea;Obazoa;Opisthokonta;Nucletmycea;Fungi;Dikarya;Ascomycota;Pezizomycotina;Sordariomycetes;Hypocreales;Bionectriaceae;Clonostachys;";"0.0";"0";"5";"5";"0";"5";"0";"430519";"5766"
"LOK1378_1mm";"SILVA (only NR);Eukaryota;Amorphea;Obazoa;Opisthokonta;Nucletmycea;Fungi;Dikarya;Ascomycota;Pezizomycotina;Sordariomycetes;Hypocreales;Bionectriaceae;Geosmithia;";"0.0";"0";"9";"7";"0";"7";"2";"430517";"5766"
"LOK1378_1mm";"SILVA (only NR);Eukaryota;Amorphea;Obazoa;Opisthokonta;Nucletmycea;Fungi;Dikarya;Ascomycota;Pezizomycotina;Sordariomycetes;Hypocreales;Bionectriaceae;Mycoarachis;";"0.0";"0";"1";"1";"0";"1";"0";"430523";"5766"
"LOK1378_1mm";"SILVA (only NR);Eukaryota;Amorphea;Obazoa;Opisthokonta;Nucletmycea;Fungi;Dikarya;Ascomycota;Pezizomycotina;Sordariomycetes;Hypocreales;Bionectriaceae;Nigrosabulum;";"0.0";"0";"1";"0";"0";"0";"1";"430524";"5766"
"LOK1378_1mm";"SILVA (only NR);Eukaryota;Amorphea;Obazoa;Opisthokonta;Nucletmycea;Fungi;Dikarya;Ascomycota;Pezizomycotina;Sordariomycetes;Hypocreales;Bionectriaceae;Ochronectria;";"0.0";"0";"1";"1";"0";"1";"0";"430523";"5766"
"LOK1378_1mm";"SILVA (only NR);Eukaryota;Amorphea;Obazoa;Opisthokonta;Nucletmycea;Fungi;Dikarya;Ascomycota;Pezizomycotina;Sordariomycetes;Hypocreales;Claviceps;";"0.0";"0";"1";"1";"0";"1";"0";"430523";"5766"
"LOK1378_1mm";"SILVA (only NR);Eukaryota;Amorphea;Obazoa;Opisthokonta;Nucletmycea;Fungi;Dikarya;Ascomycota;Pezizomycotina;Sordariomycetes;Hypocreales;Clavicipitaceae;";"0.0";"0";"39";"33";"0";"33";"6";"430491";"5766"
"LOK1378_1mm";"SILVA (only NR);Eukaryota;Amorphea;Obazoa;Opisthokonta;Nucletmycea;Fungi;Dikarya;Ascomycota;Pezizomycotina;Sordariomycetes;Hypocreales;Clavicipitaceae;Aciculosporium;";"0.0";"0";"1";"1";"0";"1";"0";"430523";"5766"
"LOK1378_1mm";"SILVA (only NR);Eukaryota;Amorphea;Obazoa;Opisthokonta;Nucletmycea;Fungi;Dikarya;Ascomycota;Pezizomycotina;Sordariomycetes;Hypocreales;Clavicipitaceae;Balansia;";"0.0";"0";"1";"0";"0";"0";"1";"430524";"5766"
"LOK1378_1mm";"SILVA (only NR);Eukaryota;Amorphea;Obazoa;Opisthokonta;Nucletmycea;Fungi;Dikarya;Ascomycota;Pezizomycotina;Sordariomycetes;Hypocreales;Clavicipitaceae;Conoideocrella;";"0.0";"0";"3";"3";"0";"3";"0";"430521";"5766"
"LOK1378_1mm";"SILVA (only NR);Eukaryota;Amorphea;Obazoa;Opisthokonta;Nucletmycea;Fungi;Dikarya;Ascomycota;Pezizomycotina;Sordariomycetes;Hypocreales;Clavicipitaceae;Epichloe;";"0.0";"0";"6";"5";"0";"5";"1";"430519";"5766"
"LOK1378_1mm";"SILVA (only NR);Eukaryota;Amorphea;Obazoa;Opisthokonta;Nucletmycea;Fungi;Dikarya;Ascomycota;Pezizomycotina;Sordariomycetes;Hypocreales;Clavicipitaceae;Hypocrella;";"0.0";"0";"1";"1";"0";"1";"0";"430523";"5766"
"LOK1378_1mm";"SILVA (only NR);Eukaryota;Amorphea;Obazoa;Opisthokonta;Nucletmycea;Fungi;Dikarya;Ascomycota;Pezizomycotina;Sordariomycetes;Hypocreales;Clavicipitaceae;Metapochonia;";"0.0";"0";"2";"2";"0";"2";"0";"430522";"5766"
"LOK1378_1mm";"SILVA (only NR);Eukaryota;Amorphea;Obazoa;Opisthokonta;Nucletmycea;Fungi;Dikarya;Ascomycota;Pezizomycotina;Sordariomycetes;Hypocreales;Clavicipitaceae;Metarhizium;";"0.0";"0";"18";"14";"0";"14";"4";"430510";"5766"
"LOK1378_1mm";"SILVA (only NR);Eukaryota;Amorphea;Obazoa;Opisthokonta;Nucletmycea;Fungi;Dikarya;Ascomycota;Pezizomycotina;Sordariomycetes;Hypocreales;Clavicipitaceae;Pochonia;";"0.0";"0";"2";"2";"0";"2";"0";"430522";"5766"
"LOK1378_1mm";"SILVA (only NR);Eukaryota;Amorphea;Obazoa;Opisthokonta;Nucletmycea;Fungi;Dikarya;Ascomycota;Pezizomycotina;Sordariomycetes;Hypocreales;Clavicipitaceae;Torrubiella;";"0.0";"0";"1";"1";"0";"1";"0";"430523";"5766"
"LOK1378_1mm";"SILVA (only NR);Eukaryota;Amorphea;Obazoa;Opisthokonta;Nucletmycea;Fungi;Dikarya;Ascomycota;Pezizomycotina;Sordariomycetes;Hypocreales;Cordycipitaceae;";"0.0";"0";"95";"73";"0";"73";"22";"430451";"5766"
"LOK1378_1mm";"SILVA (only NR);Eukaryota;Amorphea;Obazoa;Opisthokonta;Nucletmycea;Fungi;Dikarya;Ascomycota;Pezizomycotina;Sordariomycetes;Hypocreales;Cordycipitaceae;Akanthomyces;";"0.0";"0";"1";"0";"0";"0";"1";"430524";"5766"
"LOK1378_1mm";"SILVA (only NR);Eukaryota;Amorphea;Obazoa;Opisthokonta;Nucletmycea;Fungi;Dikarya;Ascomycota;Pezizomycotina;Sordariomycetes;Hypocreales;Cordycipitaceae;Beauveria;";"0.0";"0";"15";"12";"0";"12";"3";"430512";"5766"
"LOK1378_1mm";"SILVA (only NR);Eukaryota;Amorphea;Obazoa;Opisthokonta;Nucletmycea;Fungi;Dikarya;Ascomycota;Pezizomycotina;Sordariomycetes;Hypocreales;Cordycipitaceae;Blackwellomyces;";"0.0";"0";"1";"0";"0";"0";"1";"430524";"5766"
"LOK1378_1mm";"SILVA (only NR);Eukaryota;Amorphea;Obazoa;Opisthokonta;Nucletmycea;Fungi;Dikarya;Ascomycota;Pezizomycotina;Sordariomycetes;Hypocreales;Cordycipitaceae;Cordyceps;";"0.0";"0";"43";"33";"0";"33";"10";"430491";"5766"
"LOK1378_1mm";"SILVA (only NR);Eukaryota;Amorphea;Obazoa;Opisthokonta;Nucletmycea;Fungi;Dikarya;Ascomycota;Pezizomycotina;Sordariomycetes;Hypocreales;Cordycipitaceae;Gibellula;";"0.0";"0";"1";"1";"0";"1";"0";"430523";"5766"
"LOK1378_1mm";"SILVA (only NR);Eukaryota;Amorphea;Obazoa;Opisthokonta;Nucletmycea;Fungi;Dikarya;Ascomycota;Pezizomycotina;Sordariomycetes;Hypocreales;Cordycipitaceae;Hevansia;";"0.0";"0";"1";"0";"0";"0";"1";"430524";"5766"
"LOK1378_1mm";"SILVA (only NR);Eukaryota;Amorphea;Obazoa;Opisthokonta;Nucletmycea;Fungi;Dikarya;Ascomycota;Pezizomycotina;Sordariomycetes;Hypocreales;Cordycipitaceae;Isaria;";"0.0";"0";"16";"13";"0";"13";"3";"430511";"5766"
"LOK1378_1mm";"SILVA (only NR);Eukaryota;Amorphea;Obazoa;Opisthokonta;Nucletmycea;Fungi;Dikarya;Ascomycota;Pezizomycotina;Sordariomycetes;Hypocreales;Cordycipitaceae;Lecanicillium;";"0.0";"0";"5";"5";"0";"5";"0";"430519";"5766"
"LOK1378_1mm";"SILVA (only NR);Eukaryota;Amorphea;Obazoa;Opisthokonta;Nucletmycea;Fungi;Dikarya;Ascomycota;Pezizomycotina;Sordariomycetes;Hypocreales;Cordycipitaceae;Parengyodontium;";"0.0";"0";"4";"4";"0";"4";"0";"430520";"5766"
"LOK1378_1mm";"SILVA (only NR);Eukaryota;Amorphea;Obazoa;Opisthokonta;Nucletmycea;Fungi;Dikarya;Ascomycota;Pezizomycotina;Sordariomycetes;Hypocreales;Cordycipitaceae;Simplicillium;";"0.0";"0";"3";"2";"0";"2";"1";"430522";"5766"
"LOK1378_1mm";"SILVA (only NR);Eukaryota;Amorphea;Obazoa;Opisthokonta;Nucletmycea;Fungi;Dikarya;Ascomycota;Pezizomycotina;Sordariomycetes;Hypocreales;Drechmeria;";"0.0";"0";"1";"1";"0";"1";"0";"430523";"5766"
"LOK1378_1mm";"SILVA (only NR);Eukaryota;Amorphea;Obazoa;Opisthokonta;Nucletmycea;Fungi;Dikarya;Ascomycota;Pezizomycotina;Sordariomycetes;Hypocreales;Hypocreaceae;";"0.0";"0";"30";"28";"0";"28";"2";"430496";"5766"
"LOK1378_1mm";"SILVA (only NR);Eukaryota;Amorphea;Obazoa;Opisthokonta;Nucletmycea;Fungi;Dikarya;Ascomycota;Pezizomycotina;Sordariomycetes;Hypocreales;Hypocreaceae;Trichoderma;";"0.0";"0";"30";"28";"0";"28";"2";"430496";"5766"
"LOK1378_1mm";"SILVA (only NR);Eukaryota;Amorphea;Obazoa;Opisthokonta;Nucletmycea;Fungi;Dikarya;Ascomycota;Pezizomycotina;Sordariomycetes;Hypocreales;Incertae Sedis;";"0.0";"0";"50";"42";"0";"42";"8";"430482";"5766"
"LOK1378_1mm";"SILVA (only NR);Eukaryota;Amorphea;Obazoa;Opisthokonta;Nucletmycea;Fungi;Dikarya;Ascomycota;Pezizomycotina;Sordariomycetes;Hypocreales;Incertae Sedis;Acremonium;";"0.0";"0";"31";"29";"0";"29";"2";"430495";"5766"
"LOK1378_1mm";"SILVA (only NR);Eukaryota;Amorphea;Obazoa;Opisthokonta;Nucletmycea;Fungi;Dikarya;Ascomycota;Pezizomycotina;Sordariomycetes;Hypocreales;Incertae Sedis;Emericellopsis;";"0.0";"0";"1";"1";"0";"1";"0";"430523";"5766"
"LOK1378_1mm";"SILVA (only NR);Eukaryota;Amorphea;Obazoa;Opisthokonta;Nucletmycea;Fungi;Dikarya;Ascomycota;Pezizomycotina;Sordariomycetes;Hypocreales;Incertae Sedis;Sarocladium;";"0.0";"0";"14";"12";"0";"12";"2";"430512";"5766"
"LOK1378_1mm";"SILVA (only NR);Eukaryota;Amorphea;Obazoa;Opisthokonta;Nucletmycea;Fungi;Dikarya;Ascomycota;Pezizomycotina;Sordariomycetes;Hypocreales;Incertae Sedis;Trichothecium;";"0.0";"0";"2";"0";"0";"0";"2";"430524";"5766"
"LOK1378_1mm";"SILVA (only NR);Eukaryota;Amorphea;Obazoa;Opisthokonta;Nucletmycea;Fungi;Dikarya;Ascomycota;Pezizomycotina;Sordariomycetes;Hypocreales;Juncigena;";"0.0";"0";"1";"0";"0";"0";"1";"430524";"5766"
"LOK1378_1mm";"SILVA (only NR);Eukaryota;Amorphea;Obazoa;Opisthokonta;Nucletmycea;Fungi;Dikarya;Ascomycota;Pezizomycotina;Sordariomycetes;Hypocreales;Nectriaceae;";"0.0";"0";"71";"63";"0";"63";"8";"430461";"5766"
"LOK1378_1mm";"SILVA (only NR);Eukaryota;Amorphea;Obazoa;Opisthokonta;Nucletmycea;Fungi;Dikarya;Ascomycota;Pezizomycotina;Sordariomycetes;Hypocreales;Nectriaceae;Chaetopsina;";"0.0";"0";"1";"1";"0";"1";"0";"430523";"5766"
"LOK1378_1mm";"SILVA (only NR);Eukaryota;Amorphea;Obazoa;Opisthokonta;Nucletmycea;Fungi;Dikarya;Ascomycota;Pezizomycotina;Sordariomycetes;Hypocreales;Nectriaceae;Fusarium;";"0.0";"0";"57";"49";"0";"49";"8";"430475";"5766"
"LOK1378_1mm";"SILVA (only NR);Eukaryota;Amorphea;Obazoa;Opisthokonta;Nucletmycea;Fungi;Dikarya;Ascomycota;Pezizomycotina;Sordariomycetes;Hypocreales;Nectriaceae;Mariannaea;";"0.0";"0";"5";"5";"0";"5";"0";"430519";"5766"
"LOK1378_1mm";"SILVA (only NR);Eukaryota;Amorphea;Obazoa;Opisthokonta;Nucletmycea;Fungi;Dikarya;Ascomycota;Pezizomycotina;Sordariomycetes;Hypocreales;Nectriaceae;Nectria;";"0.0";"0";"5";"5";"0";"5";"0";"430519";"5766"
"LOK1378_1mm";"SILVA (only NR);Eukaryota;Amorphea;Obazoa;Opisthokonta;Nucletmycea;Fungi;Dikarya;Ascomycota;Pezizomycotina;Sordariomycetes;Hypocreales;Nectriaceae;Neonectria;";"0.0";"0";"2";"2";"0";"2";"0";"430522";"5766"
"LOK1378_1mm";"SILVA (only NR);Eukaryota;Amorphea;Obazoa;Opisthokonta;Nucletmycea;Fungi;Dikarya;Ascomycota;Pezizomycotina;Sordariomycetes;Hypocreales;Nectriaceae;Xenoacremonium;";"0.0";"0";"1";"1";"0";"1";"0";"430523";"5766"
"LOK1378_1mm";"SILVA (only NR);Eukaryota;Amorphea;Obazoa;Opisthokonta;Nucletmycea;Fungi;Dikarya;Ascomycota;Pezizomycotina;Sordariomycetes;Hypocreales;Nectriopsis;";"0.0";"0";"1";"1";"0";"1";"0";"430523";"5766"
"LOK1378_1mm";"SILVA (only NR);Eukaryota;Amorphea;Obazoa;Opisthokonta;Nucletmycea;Fungi;Dikarya;Ascomycota;Pezizomycotina;Sordariomycetes;Hypocreales;Niesslia;";"0.0";"0";"2";"2";"0";"2";"0";"430522";"5766"
"LOK1378_1mm";"SILVA (only NR);Eukaryota;Amorphea;Obazoa;Opisthokonta;Nucletmycea;Fungi;Dikarya;Ascomycota;Pezizomycotina;Sordariomycetes;Hypocreales;Ophiocordycipitaceae;";"0.0";"0";"81";"58";"0";"58";"23";"430466";"5766"
"LOK1378_1mm";"SILVA (only NR);Eukaryota;Amorphea;Obazoa;Opisthokonta;Nucletmycea;Fungi;Dikarya;Ascomycota;Pezizomycotina;Sordariomycetes;Hypocreales;Ophiocordycipitaceae;Hirsutella;";"0.0";"0";"4";"3";"0";"3";"1";"430521";"5766"
"LOK1378_1mm";"SILVA (only NR);Eukaryota;Amorphea;Obazoa;Opisthokonta;Nucletmycea;Fungi;Dikarya;Ascomycota;Pezizomycotina;Sordariomycetes;Hypocreales;Ophiocordycipitaceae;Hymenostilbe;";"0.0";"0";"1";"1";"0";"1";"0";"430523";"5766"
"LOK1378_1mm";"SILVA (only NR);Eukaryota;Amorphea;Obazoa;Opisthokonta;Nucletmycea;Fungi;Dikarya;Ascomycota;Pezizomycotina;Sordariomycetes;Hypocreales;Ophiocordycipitaceae;Ophiocordyceps;";"0.0";"0";"42";"31";"0";"31";"11";"430493";"5766"
"LOK1378_1mm";"SILVA (only NR);Eukaryota;Amorphea;Obazoa;Opisthokonta;Nucletmycea;Fungi;Dikarya;Ascomycota;Pezizomycotina;Sordariomycetes;Hypocreales;Ophiocordycipitaceae;Polycephalomyces;";"0.0";"0";"5";"5";"0";"5";"0";"430519";"5766"
"LOK1378_1mm";"SILVA (only NR);Eukaryota;Amorphea;Obazoa;Opisthokonta;Nucletmycea;Fungi;Dikarya;Ascomycota;Pezizomycotina;Sordariomycetes;Hypocreales;Ophiocordycipitaceae;Purpureocillium;";"0.0";"0";"4";"3";"0";"3";"1";"430521";"5766"
"LOK1378_1mm";"SILVA (only NR);Eukaryota;Amorphea;Obazoa;Opisthokonta;Nucletmycea;Fungi;Dikarya;Ascomycota;Pezizomycotina;Sordariomycetes;Hypocreales;Ophiocordycipitaceae;Tolypocladium;";"0.0";"0";"19";"11";"0";"11";"8";"430513";"5766"
"LOK1378_1mm";"SILVA (only NR);Eukaryota;Amorphea;Obazoa;Opisthokonta;Nucletmycea;Fungi;Dikarya;Ascomycota;Pezizomycotina;Sordariomycetes;Hypocreales;Septofusidium;";"0.0";"0";"1";"1";"0";"1";"0";"430523";"5766"
"LOK1378_1mm";"SILVA (only NR);Eukaryota;Amorphea;Obazoa;Opisthokonta;Nucletmycea;Fungi;Dikarya;Ascomycota;Pezizomycotina;Sordariomycetes;Hypocreales;Stachybotryaceae;";"0.0";"0";"32";"30";"0";"30";"2";"430494";"5766"
"LOK1378_1mm";"SILVA (only NR);Eukaryota;Amorphea;Obazoa;Opisthokonta;Nucletmycea;Fungi;Dikarya;Ascomycota;Pezizomycotina;Sordariomycetes;Hypocreales;Stachybotryaceae;Melanopsamma;";"0.0";"0";"2";"1";"0";"1";"1";"430523";"5766"
"LOK1378_1mm";"SILVA (only NR);Eukaryota;Amorphea;Obazoa;Opisthokonta;Nucletmycea;Fungi;Dikarya;Ascomycota;Pezizomycotina;Sordariomycetes;Hypocreales;Stachybotryaceae;Myrothecium;";"0.0";"0";"15";"15";"0";"15";"0";"430509";"5766"
"LOK1378_1mm";"SILVA (only NR);Eukaryota;Amorphea;Obazoa;Opisthokonta;Nucletmycea;Fungi;Dikarya;Ascomycota;Pezizomycotina;Sordariomycetes;Hypocreales;Stachybotryaceae;Paramyrothecium;";"0.0";"0";"1";"1";"0";"1";"0";"430523";"5766"
"LOK1378_1mm";"SILVA (only NR);Eukaryota;Amorphea;Obazoa;Opisthokonta;Nucletmycea;Fungi;Dikarya;Ascomycota;Pezizomycotina;Sordariomycetes;Hypocreales;Stachybotryaceae;Stachybotrys;";"0.0";"0";"12";"11";"0";"11";"1";"430513";"5766"
"LOK1378_1mm";"SILVA (only NR);Eukaryota;Amorphea;Obazoa;Opisthokonta;Nucletmycea;Fungi;Dikarya;Ascomycota;Pezizomycotina;Sordariomycetes;Hypocreales;Stachybotryaceae;Virgatospora;";"0.0";"0";"1";"1";"0";"1";"0";"430523";"5766"
"LOK1378_1mm";"SILVA (only NR);Eukaryota;Amorphea;Obazoa;Opisthokonta;Nucletmycea;Fungi;Dikarya;Ascomycota;Pezizomycotina;Sordariomycetes;Hypocreales;Stachybotryaceae;Xepicula;";"0.0";"0";"1";"1";"0";"1";"0";"430523";"5766"
"LOK1378_1mm";"SILVA (only NR);Eukaryota;Amorphea;Obazoa;Opisthokonta;Nucletmycea;Fungi;Dikarya;Ascomycota;Pezizomycotina;Sordariomycetes;Hypocreales;Ustilaginoidea;";"0.0";"0";"3";"2";"0";"2";"1";"430522";"5766"
"LOK1378_1mm";"SILVA (only NR);Eukaryota;Amorphea;Obazoa;Opisthokonta;Nucletmycea;Fungi;Dikarya;Ascomycota;Pezizomycotina;Sordariomycetes;Hypocreales;uncultured;";"0.0";"0";"2";"2";"0";"2";"0";"430522";"5766"
"LOK1378_1mm";"SILVA (only NR);Eukaryota;Amorphea;Obazoa;Opisthokonta;Nucletmycea;Fungi;Dikarya;Ascomycota;Pezizomycotina;Sordariomycetes;Incertae Sedis;";"0.0";"0";"37";"29";"0";"29";"8";"430495";"5766"
"LOK1378_1mm";"SILVA (only NR);Eukaryota;Amorphea;Obazoa;Opisthokonta;Nucletmycea;Fungi;Dikarya;Ascomycota;Pezizomycotina;Sordariomycetes;Incertae Sedis;Calcarisporium;";"0.0";"0";"2";"2";"0";"2";"0";"430522";"5766"
"LOK1378_1mm";"SILVA (only NR);Eukaryota;Amorphea;Obazoa;Opisthokonta;Nucletmycea;Fungi;Dikarya;Ascomycota;Pezizomycotina;Sordariomycetes;Incertae Sedis;Etheirophoraceae;";"0.0";"0";"1";"1";"0";"1";"0";"430523";"5766"
"LOK1378_1mm";"SILVA (only NR);Eukaryota;Amorphea;Obazoa;Opisthokonta;Nucletmycea;Fungi;Dikarya;Ascomycota;Pezizomycotina;Sordariomycetes;Incertae Sedis;Etheirophoraceae;Etheirophora;";"0.0";"0";"1";"1";"0";"1";"0";"430523";"5766"
"LOK1378_1mm";"SILVA (only NR);Eukaryota;Amorphea;Obazoa;Opisthokonta;Nucletmycea;Fungi;Dikarya;Ascomycota;Pezizomycotina;Sordariomycetes;Incertae Sedis;Incertae Sedis;";"0.0";"0";"27";"20";"0";"20";"7";"430504";"5766"
"LOK1378_1mm";"SILVA (only NR);Eukaryota;Amorphea;Obazoa;Opisthokonta;Nucletmycea;Fungi;Dikarya;Ascomycota;Pezizomycotina;Sordariomycetes;Incertae Sedis;Incertae Sedis;Asteroma;";"0.0";"0";"1";"1";"0";"1";"0";"430523";"5766"
"LOK1378_1mm";"SILVA (only NR);Eukaryota;Amorphea;Obazoa;Opisthokonta;Nucletmycea;Fungi;Dikarya;Ascomycota;Pezizomycotina;Sordariomycetes;Incertae Sedis;Incertae Sedis;Atractospora;";"0.0";"0";"1";"1";"0";"1";"0";"430523";"5766"
"LOK1378_1mm";"SILVA (only NR);Eukaryota;Amorphea;Obazoa;Opisthokonta;Nucletmycea;Fungi;Dikarya;Ascomycota;Pezizomycotina;Sordariomycetes;Incertae Sedis;Incertae Sedis;Bahusakala;";"0.0";"0";"1";"1";"0";"1";"0";"430523";"5766"
"LOK1378_1mm";"SILVA (only NR);Eukaryota;Amorphea;Obazoa;Opisthokonta;Nucletmycea;Fungi;Dikarya;Ascomycota;Pezizomycotina;Sordariomycetes;Incertae Sedis;Incertae Sedis;Barbatosphaeria;";"0.0";"0";"2";"2";"0";"2";"0";"430522";"5766"
"LOK1378_1mm";"SILVA (only NR);Eukaryota;Amorphea;Obazoa;Opisthokonta;Nucletmycea;Fungi;Dikarya;Ascomycota;Pezizomycotina;Sordariomycetes;Incertae Sedis;Incertae Sedis;Canalisporium;";"0.0";"0";"2";"0";"0";"0";"2";"430524";"5766"
"LOK1378_1mm";"SILVA (only NR);Eukaryota;Amorphea;Obazoa;Opisthokonta;Nucletmycea;Fungi;Dikarya;Ascomycota;Pezizomycotina;Sordariomycetes;Incertae Sedis;Incertae Sedis;Ceratolenta;";"0.0";"0";"1";"0";"0";"0";"1";"430524";"5766"
"LOK1378_1mm";"SILVA (only NR);Eukaryota;Amorphea;Obazoa;Opisthokonta;Nucletmycea;Fungi;Dikarya;Ascomycota;Pezizomycotina;Sordariomycetes;Incertae Sedis;Incertae Sedis;Ceratostomella;";"0.0";"0";"2";"2";"0";"2";"0";"430522";"5766"
"LOK1378_1mm";"SILVA (only NR);Eukaryota;Amorphea;Obazoa;Opisthokonta;Nucletmycea;Fungi;Dikarya;Ascomycota;Pezizomycotina;Sordariomycetes;Incertae Sedis;Incertae Sedis;Flammispora;";"0.0";"0";"2";"1";"0";"1";"1";"430523";"5766"
"LOK1378_1mm";"SILVA (only NR);Eukaryota;Amorphea;Obazoa;Opisthokonta;Nucletmycea;Fungi;Dikarya;Ascomycota;Pezizomycotina;Sordariomycetes;Incertae Sedis;Incertae Sedis;Infundibulomyces;";"0.0";"0";"2";"0";"0";"0";"2";"430524";"5766"
"LOK1378_1mm";"SILVA (only NR);Eukaryota;Amorphea;Obazoa;Opisthokonta;Nucletmycea;Fungi;Dikarya;Ascomycota;Pezizomycotina;Sordariomycetes;Incertae Sedis;Incertae Sedis;Lentomitella;";"0.0";"0";"2";"2";"0";"2";"0";"430522";"5766"
"LOK1378_1mm";"SILVA (only NR);Eukaryota;Amorphea;Obazoa;Opisthokonta;Nucletmycea;Fungi;Dikarya;Ascomycota;Pezizomycotina;Sordariomycetes;Incertae Sedis;Incertae Sedis;Lunulospora;";"0.0";"0";"1";"1";"0";"1";"0";"430523";"5766"
"LOK1378_1mm";"SILVA (only NR);Eukaryota;Amorphea;Obazoa;Opisthokonta;Nucletmycea;Fungi;Dikarya;Ascomycota;Pezizomycotina;Sordariomycetes;Incertae Sedis;Incertae Sedis;Orbimyces;";"0.0";"0";"1";"1";"0";"1";"0";"430523";"5766"
"LOK1378_1mm";"SILVA (only NR);Eukaryota;Amorphea;Obazoa;Opisthokonta;Nucletmycea;Fungi;Dikarya;Ascomycota;Pezizomycotina;Sordariomycetes;Incertae Sedis;Incertae Sedis;Platytrachelon;";"0.0";"0";"1";"1";"0";"1";"0";"430523";"5766"
"LOK1378_1mm";"SILVA (only NR);Eukaryota;Amorphea;Obazoa;Opisthokonta;Nucletmycea;Fungi;Dikarya;Ascomycota;Pezizomycotina;Sordariomycetes;Incertae Sedis;Incertae Sedis;Rhodoveronaea;";"0.0";"0";"1";"1";"0";"1";"0";"430523";"5766"
"LOK1378_1mm";"SILVA (only NR);Eukaryota;Amorphea;Obazoa;Opisthokonta;Nucletmycea;Fungi;Dikarya;Ascomycota;Pezizomycotina;Sordariomycetes;Incertae Sedis;Incertae Sedis;Rubellisphaeria;";"0.0";"0";"1";"1";"0";"1";"0";"430523";"5766"
"LOK1378_1mm";"SILVA (only NR);Eukaryota;Amorphea;Obazoa;Opisthokonta;Nucletmycea;Fungi;Dikarya;Ascomycota;Pezizomycotina;Sordariomycetes;Incertae Sedis;Incertae Sedis;Woswasia;";"0.0";"0";"1";"1";"0";"1";"0";"430523";"5766"
"LOK1378_1mm";"SILVA (only NR);Eukaryota;Amorphea;Obazoa;Opisthokonta;Nucletmycea;Fungi;Dikarya;Ascomycota;Pezizomycotina;Sordariomycetes;Incertae Sedis;Incertae Sedis;Xylochrysis;";"0.0";"0";"1";"1";"0";"1";"0";"430523";"5766"
"LOK1378_1mm";"SILVA (only NR);Eukaryota;Amorphea;Obazoa;Opisthokonta;Nucletmycea;Fungi;Dikarya;Ascomycota;Pezizomycotina;Sordariomycetes;Incertae Sedis;Incertae Sedis;Xylomelasma;";"0.0";"0";"3";"2";"0";"2";"1";"430522";"5766"
"LOK1378_1mm";"SILVA (only NR);Eukaryota;Amorphea;Obazoa;Opisthokonta;Nucletmycea;Fungi;Dikarya;Ascomycota;Pezizomycotina;Sordariomycetes;Incertae Sedis;Papulosaceae;";"0.0";"0";"2";"1";"0";"1";"1";"430523";"5766"
"LOK1378_1mm";"SILVA (only NR);Eukaryota;Amorphea;Obazoa;Opisthokonta;Nucletmycea;Fungi;Dikarya;Ascomycota;Pezizomycotina;Sordariomycetes;Incertae Sedis;Papulosaceae;Papulosa;";"0.0";"0";"2";"1";"0";"1";"1";"430523";"5766"
"LOK1378_1mm";"SILVA (only NR);Eukaryota;Amorphea;Obazoa;Opisthokonta;Nucletmycea;Fungi;Dikarya;Ascomycota;Pezizomycotina;Sordariomycetes;Incertae Sedis;Thyridiaceae;";"0.0";"0";"1";"1";"0";"1";"0";"430523";"5766"
"LOK1378_1mm";"SILVA (only NR);Eukaryota;Amorphea;Obazoa;Opisthokonta;Nucletmycea;Fungi;Dikarya;Ascomycota;Pezizomycotina;Sordariomycetes;Incertae Sedis;Thyridiaceae;Thyridium;";"0.0";"0";"1";"1";"0";"1";"0";"430523";"5766"
"LOK1378_1mm";"SILVA (only NR);Eukaryota;Amorphea;Obazoa;Opisthokonta;Nucletmycea;Fungi;Dikarya;Ascomycota;Pezizomycotina;Sordariomycetes;Lulworthiales;";"0.0";"0";"23";"23";"0";"23";"0";"430501";"5766"
"LOK1378_1mm";"SILVA (only NR);Eukaryota;Amorphea;Obazoa;Opisthokonta;Nucletmycea;Fungi;Dikarya;Ascomycota;Pezizomycotina;Sordariomycetes;Lulworthiales;Lulworthiaceae;";"0.0";"0";"21";"21";"0";"21";"0";"430503";"5766"
"LOK1378_1mm";"SILVA (only NR);Eukaryota;Amorphea;Obazoa;Opisthokonta;Nucletmycea;Fungi;Dikarya;Ascomycota;Pezizomycotina;Sordariomycetes;Lulworthiales;Lulworthiaceae;Kohlmeyeriella;";"0.0";"0";"2";"2";"0";"2";"0";"430522";"5766"
"LOK1378_1mm";"SILVA (only NR);Eukaryota;Amorphea;Obazoa;Opisthokonta;Nucletmycea;Fungi;Dikarya;Ascomycota;Pezizomycotina;Sordariomycetes;Lulworthiales;Lulworthiaceae;Lindra;";"0.0";"0";"4";"4";"0";"4";"0";"430520";"5766"
"LOK1378_1mm";"SILVA (only NR);Eukaryota;Amorphea;Obazoa;Opisthokonta;Nucletmycea;Fungi;Dikarya;Ascomycota;Pezizomycotina;Sordariomycetes;Lulworthiales;Lulworthiaceae;Lulwoana;";"0.0";"0";"2";"2";"0";"2";"0";"430522";"5766"
"LOK1378_1mm";"SILVA (only NR);Eukaryota;Amorphea;Obazoa;Opisthokonta;Nucletmycea;Fungi;Dikarya;Ascomycota;Pezizomycotina;Sordariomycetes;Lulworthiales;Lulworthiaceae;Lulwoidea;";"0.0";"0";"3";"3";"0";"3";"0";"430521";"5766"
"LOK1378_1mm";"SILVA (only NR);Eukaryota;Amorphea;Obazoa;Opisthokonta;Nucletmycea;Fungi;Dikarya;Ascomycota;Pezizomycotina;Sordariomycetes;Lulworthiales;Lulworthiaceae;Lulworthia;";"0.0";"0";"8";"8";"0";"8";"0";"430516";"5766"
"LOK1378_1mm";"SILVA (only NR);Eukaryota;Amorphea;Obazoa;Opisthokonta;Nucletmycea;Fungi;Dikarya;Ascomycota;Pezizomycotina;Sordariomycetes;Lulworthiales;Spathulosporaceae;";"0.0";"0";"2";"2";"0";"2";"0";"430522";"5766"
"LOK1378_1mm";"SILVA (only NR);Eukaryota;Amorphea;Obazoa;Opisthokonta;Nucletmycea;Fungi;Dikarya;Ascomycota;Pezizomycotina;Sordariomycetes;Lulworthiales;Spathulosporaceae;Spathulospora;";"0.0";"0";"2";"2";"0";"2";"0";"430522";"5766"
"LOK1378_1mm";"SILVA (only NR);Eukaryota;Amorphea;Obazoa;Opisthokonta;Nucletmycea;Fungi;Dikarya;Ascomycota;Pezizomycotina;Sordariomycetes;Magnaporthales;";"0.0";"0";"6";"6";"0";"6";"0";"430518";"5766"
"LOK1378_1mm";"SILVA (only NR);Eukaryota;Amorphea;Obazoa;Opisthokonta;Nucletmycea;Fungi;Dikarya;Ascomycota;Pezizomycotina;Sordariomycetes;Magnaporthales;Magnaporthaceae;";"0.0";"0";"6";"6";"0";"6";"0";"430518";"5766"
"LOK1378_1mm";"SILVA (only NR);Eukaryota;Amorphea;Obazoa;Opisthokonta;Nucletmycea;Fungi;Dikarya;Ascomycota;Pezizomycotina;Sordariomycetes;Magnaporthales;Magnaporthaceae;Ceratosphaeria;";"0.0";"0";"1";"1";"0";"1";"0";"430523";"5766"
"LOK1378_1mm";"SILVA (only NR);Eukaryota;Amorphea;Obazoa;Opisthokonta;Nucletmycea;Fungi;Dikarya;Ascomycota;Pezizomycotina;Sordariomycetes;Magnaporthales;Magnaporthaceae;Kohlmeyeriopsis;";"0.0";"0";"1";"1";"0";"1";"0";"430523";"5766"
"LOK1378_1mm";"SILVA (only NR);Eukaryota;Amorphea;Obazoa;Opisthokonta;Nucletmycea;Fungi;Dikarya;Ascomycota;Pezizomycotina;Sordariomycetes;Magnaporthales;Magnaporthaceae;Magnaporthe;";"0.0";"0";"1";"1";"0";"1";"0";"430523";"5766"
"LOK1378_1mm";"SILVA (only NR);Eukaryota;Amorphea;Obazoa;Opisthokonta;Nucletmycea;Fungi;Dikarya;Ascomycota;Pezizomycotina;Sordariomycetes;Magnaporthales;Magnaporthaceae;Ophioceras;";"0.0";"0";"1";"1";"0";"1";"0";"430523";"5766"
"LOK1378_1mm";"SILVA (only NR);Eukaryota;Amorphea;Obazoa;Opisthokonta;Nucletmycea;Fungi;Dikarya;Ascomycota;Pezizomycotina;Sordariomycetes;Magnaporthales;Magnaporthaceae;Pseudohalonectria;";"0.0";"0";"1";"1";"0";"1";"0";"430523";"5766"
"LOK1378_1mm";"SILVA (only NR);Eukaryota;Amorphea;Obazoa;Opisthokonta;Nucletmycea;Fungi;Dikarya;Ascomycota;Pezizomycotina;Sordariomycetes;Meliolales;";"0.0";"0";"2";"2";"0";"2";"0";"430522";"5766"
"LOK1378_1mm";"SILVA (only NR);Eukaryota;Amorphea;Obazoa;Opisthokonta;Nucletmycea;Fungi;Dikarya;Ascomycota;Pezizomycotina;Sordariomycetes;Meliolales;Meliolaceae;";"0.0";"0";"2";"2";"0";"2";"0";"430522";"5766"
"LOK1378_1mm";"SILVA (only NR);Eukaryota;Amorphea;Obazoa;Opisthokonta;Nucletmycea;Fungi;Dikarya;Ascomycota;Pezizomycotina;Sordariomycetes;Meliolales;Meliolaceae;Meliola;";"0.0";"0";"2";"2";"0";"2";"0";"430522";"5766"
"LOK1378_1mm";"SILVA (only NR);Eukaryota;Amorphea;Obazoa;Opisthokonta;Nucletmycea;Fungi;Dikarya;Ascomycota;Pezizomycotina;Sordariomycetes;Microascales;";"0.0";"0";"83";"68";"0";"68";"15";"430456";"5766"
"LOK1378_1mm";"SILVA (only NR);Eukaryota;Amorphea;Obazoa;Opisthokonta;Nucletmycea;Fungi;Dikarya;Ascomycota;Pezizomycotina;Sordariomycetes;Microascales;Cephalotrichiella;";"0.0";"0";"1";"1";"0";"1";"0";"430523";"5766"
"LOK1378_1mm";"SILVA (only NR);Eukaryota;Amorphea;Obazoa;Opisthokonta;Nucletmycea;Fungi;Dikarya;Ascomycota;Pezizomycotina;Sordariomycetes;Microascales;Ceratocystidaceae;";"0.0";"0";"6";"5";"0";"5";"1";"430519";"5766"
"LOK1378_1mm";"SILVA (only NR);Eukaryota;Amorphea;Obazoa;Opisthokonta;Nucletmycea;Fungi;Dikarya;Ascomycota;Pezizomycotina;Sordariomycetes;Microascales;Ceratocystidaceae;Ambrosiella;";"0.0";"0";"2";"1";"0";"1";"1";"430523";"5766"
"LOK1378_1mm";"SILVA (only NR);Eukaryota;Amorphea;Obazoa;Opisthokonta;Nucletmycea;Fungi;Dikarya;Ascomycota;Pezizomycotina;Sordariomycetes;Microascales;Ceratocystidaceae;Ceratocystis;";"0.0";"0";"1";"1";"0";"1";"0";"430523";"5766"
"LOK1378_1mm";"SILVA (only NR);Eukaryota;Amorphea;Obazoa;Opisthokonta;Nucletmycea;Fungi;Dikarya;Ascomycota;Pezizomycotina;Sordariomycetes;Microascales;Ceratocystidaceae;Huntiella;";"0.0";"0";"1";"1";"0";"1";"0";"430523";"5766"
"LOK1378_1mm";"SILVA (only NR);Eukaryota;Amorphea;Obazoa;Opisthokonta;Nucletmycea;Fungi;Dikarya;Ascomycota;Pezizomycotina;Sordariomycetes;Microascales;Ceratocystidaceae;Phialophoropsis;";"0.0";"0";"1";"1";"0";"1";"0";"430523";"5766"
"LOK1378_1mm";"SILVA (only NR);Eukaryota;Amorphea;Obazoa;Opisthokonta;Nucletmycea;Fungi;Dikarya;Ascomycota;Pezizomycotina;Sordariomycetes;Microascales;Graphiaceae;";"0.0";"0";"14";"12";"0";"12";"2";"430512";"5766"
"LOK1378_1mm";"SILVA (only NR);Eukaryota;Amorphea;Obazoa;Opisthokonta;Nucletmycea;Fungi;Dikarya;Ascomycota;Pezizomycotina;Sordariomycetes;Microascales;Graphiaceae;Graphium;";"0.0";"0";"14";"12";"0";"12";"2";"430512";"5766"
"LOK1378_1mm";"SILVA (only NR);Eukaryota;Amorphea;Obazoa;Opisthokonta;Nucletmycea;Fungi;Dikarya;Ascomycota;Pezizomycotina;Sordariomycetes;Microascales;Halosphaeriaceae;";"0.0";"0";"32";"24";"0";"24";"8";"430500";"5766"
"LOK1378_1mm";"SILVA (only NR);Eukaryota;Amorphea;Obazoa;Opisthokonta;Nucletmycea;Fungi;Dikarya;Ascomycota;Pezizomycotina;Sordariomycetes;Microascales;Halosphaeriaceae;Cirrenalia;";"0.0";"0";"2";"1";"0";"1";"1";"430523";"5766"
"LOK1378_1mm";"SILVA (only NR);Eukaryota;Amorphea;Obazoa;Opisthokonta;Nucletmycea;Fungi;Dikarya;Ascomycota;Pezizomycotina;Sordariomycetes;Microascales;Halosphaeriaceae;Corollospora;";"0.0";"0";"12";"10";"0";"10";"2";"430514";"5766"
"LOK1378_1mm";"SILVA (only NR);Eukaryota;Amorphea;Obazoa;Opisthokonta;Nucletmycea;Fungi;Dikarya;Ascomycota;Pezizomycotina;Sordariomycetes;Microascales;Halosphaeriaceae;Halosarpheia;";"0.0";"0";"1";"1";"0";"1";"0";"430523";"5766"
"LOK1378_1mm";"SILVA (only NR);Eukaryota;Amorphea;Obazoa;Opisthokonta;Nucletmycea;Fungi;Dikarya;Ascomycota;Pezizomycotina;Sordariomycetes;Microascales;Halosphaeriaceae;Lignincola;";"0.0";"0";"1";"0";"0";"0";"1";"430524";"5766"
"LOK1378_1mm";"SILVA (only NR);Eukaryota;Amorphea;Obazoa;Opisthokonta;Nucletmycea;Fungi;Dikarya;Ascomycota;Pezizomycotina;Sordariomycetes;Microascales;Halosphaeriaceae;Magnisphaera;";"0.0";"0";"1";"1";"0";"1";"0";"430523";"5766"
"LOK1378_1mm";"SILVA (only NR);Eukaryota;Amorphea;Obazoa;Opisthokonta;Nucletmycea;Fungi;Dikarya;Ascomycota;Pezizomycotina;Sordariomycetes;Microascales;Halosphaeriaceae;Natantispora;";"0.0";"0";"3";"3";"0";"3";"0";"430521";"5766"
"LOK1378_1mm";"SILVA (only NR);Eukaryota;Amorphea;Obazoa;Opisthokonta;Nucletmycea;Fungi;Dikarya;Ascomycota;Pezizomycotina;Sordariomycetes;Microascales;Halosphaeriaceae;Oceanitis;";"0.0";"0";"1";"1";"0";"1";"0";"430523";"5766"
"LOK1378_1mm";"SILVA (only NR);Eukaryota;Amorphea;Obazoa;Opisthokonta;Nucletmycea;Fungi;Dikarya;Ascomycota;Pezizomycotina;Sordariomycetes;Microascales;Halosphaeriaceae;Panorbis;";"0.0";"0";"2";"2";"0";"2";"0";"430522";"5766"
"LOK1378_1mm";"SILVA (only NR);Eukaryota;Amorphea;Obazoa;Opisthokonta;Nucletmycea;Fungi;Dikarya;Ascomycota;Pezizomycotina;Sordariomycetes;Microascales;Halosphaeriaceae;Phaeonectriella;";"0.0";"0";"1";"1";"0";"1";"0";"430523";"5766"
"LOK1378_1mm";"SILVA (only NR);Eukaryota;Amorphea;Obazoa;Opisthokonta;Nucletmycea;Fungi;Dikarya;Ascomycota;Pezizomycotina;Sordariomycetes;Microascales;Halosphaeriaceae;Sigmoidea;";"0.0";"0";"1";"0";"0";"0";"1";"430524";"5766"
"LOK1378_1mm";"SILVA (only NR);Eukaryota;Amorphea;Obazoa;Opisthokonta;Nucletmycea;Fungi;Dikarya;Ascomycota;Pezizomycotina;Sordariomycetes;Microascales;Halosphaeriaceae;Trichocladium;";"0.0";"0";"1";"1";"0";"1";"0";"430523";"5766"
"LOK1378_1mm";"SILVA (only NR);Eukaryota;Amorphea;Obazoa;Opisthokonta;Nucletmycea;Fungi;Dikarya;Ascomycota;Pezizomycotina;Sordariomycetes;Microascales;Incertae Sedis;";"0.0";"0";"2";"2";"0";"2";"0";"430522";"5766"
"LOK1378_1mm";"SILVA (only NR);Eukaryota;Amorphea;Obazoa;Opisthokonta;Nucletmycea;Fungi;Dikarya;Ascomycota;Pezizomycotina;Sordariomycetes;Microascales;Incertae Sedis;Gabarnaudia;";"0.0";"0";"1";"1";"0";"1";"0";"430523";"5766"
"LOK1378_1mm";"SILVA (only NR);Eukaryota;Amorphea;Obazoa;Opisthokonta;Nucletmycea;Fungi;Dikarya;Ascomycota;Pezizomycotina;Sordariomycetes;Microascales;Incertae Sedis;Sphaeronaemella;";"0.0";"0";"1";"1";"0";"1";"0";"430523";"5766"
"LOK1378_1mm";"SILVA (only NR);Eukaryota;Amorphea;Obazoa;Opisthokonta;Nucletmycea;Fungi;Dikarya;Ascomycota;Pezizomycotina;Sordariomycetes;Microascales;Knoxdaviesia;";"0.0";"0";"1";"1";"0";"1";"0";"430523";"5766"
"LOK1378_1mm";"SILVA (only NR);Eukaryota;Amorphea;Obazoa;Opisthokonta;Nucletmycea;Fungi;Dikarya;Ascomycota;Pezizomycotina;Sordariomycetes;Microascales;Microascaceae;";"0.0";"0";"23";"20";"0";"20";"3";"430504";"5766"
"LOK1378_1mm";"SILVA (only NR);Eukaryota;Amorphea;Obazoa;Opisthokonta;Nucletmycea;Fungi;Dikarya;Ascomycota;Pezizomycotina;Sordariomycetes;Microascales;Microascaceae;Basipetospora;";"0.0";"0";"1";"0";"0";"0";"1";"430524";"5766"
"LOK1378_1mm";"SILVA (only NR);Eukaryota;Amorphea;Obazoa;Opisthokonta;Nucletmycea;Fungi;Dikarya;Ascomycota;Pezizomycotina;Sordariomycetes;Microascales;Microascaceae;Brachyconidiellopsis;";"0.0";"0";"1";"1";"0";"1";"0";"430523";"5766"
"LOK1378_1mm";"SILVA (only NR);Eukaryota;Amorphea;Obazoa;Opisthokonta;Nucletmycea;Fungi;Dikarya;Ascomycota;Pezizomycotina;Sordariomycetes;Microascales;Microascaceae;Doratomyces;";"0.0";"0";"2";"1";"0";"1";"1";"430523";"5766"
"LOK1378_1mm";"SILVA (only NR);Eukaryota;Amorphea;Obazoa;Opisthokonta;Nucletmycea;Fungi;Dikarya;Ascomycota;Pezizomycotina;Sordariomycetes;Microascales;Microascaceae;Lomentospora;";"0.0";"0";"2";"2";"0";"2";"0";"430522";"5766"
"LOK1378_1mm";"SILVA (only NR);Eukaryota;Amorphea;Obazoa;Opisthokonta;Nucletmycea;Fungi;Dikarya;Ascomycota;Pezizomycotina;Sordariomycetes;Microascales;Microascaceae;Microascus;";"0.0";"0";"3";"3";"0";"3";"0";"430521";"5766"
"LOK1378_1mm";"SILVA (only NR);Eukaryota;Amorphea;Obazoa;Opisthokonta;Nucletmycea;Fungi;Dikarya;Ascomycota;Pezizomycotina;Sordariomycetes;Microascales;Microascaceae;Parascedosporium;";"0.0";"0";"5";"5";"0";"5";"0";"430519";"5766"
"LOK1378_1mm";"SILVA (only NR);Eukaryota;Amorphea;Obazoa;Opisthokonta;Nucletmycea;Fungi;Dikarya;Ascomycota;Pezizomycotina;Sordariomycetes;Microascales;Microascaceae;Petriella;";"0.0";"0";"2";"1";"0";"1";"1";"430523";"5766"
"LOK1378_1mm";"SILVA (only NR);Eukaryota;Amorphea;Obazoa;Opisthokonta;Nucletmycea;Fungi;Dikarya;Ascomycota;Pezizomycotina;Sordariomycetes;Microascales;Microascaceae;Pseudallescheria;";"0.0";"0";"1";"1";"0";"1";"0";"430523";"5766"
"LOK1378_1mm";"SILVA (only NR);Eukaryota;Amorphea;Obazoa;Opisthokonta;Nucletmycea;Fungi;Dikarya;Ascomycota;Pezizomycotina;Sordariomycetes;Microascales;Microascaceae;Scedosporium;";"0.0";"0";"2";"2";"0";"2";"0";"430522";"5766"
"LOK1378_1mm";"SILVA (only NR);Eukaryota;Amorphea;Obazoa;Opisthokonta;Nucletmycea;Fungi;Dikarya;Ascomycota;Pezizomycotina;Sordariomycetes;Microascales;Microascaceae;Scopulariopsis;";"0.0";"0";"1";"1";"0";"1";"0";"430523";"5766"
"LOK1378_1mm";"SILVA (only NR);Eukaryota;Amorphea;Obazoa;Opisthokonta;Nucletmycea;Fungi;Dikarya;Ascomycota;Pezizomycotina;Sordariomycetes;Microascales;Tubakiella;";"0.0";"0";"1";"0";"0";"0";"1";"430524";"5766"
"LOK1378_1mm";"SILVA (only NR);Eukaryota;Amorphea;Obazoa;Opisthokonta;Nucletmycea;Fungi;Dikarya;Ascomycota;Pezizomycotina;Sordariomycetes;Microascales;uncultured;";"0.0";"0";"2";"2";"0";"2";"0";"430522";"5766"
"LOK1378_1mm";"SILVA (only NR);Eukaryota;Amorphea;Obazoa;Opisthokonta;Nucletmycea;Fungi;Dikarya;Ascomycota;Pezizomycotina;Sordariomycetes;Myrmecridiales;";"0.0";"0";"2";"2";"0";"2";"0";"430522";"5766"
"LOK1378_1mm";"SILVA (only NR);Eukaryota;Amorphea;Obazoa;Opisthokonta;Nucletmycea;Fungi;Dikarya;Ascomycota;Pezizomycotina;Sordariomycetes;Myrmecridiales;Myrmecridiaceae;";"0.0";"0";"2";"2";"0";"2";"0";"430522";"5766"
"LOK1378_1mm";"SILVA (only NR);Eukaryota;Amorphea;Obazoa;Opisthokonta;Nucletmycea;Fungi;Dikarya;Ascomycota;Pezizomycotina;Sordariomycetes;Myrmecridiales;Myrmecridiaceae;Myrmecridium;";"0.0";"0";"2";"2";"0";"2";"0";"430522";"5766"
"LOK1378_1mm";"SILVA (only NR);Eukaryota;Amorphea;Obazoa;Opisthokonta;Nucletmycea;Fungi;Dikarya;Ascomycota;Pezizomycotina;Sordariomycetes;Ophiostomatales;";"0.0";"0";"39";"31";"0";"31";"8";"430493";"5766"
"LOK1378_1mm";"SILVA (only NR);Eukaryota;Amorphea;Obazoa;Opisthokonta;Nucletmycea;Fungi;Dikarya;Ascomycota;Pezizomycotina;Sordariomycetes;Ophiostomatales;Ophiostomataceae;";"0.0";"0";"39";"31";"0";"31";"8";"430493";"5766"
"LOK1378_1mm";"SILVA (only NR);Eukaryota;Amorphea;Obazoa;Opisthokonta;Nucletmycea;Fungi;Dikarya;Ascomycota;Pezizomycotina;Sordariomycetes;Ophiostomatales;Ophiostomataceae;Ceratocystiopsis;";"0.0";"0";"4";"4";"0";"4";"0";"430520";"5766"
"LOK1378_1mm";"SILVA (only NR);Eukaryota;Amorphea;Obazoa;Opisthokonta;Nucletmycea;Fungi;Dikarya;Ascomycota;Pezizomycotina;Sordariomycetes;Ophiostomatales;Ophiostomataceae;Fragosphaeria;";"0.0";"0";"2";"2";"0";"2";"0";"430522";"5766"
"LOK1378_1mm";"SILVA (only NR);Eukaryota;Amorphea;Obazoa;Opisthokonta;Nucletmycea;Fungi;Dikarya;Ascomycota;Pezizomycotina;Sordariomycetes;Ophiostomatales;Ophiostomataceae;Graphilbum;";"0.0";"0";"1";"1";"0";"1";"0";"430523";"5766"
"LOK1378_1mm";"SILVA (only NR);Eukaryota;Amorphea;Obazoa;Opisthokonta;Nucletmycea;Fungi;Dikarya;Ascomycota;Pezizomycotina;Sordariomycetes;Ophiostomatales;Ophiostomataceae;Grosmannia;";"0.0";"0";"4";"3";"0";"3";"1";"430521";"5766"
"LOK1378_1mm";"SILVA (only NR);Eukaryota;Amorphea;Obazoa;Opisthokonta;Nucletmycea;Fungi;Dikarya;Ascomycota;Pezizomycotina;Sordariomycetes;Ophiostomatales;Ophiostomataceae;Leptographium;";"0.0";"0";"1";"1";"0";"1";"0";"430523";"5766"
"LOK1378_1mm";"SILVA (only NR);Eukaryota;Amorphea;Obazoa;Opisthokonta;Nucletmycea;Fungi;Dikarya;Ascomycota;Pezizomycotina;Sordariomycetes;Ophiostomatales;Ophiostomataceae;Ophiostoma;";"0.0";"0";"10";"8";"0";"8";"2";"430516";"5766"
"LOK1378_1mm";"SILVA (only NR);Eukaryota;Amorphea;Obazoa;Opisthokonta;Nucletmycea;Fungi;Dikarya;Ascomycota;Pezizomycotina;Sordariomycetes;Ophiostomatales;Ophiostomataceae;Pesotum;";"0.0";"0";"1";"1";"0";"1";"0";"430523";"5766"
"LOK1378_1mm";"SILVA (only NR);Eukaryota;Amorphea;Obazoa;Opisthokonta;Nucletmycea;Fungi;Dikarya;Ascomycota;Pezizomycotina;Sordariomycetes;Ophiostomatales;Ophiostomataceae;Raffaelea;";"0.0";"0";"11";"6";"0";"6";"5";"430518";"5766"
"LOK1378_1mm";"SILVA (only NR);Eukaryota;Amorphea;Obazoa;Opisthokonta;Nucletmycea;Fungi;Dikarya;Ascomycota;Pezizomycotina;Sordariomycetes;Ophiostomatales;Ophiostomataceae;Sporothrix;";"0.0";"0";"2";"2";"0";"2";"0";"430522";"5766"
"LOK1378_1mm";"SILVA (only NR);Eukaryota;Amorphea;Obazoa;Opisthokonta;Nucletmycea;Fungi;Dikarya;Ascomycota;Pezizomycotina;Sordariomycetes;Phomatosporaceae;";"0.0";"0";"1";"1";"0";"1";"0";"430523";"5766"
"LOK1378_1mm";"SILVA (only NR);Eukaryota;Amorphea;Obazoa;Opisthokonta;Nucletmycea;Fungi;Dikarya;Ascomycota;Pezizomycotina;Sordariomycetes;Phomatosporaceae;Lanspora;";"0.0";"0";"1";"1";"0";"1";"0";"430523";"5766"
"LOK1378_1mm";"SILVA (only NR);Eukaryota;Amorphea;Obazoa;Opisthokonta;Nucletmycea;Fungi;Dikarya;Ascomycota;Pezizomycotina;Sordariomycetes;Phyllachorales;";"0.0";"0";"2";"2";"0";"2";"0";"430522";"5766"
"LOK1378_1mm";"SILVA (only NR);Eukaryota;Amorphea;Obazoa;Opisthokonta;Nucletmycea;Fungi;Dikarya;Ascomycota;Pezizomycotina;Sordariomycetes;Phyllachorales;Phyllachoraceae;";"0.0";"0";"2";"2";"0";"2";"0";"430522";"5766"
"LOK1378_1mm";"SILVA (only NR);Eukaryota;Amorphea;Obazoa;Opisthokonta;Nucletmycea;Fungi;Dikarya;Ascomycota;Pezizomycotina;Sordariomycetes;Phyllachorales;Phyllachoraceae;Haloguignardia;";"0.0";"0";"1";"1";"0";"1";"0";"430523";"5766"
"LOK1378_1mm";"SILVA (only NR);Eukaryota;Amorphea;Obazoa;Opisthokonta;Nucletmycea;Fungi;Dikarya;Ascomycota;Pezizomycotina;Sordariomycetes;Phyllachorales;Phyllachoraceae;Phyllachora;";"0.0";"0";"1";"1";"0";"1";"0";"430523";"5766"
"LOK1378_1mm";"SILVA (only NR);Eukaryota;Amorphea;Obazoa;Opisthokonta;Nucletmycea;Fungi;Dikarya;Ascomycota;Pezizomycotina;Sordariomycetes;Pisorisporiales;";"0.0";"0";"1";"1";"0";"1";"0";"430523";"5766"
"LOK1378_1mm";"SILVA (only NR);Eukaryota;Amorphea;Obazoa;Opisthokonta;Nucletmycea;Fungi;Dikarya;Ascomycota;Pezizomycotina;Sordariomycetes;Pisorisporiales;Incertae Sedis;";"0.0";"0";"1";"1";"0";"1";"0";"430523";"5766"
"LOK1378_1mm";"SILVA (only NR);Eukaryota;Amorphea;Obazoa;Opisthokonta;Nucletmycea;Fungi;Dikarya;Ascomycota;Pezizomycotina;Sordariomycetes;Pisorisporiales;Incertae Sedis;Achroceratosphaeria;";"0.0";"0";"1";"1";"0";"1";"0";"430523";"5766"
"LOK1378_1mm";"SILVA (only NR);Eukaryota;Amorphea;Obazoa;Opisthokonta;Nucletmycea;Fungi;Dikarya;Ascomycota;Pezizomycotina;Sordariomycetes;Pleurotheciales;";"0.0";"0";"8";"7";"0";"7";"1";"430517";"5766"
"LOK1378_1mm";"SILVA (only NR);Eukaryota;Amorphea;Obazoa;Opisthokonta;Nucletmycea;Fungi;Dikarya;Ascomycota;Pezizomycotina;Sordariomycetes;Pleurotheciales;Pleurotheciaceae;";"0.0";"0";"8";"7";"0";"7";"1";"430517";"5766"
"LOK1378_1mm";"SILVA (only NR);Eukaryota;Amorphea;Obazoa;Opisthokonta;Nucletmycea;Fungi;Dikarya;Ascomycota;Pezizomycotina;Sordariomycetes;Pleurotheciales;Pleurotheciaceae;Parafuscospora;";"0.0";"0";"1";"0";"0";"0";"1";"430524";"5766"
"LOK1378_1mm";"SILVA (only NR);Eukaryota;Amorphea;Obazoa;Opisthokonta;Nucletmycea;Fungi;Dikarya;Ascomycota;Pezizomycotina;Sordariomycetes;Pleurotheciales;Pleurotheciaceae;Phaeoisaria;";"0.0";"0";"1";"1";"0";"1";"0";"430523";"5766"
"LOK1378_1mm";"SILVA (only NR);Eukaryota;Amorphea;Obazoa;Opisthokonta;Nucletmycea;Fungi;Dikarya;Ascomycota;Pezizomycotina;Sordariomycetes;Pleurotheciales;Pleurotheciaceae;Plagiascoma;";"0.0";"0";"1";"1";"0";"1";"0";"430523";"5766"
"LOK1378_1mm";"SILVA (only NR);Eukaryota;Amorphea;Obazoa;Opisthokonta;Nucletmycea;Fungi;Dikarya;Ascomycota;Pezizomycotina;Sordariomycetes;Pleurotheciales;Pleurotheciaceae;Pleurotheciella;";"0.0";"0";"1";"1";"0";"1";"0";"430523";"5766"
"LOK1378_1mm";"SILVA (only NR);Eukaryota;Amorphea;Obazoa;Opisthokonta;Nucletmycea;Fungi;Dikarya;Ascomycota;Pezizomycotina;Sordariomycetes;Pleurotheciales;Pleurotheciaceae;Pleurothecium;";"0.0";"0";"4";"4";"0";"4";"0";"430520";"5766"
"LOK1378_1mm";"SILVA (only NR);Eukaryota;Amorphea;Obazoa;Opisthokonta;Nucletmycea;Fungi;Dikarya;Ascomycota;Pezizomycotina;Sordariomycetes;Pontogeneia;";"0.0";"0";"1";"1";"0";"1";"0";"430523";"5766"
"LOK1378_1mm";"SILVA (only NR);Eukaryota;Amorphea;Obazoa;Opisthokonta;Nucletmycea;Fungi;Dikarya;Ascomycota;Pezizomycotina;Sordariomycetes;Savoryellales;";"0.0";"0";"10";"1";"0";"1";"9";"430523";"5766"
"LOK1378_1mm";"SILVA (only NR);Eukaryota;Amorphea;Obazoa;Opisthokonta;Nucletmycea;Fungi;Dikarya;Ascomycota;Pezizomycotina;Sordariomycetes;Savoryellales;Incertae Sedis;";"0.0";"0";"10";"1";"0";"1";"9";"430523";"5766"
"LOK1378_1mm";"SILVA (only NR);Eukaryota;Amorphea;Obazoa;Opisthokonta;Nucletmycea;Fungi;Dikarya;Ascomycota;Pezizomycotina;Sordariomycetes;Savoryellales;Incertae Sedis;Ascotaiwania;";"0.0";"0";"2";"1";"0";"1";"1";"430523";"5766"
"LOK1378_1mm";"SILVA (only NR);Eukaryota;Amorphea;Obazoa;Opisthokonta;Nucletmycea;Fungi;Dikarya;Ascomycota;Pezizomycotina;Sordariomycetes;Savoryellales;Incertae Sedis;Savoryella;";"0.0";"0";"8";"0";"0";"0";"8";"430524";"5766"
"LOK1378_1mm";"SILVA (only NR);Eukaryota;Amorphea;Obazoa;Opisthokonta;Nucletmycea;Fungi;Dikarya;Ascomycota;Pezizomycotina;Sordariomycetes;Sordariales;";"0.0";"0";"49";"42";"0";"42";"7";"430482";"5766"
"LOK1378_1mm";"SILVA (only NR);Eukaryota;Amorphea;Obazoa;Opisthokonta;Nucletmycea;Fungi;Dikarya;Ascomycota;Pezizomycotina;Sordariomycetes;Sordariales;Cephalothecaceae;";"0.0";"0";"8";"7";"0";"7";"1";"430517";"5766"
"LOK1378_1mm";"SILVA (only NR);Eukaryota;Amorphea;Obazoa;Opisthokonta;Nucletmycea;Fungi;Dikarya;Ascomycota;Pezizomycotina;Sordariomycetes;Sordariales;Cephalothecaceae;Albertiniella;";"0.0";"0";"2";"2";"0";"2";"0";"430522";"5766"
"LOK1378_1mm";"SILVA (only NR);Eukaryota;Amorphea;Obazoa;Opisthokonta;Nucletmycea;Fungi;Dikarya;Ascomycota;Pezizomycotina;Sordariomycetes;Sordariales;Cephalothecaceae;Cephalotheca;";"0.0";"0";"2";"2";"0";"2";"0";"430522";"5766"
"LOK1378_1mm";"SILVA (only NR);Eukaryota;Amorphea;Obazoa;Opisthokonta;Nucletmycea;Fungi;Dikarya;Ascomycota;Pezizomycotina;Sordariomycetes;Sordariales;Cephalothecaceae;Phialemonium;";"0.0";"0";"4";"3";"0";"3";"1";"430521";"5766"
"LOK1378_1mm";"SILVA (only NR);Eukaryota;Amorphea;Obazoa;Opisthokonta;Nucletmycea;Fungi;Dikarya;Ascomycota;Pezizomycotina;Sordariomycetes;Sordariales;Chaetomiaceae;";"0.0";"0";"25";"21";"0";"21";"4";"430503";"5766"
"LOK1378_1mm";"SILVA (only NR);Eukaryota;Amorphea;Obazoa;Opisthokonta;Nucletmycea;Fungi;Dikarya;Ascomycota;Pezizomycotina;Sordariomycetes;Sordariales;Chaetomiaceae;Chaetomium;";"0.0";"0";"17";"13";"0";"13";"4";"430511";"5766"
"LOK1378_1mm";"SILVA (only NR);Eukaryota;Amorphea;Obazoa;Opisthokonta;Nucletmycea;Fungi;Dikarya;Ascomycota;Pezizomycotina;Sordariomycetes;Sordariales;Chaetomiaceae;Corynascus;";"0.0";"0";"1";"1";"0";"1";"0";"430523";"5766"
"LOK1378_1mm";"SILVA (only NR);Eukaryota;Amorphea;Obazoa;Opisthokonta;Nucletmycea;Fungi;Dikarya;Ascomycota;Pezizomycotina;Sordariomycetes;Sordariales;Chaetomiaceae;Humicola;";"0.0";"0";"2";"2";"0";"2";"0";"430522";"5766"
"LOK1378_1mm";"SILVA (only NR);Eukaryota;Amorphea;Obazoa;Opisthokonta;Nucletmycea;Fungi;Dikarya;Ascomycota;Pezizomycotina;Sordariomycetes;Sordariales;Chaetomiaceae;Melanocarpus;";"0.0";"0";"1";"1";"0";"1";"0";"430523";"5766"
"LOK1378_1mm";"SILVA (only NR);Eukaryota;Amorphea;Obazoa;Opisthokonta;Nucletmycea;Fungi;Dikarya;Ascomycota;Pezizomycotina;Sordariomycetes;Sordariales;Chaetomiaceae;Remersonia;";"0.0";"0";"1";"1";"0";"1";"0";"430523";"5766"
"LOK1378_1mm";"SILVA (only NR);Eukaryota;Amorphea;Obazoa;Opisthokonta;Nucletmycea;Fungi;Dikarya;Ascomycota;Pezizomycotina;Sordariomycetes;Sordariales;Chaetomiaceae;Thielavia;";"0.0";"0";"1";"1";"0";"1";"0";"430523";"5766"
"LOK1378_1mm";"SILVA (only NR);Eukaryota;Amorphea;Obazoa;Opisthokonta;Nucletmycea;Fungi;Dikarya;Ascomycota;Pezizomycotina;Sordariomycetes;Sordariales;Incertae Sedis;";"0.0";"0";"4";"4";"0";"4";"0";"430520";"5766"
"LOK1378_1mm";"SILVA (only NR);Eukaryota;Amorphea;Obazoa;Opisthokonta;Nucletmycea;Fungi;Dikarya;Ascomycota;Pezizomycotina;Sordariomycetes;Sordariales;Incertae Sedis;Kionochaeta;";"0.0";"0";"4";"4";"0";"4";"0";"430520";"5766"
"LOK1378_1mm";"SILVA (only NR);Eukaryota;Amorphea;Obazoa;Opisthokonta;Nucletmycea;Fungi;Dikarya;Ascomycota;Pezizomycotina;Sordariomycetes;Sordariales;Lasiosphaeriaceae;";"0.0";"0";"3";"2";"0";"2";"1";"430522";"5766"
"LOK1378_1mm";"SILVA (only NR);Eukaryota;Amorphea;Obazoa;Opisthokonta;Nucletmycea;Fungi;Dikarya;Ascomycota;Pezizomycotina;Sordariomycetes;Sordariales;Lasiosphaeriaceae;Ascovaginospora;";"0.0";"0";"1";"1";"0";"1";"0";"430523";"5766"
"LOK1378_1mm";"SILVA (only NR);Eukaryota;Amorphea;Obazoa;Opisthokonta;Nucletmycea;Fungi;Dikarya;Ascomycota;Pezizomycotina;Sordariomycetes;Sordariales;Lasiosphaeriaceae;Podospora;";"0.0";"0";"2";"1";"0";"1";"1";"430523";"5766"
"LOK1378_1mm";"SILVA (only NR);Eukaryota;Amorphea;Obazoa;Opisthokonta;Nucletmycea;Fungi;Dikarya;Ascomycota;Pezizomycotina;Sordariomycetes;Sordariales;Sordariaceae;";"0.0";"0";"3";"3";"0";"3";"0";"430521";"5766"
"LOK1378_1mm";"SILVA (only NR);Eukaryota;Amorphea;Obazoa;Opisthokonta;Nucletmycea;Fungi;Dikarya;Ascomycota;Pezizomycotina;Sordariomycetes;Sordariales;Sordariaceae;Neurospora;";"0.0";"0";"2";"2";"0";"2";"0";"430522";"5766"
"LOK1378_1mm";"SILVA (only NR);Eukaryota;Amorphea;Obazoa;Opisthokonta;Nucletmycea;Fungi;Dikarya;Ascomycota;Pezizomycotina;Sordariomycetes;Sordariales;Sordariaceae;Sordaria;";"0.0";"0";"1";"1";"0";"1";"0";"430523";"5766"
"LOK1378_1mm";"SILVA (only NR);Eukaryota;Amorphea;Obazoa;Opisthokonta;Nucletmycea;Fungi;Dikarya;Ascomycota;Pezizomycotina;Sordariomycetes;Sordariales;uncultured;";"0.0";"0";"4";"4";"0";"4";"0";"430520";"5766"
"LOK1378_1mm";"SILVA (only NR);Eukaryota;Amorphea;Obazoa;Opisthokonta;Nucletmycea;Fungi;Dikarya;Ascomycota;Pezizomycotina;Sordariomycetes;Togniniales;";"0.0";"0";"10";"10";"0";"10";"0";"430514";"5766"
"LOK1378_1mm";"SILVA (only NR);Eukaryota;Amorphea;Obazoa;Opisthokonta;Nucletmycea;Fungi;Dikarya;Ascomycota;Pezizomycotina;Sordariomycetes;Togniniales;Togniniaceae;";"0.0";"0";"10";"10";"0";"10";"0";"430514";"5766"
"LOK1378_1mm";"SILVA (only NR);Eukaryota;Amorphea;Obazoa;Opisthokonta;Nucletmycea;Fungi;Dikarya;Ascomycota;Pezizomycotina;Sordariomycetes;Togniniales;Togniniaceae;Phaeoacremonium;";"0.0";"0";"10";"10";"0";"10";"0";"430514";"5766"
"LOK1378_1mm";"SILVA (only NR);Eukaryota;Amorphea;Obazoa;Opisthokonta;Nucletmycea;Fungi;Dikarya;Ascomycota;Pezizomycotina;Sordariomycetes;Torpedosporales;";"0.0";"0";"4";"3";"0";"3";"1";"430521";"5766"
"LOK1378_1mm";"SILVA (only NR);Eukaryota;Amorphea;Obazoa;Opisthokonta;Nucletmycea;Fungi;Dikarya;Ascomycota;Pezizomycotina;Sordariomycetes;Torpedosporales;Torpedosporaceae;";"0.0";"0";"4";"3";"0";"3";"1";"430521";"5766"
"LOK1378_1mm";"SILVA (only NR);Eukaryota;Amorphea;Obazoa;Opisthokonta;Nucletmycea;Fungi;Dikarya;Ascomycota;Pezizomycotina;Sordariomycetes;Torpedosporales;Torpedosporaceae;Torpedospora;";"0.0";"0";"4";"3";"0";"3";"1";"430521";"5766"
"LOK1378_1mm";"SILVA (only NR);Eukaryota;Amorphea;Obazoa;Opisthokonta;Nucletmycea;Fungi;Dikarya;Ascomycota;Pezizomycotina;Sordariomycetes;Xylariales;";"0.0";"0";"114";"109";"0";"109";"5";"430415";"5766"
"LOK1378_1mm";"SILVA (only NR);Eukaryota;Amorphea;Obazoa;Opisthokonta;Nucletmycea;Fungi;Dikarya;Ascomycota;Pezizomycotina;Sordariomycetes;Xylariales;Amphisphaeriaceae;";"0.0";"0";"4";"4";"0";"4";"0";"430520";"5766"
"LOK1378_1mm";"SILVA (only NR);Eukaryota;Amorphea;Obazoa;Opisthokonta;Nucletmycea;Fungi;Dikarya;Ascomycota;Pezizomycotina;Sordariomycetes;Xylariales;Amphisphaeriaceae;Amphisphaeria;";"0.0";"0";"2";"2";"0";"2";"0";"430522";"5766"
"LOK1378_1mm";"SILVA (only NR);Eukaryota;Amorphea;Obazoa;Opisthokonta;Nucletmycea;Fungi;Dikarya;Ascomycota;Pezizomycotina;Sordariomycetes;Xylariales;Amphisphaeriaceae;Pestalosphaeria;";"0.0";"0";"1";"1";"0";"1";"0";"430523";"5766"
"LOK1378_1mm";"SILVA (only NR);Eukaryota;Amorphea;Obazoa;Opisthokonta;Nucletmycea;Fungi;Dikarya;Ascomycota;Pezizomycotina;Sordariomycetes;Xylariales;Amphisphaeriaceae;Pestalotia;";"0.0";"0";"1";"1";"0";"1";"0";"430523";"5766"
"LOK1378_1mm";"SILVA (only NR);Eukaryota;Amorphea;Obazoa;Opisthokonta;Nucletmycea;Fungi;Dikarya;Ascomycota;Pezizomycotina;Sordariomycetes;Xylariales;Apiosporaceae;";"0.0";"0";"42";"42";"0";"42";"0";"430482";"5766"
"LOK1378_1mm";"SILVA (only NR);Eukaryota;Amorphea;Obazoa;Opisthokonta;Nucletmycea;Fungi;Dikarya;Ascomycota;Pezizomycotina;Sordariomycetes;Xylariales;Apiosporaceae;Arthrinium;";"0.0";"0";"42";"42";"0";"42";"0";"430482";"5766"
"LOK1378_1mm";"SILVA (only NR);Eukaryota;Amorphea;Obazoa;Opisthokonta;Nucletmycea;Fungi;Dikarya;Ascomycota;Pezizomycotina;Sordariomycetes;Xylariales;Cainia;";"0.0";"0";"1";"1";"0";"1";"0";"430523";"5766"
"LOK1378_1mm";"SILVA (only NR);Eukaryota;Amorphea;Obazoa;Opisthokonta;Nucletmycea;Fungi;Dikarya;Ascomycota;Pezizomycotina;Sordariomycetes;Xylariales;Circinotrichum;";"0.0";"0";"1";"1";"0";"1";"0";"430523";"5766"
"LOK1378_1mm";"SILVA (only NR);Eukaryota;Amorphea;Obazoa;Opisthokonta;Nucletmycea;Fungi;Dikarya;Ascomycota;Pezizomycotina;Sordariomycetes;Xylariales;Diatrypaceae;";"0.0";"0";"8";"8";"0";"8";"0";"430516";"5766"
"LOK1378_1mm";"SILVA (only NR);Eukaryota;Amorphea;Obazoa;Opisthokonta;Nucletmycea;Fungi;Dikarya;Ascomycota;Pezizomycotina;Sordariomycetes;Xylariales;Diatrypaceae;Cryptovalsa;";"0.0";"0";"1";"1";"0";"1";"0";"430523";"5766"
"LOK1378_1mm";"SILVA (only NR);Eukaryota;Amorphea;Obazoa;Opisthokonta;Nucletmycea;Fungi;Dikarya;Ascomycota;Pezizomycotina;Sordariomycetes;Xylariales;Diatrypaceae;Diatrype;";"0.0";"0";"2";"2";"0";"2";"0";"430522";"5766"
"LOK1378_1mm";"SILVA (only NR);Eukaryota;Amorphea;Obazoa;Opisthokonta;Nucletmycea;Fungi;Dikarya;Ascomycota;Pezizomycotina;Sordariomycetes;Xylariales;Diatrypaceae;Eutypa;";"0.0";"0";"1";"1";"0";"1";"0";"430523";"5766"
"LOK1378_1mm";"SILVA (only NR);Eukaryota;Amorphea;Obazoa;Opisthokonta;Nucletmycea;Fungi;Dikarya;Ascomycota;Pezizomycotina;Sordariomycetes;Xylariales;Diatrypaceae;Melanospora;";"0.0";"0";"2";"2";"0";"2";"0";"430522";"5766"
"LOK1378_1mm";"SILVA (only NR);Eukaryota;Amorphea;Obazoa;Opisthokonta;Nucletmycea;Fungi;Dikarya;Ascomycota;Pezizomycotina;Sordariomycetes;Xylariales;Diatrypaceae;Sphaerodes;";"0.0";"0";"1";"1";"0";"1";"0";"430523";"5766"
"LOK1378_1mm";"SILVA (only NR);Eukaryota;Amorphea;Obazoa;Opisthokonta;Nucletmycea;Fungi;Dikarya;Ascomycota;Pezizomycotina;Sordariomycetes;Xylariales;Diatrypasimilis;";"0.0";"0";"1";"1";"0";"1";"0";"430523";"5766"
"LOK1378_1mm";"SILVA (only NR);Eukaryota;Amorphea;Obazoa;Opisthokonta;Nucletmycea;Fungi;Dikarya;Ascomycota;Pezizomycotina;Sordariomycetes;Xylariales;Hyponectria;";"0.0";"0";"2";"2";"0";"2";"0";"430522";"5766"
"LOK1378_1mm";"SILVA (only NR);Eukaryota;Amorphea;Obazoa;Opisthokonta;Nucletmycea;Fungi;Dikarya;Ascomycota;Pezizomycotina;Sordariomycetes;Xylariales;Incertae Sedis;";"0.0";"0";"4";"4";"0";"4";"0";"430520";"5766"
"LOK1378_1mm";"SILVA (only NR);Eukaryota;Amorphea;Obazoa;Opisthokonta;Nucletmycea;Fungi;Dikarya;Ascomycota;Pezizomycotina;Sordariomycetes;Xylariales;Incertae Sedis;Dicyma;";"0.0";"0";"1";"1";"0";"1";"0";"430523";"5766"
"LOK1378_1mm";"SILVA (only NR);Eukaryota;Amorphea;Obazoa;Opisthokonta;Nucletmycea;Fungi;Dikarya;Ascomycota;Pezizomycotina;Sordariomycetes;Xylariales;Incertae Sedis;Phialemoniopsis;";"0.0";"0";"1";"1";"0";"1";"0";"430523";"5766"
"LOK1378_1mm";"SILVA (only NR);Eukaryota;Amorphea;Obazoa;Opisthokonta;Nucletmycea;Fungi;Dikarya;Ascomycota;Pezizomycotina;Sordariomycetes;Xylariales;Incertae Sedis;Surculiseries;";"0.0";"0";"2";"2";"0";"2";"0";"430522";"5766"
"LOK1378_1mm";"SILVA (only NR);Eukaryota;Amorphea;Obazoa;Opisthokonta;Nucletmycea;Fungi;Dikarya;Ascomycota;Pezizomycotina;Sordariomycetes;Xylariales;Liberomyces;";"0.0";"0";"1";"1";"0";"1";"0";"430523";"5766"
"LOK1378_1mm";"SILVA (only NR);Eukaryota;Amorphea;Obazoa;Opisthokonta;Nucletmycea;Fungi;Dikarya;Ascomycota;Pezizomycotina;Sordariomycetes;Xylariales;Sporocadaceae;";"0.0";"0";"5";"5";"0";"5";"0";"430519";"5766"
"LOK1378_1mm";"SILVA (only NR);Eukaryota;Amorphea;Obazoa;Opisthokonta;Nucletmycea;Fungi;Dikarya;Ascomycota;Pezizomycotina;Sordariomycetes;Xylariales;Sporocadaceae;Pestalotiopsis;";"0.0";"0";"2";"2";"0";"2";"0";"430522";"5766"
"LOK1378_1mm";"SILVA (only NR);Eukaryota;Amorphea;Obazoa;Opisthokonta;Nucletmycea;Fungi;Dikarya;Ascomycota;Pezizomycotina;Sordariomycetes;Xylariales;Sporocadaceae;Seiridium;";"0.0";"0";"2";"2";"0";"2";"0";"430522";"5766"
"LOK1378_1mm";"SILVA (only NR);Eukaryota;Amorphea;Obazoa;Opisthokonta;Nucletmycea;Fungi;Dikarya;Ascomycota;Pezizomycotina;Sordariomycetes;Xylariales;Sporocadaceae;Truncatella;";"0.0";"0";"1";"1";"0";"1";"0";"430523";"5766"
"LOK1378_1mm";"SILVA (only NR);Eukaryota;Amorphea;Obazoa;Opisthokonta;Nucletmycea;Fungi;Dikarya;Ascomycota;Pezizomycotina;Sordariomycetes;Xylariales;Xylariaceae;";"0.0";"0";"38";"34";"0";"34";"4";"430490";"5766"
"LOK1378_1mm";"SILVA (only NR);Eukaryota;Amorphea;Obazoa;Opisthokonta;Nucletmycea;Fungi;Dikarya;Ascomycota;Pezizomycotina;Sordariomycetes;Xylariales;Xylariaceae;Anthostomella;";"0.0";"0";"1";"1";"0";"1";"0";"430523";"5766"
"LOK1378_1mm";"SILVA (only NR);Eukaryota;Amorphea;Obazoa;Opisthokonta;Nucletmycea;Fungi;Dikarya;Ascomycota;Pezizomycotina;Sordariomycetes;Xylariales;Xylariaceae;Ascotricha;";"0.0";"0";"3";"3";"0";"3";"0";"430521";"5766"
"LOK1378_1mm";"SILVA (only NR);Eukaryota;Amorphea;Obazoa;Opisthokonta;Nucletmycea;Fungi;Dikarya;Ascomycota;Pezizomycotina;Sordariomycetes;Xylariales;Xylariaceae;Barrmaelia;";"0.0";"0";"1";"1";"0";"1";"0";"430523";"5766"
"LOK1378_1mm";"SILVA (only NR);Eukaryota;Amorphea;Obazoa;Opisthokonta;Nucletmycea;Fungi;Dikarya;Ascomycota;Pezizomycotina;Sordariomycetes;Xylariales;Xylariaceae;Biscogniauxia;";"0.0";"0";"1";"1";"0";"1";"0";"430523";"5766"
"LOK1378_1mm";"SILVA (only NR);Eukaryota;Amorphea;Obazoa;Opisthokonta;Nucletmycea;Fungi;Dikarya;Ascomycota;Pezizomycotina;Sordariomycetes;Xylariales;Xylariaceae;Geniculisynnema;";"0.0";"0";"1";"1";"0";"1";"0";"430523";"5766"
"LOK1378_1mm";"SILVA (only NR);Eukaryota;Amorphea;Obazoa;Opisthokonta;Nucletmycea;Fungi;Dikarya;Ascomycota;Pezizomycotina;Sordariomycetes;Xylariales;Xylariaceae;Hypoxylon;";"0.0";"0";"11";"8";"0";"8";"3";"430516";"5766"
"LOK1378_1mm";"SILVA (only NR);Eukaryota;Amorphea;Obazoa;Opisthokonta;Nucletmycea;Fungi;Dikarya;Ascomycota;Pezizomycotina;Sordariomycetes;Xylariales;Xylariaceae;Kretzschmaria;";"0.0";"0";"1";"1";"0";"1";"0";"430523";"5766"
"LOK1378_1mm";"SILVA (only NR);Eukaryota;Amorphea;Obazoa;Opisthokonta;Nucletmycea;Fungi;Dikarya;Ascomycota;Pezizomycotina;Sordariomycetes;Xylariales;Xylariaceae;Muscodor;";"0.0";"0";"4";"4";"0";"4";"0";"430520";"5766"
"LOK1378_1mm";"SILVA (only NR);Eukaryota;Amorphea;Obazoa;Opisthokonta;Nucletmycea;Fungi;Dikarya;Ascomycota;Pezizomycotina;Sordariomycetes;Xylariales;Xylariaceae;Rosellinia;";"0.0";"0";"1";"1";"0";"1";"0";"430523";"5766"
"LOK1378_1mm";"SILVA (only NR);Eukaryota;Amorphea;Obazoa;Opisthokonta;Nucletmycea;Fungi;Dikarya;Ascomycota;Pezizomycotina;Sordariomycetes;Xylariales;Xylariaceae;Xylaria;";"0.0";"0";"7";"7";"0";"7";"0";"430517";"5766"
"LOK1378_1mm";"SILVA (only NR);Eukaryota;Amorphea;Obazoa;Opisthokonta;Nucletmycea;Fungi;Dikarya;Ascomycota;Pezizomycotina;Sordariomycetes;Xylariales;Xylariaceae;artificial;";"0.0";"0";"1";"1";"0";"1";"0";"430523";"5766"
"LOK1378_1mm";"SILVA (only NR);Eukaryota;Amorphea;Obazoa;Opisthokonta;Nucletmycea;Fungi;Dikarya;Ascomycota;Pezizomycotina;Sordariomycetes;uncultured;";"0.0";"0";"6";"6";"0";"6";"0";"430518";"5766"
"LOK1378_1mm";"SILVA (only NR);Eukaryota;Amorphea;Obazoa;Opisthokonta;Nucletmycea;Fungi;Dikarya;Ascomycota;Pezizomycotina;Xylobotryomycetes;";"0.0";"0";"3";"3";"0";"3";"0";"430521";"5766"
"LOK1378_1mm";"SILVA (only NR);Eukaryota;Amorphea;Obazoa;Opisthokonta;Nucletmycea;Fungi;Dikarya;Ascomycota;Pezizomycotina;Xylobotryomycetes;Xylobotryales;";"0.0";"0";"3";"3";"0";"3";"0";"430521";"5766"
"LOK1378_1mm";"SILVA (only NR);Eukaryota;Amorphea;Obazoa;Opisthokonta;Nucletmycea;Fungi;Dikarya;Ascomycota;Pezizomycotina;Xylobotryomycetes;Xylobotryales;Cirrosporium;";"0.0";"0";"1";"1";"0";"1";"0";"430523";"5766"
"LOK1378_1mm";"SILVA (only NR);Eukaryota;Amorphea;Obazoa;Opisthokonta;Nucletmycea;Fungi;Dikarya;Ascomycota;Pezizomycotina;Xylobotryomycetes;Xylobotryales;Xylobotryum;";"0.0";"0";"1";"1";"0";"1";"0";"430523";"5766"
"LOK1378_1mm";"SILVA (only NR);Eukaryota;Amorphea;Obazoa;Opisthokonta;Nucletmycea;Fungi;Dikarya;Ascomycota;Pezizomycotina;Xylonomycetes;";"0.0";"0";"5";"5";"0";"5";"0";"430519";"5766"
"LOK1378_1mm";"SILVA (only NR);Eukaryota;Amorphea;Obazoa;Opisthokonta;Nucletmycea;Fungi;Dikarya;Ascomycota;Pezizomycotina;Xylonomycetes;Incertae Sedis;";"0.0";"0";"4";"4";"0";"4";"0";"430520";"5766"
"LOK1378_1mm";"SILVA (only NR);Eukaryota;Amorphea;Obazoa;Opisthokonta;Nucletmycea;Fungi;Dikarya;Ascomycota;Pezizomycotina;Xylonomycetes;Incertae Sedis;Incertae Sedis;";"0.0";"0";"4";"4";"0";"4";"0";"430520";"5766"
"LOK1378_1mm";"SILVA (only NR);Eukaryota;Amorphea;Obazoa;Opisthokonta;Nucletmycea;Fungi;Dikarya;Ascomycota;Pezizomycotina;Xylonomycetes;Incertae Sedis;Incertae Sedis;Symbiotaphrina;";"0.0";"0";"4";"4";"0";"4";"0";"430520";"5766"
"LOK1378_1mm";"SILVA (only NR);Eukaryota;Amorphea;Obazoa;Opisthokonta;Nucletmycea;Fungi;Dikarya;Ascomycota;Pezizomycotina;Xylonomycetes;Xylonomycetales;";"0.0";"0";"1";"1";"0";"1";"0";"430523";"5766"
"LOK1378_1mm";"SILVA (only NR);Eukaryota;Amorphea;Obazoa;Opisthokonta;Nucletmycea;Fungi;Dikarya;Ascomycota;Pezizomycotina;Xylonomycetes;Xylonomycetales;Xylonomycetaceae;";"0.0";"0";"1";"1";"0";"1";"0";"430523";"5766"
"LOK1378_1mm";"SILVA (only NR);Eukaryota;Amorphea;Obazoa;Opisthokonta;Nucletmycea;Fungi;Dikarya;Ascomycota;Pezizomycotina;Xylonomycetes;Xylonomycetales;Xylonomycetaceae;Xylona;";"0.0";"0";"1";"1";"0";"1";"0";"430523";"5766"
"LOK1378_1mm";"SILVA (only NR);Eukaryota;Amorphea;Obazoa;Opisthokonta;Nucletmycea;Fungi;Dikarya;Ascomycota;Pezizomycotina;uncultured;";"0.0";"0";"8";"8";"0";"8";"0";"430516";"5766"
"LOK1378_1mm";"SILVA (only NR);Eukaryota;Amorphea;Obazoa;Opisthokonta;Nucletmycea;Fungi;Dikarya;Ascomycota;Saccharomycotina;";"0.0";"0";"1418";"1390";"0";"1390";"28";"429134";"5766"
"LOK1378_1mm";"SILVA (only NR);Eukaryota;Amorphea;Obazoa;Opisthokonta;Nucletmycea;Fungi;Dikarya;Ascomycota;Saccharomycotina;Saccharomycetes;";"0.0";"0";"1418";"1390";"0";"1390";"28";"429134";"5766"
"LOK1378_1mm";"SILVA (only NR);Eukaryota;Amorphea;Obazoa;Opisthokonta;Nucletmycea;Fungi;Dikarya;Ascomycota;Saccharomycotina;Saccharomycetes;Saccharomycetales;";"0.0";"0";"1418";"1390";"0";"1390";"28";"429134";"5766"
"LOK1378_1mm";"SILVA (only NR);Eukaryota;Amorphea;Obazoa;Opisthokonta;Nucletmycea;Fungi;Dikarya;Ascomycota;Saccharomycotina;Saccharomycetes;Saccharomycetales;Alloascoideaceae;";"0.0";"0";"2";"2";"0";"2";"0";"430522";"5766"
"LOK1378_1mm";"SILVA (only NR);Eukaryota;Amorphea;Obazoa;Opisthokonta;Nucletmycea;Fungi;Dikarya;Ascomycota;Saccharomycotina;Saccharomycetes;Saccharomycetales;Alloascoideaceae;Alloascoidea;";"0.0";"0";"2";"2";"0";"2";"0";"430522";"5766"
"LOK1378_1mm";"SILVA (only NR);Eukaryota;Amorphea;Obazoa;Opisthokonta;Nucletmycea;Fungi;Dikarya;Ascomycota;Saccharomycotina;Saccharomycetes;Saccharomycetales;Ascoideaceae;";"0.0";"0";"4";"4";"0";"4";"0";"430520";"5766"
"LOK1378_1mm";"SILVA (only NR);Eukaryota;Amorphea;Obazoa;Opisthokonta;Nucletmycea;Fungi;Dikarya;Ascomycota;Saccharomycotina;Saccharomycetes;Saccharomycetales;Ascoideaceae;Ascoidea;";"0.0";"0";"2";"2";"0";"2";"0";"430522";"5766"
"LOK1378_1mm";"SILVA (only NR);Eukaryota;Amorphea;Obazoa;Opisthokonta;Nucletmycea;Fungi;Dikarya;Ascomycota;Saccharomycotina;Saccharomycetes;Saccharomycetales;Candida;";"0.0";"0";"4";"3";"0";"3";"1";"430521";"5766"
"LOK1378_1mm";"SILVA (only NR);Eukaryota;Amorphea;Obazoa;Opisthokonta;Nucletmycea;Fungi;Dikarya;Ascomycota;Saccharomycotina;Saccharomycetes;Saccharomycetales;Cephaloascus;";"0.0";"0";"1";"1";"0";"1";"0";"430523";"5766"
"LOK1378_1mm";"SILVA (only NR);Eukaryota;Amorphea;Obazoa;Opisthokonta;Nucletmycea;Fungi;Dikarya;Ascomycota;Saccharomycotina;Saccharomycetes;Saccharomycetales;Debaryomycetaceae;";"0.0";"0";"314";"303";"0";"303";"11";"430221";"5766"
"LOK1378_1mm";"SILVA (only NR);Eukaryota;Amorphea;Obazoa;Opisthokonta;Nucletmycea;Fungi;Dikarya;Ascomycota;Saccharomycotina;Saccharomycetes;Saccharomycetales;Debaryomycetaceae;Babjeviella;";"0.0";"0";"3";"3";"0";"3";"0";"430521";"5766"
"LOK1378_1mm";"SILVA (only NR);Eukaryota;Amorphea;Obazoa;Opisthokonta;Nucletmycea;Fungi;Dikarya;Ascomycota;Saccharomycotina;Saccharomycetes;Saccharomycetales;Debaryomycetaceae;Candida glaebosa clade;";"0.0";"0";"13";"13";"0";"13";"0";"430511";"5766"
"LOK1378_1mm";"SILVA (only NR);Eukaryota;Amorphea;Obazoa;Opisthokonta;Nucletmycea;Fungi;Dikarya;Ascomycota;Saccharomycotina;Saccharomycetes;Saccharomycetales;Debaryomycetaceae;Candida kruisii clade;";"0.0";"0";"5";"5";"0";"5";"0";"430519";"5766"
"LOK1378_1mm";"SILVA (only NR);Eukaryota;Amorphea;Obazoa;Opisthokonta;Nucletmycea;Fungi;Dikarya;Ascomycota;Saccharomycotina;Saccharomycetes;Saccharomycetales;Debaryomycetaceae;Candida tanzawaensis clade;";"0.0";"0";"9";"9";"0";"9";"0";"430515";"5766"
"LOK1378_1mm";"SILVA (only NR);Eukaryota;Amorphea;Obazoa;Opisthokonta;Nucletmycea;Fungi;Dikarya;Ascomycota;Saccharomycotina;Saccharomycetes;Saccharomycetales;Debaryomycetaceae;Candida-Lodderomyces clade;";"0.0";"0";"65";"61";"0";"61";"4";"430463";"5766"
"LOK1378_1mm";"SILVA (only NR);Eukaryota;Amorphea;Obazoa;Opisthokonta;Nucletmycea;Fungi;Dikarya;Ascomycota;Saccharomycotina;Saccharomycetes;Saccharomycetales;Debaryomycetaceae;Debaryomyces;";"0.0";"0";"38";"38";"0";"38";"0";"430486";"5766"
"LOK1378_1mm";"SILVA (only NR);Eukaryota;Amorphea;Obazoa;Opisthokonta;Nucletmycea;Fungi;Dikarya;Ascomycota;Saccharomycotina;Saccharomycetes;Saccharomycetales;Debaryomycetaceae;Hypopichia-Candida clade;";"0.0";"0";"13";"13";"0";"13";"0";"430511";"5766"
"LOK1378_1mm";"SILVA (only NR);Eukaryota;Amorphea;Obazoa;Opisthokonta;Nucletmycea;Fungi;Dikarya;Ascomycota;Saccharomycotina;Saccharomycetes;Saccharomycetales;Debaryomycetaceae;Kurtzmaniella-Candida clade;";"0.0";"0";"24";"24";"0";"24";"0";"430500";"5766"
"LOK1378_1mm";"SILVA (only NR);Eukaryota;Amorphea;Obazoa;Opisthokonta;Nucletmycea;Fungi;Dikarya;Ascomycota;Saccharomycotina;Saccharomycetes;Saccharomycetales;Debaryomycetaceae;Meyerozyma-Candida clade;";"0.0";"0";"34";"28";"0";"28";"6";"430496";"5766"
"LOK1378_1mm";"SILVA (only NR);Eukaryota;Amorphea;Obazoa;Opisthokonta;Nucletmycea;Fungi;Dikarya;Ascomycota;Saccharomycotina;Saccharomycetes;Saccharomycetales;Debaryomycetaceae;Millerozyma;";"0.0";"0";"4";"4";"0";"4";"0";"430520";"5766"
"LOK1378_1mm";"SILVA (only NR);Eukaryota;Amorphea;Obazoa;Opisthokonta;Nucletmycea;Fungi;Dikarya;Ascomycota;Saccharomycotina;Saccharomycetes;Saccharomycetales;Debaryomycetaceae;Peterozyma;";"0.0";"0";"2";"2";"0";"2";"0";"430522";"5766"
"LOK1378_1mm";"SILVA (only NR);Eukaryota;Amorphea;Obazoa;Opisthokonta;Nucletmycea;Fungi;Dikarya;Ascomycota;Saccharomycotina;Saccharomycetes;Saccharomycetales;Debaryomycetaceae;Priceomyces;";"0.0";"0";"8";"8";"0";"8";"0";"430516";"5766"
"LOK1378_1mm";"SILVA (only NR);Eukaryota;Amorphea;Obazoa;Opisthokonta;Nucletmycea;Fungi;Dikarya;Ascomycota;Saccharomycotina;Saccharomycetes;Saccharomycetales;Debaryomycetaceae;Scheffersomyces;";"0.0";"0";"34";"33";"0";"33";"1";"430491";"5766"
"LOK1378_1mm";"SILVA (only NR);Eukaryota;Amorphea;Obazoa;Opisthokonta;Nucletmycea;Fungi;Dikarya;Ascomycota;Saccharomycotina;Saccharomycetes;Saccharomycetales;Debaryomycetaceae;Schwanniomyces;";"0.0";"0";"12";"12";"0";"12";"0";"430512";"5766"
"LOK1378_1mm";"SILVA (only NR);Eukaryota;Amorphea;Obazoa;Opisthokonta;Nucletmycea;Fungi;Dikarya;Ascomycota;Saccharomycotina;Saccharomycetes;Saccharomycetales;Debaryomycetaceae;Spathospora;";"0.0";"0";"6";"6";"0";"6";"0";"430518";"5766"
"LOK1378_1mm";"SILVA (only NR);Eukaryota;Amorphea;Obazoa;Opisthokonta;Nucletmycea;Fungi;Dikarya;Ascomycota;Saccharomycotina;Saccharomycetes;Saccharomycetales;Debaryomycetaceae;Yamadazyma-Candida clade;";"0.0";"0";"44";"44";"0";"44";"0";"430480";"5766"
"LOK1378_1mm";"SILVA (only NR);Eukaryota;Amorphea;Obazoa;Opisthokonta;Nucletmycea;Fungi;Dikarya;Ascomycota;Saccharomycotina;Saccharomycetes;Saccharomycetales;Dipodascaceae;";"0.0";"0";"60";"56";"0";"56";"4";"430468";"5766"
"LOK1378_1mm";"SILVA (only NR);Eukaryota;Amorphea;Obazoa;Opisthokonta;Nucletmycea;Fungi;Dikarya;Ascomycota;Saccharomycotina;Saccharomycetes;Saccharomycetales;Dipodascaceae;Dipodascus;";"0.0";"0";"10";"10";"0";"10";"0";"430514";"5766"
"LOK1378_1mm";"SILVA (only NR);Eukaryota;Amorphea;Obazoa;Opisthokonta;Nucletmycea;Fungi;Dikarya;Ascomycota;Saccharomycotina;Saccharomycetes;Saccharomycetales;Dipodascaceae;Galactomyces;";"0.0";"0";"5";"4";"0";"4";"1";"430520";"5766"
"LOK1378_1mm";"SILVA (only NR);Eukaryota;Amorphea;Obazoa;Opisthokonta;Nucletmycea;Fungi;Dikarya;Ascomycota;Saccharomycotina;Saccharomycetes;Saccharomycetales;Dipodascaceae;Geotrichum;";"0.0";"0";"13";"12";"0";"12";"1";"430512";"5766"
"LOK1378_1mm";"SILVA (only NR);Eukaryota;Amorphea;Obazoa;Opisthokonta;Nucletmycea;Fungi;Dikarya;Ascomycota;Saccharomycotina;Saccharomycetes;Saccharomycetales;Dipodascaceae;Magnusiomyces;";"0.0";"0";"8";"8";"0";"8";"0";"430516";"5766"
"LOK1378_1mm";"SILVA (only NR);Eukaryota;Amorphea;Obazoa;Opisthokonta;Nucletmycea;Fungi;Dikarya;Ascomycota;Saccharomycotina;Saccharomycetes;Saccharomycetales;Dipodascaceae;Saprochaete;";"0.0";"0";"4";"4";"0";"4";"0";"430520";"5766"
"LOK1378_1mm";"SILVA (only NR);Eukaryota;Amorphea;Obazoa;Opisthokonta;Nucletmycea;Fungi;Dikarya;Ascomycota;Saccharomycotina;Saccharomycetes;Saccharomycetales;Dipodascaceae;Yarrowia;";"0.0";"0";"20";"18";"0";"18";"2";"430506";"5766"
"LOK1378_1mm";"SILVA (only NR);Eukaryota;Amorphea;Obazoa;Opisthokonta;Nucletmycea;Fungi;Dikarya;Ascomycota;Saccharomycotina;Saccharomycetes;Saccharomycetales;Endomycetaceae;";"0.0";"0";"2";"2";"0";"2";"0";"430522";"5766"
"LOK1378_1mm";"SILVA (only NR);Eukaryota;Amorphea;Obazoa;Opisthokonta;Nucletmycea;Fungi;Dikarya;Ascomycota;Saccharomycotina;Saccharomycetes;Saccharomycetales;Endomycetaceae;Endomyces;";"0.0";"0";"2";"2";"0";"2";"0";"430522";"5766"
"LOK1378_1mm";"SILVA (only NR);Eukaryota;Amorphea;Obazoa;Opisthokonta;Nucletmycea;Fungi;Dikarya;Ascomycota;Saccharomycotina;Saccharomycetes;Saccharomycetales;Incertae Sedis;";"0.0";"0";"116";"115";"0";"115";"1";"430409";"5766"
"LOK1378_1mm";"SILVA (only NR);Eukaryota;Amorphea;Obazoa;Opisthokonta;Nucletmycea;Fungi;Dikarya;Ascomycota;Saccharomycotina;Saccharomycetes;Saccharomycetales;Incertae Sedis;Ambrosiozyma;";"0.0";"0";"16";"16";"0";"16";"0";"430508";"5766"
"LOK1378_1mm";"SILVA (only NR);Eukaryota;Amorphea;Obazoa;Opisthokonta;Nucletmycea;Fungi;Dikarya;Ascomycota;Saccharomycotina;Saccharomycetes;Saccharomycetales;Incertae Sedis;Candida;";"0.0";"0";"53";"52";"0";"52";"1";"430472";"5766"
"LOK1378_1mm";"SILVA (only NR);Eukaryota;Amorphea;Obazoa;Opisthokonta;Nucletmycea;Fungi;Dikarya;Ascomycota;Saccharomycotina;Saccharomycetes;Saccharomycetales;Incertae Sedis;Kuraishia;";"0.0";"0";"10";"10";"0";"10";"0";"430514";"5766"
"LOK1378_1mm";"SILVA (only NR);Eukaryota;Amorphea;Obazoa;Opisthokonta;Nucletmycea;Fungi;Dikarya;Ascomycota;Saccharomycotina;Saccharomycetes;Saccharomycetales;Incertae Sedis;Middelhovenomyces;";"0.0";"0";"8";"8";"0";"8";"0";"430516";"5766"
"LOK1378_1mm";"SILVA (only NR);Eukaryota;Amorphea;Obazoa;Opisthokonta;Nucletmycea;Fungi;Dikarya;Ascomycota;Saccharomycotina;Saccharomycetes;Saccharomycetales;Incertae Sedis;Nadsonia;";"0.0";"0";"2";"2";"0";"2";"0";"430522";"5766"
"LOK1378_1mm";"SILVA (only NR);Eukaryota;Amorphea;Obazoa;Opisthokonta;Nucletmycea;Fungi;Dikarya;Ascomycota;Saccharomycotina;Saccharomycetes;Saccharomycetales;Incertae Sedis;Starmerella-Candida clade;";"0.0";"0";"27";"27";"0";"27";"0";"430497";"5766"
"LOK1378_1mm";"SILVA (only NR);Eukaryota;Amorphea;Obazoa;Opisthokonta;Nucletmycea;Fungi;Dikarya;Ascomycota;Saccharomycotina;Saccharomycetes;Saccharomycetales;Lipomycetaceae;";"0.0";"0";"31";"30";"0";"30";"1";"430494";"5766"
"LOK1378_1mm";"SILVA (only NR);Eukaryota;Amorphea;Obazoa;Opisthokonta;Nucletmycea;Fungi;Dikarya;Ascomycota;Saccharomycotina;Saccharomycetes;Saccharomycetales;Lipomycetaceae;Dipodascopsis;";"0.0";"0";"4";"4";"0";"4";"0";"430520";"5766"
"LOK1378_1mm";"SILVA (only NR);Eukaryota;Amorphea;Obazoa;Opisthokonta;Nucletmycea;Fungi;Dikarya;Ascomycota;Saccharomycotina;Saccharomycetes;Saccharomycetales;Lipomycetaceae;Lipomyces;";"0.0";"0";"15";"14";"0";"14";"1";"430510";"5766"
"LOK1378_1mm";"SILVA (only NR);Eukaryota;Amorphea;Obazoa;Opisthokonta;Nucletmycea;Fungi;Dikarya;Ascomycota;Saccharomycotina;Saccharomycetes;Saccharomycetales;Lipomycetaceae;Myxozyma;";"0.0";"0";"12";"12";"0";"12";"0";"430512";"5766"
"LOK1378_1mm";"SILVA (only NR);Eukaryota;Amorphea;Obazoa;Opisthokonta;Nucletmycea;Fungi;Dikarya;Ascomycota;Saccharomycotina;Saccharomycetes;Saccharomycetales;Metschnikowiaceae;";"0.0";"0";"94";"93";"0";"93";"1";"430431";"5766"
"LOK1378_1mm";"SILVA (only NR);Eukaryota;Amorphea;Obazoa;Opisthokonta;Nucletmycea;Fungi;Dikarya;Ascomycota;Saccharomycotina;Saccharomycetes;Saccharomycetales;Metschnikowiaceae;Aciculoconidium;";"0.0";"0";"1";"1";"0";"1";"0";"430523";"5766"
"LOK1378_1mm";"SILVA (only NR);Eukaryota;Amorphea;Obazoa;Opisthokonta;Nucletmycea;Fungi;Dikarya;Ascomycota;Saccharomycotina;Saccharomycetes;Saccharomycetales;Metschnikowiaceae;Clavispora-Candida clade;";"0.0";"0";"38";"38";"0";"38";"0";"430486";"5766"
"LOK1378_1mm";"SILVA (only NR);Eukaryota;Amorphea;Obazoa;Opisthokonta;Nucletmycea;Fungi;Dikarya;Ascomycota;Saccharomycotina;Saccharomycetes;Saccharomycetales;Metschnikowiaceae;Danielozyma;";"0.0";"0";"2";"2";"0";"2";"0";"430522";"5766"
"LOK1378_1mm";"SILVA (only NR);Eukaryota;Amorphea;Obazoa;Opisthokonta;Nucletmycea;Fungi;Dikarya;Ascomycota;Saccharomycotina;Saccharomycetes;Saccharomycetales;Metschnikowiaceae;Kodamaea-Candida clade;";"0.0";"0";"6";"6";"0";"6";"0";"430518";"5766"
"LOK1378_1mm";"SILVA (only NR);Eukaryota;Amorphea;Obazoa;Opisthokonta;Nucletmycea;Fungi;Dikarya;Ascomycota;Saccharomycotina;Saccharomycetes;Saccharomycetales;Metschnikowiaceae;Kodamaea;";"0.0";"0";"7";"7";"0";"7";"0";"430517";"5766"
"LOK1378_1mm";"SILVA (only NR);Eukaryota;Amorphea;Obazoa;Opisthokonta;Nucletmycea;Fungi;Dikarya;Ascomycota;Saccharomycotina;Saccharomycetes;Saccharomycetales;Metschnikowiaceae;Metschnikowia;";"0.0";"0";"38";"37";"0";"37";"1";"430487";"5766"
"LOK1378_1mm";"SILVA (only NR);Eukaryota;Amorphea;Obazoa;Opisthokonta;Nucletmycea;Fungi;Dikarya;Ascomycota;Saccharomycotina;Saccharomycetes;Saccharomycetales;Phaffomycetaceae;";"0.0";"0";"168";"168";"0";"168";"0";"430356";"5766"
"LOK1378_1mm";"SILVA (only NR);Eukaryota;Amorphea;Obazoa;Opisthokonta;Nucletmycea;Fungi;Dikarya;Ascomycota;Saccharomycotina;Saccharomycetes;Saccharomycetales;Phaffomycetaceae;Barnettozyma-Candida clade;";"0.0";"0";"14";"14";"0";"14";"0";"430510";"5766"
"LOK1378_1mm";"SILVA (only NR);Eukaryota;Amorphea;Obazoa;Opisthokonta;Nucletmycea;Fungi;Dikarya;Ascomycota;Saccharomycotina;Saccharomycetes;Saccharomycetales;Phaffomycetaceae;Cyberlindnera-Candida clade;";"0.0";"0";"43";"43";"0";"43";"0";"430481";"5766"
"LOK1378_1mm";"SILVA (only NR);Eukaryota;Amorphea;Obazoa;Opisthokonta;Nucletmycea;Fungi;Dikarya;Ascomycota;Saccharomycotina;Saccharomycetes;Saccharomycetales;Phaffomycetaceae;Cyberlindnera;";"0.0";"0";"2";"2";"0";"2";"0";"430522";"5766"
"LOK1378_1mm";"SILVA (only NR);Eukaryota;Amorphea;Obazoa;Opisthokonta;Nucletmycea;Fungi;Dikarya;Ascomycota;Saccharomycotina;Saccharomycetes;Saccharomycetales;Phaffomycetaceae;Deakozyma;";"0.0";"0";"1";"1";"0";"1";"0";"430523";"5766"
"LOK1378_1mm";"SILVA (only NR);Eukaryota;Amorphea;Obazoa;Opisthokonta;Nucletmycea;Fungi;Dikarya;Ascomycota;Saccharomycotina;Saccharomycetes;Saccharomycetales;Phaffomycetaceae;Komagataella;";"0.0";"0";"21";"21";"0";"21";"0";"430503";"5766"
"LOK1378_1mm";"SILVA (only NR);Eukaryota;Amorphea;Obazoa;Opisthokonta;Nucletmycea;Fungi;Dikarya;Ascomycota;Saccharomycotina;Saccharomycetes;Saccharomycetales;Phaffomycetaceae;Phaffomyces;";"0.0";"0";"11";"11";"0";"11";"0";"430513";"5766"
"LOK1378_1mm";"SILVA (only NR);Eukaryota;Amorphea;Obazoa;Opisthokonta;Nucletmycea;Fungi;Dikarya;Ascomycota;Saccharomycotina;Saccharomycetes;Saccharomycetales;Phaffomycetaceae;Starmera-Candida clade;";"0.0";"0";"14";"14";"0";"14";"0";"430510";"5766"
"LOK1378_1mm";"SILVA (only NR);Eukaryota;Amorphea;Obazoa;Opisthokonta;Nucletmycea;Fungi;Dikarya;Ascomycota;Saccharomycotina;Saccharomycetes;Saccharomycetales;Phaffomycetaceae;Starmera;";"0.0";"0";"1";"1";"0";"1";"0";"430523";"5766"
"LOK1378_1mm";"SILVA (only NR);Eukaryota;Amorphea;Obazoa;Opisthokonta;Nucletmycea;Fungi;Dikarya;Ascomycota;Saccharomycotina;Saccharomycetes;Saccharomycetales;Phaffomycetaceae;Wickerhamomyces-Candida clade;";"0.0";"0";"37";"37";"0";"37";"0";"430487";"5766"
"LOK1378_1mm";"SILVA (only NR);Eukaryota;Amorphea;Obazoa;Opisthokonta;Nucletmycea;Fungi;Dikarya;Ascomycota;Saccharomycotina;Saccharomycetes;Saccharomycetales;Phaffomycetaceae;Wickerhamomyces;";"0.0";"0";"18";"18";"0";"18";"0";"430506";"5766"
"LOK1378_1mm";"SILVA (only NR);Eukaryota;Amorphea;Obazoa;Opisthokonta;Nucletmycea;Fungi;Dikarya;Ascomycota;Saccharomycotina;Saccharomycetes;Saccharomycetales;Pichiaceae;";"0.0";"0";"219";"219";"0";"219";"0";"430305";"5766"
"LOK1378_1mm";"SILVA (only NR);Eukaryota;Amorphea;Obazoa;Opisthokonta;Nucletmycea;Fungi;Dikarya;Ascomycota;Saccharomycotina;Saccharomycetes;Saccharomycetales;Pichiaceae;Brettanomyces;";"0.0";"0";"19";"19";"0";"19";"0";"430505";"5766"
"LOK1378_1mm";"SILVA (only NR);Eukaryota;Amorphea;Obazoa;Opisthokonta;Nucletmycea;Fungi;Dikarya;Ascomycota;Saccharomycotina;Saccharomycetes;Saccharomycetales;Pichiaceae;Kregervanrija;";"0.0";"0";"4";"4";"0";"4";"0";"430520";"5766"
"LOK1378_1mm";"SILVA (only NR);Eukaryota;Amorphea;Obazoa;Opisthokonta;Nucletmycea;Fungi;Dikarya;Ascomycota;Saccharomycotina;Saccharomycetes;Saccharomycetales;Pichiaceae;Martiniozyma;";"0.0";"0";"4";"4";"0";"4";"0";"430520";"5766"
"LOK1378_1mm";"SILVA (only NR);Eukaryota;Amorphea;Obazoa;Opisthokonta;Nucletmycea;Fungi;Dikarya;Ascomycota;Saccharomycotina;Saccharomycetes;Saccharomycetales;Pichiaceae;Nakazawaea;";"0.0";"0";"22";"22";"0";"22";"0";"430502";"5766"
"LOK1378_1mm";"SILVA (only NR);Eukaryota;Amorphea;Obazoa;Opisthokonta;Nucletmycea;Fungi;Dikarya;Ascomycota;Saccharomycotina;Saccharomycetes;Saccharomycetales;Pichiaceae;Ogataea-Candida clade;";"0.0";"0";"72";"72";"0";"72";"0";"430452";"5766"
"LOK1378_1mm";"SILVA (only NR);Eukaryota;Amorphea;Obazoa;Opisthokonta;Nucletmycea;Fungi;Dikarya;Ascomycota;Saccharomycotina;Saccharomycetes;Saccharomycetales;Pichiaceae;Pichia;";"0.0";"0";"77";"77";"0";"77";"0";"430447";"5766"
"LOK1378_1mm";"SILVA (only NR);Eukaryota;Amorphea;Obazoa;Opisthokonta;Nucletmycea;Fungi;Dikarya;Ascomycota;Saccharomycotina;Saccharomycetes;Saccharomycetales;Pichiaceae;Saturnispora;";"0.0";"0";"19";"19";"0";"19";"0";"430505";"5766"
"LOK1378_1mm";"SILVA (only NR);Eukaryota;Amorphea;Obazoa;Opisthokonta;Nucletmycea;Fungi;Dikarya;Ascomycota;Saccharomycotina;Saccharomycetes;Saccharomycetales;Saccharomycetaceae;";"0.0";"0";"268";"260";"0";"260";"8";"430264";"5766"
"LOK1378_1mm";"SILVA (only NR);Eukaryota;Amorphea;Obazoa;Opisthokonta;Nucletmycea;Fungi;Dikarya;Ascomycota;Saccharomycotina;Saccharomycetes;Saccharomycetales;Saccharomycetaceae;Citeromyces;";"0.0";"0";"9";"9";"0";"9";"0";"430515";"5766"
"LOK1378_1mm";"SILVA (only NR);Eukaryota;Amorphea;Obazoa;Opisthokonta;Nucletmycea;Fungi;Dikarya;Ascomycota;Saccharomycotina;Saccharomycetes;Saccharomycetales;Saccharomycetaceae;Cyniclomyces;";"0.0";"0";"1";"1";"0";"1";"0";"430523";"5766"
"LOK1378_1mm";"SILVA (only NR);Eukaryota;Amorphea;Obazoa;Opisthokonta;Nucletmycea;Fungi;Dikarya;Ascomycota;Saccharomycotina;Saccharomycetes;Saccharomycetales;Saccharomycetaceae;Eremothecium;";"0.0";"0";"13";"13";"0";"13";"0";"430511";"5766"
"LOK1378_1mm";"SILVA (only NR);Eukaryota;Amorphea;Obazoa;Opisthokonta;Nucletmycea;Fungi;Dikarya;Ascomycota;Saccharomycotina;Saccharomycetes;Saccharomycetales;Saccharomycetaceae;Hagleromyces;";"0.0";"0";"1";"1";"0";"1";"0";"430523";"5766"
"LOK1378_1mm";"SILVA (only NR);Eukaryota;Amorphea;Obazoa;Opisthokonta;Nucletmycea;Fungi;Dikarya;Ascomycota;Saccharomycotina;Saccharomycetes;Saccharomycetales;Saccharomycetaceae;Issatchenkia;";"0.0";"0";"2";"2";"0";"2";"0";"430522";"5766"
"LOK1378_1mm";"SILVA (only NR);Eukaryota;Amorphea;Obazoa;Opisthokonta;Nucletmycea;Fungi;Dikarya;Ascomycota;Saccharomycotina;Saccharomycetes;Saccharomycetales;Saccharomycetaceae;Kazachstania-Candida clade;";"0.0";"0";"29";"29";"0";"29";"0";"430495";"5766"
"LOK1378_1mm";"SILVA (only NR);Eukaryota;Amorphea;Obazoa;Opisthokonta;Nucletmycea;Fungi;Dikarya;Ascomycota;Saccharomycotina;Saccharomycetes;Saccharomycetales;Saccharomycetaceae;Kazachstania;";"0.0";"0";"35";"35";"0";"35";"0";"430489";"5766"
"LOK1378_1mm";"SILVA (only NR);Eukaryota;Amorphea;Obazoa;Opisthokonta;Nucletmycea;Fungi;Dikarya;Ascomycota;Saccharomycotina;Saccharomycetes;Saccharomycetales;Saccharomycetaceae;Kluyveromyces;";"0.0";"0";"23";"22";"0";"22";"1";"430502";"5766"
"LOK1378_1mm";"SILVA (only NR);Eukaryota;Amorphea;Obazoa;Opisthokonta;Nucletmycea;Fungi;Dikarya;Ascomycota;Saccharomycotina;Saccharomycetes;Saccharomycetales;Saccharomycetaceae;Lachancea;";"0.0";"0";"16";"15";"0";"15";"1";"430509";"5766"
"LOK1378_1mm";"SILVA (only NR);Eukaryota;Amorphea;Obazoa;Opisthokonta;Nucletmycea;Fungi;Dikarya;Ascomycota;Saccharomycotina;Saccharomycetes;Saccharomycetales;Saccharomycetaceae;Macrorhabdus;";"0.0";"0";"1";"1";"0";"1";"0";"430523";"5766"
"LOK1378_1mm";"SILVA (only NR);Eukaryota;Amorphea;Obazoa;Opisthokonta;Nucletmycea;Fungi;Dikarya;Ascomycota;Saccharomycotina;Saccharomycetes;Saccharomycetales;Saccharomycetaceae;Nakaseomyces-Candida clade;";"0.0";"0";"9";"9";"0";"9";"0";"430515";"5766"
"LOK1378_1mm";"SILVA (only NR);Eukaryota;Amorphea;Obazoa;Opisthokonta;Nucletmycea;Fungi;Dikarya;Ascomycota;Saccharomycotina;Saccharomycetes;Saccharomycetales;Saccharomycetaceae;Nakaseomyces;";"0.0";"0";"1";"1";"0";"1";"0";"430523";"5766"
"LOK1378_1mm";"SILVA (only NR);Eukaryota;Amorphea;Obazoa;Opisthokonta;Nucletmycea;Fungi;Dikarya;Ascomycota;Saccharomycotina;Saccharomycetes;Saccharomycetales;Saccharomycetaceae;Naumovozyma;";"0.0";"0";"6";"6";"0";"6";"0";"430518";"5766"
"LOK1378_1mm";"SILVA (only NR);Eukaryota;Amorphea;Obazoa;Opisthokonta;Nucletmycea;Fungi;Dikarya;Ascomycota;Saccharomycotina;Saccharomycetes;Saccharomycetales;Saccharomycetaceae;Pachysolen;";"0.0";"0";"3";"3";"0";"3";"0";"430521";"5766"
"LOK1378_1mm";"SILVA (only NR);Eukaryota;Amorphea;Obazoa;Opisthokonta;Nucletmycea;Fungi;Dikarya;Ascomycota;Saccharomycotina;Saccharomycetes;Saccharomycetales;Saccharomycetaceae;Saccharomyces;";"0.0";"0";"49";"46";"0";"46";"3";"430478";"5766"
"LOK1378_1mm";"SILVA (only NR);Eukaryota;Amorphea;Obazoa;Opisthokonta;Nucletmycea;Fungi;Dikarya;Ascomycota;Saccharomycotina;Saccharomycetes;Saccharomycetales;Saccharomycetaceae;Tetrapisispora;";"0.0";"0";"15";"15";"0";"15";"0";"430509";"5766"
"LOK1378_1mm";"SILVA (only NR);Eukaryota;Amorphea;Obazoa;Opisthokonta;Nucletmycea;Fungi;Dikarya;Ascomycota;Saccharomycotina;Saccharomycetes;Saccharomycetales;Saccharomycetaceae;Torulaspora;";"0.0";"0";"12";"12";"0";"12";"0";"430512";"5766"
"LOK1378_1mm";"SILVA (only NR);Eukaryota;Amorphea;Obazoa;Opisthokonta;Nucletmycea;Fungi;Dikarya;Ascomycota;Saccharomycotina;Saccharomycetes;Saccharomycetales;Saccharomycetaceae;Vanderwaltozyma;";"0.0";"0";"11";"10";"0";"10";"1";"430514";"5766"
"LOK1378_1mm";"SILVA (only NR);Eukaryota;Amorphea;Obazoa;Opisthokonta;Nucletmycea;Fungi;Dikarya;Ascomycota;Saccharomycotina;Saccharomycetes;Saccharomycetales;Saccharomycetaceae;Yueomyces;";"0.0";"0";"4";"4";"0";"4";"0";"430520";"5766"
"LOK1378_1mm";"SILVA (only NR);Eukaryota;Amorphea;Obazoa;Opisthokonta;Nucletmycea;Fungi;Dikarya;Ascomycota;Saccharomycotina;Saccharomycetes;Saccharomycetales;Saccharomycetaceae;Zygosaccharomyces;";"0.0";"0";"26";"24";"0";"24";"2";"430500";"5766"
"LOK1378_1mm";"SILVA (only NR);Eukaryota;Amorphea;Obazoa;Opisthokonta;Nucletmycea;Fungi;Dikarya;Ascomycota;Saccharomycotina;Saccharomycetes;Saccharomycetales;Saccharomycetaceae;Zygotorulaspora;";"0.0";"0";"2";"2";"0";"2";"0";"430522";"5766"
"LOK1378_1mm";"SILVA (only NR);Eukaryota;Amorphea;Obazoa;Opisthokonta;Nucletmycea;Fungi;Dikarya;Ascomycota;Saccharomycotina;Saccharomycetes;Saccharomycetales;Saccharomycodaceae;";"0.0";"0";"16";"16";"0";"16";"0";"430508";"5766"
"LOK1378_1mm";"SILVA (only NR);Eukaryota;Amorphea;Obazoa;Opisthokonta;Nucletmycea;Fungi;Dikarya;Ascomycota;Saccharomycotina;Saccharomycetes;Saccharomycetales;Saccharomycodaceae;Hanseniaspora;";"0.0";"0";"12";"12";"0";"12";"0";"430512";"5766"
"LOK1378_1mm";"SILVA (only NR);Eukaryota;Amorphea;Obazoa;Opisthokonta;Nucletmycea;Fungi;Dikarya;Ascomycota;Saccharomycotina;Saccharomycetes;Saccharomycetales;Saccharomycodaceae;Saccharomycodes;";"0.0";"0";"4";"4";"0";"4";"0";"430520";"5766"
"LOK1378_1mm";"SILVA (only NR);Eukaryota;Amorphea;Obazoa;Opisthokonta;Nucletmycea;Fungi;Dikarya;Ascomycota;Saccharomycotina;Saccharomycetes;Saccharomycetales;Saccharomycopsidaceae;";"0.0";"0";"25";"24";"0";"24";"1";"430500";"5766"
"LOK1378_1mm";"SILVA (only NR);Eukaryota;Amorphea;Obazoa;Opisthokonta;Nucletmycea;Fungi;Dikarya;Ascomycota;Saccharomycotina;Saccharomycetes;Saccharomycetales;Saccharomycopsidaceae;Saccharomycopsis;";"0.0";"0";"25";"24";"0";"24";"1";"430500";"5766"
"LOK1378_1mm";"SILVA (only NR);Eukaryota;Amorphea;Obazoa;Opisthokonta;Nucletmycea;Fungi;Dikarya;Ascomycota;Saccharomycotina;Saccharomycetes;Saccharomycetales;Sporopachydermia;";"0.0";"0";"1";"1";"0";"1";"0";"430523";"5766"
"LOK1378_1mm";"SILVA (only NR);Eukaryota;Amorphea;Obazoa;Opisthokonta;Nucletmycea;Fungi;Dikarya;Ascomycota;Saccharomycotina;Saccharomycetes;Saccharomycetales;Trichomonascaceae;";"0.0";"0";"79";"79";"0";"79";"0";"430445";"5766"
"LOK1378_1mm";"SILVA (only NR);Eukaryota;Amorphea;Obazoa;Opisthokonta;Nucletmycea;Fungi;Dikarya;Ascomycota;Saccharomycotina;Saccharomycetes;Saccharomycetales;Trichomonascaceae;BG02-7-13-27C-2-1;";"0.0";"0";"2";"2";"0";"2";"0";"430522";"5766"
"LOK1378_1mm";"SILVA (only NR);Eukaryota;Amorphea;Obazoa;Opisthokonta;Nucletmycea;Fungi;Dikarya;Ascomycota;Saccharomycotina;Saccharomycetes;Saccharomycetales;Trichomonascaceae;Blastobotrys;";"0.0";"0";"5";"5";"0";"5";"0";"430519";"5766"
"LOK1378_1mm";"SILVA (only NR);Eukaryota;Amorphea;Obazoa;Opisthokonta;Nucletmycea;Fungi;Dikarya;Ascomycota;Saccharomycotina;Saccharomycetes;Saccharomycetales;Trichomonascaceae;JCM8259;";"0.0";"0";"6";"6";"0";"6";"0";"430518";"5766"
"LOK1378_1mm";"SILVA (only NR);Eukaryota;Amorphea;Obazoa;Opisthokonta;Nucletmycea;Fungi;Dikarya;Ascomycota;Saccharomycotina;Saccharomycetes;Saccharomycetales;Trichomonascaceae;Spencermartinsiella;";"0.0";"0";"7";"7";"0";"7";"0";"430517";"5766"
"LOK1378_1mm";"SILVA (only NR);Eukaryota;Amorphea;Obazoa;Opisthokonta;Nucletmycea;Fungi;Dikarya;Ascomycota;Saccharomycotina;Saccharomycetes;Saccharomycetales;Trichomonascaceae;Sugiyamaella;";"0.0";"0";"19";"19";"0";"19";"0";"430505";"5766"
"LOK1378_1mm";"SILVA (only NR);Eukaryota;Amorphea;Obazoa;Opisthokonta;Nucletmycea;Fungi;Dikarya;Ascomycota;Saccharomycotina;Saccharomycetes;Saccharomycetales;Trichomonascaceae;Trichomonascus;";"0.0";"0";"18";"18";"0";"18";"0";"430506";"5766"
"LOK1378_1mm";"SILVA (only NR);Eukaryota;Amorphea;Obazoa;Opisthokonta;Nucletmycea;Fungi;Dikarya;Ascomycota;Saccharomycotina;Saccharomycetes;Saccharomycetales;Trichomonascaceae;Wicherhamiella-Candida clade;";"0.0";"0";"17";"17";"0";"17";"0";"430507";"5766"
"LOK1378_1mm";"SILVA (only NR);Eukaryota;Amorphea;Obazoa;Opisthokonta;Nucletmycea;Fungi;Dikarya;Ascomycota;Saccharomycotina;Saccharomycetes;Saccharomycetales;Trichomonascaceae;Zygoascus-Candida clade;";"0.0";"0";"5";"5";"0";"5";"0";"430519";"5766"
"LOK1378_1mm";"SILVA (only NR);Eukaryota;Amorphea;Obazoa;Opisthokonta;Nucletmycea;Fungi;Dikarya;Ascomycota;Saccharomycotina;Saccharomycetes;Saccharomycetales;Trigonopsidaceae;";"0.0";"0";"5";"5";"0";"5";"0";"430519";"5766"
"LOK1378_1mm";"SILVA (only NR);Eukaryota;Amorphea;Obazoa;Opisthokonta;Nucletmycea;Fungi;Dikarya;Ascomycota;Saccharomycotina;Saccharomycetes;Saccharomycetales;Trigonopsidaceae;Botryozyma;";"0.0";"0";"1";"1";"0";"1";"0";"430523";"5766"
"LOK1378_1mm";"SILVA (only NR);Eukaryota;Amorphea;Obazoa;Opisthokonta;Nucletmycea;Fungi;Dikarya;Ascomycota;Saccharomycotina;Saccharomycetes;Saccharomycetales;Trigonopsidaceae;Tortispora;";"0.0";"0";"1";"1";"0";"1";"0";"430523";"5766"
"LOK1378_1mm";"SILVA (only NR);Eukaryota;Amorphea;Obazoa;Opisthokonta;Nucletmycea;Fungi;Dikarya;Ascomycota;Saccharomycotina;Saccharomycetes;Saccharomycetales;Trigonopsidaceae;Trigonopsis;";"0.0";"0";"3";"3";"0";"3";"0";"430521";"5766"
"LOK1378_1mm";"SILVA (only NR);Eukaryota;Amorphea;Obazoa;Opisthokonta;Nucletmycea;Fungi;Dikarya;Ascomycota;Saccharomycotina;Saccharomycetes;Saccharomycetales;Wickerhamia;";"0.0";"0";"1";"1";"0";"1";"0";"430523";"5766"
"LOK1378_1mm";"SILVA (only NR);Eukaryota;Amorphea;Obazoa;Opisthokonta;Nucletmycea;Fungi;Dikarya;Ascomycota;Taphrinomycotina;";"0.0";"0";"68";"67";"0";"67";"1";"430457";"5766"
"LOK1378_1mm";"SILVA (only NR);Eukaryota;Amorphea;Obazoa;Opisthokonta;Nucletmycea;Fungi;Dikarya;Ascomycota;Taphrinomycotina;Archaeorhizomycetes;";"0.0";"0";"3";"3";"0";"3";"0";"430521";"5766"
"LOK1378_1mm";"SILVA (only NR);Eukaryota;Amorphea;Obazoa;Opisthokonta;Nucletmycea;Fungi;Dikarya;Ascomycota;Taphrinomycotina;Archaeorhizomycetes;Archaeorhizomycetales;";"0.0";"0";"3";"3";"0";"3";"0";"430521";"5766"
"LOK1378_1mm";"SILVA (only NR);Eukaryota;Amorphea;Obazoa;Opisthokonta;Nucletmycea;Fungi;Dikarya;Ascomycota;Taphrinomycotina;Archaeorhizomycetes;Archaeorhizomycetales;Archaeorhizomycetaceae;";"0.0";"0";"3";"3";"0";"3";"0";"430521";"5766"
"LOK1378_1mm";"SILVA (only NR);Eukaryota;Amorphea;Obazoa;Opisthokonta;Nucletmycea;Fungi;Dikarya;Ascomycota;Taphrinomycotina;Archaeorhizomycetes;Archaeorhizomycetales;Archaeorhizomycetaceae;Archaeorhizomyces;";"0.0";"0";"3";"3";"0";"3";"0";"430521";"5766"
"LOK1378_1mm";"SILVA (only NR);Eukaryota;Amorphea;Obazoa;Opisthokonta;Nucletmycea;Fungi;Dikarya;Ascomycota;Taphrinomycotina;Incertae Sedis;";"0.0";"0";"3";"3";"0";"3";"0";"430521";"5766"
"LOK1378_1mm";"SILVA (only NR);Eukaryota;Amorphea;Obazoa;Opisthokonta;Nucletmycea;Fungi;Dikarya;Ascomycota;Taphrinomycotina;Incertae Sedis;Incertae Sedis;";"0.0";"0";"3";"3";"0";"3";"0";"430521";"5766"
"LOK1378_1mm";"SILVA (only NR);Eukaryota;Amorphea;Obazoa;Opisthokonta;Nucletmycea;Fungi;Dikarya;Ascomycota;Taphrinomycotina;Incertae Sedis;Incertae Sedis;Incertae Sedis;";"0.0";"0";"3";"3";"0";"3";"0";"430521";"5766"
"LOK1378_1mm";"SILVA (only NR);Eukaryota;Amorphea;Obazoa;Opisthokonta;Nucletmycea;Fungi;Dikarya;Ascomycota;Taphrinomycotina;Incertae Sedis;Incertae Sedis;Incertae Sedis;Saitoella;";"0.0";"0";"3";"3";"0";"3";"0";"430521";"5766"
"LOK1378_1mm";"SILVA (only NR);Eukaryota;Amorphea;Obazoa;Opisthokonta;Nucletmycea;Fungi;Dikarya;Ascomycota;Taphrinomycotina;Neolectomycetes;";"0.0";"0";"1";"1";"0";"1";"0";"430523";"5766"
"LOK1378_1mm";"SILVA (only NR);Eukaryota;Amorphea;Obazoa;Opisthokonta;Nucletmycea;Fungi;Dikarya;Ascomycota;Taphrinomycotina;Neolectomycetes;Neolectales;";"0.0";"0";"1";"1";"0";"1";"0";"430523";"5766"
"LOK1378_1mm";"SILVA (only NR);Eukaryota;Amorphea;Obazoa;Opisthokonta;Nucletmycea;Fungi;Dikarya;Ascomycota;Taphrinomycotina;Neolectomycetes;Neolectales;Neolectaceae;";"0.0";"0";"1";"1";"0";"1";"0";"430523";"5766"
"LOK1378_1mm";"SILVA (only NR);Eukaryota;Amorphea;Obazoa;Opisthokonta;Nucletmycea;Fungi;Dikarya;Ascomycota;Taphrinomycotina;Neolectomycetes;Neolectales;Neolectaceae;Neolecta;";"0.0";"0";"1";"1";"0";"1";"0";"430523";"5766"
"LOK1378_1mm";"SILVA (only NR);Eukaryota;Amorphea;Obazoa;Opisthokonta;Nucletmycea;Fungi;Dikarya;Ascomycota;Taphrinomycotina;Pneumocystidomycetes;";"0.0";"0";"6";"6";"0";"6";"0";"430518";"5766"
"LOK1378_1mm";"SILVA (only NR);Eukaryota;Amorphea;Obazoa;Opisthokonta;Nucletmycea;Fungi;Dikarya;Ascomycota;Taphrinomycotina;Pneumocystidomycetes;Pneumocystidales;";"0.0";"0";"6";"6";"0";"6";"0";"430518";"5766"
"LOK1378_1mm";"SILVA (only NR);Eukaryota;Amorphea;Obazoa;Opisthokonta;Nucletmycea;Fungi;Dikarya;Ascomycota;Taphrinomycotina;Pneumocystidomycetes;Pneumocystidales;Pneumocystidaceae;";"0.0";"0";"6";"6";"0";"6";"0";"430518";"5766"
"LOK1378_1mm";"SILVA (only NR);Eukaryota;Amorphea;Obazoa;Opisthokonta;Nucletmycea;Fungi;Dikarya;Ascomycota;Taphrinomycotina;Pneumocystidomycetes;Pneumocystidales;Pneumocystidaceae;Pneumocystis;";"0.0";"0";"6";"6";"0";"6";"0";"430518";"5766"
"LOK1378_1mm";"SILVA (only NR);Eukaryota;Amorphea;Obazoa;Opisthokonta;Nucletmycea;Fungi;Dikarya;Ascomycota;Taphrinomycotina;Schizosaccharomycetes;";"0.0";"0";"26";"25";"0";"25";"1";"430499";"5766"
"LOK1378_1mm";"SILVA (only NR);Eukaryota;Amorphea;Obazoa;Opisthokonta;Nucletmycea;Fungi;Dikarya;Ascomycota;Taphrinomycotina;Schizosaccharomycetes;Schizosaccharomycetales;";"0.0";"0";"26";"25";"0";"25";"1";"430499";"5766"
"LOK1378_1mm";"SILVA (only NR);Eukaryota;Amorphea;Obazoa;Opisthokonta;Nucletmycea;Fungi;Dikarya;Ascomycota;Taphrinomycotina;Schizosaccharomycetes;Schizosaccharomycetales;Schizosaccharomycetaceae;";"0.0";"0";"26";"25";"0";"25";"1";"430499";"5766"
"LOK1378_1mm";"SILVA (only NR);Eukaryota;Amorphea;Obazoa;Opisthokonta;Nucletmycea;Fungi;Dikarya;Ascomycota;Taphrinomycotina;Schizosaccharomycetes;Schizosaccharomycetales;Schizosaccharomycetaceae;Schizosaccharomyces;";"0.0";"0";"26";"25";"0";"25";"1";"430499";"5766"
"LOK1378_1mm";"SILVA (only NR);Eukaryota;Amorphea;Obazoa;Opisthokonta;Nucletmycea;Fungi;Dikarya;Ascomycota;Taphrinomycotina;Taphrinomycetes;";"0.0";"0";"29";"29";"0";"29";"0";"430495";"5766"
"LOK1378_1mm";"SILVA (only NR);Eukaryota;Amorphea;Obazoa;Opisthokonta;Nucletmycea;Fungi;Dikarya;Ascomycota;Taphrinomycotina;Taphrinomycetes;Taphrinales;";"0.0";"0";"29";"29";"0";"29";"0";"430495";"5766"
"LOK1378_1mm";"SILVA (only NR);Eukaryota;Amorphea;Obazoa;Opisthokonta;Nucletmycea;Fungi;Dikarya;Ascomycota;Taphrinomycotina;Taphrinomycetes;Taphrinales;Protomycetaceae;";"0.0";"0";"4";"4";"0";"4";"0";"430520";"5766"
"LOK1378_1mm";"SILVA (only NR);Eukaryota;Amorphea;Obazoa;Opisthokonta;Nucletmycea;Fungi;Dikarya;Ascomycota;Taphrinomycotina;Taphrinomycetes;Taphrinales;Protomycetaceae;Protomyces;";"0.0";"0";"4";"4";"0";"4";"0";"430520";"5766"
"LOK1378_1mm";"SILVA (only NR);Eukaryota;Amorphea;Obazoa;Opisthokonta;Nucletmycea;Fungi;Dikarya;Ascomycota;Taphrinomycotina;Taphrinomycetes;Taphrinales;Taphrinaceae;";"0.0";"0";"23";"23";"0";"23";"0";"430501";"5766"
"LOK1378_1mm";"SILVA (only NR);Eukaryota;Amorphea;Obazoa;Opisthokonta;Nucletmycea;Fungi;Dikarya;Ascomycota;Taphrinomycotina;Taphrinomycetes;Taphrinales;Taphrinaceae;Taphrina;";"0.0";"0";"23";"23";"0";"23";"0";"430501";"5766"
"LOK1378_1mm";"SILVA (only NR);Eukaryota;Amorphea;Obazoa;Opisthokonta;Nucletmycea;Fungi;Dikarya;Basidiomycota;";"0.0";"0";"2538";"2447";"0";"2447";"91";"428077";"5766"
"LOK1378_1mm";"SILVA (only NR);Eukaryota;Amorphea;Obazoa;Opisthokonta;Nucletmycea;Fungi;Dikarya;Basidiomycota;Agaricomycotina;";"0.0";"0";"1366";"1316";"0";"1316";"50";"429208";"5766"
"LOK1378_1mm";"SILVA (only NR);Eukaryota;Amorphea;Obazoa;Opisthokonta;Nucletmycea;Fungi;Dikarya;Basidiomycota;Agaricomycotina;Agaricomycetes;";"0.0";"0";"864";"819";"0";"819";"45";"429705";"5766"
"LOK1378_1mm";"SILVA (only NR);Eukaryota;Amorphea;Obazoa;Opisthokonta;Nucletmycea;Fungi;Dikarya;Basidiomycota;Agaricomycotina;Agaricomycetes;Agaricales;";"0.0";"0";"303";"285";"0";"285";"18";"430239";"5766"
"LOK1378_1mm";"SILVA (only NR);Eukaryota;Amorphea;Obazoa;Opisthokonta;Nucletmycea;Fungi;Dikarya;Basidiomycota;Agaricomycotina;Agaricomycetes;Agaricales;Agaricaceae;";"0.0";"0";"11";"11";"0";"11";"0";"430513";"5766"
"LOK1378_1mm";"SILVA (only NR);Eukaryota;Amorphea;Obazoa;Opisthokonta;Nucletmycea;Fungi;Dikarya;Basidiomycota;Agaricomycotina;Agaricomycetes;Agaricales;Agaricaceae;Agaricus;";"0.0";"0";"4";"4";"0";"4";"0";"430520";"5766"
"LOK1378_1mm";"SILVA (only NR);Eukaryota;Amorphea;Obazoa;Opisthokonta;Nucletmycea;Fungi;Dikarya;Basidiomycota;Agaricomycotina;Agaricomycetes;Agaricales;Agaricaceae;Leucoagaricus;";"0.0";"0";"5";"5";"0";"5";"0";"430519";"5766"
"LOK1378_1mm";"SILVA (only NR);Eukaryota;Amorphea;Obazoa;Opisthokonta;Nucletmycea;Fungi;Dikarya;Basidiomycota;Agaricomycotina;Agaricomycetes;Agaricales;Agaricaceae;Macrolepiota;";"0.0";"0";"1";"1";"0";"1";"0";"430523";"5766"
"LOK1378_1mm";"SILVA (only NR);Eukaryota;Amorphea;Obazoa;Opisthokonta;Nucletmycea;Fungi;Dikarya;Basidiomycota;Agaricomycotina;Agaricomycetes;Agaricales;Agrocybe;";"0.0";"0";"1";"1";"0";"1";"0";"430523";"5766"
"LOK1378_1mm";"SILVA (only NR);Eukaryota;Amorphea;Obazoa;Opisthokonta;Nucletmycea;Fungi;Dikarya;Basidiomycota;Agaricomycotina;Agaricomycetes;Agaricales;Amanitaceae;";"0.0";"0";"8";"4";"0";"4";"4";"430520";"5766"
"LOK1378_1mm";"SILVA (only NR);Eukaryota;Amorphea;Obazoa;Opisthokonta;Nucletmycea;Fungi;Dikarya;Basidiomycota;Agaricomycotina;Agaricomycetes;Agaricales;Amanitaceae;Amanita;";"0.0";"0";"8";"4";"0";"4";"4";"430520";"5766"
"LOK1378_1mm";"SILVA (only NR);Eukaryota;Amorphea;Obazoa;Opisthokonta;Nucletmycea;Fungi;Dikarya;Basidiomycota;Agaricomycotina;Agaricomycetes;Agaricales;Ampulloclitocybe;";"0.0";"0";"1";"1";"0";"1";"0";"430523";"5766"
"LOK1378_1mm";"SILVA (only NR);Eukaryota;Amorphea;Obazoa;Opisthokonta;Nucletmycea;Fungi;Dikarya;Basidiomycota;Agaricomycotina;Agaricomycetes;Agaricales;Baeospora;";"0.0";"0";"1";"1";"0";"1";"0";"430523";"5766"
"LOK1378_1mm";"SILVA (only NR);Eukaryota;Amorphea;Obazoa;Opisthokonta;Nucletmycea;Fungi;Dikarya;Basidiomycota;Agaricomycotina;Agaricomycetes;Agaricales;Bolbitiaceae;";"0.0";"0";"3";"2";"0";"2";"1";"430522";"5766"
"LOK1378_1mm";"SILVA (only NR);Eukaryota;Amorphea;Obazoa;Opisthokonta;Nucletmycea;Fungi;Dikarya;Basidiomycota;Agaricomycotina;Agaricomycetes;Agaricales;Bolbitiaceae;Conocybe;";"0.0";"0";"3";"2";"0";"2";"1";"430522";"5766"
"LOK1378_1mm";"SILVA (only NR);Eukaryota;Amorphea;Obazoa;Opisthokonta;Nucletmycea;Fungi;Dikarya;Basidiomycota;Agaricomycotina;Agaricomycetes;Agaricales;Bolbitius;";"0.0";"0";"2";"2";"0";"2";"0";"430522";"5766"
"LOK1378_1mm";"SILVA (only NR);Eukaryota;Amorphea;Obazoa;Opisthokonta;Nucletmycea;Fungi;Dikarya;Basidiomycota;Agaricomycotina;Agaricomycetes;Agaricales;Calathella;";"0.0";"0";"1";"1";"0";"1";"0";"430523";"5766"
"LOK1378_1mm";"SILVA (only NR);Eukaryota;Amorphea;Obazoa;Opisthokonta;Nucletmycea;Fungi;Dikarya;Basidiomycota;Agaricomycotina;Agaricomycetes;Agaricales;Calvatia;";"0.0";"0";"1";"1";"0";"1";"0";"430523";"5766"
"LOK1378_1mm";"SILVA (only NR);Eukaryota;Amorphea;Obazoa;Opisthokonta;Nucletmycea;Fungi;Dikarya;Basidiomycota;Agaricomycotina;Agaricomycetes;Agaricales;Catathelasma;";"0.0";"0";"1";"1";"0";"1";"0";"430523";"5766"
"LOK1378_1mm";"SILVA (only NR);Eukaryota;Amorphea;Obazoa;Opisthokonta;Nucletmycea;Fungi;Dikarya;Basidiomycota;Agaricomycotina;Agaricomycetes;Agaricales;Chamaeota;";"0.0";"0";"1";"1";"0";"1";"0";"430523";"5766"
"LOK1378_1mm";"SILVA (only NR);Eukaryota;Amorphea;Obazoa;Opisthokonta;Nucletmycea;Fungi;Dikarya;Basidiomycota;Agaricomycotina;Agaricomycetes;Agaricales;Chlorophyllum;";"0.0";"0";"1";"1";"0";"1";"0";"430523";"5766"
"LOK1378_1mm";"SILVA (only NR);Eukaryota;Amorphea;Obazoa;Opisthokonta;Nucletmycea;Fungi;Dikarya;Basidiomycota;Agaricomycotina;Agaricomycetes;Agaricales;Chondrostereum;";"0.0";"0";"1";"1";"0";"1";"0";"430523";"5766"
"LOK1378_1mm";"SILVA (only NR);Eukaryota;Amorphea;Obazoa;Opisthokonta;Nucletmycea;Fungi;Dikarya;Basidiomycota;Agaricomycotina;Agaricomycetes;Agaricales;Chromosera;";"0.0";"0";"1";"1";"0";"1";"0";"430523";"5766"
"LOK1378_1mm";"SILVA (only NR);Eukaryota;Amorphea;Obazoa;Opisthokonta;Nucletmycea;Fungi;Dikarya;Basidiomycota;Agaricomycotina;Agaricomycetes;Agaricales;Chrysomphalina;";"0.0";"0";"2";"2";"0";"2";"0";"430522";"5766"
"LOK1378_1mm";"SILVA (only NR);Eukaryota;Amorphea;Obazoa;Opisthokonta;Nucletmycea;Fungi;Dikarya;Basidiomycota;Agaricomycotina;Agaricomycetes;Agaricales;Clavaria;";"0.0";"0";"1";"1";"0";"1";"0";"430523";"5766"
"LOK1378_1mm";"SILVA (only NR);Eukaryota;Amorphea;Obazoa;Opisthokonta;Nucletmycea;Fungi;Dikarya;Basidiomycota;Agaricomycotina;Agaricomycetes;Agaricales;Clitocybe;";"0.0";"0";"2";"2";"0";"2";"0";"430522";"5766"
"LOK1378_1mm";"SILVA (only NR);Eukaryota;Amorphea;Obazoa;Opisthokonta;Nucletmycea;Fungi;Dikarya;Basidiomycota;Agaricomycotina;Agaricomycetes;Agaricales;Coprinopsis;";"0.0";"0";"2";"1";"0";"1";"1";"430523";"5766"
"LOK1378_1mm";"SILVA (only NR);Eukaryota;Amorphea;Obazoa;Opisthokonta;Nucletmycea;Fungi;Dikarya;Basidiomycota;Agaricomycotina;Agaricomycetes;Agaricales;Corneriella;";"0.0";"0";"1";"1";"0";"1";"0";"430523";"5766"
"LOK1378_1mm";"SILVA (only NR);Eukaryota;Amorphea;Obazoa;Opisthokonta;Nucletmycea;Fungi;Dikarya;Basidiomycota;Agaricomycotina;Agaricomycetes;Agaricales;Cortinariaceae;";"0.0";"0";"4";"4";"0";"4";"0";"430520";"5766"
"LOK1378_1mm";"SILVA (only NR);Eukaryota;Amorphea;Obazoa;Opisthokonta;Nucletmycea;Fungi;Dikarya;Basidiomycota;Agaricomycotina;Agaricomycetes;Agaricales;Cortinariaceae;Cortinarius;";"0.0";"0";"4";"4";"0";"4";"0";"430520";"5766"
"LOK1378_1mm";"SILVA (only NR);Eukaryota;Amorphea;Obazoa;Opisthokonta;Nucletmycea;Fungi;Dikarya;Basidiomycota;Agaricomycotina;Agaricomycetes;Agaricales;Crepidotaceae;";"0.0";"0";"2";"2";"0";"2";"0";"430522";"5766"
"LOK1378_1mm";"SILVA (only NR);Eukaryota;Amorphea;Obazoa;Opisthokonta;Nucletmycea;Fungi;Dikarya;Basidiomycota;Agaricomycotina;Agaricomycetes;Agaricales;Crepidotaceae;Crepidotus;";"0.0";"0";"1";"1";"0";"1";"0";"430523";"5766"
"LOK1378_1mm";"SILVA (only NR);Eukaryota;Amorphea;Obazoa;Opisthokonta;Nucletmycea;Fungi;Dikarya;Basidiomycota;Agaricomycotina;Agaricomycetes;Agaricales;Cuphophyllus;";"0.0";"0";"1";"1";"0";"1";"0";"430523";"5766"
"LOK1378_1mm";"SILVA (only NR);Eukaryota;Amorphea;Obazoa;Opisthokonta;Nucletmycea;Fungi;Dikarya;Basidiomycota;Agaricomycotina;Agaricomycetes;Agaricales;Cyathus;";"0.0";"0";"1";"1";"0";"1";"0";"430523";"5766"
"LOK1378_1mm";"SILVA (only NR);Eukaryota;Amorphea;Obazoa;Opisthokonta;Nucletmycea;Fungi;Dikarya;Basidiomycota;Agaricomycotina;Agaricomycetes;Agaricales;Cyphellaceae;";"0.0";"0";"3";"3";"0";"3";"0";"430521";"5766"
"LOK1378_1mm";"SILVA (only NR);Eukaryota;Amorphea;Obazoa;Opisthokonta;Nucletmycea;Fungi;Dikarya;Basidiomycota;Agaricomycotina;Agaricomycetes;Agaricales;Cyphellaceae;Cyphellopsis;";"0.0";"0";"1";"1";"0";"1";"0";"430523";"5766"
"LOK1378_1mm";"SILVA (only NR);Eukaryota;Amorphea;Obazoa;Opisthokonta;Nucletmycea;Fungi;Dikarya;Basidiomycota;Agaricomycotina;Agaricomycetes;Agaricales;Cyphellaceae;Globulicium;";"0.0";"0";"1";"1";"0";"1";"0";"430523";"5766"
"LOK1378_1mm";"SILVA (only NR);Eukaryota;Amorphea;Obazoa;Opisthokonta;Nucletmycea;Fungi;Dikarya;Basidiomycota;Agaricomycotina;Agaricomycetes;Agaricales;Cyphellaceae;Halocyphina;";"0.0";"0";"1";"1";"0";"1";"0";"430523";"5766"
"LOK1378_1mm";"SILVA (only NR);Eukaryota;Amorphea;Obazoa;Opisthokonta;Nucletmycea;Fungi;Dikarya;Basidiomycota;Agaricomycotina;Agaricomycetes;Agaricales;Cystoderma;";"0.0";"0";"1";"1";"0";"1";"0";"430523";"5766"
"LOK1378_1mm";"SILVA (only NR);Eukaryota;Amorphea;Obazoa;Opisthokonta;Nucletmycea;Fungi;Dikarya;Basidiomycota;Agaricomycotina;Agaricomycetes;Agaricales;Entolomataceae;";"0.0";"0";"9";"9";"0";"9";"0";"430515";"5766"
"LOK1378_1mm";"SILVA (only NR);Eukaryota;Amorphea;Obazoa;Opisthokonta;Nucletmycea;Fungi;Dikarya;Basidiomycota;Agaricomycotina;Agaricomycetes;Agaricales;Entolomataceae;Clitopilus;";"0.0";"0";"2";"2";"0";"2";"0";"430522";"5766"
"LOK1378_1mm";"SILVA (only NR);Eukaryota;Amorphea;Obazoa;Opisthokonta;Nucletmycea;Fungi;Dikarya;Basidiomycota;Agaricomycotina;Agaricomycetes;Agaricales;Entolomataceae;Entoloma;";"0.0";"0";"4";"4";"0";"4";"0";"430520";"5766"
"LOK1378_1mm";"SILVA (only NR);Eukaryota;Amorphea;Obazoa;Opisthokonta;Nucletmycea;Fungi;Dikarya;Basidiomycota;Agaricomycotina;Agaricomycetes;Agaricales;Entolomataceae;Rhodocybe;";"0.0";"0";"1";"1";"0";"1";"0";"430523";"5766"
"LOK1378_1mm";"SILVA (only NR);Eukaryota;Amorphea;Obazoa;Opisthokonta;Nucletmycea;Fungi;Dikarya;Basidiomycota;Agaricomycotina;Agaricomycetes;Agaricales;Entolomataceae;Rhodocybella;";"0.0";"0";"1";"1";"0";"1";"0";"430523";"5766"
"LOK1378_1mm";"SILVA (only NR);Eukaryota;Amorphea;Obazoa;Opisthokonta;Nucletmycea;Fungi;Dikarya;Basidiomycota;Agaricomycotina;Agaricomycetes;Agaricales;Entolomataceae;Richoniella;";"0.0";"0";"1";"1";"0";"1";"0";"430523";"5766"
"LOK1378_1mm";"SILVA (only NR);Eukaryota;Amorphea;Obazoa;Opisthokonta;Nucletmycea;Fungi;Dikarya;Basidiomycota;Agaricomycotina;Agaricomycetes;Agaricales;Favolaschia;";"0.0";"0";"1";"1";"0";"1";"0";"430523";"5766"
"LOK1378_1mm";"SILVA (only NR);Eukaryota;Amorphea;Obazoa;Opisthokonta;Nucletmycea;Fungi;Dikarya;Basidiomycota;Agaricomycotina;Agaricomycetes;Agaricales;Fistulinaceae;";"0.0";"0";"4";"4";"0";"4";"0";"430520";"5766"
"LOK1378_1mm";"SILVA (only NR);Eukaryota;Amorphea;Obazoa;Opisthokonta;Nucletmycea;Fungi;Dikarya;Basidiomycota;Agaricomycotina;Agaricomycetes;Agaricales;Fistulinaceae;Fistulina;";"0.0";"0";"4";"4";"0";"4";"0";"430520";"5766"
"LOK1378_1mm";"SILVA (only NR);Eukaryota;Amorphea;Obazoa;Opisthokonta;Nucletmycea;Fungi;Dikarya;Basidiomycota;Agaricomycotina;Agaricomycetes;Agaricales;Galerina;";"0.0";"0";"1";"1";"0";"1";"0";"430523";"5766"
"LOK1378_1mm";"SILVA (only NR);Eukaryota;Amorphea;Obazoa;Opisthokonta;Nucletmycea;Fungi;Dikarya;Basidiomycota;Agaricomycotina;Agaricomycetes;Agaricales;Guyanagarika;";"0.0";"0";"1";"1";"0";"1";"0";"430523";"5766"
"LOK1378_1mm";"SILVA (only NR);Eukaryota;Amorphea;Obazoa;Opisthokonta;Nucletmycea;Fungi;Dikarya;Basidiomycota;Agaricomycotina;Agaricomycetes;Agaricales;Hebeloma;";"0.0";"0";"1";"0";"0";"0";"1";"430524";"5766"
"LOK1378_1mm";"SILVA (only NR);Eukaryota;Amorphea;Obazoa;Opisthokonta;Nucletmycea;Fungi;Dikarya;Basidiomycota;Agaricomycotina;Agaricomycetes;Agaricales;Henningsomyces;";"0.0";"0";"1";"1";"0";"1";"0";"430523";"5766"
"LOK1378_1mm";"SILVA (only NR);Eukaryota;Amorphea;Obazoa;Opisthokonta;Nucletmycea;Fungi;Dikarya;Basidiomycota;Agaricomycotina;Agaricomycetes;Agaricales;Hodophilus;";"0.0";"0";"1";"1";"0";"1";"0";"430523";"5766"
"LOK1378_1mm";"SILVA (only NR);Eukaryota;Amorphea;Obazoa;Opisthokonta;Nucletmycea;Fungi;Dikarya;Basidiomycota;Agaricomycotina;Agaricomycetes;Agaricales;Hohenbuehelia;";"0.0";"0";"1";"1";"0";"1";"0";"430523";"5766"
"LOK1378_1mm";"SILVA (only NR);Eukaryota;Amorphea;Obazoa;Opisthokonta;Nucletmycea;Fungi;Dikarya;Basidiomycota;Agaricomycotina;Agaricomycetes;Agaricales;Hygrophoraceae;";"0.0";"0";"29";"27";"0";"27";"2";"430497";"5766"
"LOK1378_1mm";"SILVA (only NR);Eukaryota;Amorphea;Obazoa;Opisthokonta;Nucletmycea;Fungi;Dikarya;Basidiomycota;Agaricomycotina;Agaricomycetes;Agaricales;Hygrophoraceae;Dictyonema;";"0.0";"0";"3";"3";"0";"3";"0";"430521";"5766"
"LOK1378_1mm";"SILVA (only NR);Eukaryota;Amorphea;Obazoa;Opisthokonta;Nucletmycea;Fungi;Dikarya;Basidiomycota;Agaricomycotina;Agaricomycetes;Agaricales;Hygrophoraceae;Gliophorus;";"0.0";"0";"5";"5";"0";"5";"0";"430519";"5766"
"LOK1378_1mm";"SILVA (only NR);Eukaryota;Amorphea;Obazoa;Opisthokonta;Nucletmycea;Fungi;Dikarya;Basidiomycota;Agaricomycotina;Agaricomycetes;Agaricales;Hygrophoraceae;Humidicutis;";"0.0";"0";"2";"2";"0";"2";"0";"430522";"5766"
"LOK1378_1mm";"SILVA (only NR);Eukaryota;Amorphea;Obazoa;Opisthokonta;Nucletmycea;Fungi;Dikarya;Basidiomycota;Agaricomycotina;Agaricomycetes;Agaricales;Hygrophoraceae;Hygroaster;";"0.0";"0";"2";"2";"0";"2";"0";"430522";"5766"
"LOK1378_1mm";"SILVA (only NR);Eukaryota;Amorphea;Obazoa;Opisthokonta;Nucletmycea;Fungi;Dikarya;Basidiomycota;Agaricomycotina;Agaricomycetes;Agaricales;Hygrophoraceae;Hygrocybe;";"0.0";"0";"11";"10";"0";"10";"1";"430514";"5766"
"LOK1378_1mm";"SILVA (only NR);Eukaryota;Amorphea;Obazoa;Opisthokonta;Nucletmycea;Fungi;Dikarya;Basidiomycota;Agaricomycotina;Agaricomycetes;Agaricales;Hygrophoraceae;Hygrophorus;";"0.0";"0";"5";"4";"0";"4";"1";"430520";"5766"
"LOK1378_1mm";"SILVA (only NR);Eukaryota;Amorphea;Obazoa;Opisthokonta;Nucletmycea;Fungi;Dikarya;Basidiomycota;Agaricomycotina;Agaricomycetes;Agaricales;Hygrophoraceae;Typhula;";"0.0";"0";"1";"1";"0";"1";"0";"430523";"5766"
"LOK1378_1mm";"SILVA (only NR);Eukaryota;Amorphea;Obazoa;Opisthokonta;Nucletmycea;Fungi;Dikarya;Basidiomycota;Agaricomycotina;Agaricomycetes;Agaricales;Incertae Sedis;";"0.0";"0";"1";"1";"0";"1";"0";"430523";"5766"
"LOK1378_1mm";"SILVA (only NR);Eukaryota;Amorphea;Obazoa;Opisthokonta;Nucletmycea;Fungi;Dikarya;Basidiomycota;Agaricomycotina;Agaricomycetes;Agaricales;Incertae Sedis;Dendrothele;";"0.0";"0";"1";"1";"0";"1";"0";"430523";"5766"
"LOK1378_1mm";"SILVA (only NR);Eukaryota;Amorphea;Obazoa;Opisthokonta;Nucletmycea;Fungi;Dikarya;Basidiomycota;Agaricomycotina;Agaricomycetes;Agaricales;Inocybaceae;";"0.0";"0";"5";"5";"0";"5";"0";"430519";"5766"
"LOK1378_1mm";"SILVA (only NR);Eukaryota;Amorphea;Obazoa;Opisthokonta;Nucletmycea;Fungi;Dikarya;Basidiomycota;Agaricomycotina;Agaricomycetes;Agaricales;Inocybaceae;Inocybe;";"0.0";"0";"5";"5";"0";"5";"0";"430519";"5766"
"LOK1378_1mm";"SILVA (only NR);Eukaryota;Amorphea;Obazoa;Opisthokonta;Nucletmycea;Fungi;Dikarya;Basidiomycota;Agaricomycotina;Agaricomycetes;Agaricales;Limnoperdon;";"0.0";"0";"1";"1";"0";"1";"0";"430523";"5766"
"LOK1378_1mm";"SILVA (only NR);Eukaryota;Amorphea;Obazoa;Opisthokonta;Nucletmycea;Fungi;Dikarya;Basidiomycota;Agaricomycotina;Agaricomycetes;Agaricales;Lyophyllaceae;";"0.0";"0";"4";"4";"0";"4";"0";"430520";"5766"
"LOK1378_1mm";"SILVA (only NR);Eukaryota;Amorphea;Obazoa;Opisthokonta;Nucletmycea;Fungi;Dikarya;Basidiomycota;Agaricomycotina;Agaricomycetes;Agaricales;Lyophyllaceae;Asterophora;";"0.0";"0";"3";"3";"0";"3";"0";"430521";"5766"
"LOK1378_1mm";"SILVA (only NR);Eukaryota;Amorphea;Obazoa;Opisthokonta;Nucletmycea;Fungi;Dikarya;Basidiomycota;Agaricomycotina;Agaricomycetes;Agaricales;Lyophyllaceae;Hypsizygus;";"0.0";"0";"1";"1";"0";"1";"0";"430523";"5766"
"LOK1378_1mm";"SILVA (only NR);Eukaryota;Amorphea;Obazoa;Opisthokonta;Nucletmycea;Fungi;Dikarya;Basidiomycota;Agaricomycotina;Agaricomycetes;Agaricales;Lyophyllum;";"0.0";"0";"2";"1";"0";"1";"1";"430523";"5766"
"LOK1378_1mm";"SILVA (only NR);Eukaryota;Amorphea;Obazoa;Opisthokonta;Nucletmycea;Fungi;Dikarya;Basidiomycota;Agaricomycotina;Agaricomycetes;Agaricales;Marasmiaceae;";"0.0";"0";"15";"15";"0";"15";"0";"430509";"5766"
"LOK1378_1mm";"SILVA (only NR);Eukaryota;Amorphea;Obazoa;Opisthokonta;Nucletmycea;Fungi;Dikarya;Basidiomycota;Agaricomycotina;Agaricomycetes;Agaricales;Marasmiaceae;Campanella;";"0.0";"0";"1";"1";"0";"1";"0";"430523";"5766"
"LOK1378_1mm";"SILVA (only NR);Eukaryota;Amorphea;Obazoa;Opisthokonta;Nucletmycea;Fungi;Dikarya;Basidiomycota;Agaricomycotina;Agaricomycetes;Agaricales;Marasmiaceae;Chaetocalathus;";"0.0";"0";"1";"1";"0";"1";"0";"430523";"5766"
"LOK1378_1mm";"SILVA (only NR);Eukaryota;Amorphea;Obazoa;Opisthokonta;Nucletmycea;Fungi;Dikarya;Basidiomycota;Agaricomycotina;Agaricomycetes;Agaricales;Marasmiaceae;Crinipellis;";"0.0";"0";"1";"1";"0";"1";"0";"430523";"5766"
"LOK1378_1mm";"SILVA (only NR);Eukaryota;Amorphea;Obazoa;Opisthokonta;Nucletmycea;Fungi;Dikarya;Basidiomycota;Agaricomycotina;Agaricomycetes;Agaricales;Marasmiaceae;Marasmius;";"0.0";"0";"3";"3";"0";"3";"0";"430521";"5766"
"LOK1378_1mm";"SILVA (only NR);Eukaryota;Amorphea;Obazoa;Opisthokonta;Nucletmycea;Fungi;Dikarya;Basidiomycota;Agaricomycotina;Agaricomycetes;Agaricales;Marasmiaceae;Moniliophthora;";"0.0";"0";"2";"2";"0";"2";"0";"430522";"5766"
"LOK1378_1mm";"SILVA (only NR);Eukaryota;Amorphea;Obazoa;Opisthokonta;Nucletmycea;Fungi;Dikarya;Basidiomycota;Agaricomycotina;Agaricomycetes;Agaricales;Marasmiaceae;Neocampanella;";"0.0";"0";"1";"1";"0";"1";"0";"430523";"5766"
"LOK1378_1mm";"SILVA (only NR);Eukaryota;Amorphea;Obazoa;Opisthokonta;Nucletmycea;Fungi;Dikarya;Basidiomycota;Agaricomycotina;Agaricomycetes;Agaricales;Marasmiaceae;uncultured;";"0.0";"0";"5";"5";"0";"5";"0";"430519";"5766"
"LOK1378_1mm";"SILVA (only NR);Eukaryota;Amorphea;Obazoa;Opisthokonta;Nucletmycea;Fungi;Dikarya;Basidiomycota;Agaricomycotina;Agaricomycetes;Agaricales;Megacollybia;";"0.0";"0";"1";"1";"0";"1";"0";"430523";"5766"
"LOK1378_1mm";"SILVA (only NR);Eukaryota;Amorphea;Obazoa;Opisthokonta;Nucletmycea;Fungi;Dikarya;Basidiomycota;Agaricomycotina;Agaricomycetes;Agaricales;Mycocalia;";"0.0";"0";"1";"1";"0";"1";"0";"430523";"5766"
"LOK1378_1mm";"SILVA (only NR);Eukaryota;Amorphea;Obazoa;Opisthokonta;Nucletmycea;Fungi;Dikarya;Basidiomycota;Agaricomycotina;Agaricomycetes;Agaricales;Neohygrocybe;";"0.0";"0";"3";"1";"0";"1";"2";"430523";"5766"
"LOK1378_1mm";"SILVA (only NR);Eukaryota;Amorphea;Obazoa;Opisthokonta;Nucletmycea;Fungi;Dikarya;Basidiomycota;Agaricomycotina;Agaricomycetes;Agaricales;Nia;";"0.0";"0";"1";"1";"0";"1";"0";"430523";"5766"
"LOK1378_1mm";"SILVA (only NR);Eukaryota;Amorphea;Obazoa;Opisthokonta;Nucletmycea;Fungi;Dikarya;Basidiomycota;Agaricomycotina;Agaricomycetes;Agaricales;Nidula;";"0.0";"0";"1";"1";"0";"1";"0";"430523";"5766"
"LOK1378_1mm";"SILVA (only NR);Eukaryota;Amorphea;Obazoa;Opisthokonta;Nucletmycea;Fungi;Dikarya;Basidiomycota;Agaricomycotina;Agaricomycetes;Agaricales;Omphalotaceae;";"0.0";"0";"9";"9";"0";"9";"0";"430515";"5766"
"LOK1378_1mm";"SILVA (only NR);Eukaryota;Amorphea;Obazoa;Opisthokonta;Nucletmycea;Fungi;Dikarya;Basidiomycota;Agaricomycotina;Agaricomycetes;Agaricales;Omphalotaceae;Collybia;";"0.0";"0";"1";"1";"0";"1";"0";"430523";"5766"
"LOK1378_1mm";"SILVA (only NR);Eukaryota;Amorphea;Obazoa;Opisthokonta;Nucletmycea;Fungi;Dikarya;Basidiomycota;Agaricomycotina;Agaricomycetes;Agaricales;Omphalotaceae;Gymnopus;";"0.0";"0";"2";"2";"0";"2";"0";"430522";"5766"
"LOK1378_1mm";"SILVA (only NR);Eukaryota;Amorphea;Obazoa;Opisthokonta;Nucletmycea;Fungi;Dikarya;Basidiomycota;Agaricomycotina;Agaricomycetes;Agaricales;Omphalotaceae;Lentinula;";"0.0";"0";"3";"3";"0";"3";"0";"430521";"5766"
"LOK1378_1mm";"SILVA (only NR);Eukaryota;Amorphea;Obazoa;Opisthokonta;Nucletmycea;Fungi;Dikarya;Basidiomycota;Agaricomycotina;Agaricomycetes;Agaricales;Omphalotaceae;Omphalotus;";"0.0";"0";"1";"1";"0";"1";"0";"430523";"5766"
"LOK1378_1mm";"SILVA (only NR);Eukaryota;Amorphea;Obazoa;Opisthokonta;Nucletmycea;Fungi;Dikarya;Basidiomycota;Agaricomycotina;Agaricomycetes;Agaricales;Omphalotaceae;uncultured;";"0.0";"0";"2";"2";"0";"2";"0";"430522";"5766"
"LOK1378_1mm";"SILVA (only NR);Eukaryota;Amorphea;Obazoa;Opisthokonta;Nucletmycea;Fungi;Dikarya;Basidiomycota;Agaricomycotina;Agaricomycetes;Agaricales;Pholiotina;";"0.0";"0";"1";"1";"0";"1";"0";"430523";"5766"
"LOK1378_1mm";"SILVA (only NR);Eukaryota;Amorphea;Obazoa;Opisthokonta;Nucletmycea;Fungi;Dikarya;Basidiomycota;Agaricomycotina;Agaricomycetes;Agaricales;Physalacriaceae;";"0.0";"0";"7";"6";"0";"6";"1";"430518";"5766"
"LOK1378_1mm";"SILVA (only NR);Eukaryota;Amorphea;Obazoa;Opisthokonta;Nucletmycea;Fungi;Dikarya;Basidiomycota;Agaricomycotina;Agaricomycetes;Agaricales;Physalacriaceae;Armillaria;";"0.0";"0";"1";"1";"0";"1";"0";"430523";"5766"
"LOK1378_1mm";"SILVA (only NR);Eukaryota;Amorphea;Obazoa;Opisthokonta;Nucletmycea;Fungi;Dikarya;Basidiomycota;Agaricomycotina;Agaricomycetes;Agaricales;Physalacriaceae;Cylindrobasidium;";"0.0";"0";"1";"1";"0";"1";"0";"430523";"5766"
"LOK1378_1mm";"SILVA (only NR);Eukaryota;Amorphea;Obazoa;Opisthokonta;Nucletmycea;Fungi;Dikarya;Basidiomycota;Agaricomycotina;Agaricomycetes;Agaricales;Physalacriaceae;Flammulina;";"0.0";"0";"2";"2";"0";"2";"0";"430522";"5766"
"LOK1378_1mm";"SILVA (only NR);Eukaryota;Amorphea;Obazoa;Opisthokonta;Nucletmycea;Fungi;Dikarya;Basidiomycota;Agaricomycotina;Agaricomycetes;Agaricales;Physalacriaceae;Hymenopellis;";"0.0";"0";"1";"1";"0";"1";"0";"430523";"5766"
"LOK1378_1mm";"SILVA (only NR);Eukaryota;Amorphea;Obazoa;Opisthokonta;Nucletmycea;Fungi;Dikarya;Basidiomycota;Agaricomycotina;Agaricomycetes;Agaricales;Physalacriaceae;Mycotribulus;";"0.0";"0";"1";"0";"0";"0";"1";"430524";"5766"
"LOK1378_1mm";"SILVA (only NR);Eukaryota;Amorphea;Obazoa;Opisthokonta;Nucletmycea;Fungi;Dikarya;Basidiomycota;Agaricomycotina;Agaricomycetes;Agaricales;Physalacriaceae;Physalacria;";"0.0";"0";"1";"1";"0";"1";"0";"430523";"5766"
"LOK1378_1mm";"SILVA (only NR);Eukaryota;Amorphea;Obazoa;Opisthokonta;Nucletmycea;Fungi;Dikarya;Basidiomycota;Agaricomycotina;Agaricomycetes;Agaricales;Pleuroflammula;";"0.0";"0";"1";"1";"0";"1";"0";"430523";"5766"
"LOK1378_1mm";"SILVA (only NR);Eukaryota;Amorphea;Obazoa;Opisthokonta;Nucletmycea;Fungi;Dikarya;Basidiomycota;Agaricomycotina;Agaricomycetes;Agaricales;Pleurotaceae;";"0.0";"0";"8";"8";"0";"8";"0";"430516";"5766"
"LOK1378_1mm";"SILVA (only NR);Eukaryota;Amorphea;Obazoa;Opisthokonta;Nucletmycea;Fungi;Dikarya;Basidiomycota;Agaricomycotina;Agaricomycetes;Agaricales;Pleurotaceae;Pleurotus;";"0.0";"0";"8";"8";"0";"8";"0";"430516";"5766"
"LOK1378_1mm";"SILVA (only NR);Eukaryota;Amorphea;Obazoa;Opisthokonta;Nucletmycea;Fungi;Dikarya;Basidiomycota;Agaricomycotina;Agaricomycetes;Agaricales;Pleurotopsis;";"0.0";"0";"1";"1";"0";"1";"0";"430523";"5766"
"LOK1378_1mm";"SILVA (only NR);Eukaryota;Amorphea;Obazoa;Opisthokonta;Nucletmycea;Fungi;Dikarya;Basidiomycota;Agaricomycotina;Agaricomycetes;Agaricales;Plicaturopsis;";"0.0";"0";"1";"1";"0";"1";"0";"430523";"5766"
"LOK1378_1mm";"SILVA (only NR);Eukaryota;Amorphea;Obazoa;Opisthokonta;Nucletmycea;Fungi;Dikarya;Basidiomycota;Agaricomycotina;Agaricomycetes;Agaricales;Pluteaceae;";"0.0";"0";"9";"9";"0";"9";"0";"430515";"5766"
"LOK1378_1mm";"SILVA (only NR);Eukaryota;Amorphea;Obazoa;Opisthokonta;Nucletmycea;Fungi;Dikarya;Basidiomycota;Agaricomycotina;Agaricomycetes;Agaricales;Pluteaceae;Pluteus;";"0.0";"0";"4";"4";"0";"4";"0";"430520";"5766"
"LOK1378_1mm";"SILVA (only NR);Eukaryota;Amorphea;Obazoa;Opisthokonta;Nucletmycea;Fungi;Dikarya;Basidiomycota;Agaricomycotina;Agaricomycetes;Agaricales;Pluteaceae;Volvariella;";"0.0";"0";"5";"5";"0";"5";"0";"430519";"5766"
"LOK1378_1mm";"SILVA (only NR);Eukaryota;Amorphea;Obazoa;Opisthokonta;Nucletmycea;Fungi;Dikarya;Basidiomycota;Agaricomycotina;Agaricomycetes;Agaricales;Psathyrellaceae;";"0.0";"0";"2";"2";"0";"2";"0";"430522";"5766"
"LOK1378_1mm";"SILVA (only NR);Eukaryota;Amorphea;Obazoa;Opisthokonta;Nucletmycea;Fungi;Dikarya;Basidiomycota;Agaricomycotina;Agaricomycetes;Agaricales;Psathyrellaceae;Psathyrella;";"0.0";"0";"2";"2";"0";"2";"0";"430522";"5766"
"LOK1378_1mm";"SILVA (only NR);Eukaryota;Amorphea;Obazoa;Opisthokonta;Nucletmycea;Fungi;Dikarya;Basidiomycota;Agaricomycotina;Agaricomycetes;Agaricales;Pseudoomphalina;";"0.0";"0";"1";"1";"0";"1";"0";"430523";"5766"
"LOK1378_1mm";"SILVA (only NR);Eukaryota;Amorphea;Obazoa;Opisthokonta;Nucletmycea;Fungi;Dikarya;Basidiomycota;Agaricomycotina;Agaricomycetes;Agaricales;Pseudotricholoma;";"0.0";"0";"1";"1";"0";"1";"0";"430523";"5766"
"LOK1378_1mm";"SILVA (only NR);Eukaryota;Amorphea;Obazoa;Opisthokonta;Nucletmycea;Fungi;Dikarya;Basidiomycota;Agaricomycotina;Agaricomycetes;Agaricales;Pterulaceae;";"0.0";"0";"3";"3";"0";"3";"0";"430521";"5766"
"LOK1378_1mm";"SILVA (only NR);Eukaryota;Amorphea;Obazoa;Opisthokonta;Nucletmycea;Fungi;Dikarya;Basidiomycota;Agaricomycotina;Agaricomycetes;Agaricales;Pterulaceae;Aphanobasidium;";"0.0";"0";"1";"1";"0";"1";"0";"430523";"5766"
"LOK1378_1mm";"SILVA (only NR);Eukaryota;Amorphea;Obazoa;Opisthokonta;Nucletmycea;Fungi;Dikarya;Basidiomycota;Agaricomycotina;Agaricomycetes;Agaricales;Pterulaceae;Pterula;";"0.0";"0";"1";"1";"0";"1";"0";"430523";"5766"
"LOK1378_1mm";"SILVA (only NR);Eukaryota;Amorphea;Obazoa;Opisthokonta;Nucletmycea;Fungi;Dikarya;Basidiomycota;Agaricomycotina;Agaricomycetes;Agaricales;Rugosomyces;";"0.0";"0";"1";"1";"0";"1";"0";"430523";"5766"
"LOK1378_1mm";"SILVA (only NR);Eukaryota;Amorphea;Obazoa;Opisthokonta;Nucletmycea;Fungi;Dikarya;Basidiomycota;Agaricomycotina;Agaricomycetes;Agaricales;Sarcomyxa;";"0.0";"0";"1";"1";"0";"1";"0";"430523";"5766"
"LOK1378_1mm";"SILVA (only NR);Eukaryota;Amorphea;Obazoa;Opisthokonta;Nucletmycea;Fungi;Dikarya;Basidiomycota;Agaricomycotina;Agaricomycetes;Agaricales;Schizophyllaceae;";"0.0";"0";"5";"4";"0";"4";"1";"430520";"5766"
"LOK1378_1mm";"SILVA (only NR);Eukaryota;Amorphea;Obazoa;Opisthokonta;Nucletmycea;Fungi;Dikarya;Basidiomycota;Agaricomycotina;Agaricomycetes;Agaricales;Schizophyllaceae;Grifola;";"0.0";"0";"2";"2";"0";"2";"0";"430522";"5766"
"LOK1378_1mm";"SILVA (only NR);Eukaryota;Amorphea;Obazoa;Opisthokonta;Nucletmycea;Fungi;Dikarya;Basidiomycota;Agaricomycotina;Agaricomycetes;Agaricales;Schizophyllaceae;Schizophyllum;";"0.0";"0";"3";"2";"0";"2";"1";"430522";"5766"
"LOK1378_1mm";"SILVA (only NR);Eukaryota;Amorphea;Obazoa;Opisthokonta;Nucletmycea;Fungi;Dikarya;Basidiomycota;Agaricomycotina;Agaricomycetes;Agaricales;Serendipita;";"0.0";"0";"1";"0";"0";"0";"1";"430524";"5766"
"LOK1378_1mm";"SILVA (only NR);Eukaryota;Amorphea;Obazoa;Opisthokonta;Nucletmycea;Fungi;Dikarya;Basidiomycota;Agaricomycotina;Agaricomycetes;Agaricales;Stephanospora;";"0.0";"0";"1";"1";"0";"1";"0";"430523";"5766"
"LOK1378_1mm";"SILVA (only NR);Eukaryota;Amorphea;Obazoa;Opisthokonta;Nucletmycea;Fungi;Dikarya;Basidiomycota;Agaricomycotina;Agaricomycetes;Agaricales;Stropharia;";"0.0";"0";"2";"2";"0";"2";"0";"430522";"5766"
"LOK1378_1mm";"SILVA (only NR);Eukaryota;Amorphea;Obazoa;Opisthokonta;Nucletmycea;Fungi;Dikarya;Basidiomycota;Agaricomycotina;Agaricomycetes;Agaricales;Strophariaceae;";"0.0";"0";"3";"3";"0";"3";"0";"430521";"5766"
"LOK1378_1mm";"SILVA (only NR);Eukaryota;Amorphea;Obazoa;Opisthokonta;Nucletmycea;Fungi;Dikarya;Basidiomycota;Agaricomycotina;Agaricomycetes;Agaricales;Strophariaceae;Phaeomarasmius;";"0.0";"0";"1";"1";"0";"1";"0";"430523";"5766"
"LOK1378_1mm";"SILVA (only NR);Eukaryota;Amorphea;Obazoa;Opisthokonta;Nucletmycea;Fungi;Dikarya;Basidiomycota;Agaricomycotina;Agaricomycetes;Agaricales;Strophariaceae;Tubaria;";"0.0";"0";"2";"2";"0";"2";"0";"430522";"5766"
"LOK1378_1mm";"SILVA (only NR);Eukaryota;Amorphea;Obazoa;Opisthokonta;Nucletmycea;Fungi;Dikarya;Basidiomycota;Agaricomycotina;Agaricomycetes;Agaricales;Tephrocybe;";"0.0";"0";"1";"1";"0";"1";"0";"430523";"5766"
"LOK1378_1mm";"SILVA (only NR);Eukaryota;Amorphea;Obazoa;Opisthokonta;Nucletmycea;Fungi;Dikarya;Basidiomycota;Agaricomycotina;Agaricomycetes;Agaricales;Termitomyces;";"0.0";"0";"1";"1";"0";"1";"0";"430523";"5766"
"LOK1378_1mm";"SILVA (only NR);Eukaryota;Amorphea;Obazoa;Opisthokonta;Nucletmycea;Fungi;Dikarya;Basidiomycota;Agaricomycotina;Agaricomycetes;Agaricales;Tricholoma;";"0.0";"0";"1";"1";"0";"1";"0";"430523";"5766"
"LOK1378_1mm";"SILVA (only NR);Eukaryota;Amorphea;Obazoa;Opisthokonta;Nucletmycea;Fungi;Dikarya;Basidiomycota;Agaricomycotina;Agaricomycetes;Agaricales;Tricholomataceae;";"0.0";"0";"54";"53";"0";"53";"1";"430471";"5766"
"LOK1378_1mm";"SILVA (only NR);Eukaryota;Amorphea;Obazoa;Opisthokonta;Nucletmycea;Fungi;Dikarya;Basidiomycota;Agaricomycotina;Agaricomycetes;Agaricales;Tricholomataceae;Albomagister;";"0.0";"0";"1";"1";"0";"1";"0";"430523";"5766"
"LOK1378_1mm";"SILVA (only NR);Eukaryota;Amorphea;Obazoa;Opisthokonta;Nucletmycea;Fungi;Dikarya;Basidiomycota;Agaricomycotina;Agaricomycetes;Agaricales;Tricholomataceae;Alloclavaria;";"0.0";"0";"1";"1";"0";"1";"0";"430523";"5766"
"LOK1378_1mm";"SILVA (only NR);Eukaryota;Amorphea;Obazoa;Opisthokonta;Nucletmycea;Fungi;Dikarya;Basidiomycota;Agaricomycotina;Agaricomycetes;Agaricales;Tricholomataceae;Callistosporium;";"0.0";"0";"1";"1";"0";"1";"0";"430523";"5766"
"LOK1378_1mm";"SILVA (only NR);Eukaryota;Amorphea;Obazoa;Opisthokonta;Nucletmycea;Fungi;Dikarya;Basidiomycota;Agaricomycotina;Agaricomycetes;Agaricales;Tricholomataceae;Camarophyllopsis;";"0.0";"0";"1";"1";"0";"1";"0";"430523";"5766"
"LOK1378_1mm";"SILVA (only NR);Eukaryota;Amorphea;Obazoa;Opisthokonta;Nucletmycea;Fungi;Dikarya;Basidiomycota;Agaricomycotina;Agaricomycetes;Agaricales;Tricholomataceae;Camarophyllus;";"0.0";"0";"2";"2";"0";"2";"0";"430522";"5766"
"LOK1378_1mm";"SILVA (only NR);Eukaryota;Amorphea;Obazoa;Opisthokonta;Nucletmycea;Fungi;Dikarya;Basidiomycota;Agaricomycotina;Agaricomycetes;Agaricales;Tricholomataceae;Cheimonophyllum;";"0.0";"0";"1";"1";"0";"1";"0";"430523";"5766"
"LOK1378_1mm";"SILVA (only NR);Eukaryota;Amorphea;Obazoa;Opisthokonta;Nucletmycea;Fungi;Dikarya;Basidiomycota;Agaricomycotina;Agaricomycetes;Agaricales;Tricholomataceae;Cleistocybe;";"0.0";"0";"1";"1";"0";"1";"0";"430523";"5766"
"LOK1378_1mm";"SILVA (only NR);Eukaryota;Amorphea;Obazoa;Opisthokonta;Nucletmycea;Fungi;Dikarya;Basidiomycota;Agaricomycotina;Agaricomycetes;Agaricales;Tricholomataceae;Cystostereum;";"0.0";"0";"1";"1";"0";"1";"0";"430523";"5766"
"LOK1378_1mm";"SILVA (only NR);Eukaryota;Amorphea;Obazoa;Opisthokonta;Nucletmycea;Fungi;Dikarya;Basidiomycota;Agaricomycotina;Agaricomycetes;Agaricales;Tricholomataceae;Dendrocollybia;";"0.0";"0";"1";"1";"0";"1";"0";"430523";"5766"
"LOK1378_1mm";"SILVA (only NR);Eukaryota;Amorphea;Obazoa;Opisthokonta;Nucletmycea;Fungi;Dikarya;Basidiomycota;Agaricomycotina;Agaricomycetes;Agaricales;Tricholomataceae;Granulobasidium;";"0.0";"0";"1";"0";"0";"0";"1";"430524";"5766"
"LOK1378_1mm";"SILVA (only NR);Eukaryota;Amorphea;Obazoa;Opisthokonta;Nucletmycea;Fungi;Dikarya;Basidiomycota;Agaricomycotina;Agaricomycetes;Agaricales;Tricholomataceae;Hemimycena;";"0.0";"0";"1";"1";"0";"1";"0";"430523";"5766"
"LOK1378_1mm";"SILVA (only NR);Eukaryota;Amorphea;Obazoa;Opisthokonta;Nucletmycea;Fungi;Dikarya;Basidiomycota;Agaricomycotina;Agaricomycetes;Agaricales;Tricholomataceae;Hydropus;";"0.0";"0";"2";"2";"0";"2";"0";"430522";"5766"
"LOK1378_1mm";"SILVA (only NR);Eukaryota;Amorphea;Obazoa;Opisthokonta;Nucletmycea;Fungi;Dikarya;Basidiomycota;Agaricomycotina;Agaricomycetes;Agaricales;Tricholomataceae;Infundibulicybe;";"0.0";"0";"1";"1";"0";"1";"0";"430523";"5766"
"LOK1378_1mm";"SILVA (only NR);Eukaryota;Amorphea;Obazoa;Opisthokonta;Nucletmycea;Fungi;Dikarya;Basidiomycota;Agaricomycotina;Agaricomycetes;Agaricales;Tricholomataceae;Lachnella;";"0.0";"0";"1";"1";"0";"1";"0";"430523";"5766"
"LOK1378_1mm";"SILVA (only NR);Eukaryota;Amorphea;Obazoa;Opisthokonta;Nucletmycea;Fungi;Dikarya;Basidiomycota;Agaricomycotina;Agaricomycetes;Agaricales;Tricholomataceae;Laetiporus;";"0.0";"0";"1";"1";"0";"1";"0";"430523";"5766"
"LOK1378_1mm";"SILVA (only NR);Eukaryota;Amorphea;Obazoa;Opisthokonta;Nucletmycea;Fungi;Dikarya;Basidiomycota;Agaricomycotina;Agaricomycetes;Agaricales;Tricholomataceae;Leucopaxillus;";"0.0";"0";"3";"3";"0";"3";"0";"430521";"5766"
"LOK1378_1mm";"SILVA (only NR);Eukaryota;Amorphea;Obazoa;Opisthokonta;Nucletmycea;Fungi;Dikarya;Basidiomycota;Agaricomycotina;Agaricomycetes;Agaricales;Tricholomataceae;Lichenomphalia;";"0.0";"0";"3";"3";"0";"3";"0";"430521";"5766"
"LOK1378_1mm";"SILVA (only NR);Eukaryota;Amorphea;Obazoa;Opisthokonta;Nucletmycea;Fungi;Dikarya;Basidiomycota;Agaricomycotina;Agaricomycetes;Agaricales;Tricholomataceae;Melanoleuca;";"0.0";"0";"1";"1";"0";"1";"0";"430523";"5766"
"LOK1378_1mm";"SILVA (only NR);Eukaryota;Amorphea;Obazoa;Opisthokonta;Nucletmycea;Fungi;Dikarya;Basidiomycota;Agaricomycotina;Agaricomycetes;Agaricales;Tricholomataceae;Mycena;";"0.0";"0";"3";"3";"0";"3";"0";"430521";"5766"
"LOK1378_1mm";"SILVA (only NR);Eukaryota;Amorphea;Obazoa;Opisthokonta;Nucletmycea;Fungi;Dikarya;Basidiomycota;Agaricomycotina;Agaricomycetes;Agaricales;Tricholomataceae;Panellus;";"0.0";"0";"1";"1";"0";"1";"0";"430523";"5766"
"LOK1378_1mm";"SILVA (only NR);Eukaryota;Amorphea;Obazoa;Opisthokonta;Nucletmycea;Fungi;Dikarya;Basidiomycota;Agaricomycotina;Agaricomycetes;Agaricales;Tricholomataceae;Phyllotopsis;";"0.0";"0";"1";"1";"0";"1";"0";"430523";"5766"
"LOK1378_1mm";"SILVA (only NR);Eukaryota;Amorphea;Obazoa;Opisthokonta;Nucletmycea;Fungi;Dikarya;Basidiomycota;Agaricomycotina;Agaricomycetes;Agaricales;Tricholomataceae;Pleurocybella;";"0.0";"0";"1";"1";"0";"1";"0";"430523";"5766"
"LOK1378_1mm";"SILVA (only NR);Eukaryota;Amorphea;Obazoa;Opisthokonta;Nucletmycea;Fungi;Dikarya;Basidiomycota;Agaricomycotina;Agaricomycetes;Agaricales;Tricholomataceae;Pogonoloma;";"0.0";"0";"1";"1";"0";"1";"0";"430523";"5766"
"LOK1378_1mm";"SILVA (only NR);Eukaryota;Amorphea;Obazoa;Opisthokonta;Nucletmycea;Fungi;Dikarya;Basidiomycota;Agaricomycotina;Agaricomycetes;Agaricales;Tricholomataceae;Porpoloma;";"0.0";"0";"1";"1";"0";"1";"0";"430523";"5766"
"LOK1378_1mm";"SILVA (only NR);Eukaryota;Amorphea;Obazoa;Opisthokonta;Nucletmycea;Fungi;Dikarya;Basidiomycota;Agaricomycotina;Agaricomycetes;Agaricales;Tricholomataceae;Porpolomopsis;";"0.0";"0";"1";"1";"0";"1";"0";"430523";"5766"
"LOK1378_1mm";"SILVA (only NR);Eukaryota;Amorphea;Obazoa;Opisthokonta;Nucletmycea;Fungi;Dikarya;Basidiomycota;Agaricomycotina;Agaricomycetes;Agaricales;Tricholomataceae;Pseudoarmillariella;";"0.0";"0";"1";"1";"0";"1";"0";"430523";"5766"
"LOK1378_1mm";"SILVA (only NR);Eukaryota;Amorphea;Obazoa;Opisthokonta;Nucletmycea;Fungi;Dikarya;Basidiomycota;Agaricomycotina;Agaricomycetes;Agaricales;Tricholomataceae;Pseudobaeospora;";"0.0";"0";"2";"2";"0";"2";"0";"430522";"5766"
"LOK1378_1mm";"SILVA (only NR);Eukaryota;Amorphea;Obazoa;Opisthokonta;Nucletmycea;Fungi;Dikarya;Basidiomycota;Agaricomycotina;Agaricomycetes;Agaricales;Tricholomataceae;Pseudoclitocybe;";"0.0";"0";"1";"1";"0";"1";"0";"430523";"5766"
"LOK1378_1mm";"SILVA (only NR);Eukaryota;Amorphea;Obazoa;Opisthokonta;Nucletmycea;Fungi;Dikarya;Basidiomycota;Agaricomycotina;Agaricomycetes;Agaricales;Tricholomataceae;Pseudolaccaria;";"0.0";"0";"1";"1";"0";"1";"0";"430523";"5766"
"LOK1378_1mm";"SILVA (only NR);Eukaryota;Amorphea;Obazoa;Opisthokonta;Nucletmycea;Fungi;Dikarya;Basidiomycota;Agaricomycotina;Agaricomycetes;Agaricales;Tricholomataceae;Singerocybe;";"0.0";"0";"1";"1";"0";"1";"0";"430523";"5766"
"LOK1378_1mm";"SILVA (only NR);Eukaryota;Amorphea;Obazoa;Opisthokonta;Nucletmycea;Fungi;Dikarya;Basidiomycota;Agaricomycotina;Agaricomycetes;Agaricales;Tricholomataceae;Squamanita;";"0.0";"0";"1";"1";"0";"1";"0";"430523";"5766"
"LOK1378_1mm";"SILVA (only NR);Eukaryota;Amorphea;Obazoa;Opisthokonta;Nucletmycea;Fungi;Dikarya;Basidiomycota;Agaricomycotina;Agaricomycetes;Agaricales;Tricholomataceae;Tricholoma;";"0.0";"0";"5";"5";"0";"5";"0";"430519";"5766"
"LOK1378_1mm";"SILVA (only NR);Eukaryota;Amorphea;Obazoa;Opisthokonta;Nucletmycea;Fungi;Dikarya;Basidiomycota;Agaricomycotina;Agaricomycetes;Agaricales;Tricholomataceae;Tricholomopsis;";"0.0";"0";"1";"1";"0";"1";"0";"430523";"5766"
"LOK1378_1mm";"SILVA (only NR);Eukaryota;Amorphea;Obazoa;Opisthokonta;Nucletmycea;Fungi;Dikarya;Basidiomycota;Agaricomycotina;Agaricomycetes;Agaricales;Tulostoma;";"0.0";"0";"1";"1";"0";"1";"0";"430523";"5766"
"LOK1378_1mm";"SILVA (only NR);Eukaryota;Amorphea;Obazoa;Opisthokonta;Nucletmycea;Fungi;Dikarya;Basidiomycota;Agaricomycotina;Agaricomycetes;Agaricales;Verrucospora;";"0.0";"0";"1";"1";"0";"1";"0";"430523";"5766"
"LOK1378_1mm";"SILVA (only NR);Eukaryota;Amorphea;Obazoa;Opisthokonta;Nucletmycea;Fungi;Dikarya;Basidiomycota;Agaricomycotina;Agaricomycetes;Agaricales;uncultured;";"0.0";"0";"22";"22";"0";"22";"0";"430502";"5766"
"LOK1378_1mm";"SILVA (only NR);Eukaryota;Amorphea;Obazoa;Opisthokonta;Nucletmycea;Fungi;Dikarya;Basidiomycota;Agaricomycotina;Agaricomycetes;Amylocorticiales;";"0.0";"0";"4";"4";"0";"4";"0";"430520";"5766"
"LOK1378_1mm";"SILVA (only NR);Eukaryota;Amorphea;Obazoa;Opisthokonta;Nucletmycea;Fungi;Dikarya;Basidiomycota;Agaricomycotina;Agaricomycetes;Amylocorticiales;Amylocorticiaceae;";"0.0";"0";"4";"4";"0";"4";"0";"430520";"5766"
"LOK1378_1mm";"SILVA (only NR);Eukaryota;Amorphea;Obazoa;Opisthokonta;Nucletmycea;Fungi;Dikarya;Basidiomycota;Agaricomycotina;Agaricomycetes;Amylocorticiales;Amylocorticiaceae;Amylocorticium;";"0.0";"0";"2";"2";"0";"2";"0";"430522";"5766"
"LOK1378_1mm";"SILVA (only NR);Eukaryota;Amorphea;Obazoa;Opisthokonta;Nucletmycea;Fungi;Dikarya;Basidiomycota;Agaricomycotina;Agaricomycetes;Amylocorticiales;Amylocorticiaceae;Anomoloma;";"0.0";"0";"1";"1";"0";"1";"0";"430523";"5766"
"LOK1378_1mm";"SILVA (only NR);Eukaryota;Amorphea;Obazoa;Opisthokonta;Nucletmycea;Fungi;Dikarya;Basidiomycota;Agaricomycotina;Agaricomycetes;Amylocorticiales;Amylocorticiaceae;Anomoporia;";"0.0";"0";"1";"1";"0";"1";"0";"430523";"5766"
"LOK1378_1mm";"SILVA (only NR);Eukaryota;Amorphea;Obazoa;Opisthokonta;Nucletmycea;Fungi;Dikarya;Basidiomycota;Agaricomycotina;Agaricomycetes;Atheliales;";"0.0";"0";"3";"3";"0";"3";"0";"430521";"5766"
"LOK1378_1mm";"SILVA (only NR);Eukaryota;Amorphea;Obazoa;Opisthokonta;Nucletmycea;Fungi;Dikarya;Basidiomycota;Agaricomycotina;Agaricomycetes;Atheliales;Atheliaceae;";"0.0";"0";"3";"3";"0";"3";"0";"430521";"5766"
"LOK1378_1mm";"SILVA (only NR);Eukaryota;Amorphea;Obazoa;Opisthokonta;Nucletmycea;Fungi;Dikarya;Basidiomycota;Agaricomycotina;Agaricomycetes;Atheliales;Atheliaceae;Athelia;";"0.0";"0";"2";"2";"0";"2";"0";"430522";"5766"
"LOK1378_1mm";"SILVA (only NR);Eukaryota;Amorphea;Obazoa;Opisthokonta;Nucletmycea;Fungi;Dikarya;Basidiomycota;Agaricomycotina;Agaricomycetes;Atheliales;Atheliaceae;Piloderma;";"0.0";"0";"1";"1";"0";"1";"0";"430523";"5766"
"LOK1378_1mm";"SILVA (only NR);Eukaryota;Amorphea;Obazoa;Opisthokonta;Nucletmycea;Fungi;Dikarya;Basidiomycota;Agaricomycotina;Agaricomycetes;Auriculariales;";"0.0";"0";"26";"26";"0";"26";"0";"430498";"5766"
"LOK1378_1mm";"SILVA (only NR);Eukaryota;Amorphea;Obazoa;Opisthokonta;Nucletmycea;Fungi;Dikarya;Basidiomycota;Agaricomycotina;Agaricomycetes;Auriculariales;Auriculariaceae;";"0.0";"0";"14";"14";"0";"14";"0";"430510";"5766"
"LOK1378_1mm";"SILVA (only NR);Eukaryota;Amorphea;Obazoa;Opisthokonta;Nucletmycea;Fungi;Dikarya;Basidiomycota;Agaricomycotina;Agaricomycetes;Auriculariales;Auriculariaceae;Auricularia;";"0.0";"0";"14";"14";"0";"14";"0";"430510";"5766"
"LOK1378_1mm";"SILVA (only NR);Eukaryota;Amorphea;Obazoa;Opisthokonta;Nucletmycea;Fungi;Dikarya;Basidiomycota;Agaricomycotina;Agaricomycetes;Auriculariales;Exidiaceae;";"0.0";"0";"5";"5";"0";"5";"0";"430519";"5766"
"LOK1378_1mm";"SILVA (only NR);Eukaryota;Amorphea;Obazoa;Opisthokonta;Nucletmycea;Fungi;Dikarya;Basidiomycota;Agaricomycotina;Agaricomycetes;Auriculariales;Exidiaceae;Exidia;";"0.0";"0";"3";"3";"0";"3";"0";"430521";"5766"
"LOK1378_1mm";"SILVA (only NR);Eukaryota;Amorphea;Obazoa;Opisthokonta;Nucletmycea;Fungi;Dikarya;Basidiomycota;Agaricomycotina;Agaricomycetes;Auriculariales;Exidiaceae;Exidiopsis;";"0.0";"0";"1";"1";"0";"1";"0";"430523";"5766"
"LOK1378_1mm";"SILVA (only NR);Eukaryota;Amorphea;Obazoa;Opisthokonta;Nucletmycea;Fungi;Dikarya;Basidiomycota;Agaricomycotina;Agaricomycetes;Auriculariales;Hyaloriaceae;";"0.0";"0";"6";"6";"0";"6";"0";"430518";"5766"
"LOK1378_1mm";"SILVA (only NR);Eukaryota;Amorphea;Obazoa;Opisthokonta;Nucletmycea;Fungi;Dikarya;Basidiomycota;Agaricomycotina;Agaricomycetes;Auriculariales;Hyaloriaceae;Pseudohydnum;";"0.0";"0";"2";"2";"0";"2";"0";"430522";"5766"
"LOK1378_1mm";"SILVA (only NR);Eukaryota;Amorphea;Obazoa;Opisthokonta;Nucletmycea;Fungi;Dikarya;Basidiomycota;Agaricomycotina;Agaricomycetes;Auriculariales;Hyaloriaceae;Tremiscus;";"0.0";"0";"4";"4";"0";"4";"0";"430520";"5766"
"LOK1378_1mm";"SILVA (only NR);Eukaryota;Amorphea;Obazoa;Opisthokonta;Nucletmycea;Fungi;Dikarya;Basidiomycota;Agaricomycotina;Agaricomycetes;Boletales;";"0.0";"0";"55";"51";"0";"51";"4";"430473";"5766"
"LOK1378_1mm";"SILVA (only NR);Eukaryota;Amorphea;Obazoa;Opisthokonta;Nucletmycea;Fungi;Dikarya;Basidiomycota;Agaricomycotina;Agaricomycetes;Boletales;Boletaceae;";"0.0";"0";"9";"9";"0";"9";"0";"430515";"5766"
"LOK1378_1mm";"SILVA (only NR);Eukaryota;Amorphea;Obazoa;Opisthokonta;Nucletmycea;Fungi;Dikarya;Basidiomycota;Agaricomycotina;Agaricomycetes;Boletales;Boletaceae;Aureoboletus;";"0.0";"0";"1";"1";"0";"1";"0";"430523";"5766"
"LOK1378_1mm";"SILVA (only NR);Eukaryota;Amorphea;Obazoa;Opisthokonta;Nucletmycea;Fungi;Dikarya;Basidiomycota;Agaricomycotina;Agaricomycetes;Boletales;Boletaceae;Boletellus;";"0.0";"0";"1";"1";"0";"1";"0";"430523";"5766"
"LOK1378_1mm";"SILVA (only NR);Eukaryota;Amorphea;Obazoa;Opisthokonta;Nucletmycea;Fungi;Dikarya;Basidiomycota;Agaricomycotina;Agaricomycetes;Boletales;Boletaceae;Boletus;";"0.0";"0";"3";"3";"0";"3";"0";"430521";"5766"
"LOK1378_1mm";"SILVA (only NR);Eukaryota;Amorphea;Obazoa;Opisthokonta;Nucletmycea;Fungi;Dikarya;Basidiomycota;Agaricomycotina;Agaricomycetes;Boletales;Boletaceae;Chalciporus;";"0.0";"0";"1";"1";"0";"1";"0";"430523";"5766"
"LOK1378_1mm";"SILVA (only NR);Eukaryota;Amorphea;Obazoa;Opisthokonta;Nucletmycea;Fungi;Dikarya;Basidiomycota;Agaricomycotina;Agaricomycetes;Boletales;Boletaceae;Strobilomyces;";"0.0";"0";"1";"1";"0";"1";"0";"430523";"5766"
"LOK1378_1mm";"SILVA (only NR);Eukaryota;Amorphea;Obazoa;Opisthokonta;Nucletmycea;Fungi;Dikarya;Basidiomycota;Agaricomycotina;Agaricomycetes;Boletales;Boletaceae;Tylopilus;";"0.0";"0";"1";"1";"0";"1";"0";"430523";"5766"
"LOK1378_1mm";"SILVA (only NR);Eukaryota;Amorphea;Obazoa;Opisthokonta;Nucletmycea;Fungi;Dikarya;Basidiomycota;Agaricomycotina;Agaricomycetes;Boletales;Boletinellaceae;";"0.0";"0";"2";"1";"0";"1";"1";"430523";"5766"
"LOK1378_1mm";"SILVA (only NR);Eukaryota;Amorphea;Obazoa;Opisthokonta;Nucletmycea;Fungi;Dikarya;Basidiomycota;Agaricomycotina;Agaricomycetes;Boletales;Boletinellaceae;Boletinellus;";"0.0";"0";"1";"1";"0";"1";"0";"430523";"5766"
"LOK1378_1mm";"SILVA (only NR);Eukaryota;Amorphea;Obazoa;Opisthokonta;Nucletmycea;Fungi;Dikarya;Basidiomycota;Agaricomycotina;Agaricomycetes;Boletales;Boletinellaceae;Phlebopus;";"0.0";"0";"1";"0";"0";"0";"1";"430524";"5766"
"LOK1378_1mm";"SILVA (only NR);Eukaryota;Amorphea;Obazoa;Opisthokonta;Nucletmycea;Fungi;Dikarya;Basidiomycota;Agaricomycotina;Agaricomycetes;Boletales;Calostoma;";"0.0";"0";"2";"1";"0";"1";"1";"430523";"5766"
"LOK1378_1mm";"SILVA (only NR);Eukaryota;Amorphea;Obazoa;Opisthokonta;Nucletmycea;Fungi;Dikarya;Basidiomycota;Agaricomycotina;Agaricomycetes;Boletales;Coniophoraceae;";"0.0";"0";"5";"5";"0";"5";"0";"430519";"5766"
"LOK1378_1mm";"SILVA (only NR);Eukaryota;Amorphea;Obazoa;Opisthokonta;Nucletmycea;Fungi;Dikarya;Basidiomycota;Agaricomycotina;Agaricomycetes;Boletales;Coniophoraceae;Coniophora;";"0.0";"0";"4";"4";"0";"4";"0";"430520";"5766"
"LOK1378_1mm";"SILVA (only NR);Eukaryota;Amorphea;Obazoa;Opisthokonta;Nucletmycea;Fungi;Dikarya;Basidiomycota;Agaricomycotina;Agaricomycetes;Boletales;Coniophoraceae;Gyrodontium;";"0.0";"0";"1";"1";"0";"1";"0";"430523";"5766"
"LOK1378_1mm";"SILVA (only NR);Eukaryota;Amorphea;Obazoa;Opisthokonta;Nucletmycea;Fungi;Dikarya;Basidiomycota;Agaricomycotina;Agaricomycetes;Boletales;Gomphidiaceae;";"0.0";"0";"2";"2";"0";"2";"0";"430522";"5766"
"LOK1378_1mm";"SILVA (only NR);Eukaryota;Amorphea;Obazoa;Opisthokonta;Nucletmycea;Fungi;Dikarya;Basidiomycota;Agaricomycotina;Agaricomycetes;Boletales;Gomphidiaceae;Gomphidius;";"0.0";"0";"2";"2";"0";"2";"0";"430522";"5766"
"LOK1378_1mm";"SILVA (only NR);Eukaryota;Amorphea;Obazoa;Opisthokonta;Nucletmycea;Fungi;Dikarya;Basidiomycota;Agaricomycotina;Agaricomycetes;Boletales;Gyroporus;";"0.0";"0";"1";"1";"0";"1";"0";"430523";"5766"
"LOK1378_1mm";"SILVA (only NR);Eukaryota;Amorphea;Obazoa;Opisthokonta;Nucletmycea;Fungi;Dikarya;Basidiomycota;Agaricomycotina;Agaricomycetes;Boletales;Hygrophoropsis;";"0.0";"0";"1";"1";"0";"1";"0";"430523";"5766"
"LOK1378_1mm";"SILVA (only NR);Eukaryota;Amorphea;Obazoa;Opisthokonta;Nucletmycea;Fungi;Dikarya;Basidiomycota;Agaricomycotina;Agaricomycetes;Boletales;Incertae Sedis;";"0.0";"0";"3";"3";"0";"3";"0";"430521";"5766"
"LOK1378_1mm";"SILVA (only NR);Eukaryota;Amorphea;Obazoa;Opisthokonta;Nucletmycea;Fungi;Dikarya;Basidiomycota;Agaricomycotina;Agaricomycetes;Boletales;Incertae Sedis;Leucogyrophana;";"0.0";"0";"3";"3";"0";"3";"0";"430521";"5766"
"LOK1378_1mm";"SILVA (only NR);Eukaryota;Amorphea;Obazoa;Opisthokonta;Nucletmycea;Fungi;Dikarya;Basidiomycota;Agaricomycotina;Agaricomycetes;Boletales;Melanogaster;";"0.0";"0";"1";"1";"0";"1";"0";"430523";"5766"
"LOK1378_1mm";"SILVA (only NR);Eukaryota;Amorphea;Obazoa;Opisthokonta;Nucletmycea;Fungi;Dikarya;Basidiomycota;Agaricomycotina;Agaricomycetes;Boletales;Paxillaceae;";"0.0";"0";"3";"3";"0";"3";"0";"430521";"5766"
"LOK1378_1mm";"SILVA (only NR);Eukaryota;Amorphea;Obazoa;Opisthokonta;Nucletmycea;Fungi;Dikarya;Basidiomycota;Agaricomycotina;Agaricomycetes;Boletales;Paxillaceae;Hydnomerulius;";"0.0";"0";"1";"1";"0";"1";"0";"430523";"5766"
"LOK1378_1mm";"SILVA (only NR);Eukaryota;Amorphea;Obazoa;Opisthokonta;Nucletmycea;Fungi;Dikarya;Basidiomycota;Agaricomycotina;Agaricomycetes;Boletales;Paxillaceae;Paxillus;";"0.0";"0";"2";"2";"0";"2";"0";"430522";"5766"
"LOK1378_1mm";"SILVA (only NR);Eukaryota;Amorphea;Obazoa;Opisthokonta;Nucletmycea;Fungi;Dikarya;Basidiomycota;Agaricomycotina;Agaricomycetes;Boletales;Phylloporus;";"0.0";"0";"1";"1";"0";"1";"0";"430523";"5766"
"LOK1378_1mm";"SILVA (only NR);Eukaryota;Amorphea;Obazoa;Opisthokonta;Nucletmycea;Fungi;Dikarya;Basidiomycota;Agaricomycotina;Agaricomycetes;Boletales;Pisolithus;";"0.0";"0";"1";"1";"0";"1";"0";"430523";"5766"
"LOK1378_1mm";"SILVA (only NR);Eukaryota;Amorphea;Obazoa;Opisthokonta;Nucletmycea;Fungi;Dikarya;Basidiomycota;Agaricomycotina;Agaricomycetes;Boletales;Rhizopogonaceae;";"0.0";"0";"2";"2";"0";"2";"0";"430522";"5766"
"LOK1378_1mm";"SILVA (only NR);Eukaryota;Amorphea;Obazoa;Opisthokonta;Nucletmycea;Fungi;Dikarya;Basidiomycota;Agaricomycotina;Agaricomycetes;Boletales;Rhizopogonaceae;Rhizopogon;";"0.0";"0";"2";"2";"0";"2";"0";"430522";"5766"
"LOK1378_1mm";"SILVA (only NR);Eukaryota;Amorphea;Obazoa;Opisthokonta;Nucletmycea;Fungi;Dikarya;Basidiomycota;Agaricomycotina;Agaricomycetes;Boletales;Sclerodermataceae;";"0.0";"0";"2";"2";"0";"2";"0";"430522";"5766"
"LOK1378_1mm";"SILVA (only NR);Eukaryota;Amorphea;Obazoa;Opisthokonta;Nucletmycea;Fungi;Dikarya;Basidiomycota;Agaricomycotina;Agaricomycetes;Boletales;Sclerodermataceae;Scleroderma;";"0.0";"0";"2";"2";"0";"2";"0";"430522";"5766"
"LOK1378_1mm";"SILVA (only NR);Eukaryota;Amorphea;Obazoa;Opisthokonta;Nucletmycea;Fungi;Dikarya;Basidiomycota;Agaricomycotina;Agaricomycetes;Boletales;Serpulaceae;";"0.0";"0";"7";"5";"0";"5";"2";"430519";"5766"
"LOK1378_1mm";"SILVA (only NR);Eukaryota;Amorphea;Obazoa;Opisthokonta;Nucletmycea;Fungi;Dikarya;Basidiomycota;Agaricomycotina;Agaricomycetes;Boletales;Serpulaceae;Serpula;";"0.0";"0";"7";"5";"0";"5";"2";"430519";"5766"
"LOK1378_1mm";"SILVA (only NR);Eukaryota;Amorphea;Obazoa;Opisthokonta;Nucletmycea;Fungi;Dikarya;Basidiomycota;Agaricomycotina;Agaricomycetes;Boletales;Suillaceae;";"0.0";"0";"2";"2";"0";"2";"0";"430522";"5766"
"LOK1378_1mm";"SILVA (only NR);Eukaryota;Amorphea;Obazoa;Opisthokonta;Nucletmycea;Fungi;Dikarya;Basidiomycota;Agaricomycotina;Agaricomycetes;Boletales;Suillaceae;Suillus;";"0.0";"0";"2";"2";"0";"2";"0";"430522";"5766"
"LOK1378_1mm";"SILVA (only NR);Eukaryota;Amorphea;Obazoa;Opisthokonta;Nucletmycea;Fungi;Dikarya;Basidiomycota;Agaricomycotina;Agaricomycetes;Boletales;Tapinella;";"0.0";"0";"1";"1";"0";"1";"0";"430523";"5766"
"LOK1378_1mm";"SILVA (only NR);Eukaryota;Amorphea;Obazoa;Opisthokonta;Nucletmycea;Fungi;Dikarya;Basidiomycota;Agaricomycotina;Agaricomycetes;Boletales;Tapinellaceae;";"0.0";"0";"3";"3";"0";"3";"0";"430521";"5766"
"LOK1378_1mm";"SILVA (only NR);Eukaryota;Amorphea;Obazoa;Opisthokonta;Nucletmycea;Fungi;Dikarya;Basidiomycota;Agaricomycotina;Agaricomycetes;Boletales;Tapinellaceae;Pseudomerulius;";"0.0";"0";"1";"1";"0";"1";"0";"430523";"5766"
"LOK1378_1mm";"SILVA (only NR);Eukaryota;Amorphea;Obazoa;Opisthokonta;Nucletmycea;Fungi;Dikarya;Basidiomycota;Agaricomycotina;Agaricomycetes;Boletales;Tapinellaceae;Tapinella;";"0.0";"0";"2";"2";"0";"2";"0";"430522";"5766"
"LOK1378_1mm";"SILVA (only NR);Eukaryota;Amorphea;Obazoa;Opisthokonta;Nucletmycea;Fungi;Dikarya;Basidiomycota;Agaricomycotina;Agaricomycetes;Boletales;Truncocolumella;";"0.0";"0";"1";"1";"0";"1";"0";"430523";"5766"
"LOK1378_1mm";"SILVA (only NR);Eukaryota;Amorphea;Obazoa;Opisthokonta;Nucletmycea;Fungi;Dikarya;Basidiomycota;Agaricomycotina;Agaricomycetes;Boletales;uncultured;";"0.0";"0";"5";"5";"0";"5";"0";"430519";"5766"
"LOK1378_1mm";"SILVA (only NR);Eukaryota;Amorphea;Obazoa;Opisthokonta;Nucletmycea;Fungi;Dikarya;Basidiomycota;Agaricomycotina;Agaricomycetes;Cantharellales;";"0.0";"0";"37";"37";"0";"37";"0";"430487";"5766"
"LOK1378_1mm";"SILVA (only NR);Eukaryota;Amorphea;Obazoa;Opisthokonta;Nucletmycea;Fungi;Dikarya;Basidiomycota;Agaricomycotina;Agaricomycetes;Cantharellales;Botryobasidiaceae;";"0.0";"0";"5";"5";"0";"5";"0";"430519";"5766"
"LOK1378_1mm";"SILVA (only NR);Eukaryota;Amorphea;Obazoa;Opisthokonta;Nucletmycea;Fungi;Dikarya;Basidiomycota;Agaricomycotina;Agaricomycetes;Cantharellales;Botryobasidiaceae;Botryobasidium;";"0.0";"0";"4";"4";"0";"4";"0";"430520";"5766"
"LOK1378_1mm";"SILVA (only NR);Eukaryota;Amorphea;Obazoa;Opisthokonta;Nucletmycea;Fungi;Dikarya;Basidiomycota;Agaricomycotina;Agaricomycetes;Cantharellales;Botryobasidiaceae;Botryohypochnus;";"0.0";"0";"1";"1";"0";"1";"0";"430523";"5766"
"LOK1378_1mm";"SILVA (only NR);Eukaryota;Amorphea;Obazoa;Opisthokonta;Nucletmycea;Fungi;Dikarya;Basidiomycota;Agaricomycotina;Agaricomycetes;Cantharellales;Cantharellaceae;";"0.0";"0";"6";"6";"0";"6";"0";"430518";"5766"
"LOK1378_1mm";"SILVA (only NR);Eukaryota;Amorphea;Obazoa;Opisthokonta;Nucletmycea;Fungi;Dikarya;Basidiomycota;Agaricomycotina;Agaricomycetes;Cantharellales;Cantharellaceae;Cantharellus;";"0.0";"0";"4";"4";"0";"4";"0";"430520";"5766"
"LOK1378_1mm";"SILVA (only NR);Eukaryota;Amorphea;Obazoa;Opisthokonta;Nucletmycea;Fungi;Dikarya;Basidiomycota;Agaricomycotina;Agaricomycetes;Cantharellales;Cantharellaceae;Craterellus;";"0.0";"0";"2";"2";"0";"2";"0";"430522";"5766"
"LOK1378_1mm";"SILVA (only NR);Eukaryota;Amorphea;Obazoa;Opisthokonta;Nucletmycea;Fungi;Dikarya;Basidiomycota;Agaricomycotina;Agaricomycetes;Cantharellales;Ceratobasidiaceae;";"0.0";"0";"11";"11";"0";"11";"0";"430513";"5766"
"LOK1378_1mm";"SILVA (only NR);Eukaryota;Amorphea;Obazoa;Opisthokonta;Nucletmycea;Fungi;Dikarya;Basidiomycota;Agaricomycotina;Agaricomycetes;Cantharellales;Ceratobasidiaceae;Ceratobasidium;";"0.0";"0";"1";"1";"0";"1";"0";"430523";"5766"
"LOK1378_1mm";"SILVA (only NR);Eukaryota;Amorphea;Obazoa;Opisthokonta;Nucletmycea;Fungi;Dikarya;Basidiomycota;Agaricomycotina;Agaricomycetes;Cantharellales;Ceratobasidiaceae;Rhizoctonia;";"0.0";"0";"5";"5";"0";"5";"0";"430519";"5766"
"LOK1378_1mm";"SILVA (only NR);Eukaryota;Amorphea;Obazoa;Opisthokonta;Nucletmycea;Fungi;Dikarya;Basidiomycota;Agaricomycotina;Agaricomycetes;Cantharellales;Ceratobasidiaceae;Thanatephorus;";"0.0";"0";"3";"3";"0";"3";"0";"430521";"5766"
"LOK1378_1mm";"SILVA (only NR);Eukaryota;Amorphea;Obazoa;Opisthokonta;Nucletmycea;Fungi;Dikarya;Basidiomycota;Agaricomycotina;Agaricomycetes;Cantharellales;Clavulinaceae;";"0.0";"0";"7";"7";"0";"7";"0";"430517";"5766"
"LOK1378_1mm";"SILVA (only NR);Eukaryota;Amorphea;Obazoa;Opisthokonta;Nucletmycea;Fungi;Dikarya;Basidiomycota;Agaricomycotina;Agaricomycetes;Cantharellales;Clavulinaceae;Clavulicium;";"0.0";"0";"3";"3";"0";"3";"0";"430521";"5766"
"LOK1378_1mm";"SILVA (only NR);Eukaryota;Amorphea;Obazoa;Opisthokonta;Nucletmycea;Fungi;Dikarya;Basidiomycota;Agaricomycotina;Agaricomycetes;Cantharellales;Clavulinaceae;Clavulina;";"0.0";"0";"1";"1";"0";"1";"0";"430523";"5766"
"LOK1378_1mm";"SILVA (only NR);Eukaryota;Amorphea;Obazoa;Opisthokonta;Nucletmycea;Fungi;Dikarya;Basidiomycota;Agaricomycotina;Agaricomycetes;Cantharellales;Clavulinaceae;Multiclavula;";"0.0";"0";"2";"2";"0";"2";"0";"430522";"5766"
"LOK1378_1mm";"SILVA (only NR);Eukaryota;Amorphea;Obazoa;Opisthokonta;Nucletmycea;Fungi;Dikarya;Basidiomycota;Agaricomycotina;Agaricomycetes;Cantharellales;Hydnum;";"0.0";"0";"1";"1";"0";"1";"0";"430523";"5766"
"LOK1378_1mm";"SILVA (only NR);Eukaryota;Amorphea;Obazoa;Opisthokonta;Nucletmycea;Fungi;Dikarya;Basidiomycota;Agaricomycotina;Agaricomycetes;Cantharellales;Incertae Sedis;";"0.0";"0";"3";"3";"0";"3";"0";"430521";"5766"
"LOK1378_1mm";"SILVA (only NR);Eukaryota;Amorphea;Obazoa;Opisthokonta;Nucletmycea;Fungi;Dikarya;Basidiomycota;Agaricomycotina;Agaricomycetes;Cantharellales;Incertae Sedis;Burgella;";"0.0";"0";"1";"1";"0";"1";"0";"430523";"5766"
"LOK1378_1mm";"SILVA (only NR);Eukaryota;Amorphea;Obazoa;Opisthokonta;Nucletmycea;Fungi;Dikarya;Basidiomycota;Agaricomycotina;Agaricomycetes;Cantharellales;Incertae Sedis;Marchandiobasidium;";"0.0";"0";"1";"1";"0";"1";"0";"430523";"5766"
"LOK1378_1mm";"SILVA (only NR);Eukaryota;Amorphea;Obazoa;Opisthokonta;Nucletmycea;Fungi;Dikarya;Basidiomycota;Agaricomycotina;Agaricomycetes;Cantharellales;Incertae Sedis;Minimedusa;";"0.0";"0";"1";"1";"0";"1";"0";"430523";"5766"
"LOK1378_1mm";"SILVA (only NR);Eukaryota;Amorphea;Obazoa;Opisthokonta;Nucletmycea;Fungi;Dikarya;Basidiomycota;Agaricomycotina;Agaricomycetes;Cantharellales;Tulasnellaceae;";"0.0";"0";"4";"4";"0";"4";"0";"430520";"5766"
"LOK1378_1mm";"SILVA (only NR);Eukaryota;Amorphea;Obazoa;Opisthokonta;Nucletmycea;Fungi;Dikarya;Basidiomycota;Agaricomycotina;Agaricomycetes;Cantharellales;Tulasnellaceae;Tulasnella;";"0.0";"0";"4";"4";"0";"4";"0";"430520";"5766"
"LOK1378_1mm";"SILVA (only NR);Eukaryota;Amorphea;Obazoa;Opisthokonta;Nucletmycea;Fungi;Dikarya;Basidiomycota;Agaricomycotina;Agaricomycetes;Corticiales;";"0.0";"0";"78";"73";"0";"73";"5";"430451";"5766"
"LOK1378_1mm";"SILVA (only NR);Eukaryota;Amorphea;Obazoa;Opisthokonta;Nucletmycea;Fungi;Dikarya;Basidiomycota;Agaricomycotina;Agaricomycetes;Corticiales;Corticiaceae;";"0.0";"0";"76";"71";"0";"71";"5";"430453";"5766"
"LOK1378_1mm";"SILVA (only NR);Eukaryota;Amorphea;Obazoa;Opisthokonta;Nucletmycea;Fungi;Dikarya;Basidiomycota;Agaricomycotina;Agaricomycetes;Corticiales;Corticiaceae;Acantholichen;";"0.0";"0";"2";"2";"0";"2";"0";"430522";"5766"
"LOK1378_1mm";"SILVA (only NR);Eukaryota;Amorphea;Obazoa;Opisthokonta;Nucletmycea;Fungi;Dikarya;Basidiomycota;Agaricomycotina;Agaricomycetes;Corticiales;Corticiaceae;Candelabrochaete;";"0.0";"0";"1";"1";"0";"1";"0";"430523";"5766"
"LOK1378_1mm";"SILVA (only NR);Eukaryota;Amorphea;Obazoa;Opisthokonta;Nucletmycea;Fungi;Dikarya;Basidiomycota;Agaricomycotina;Agaricomycetes;Corticiales;Corticiaceae;Dentocorticium;";"0.0";"0";"1";"1";"0";"1";"0";"430523";"5766"
"LOK1378_1mm";"SILVA (only NR);Eukaryota;Amorphea;Obazoa;Opisthokonta;Nucletmycea;Fungi;Dikarya;Basidiomycota;Agaricomycotina;Agaricomycetes;Corticiales;Corticiaceae;Fibricium;";"0.0";"0";"1";"1";"0";"1";"0";"430523";"5766"
"LOK1378_1mm";"SILVA (only NR);Eukaryota;Amorphea;Obazoa;Opisthokonta;Nucletmycea;Fungi;Dikarya;Basidiomycota;Agaricomycotina;Agaricomycetes;Corticiales;Corticiaceae;Haplotrichum;";"0.0";"0";"1";"1";"0";"1";"0";"430523";"5766"
"LOK1378_1mm";"SILVA (only NR);Eukaryota;Amorphea;Obazoa;Opisthokonta;Nucletmycea;Fungi;Dikarya;Basidiomycota;Agaricomycotina;Agaricomycetes;Corticiales;Corticiaceae;Hyphodontia;";"0.0";"0";"11";"11";"0";"11";"0";"430513";"5766"
"LOK1378_1mm";"SILVA (only NR);Eukaryota;Amorphea;Obazoa;Opisthokonta;Nucletmycea;Fungi;Dikarya;Basidiomycota;Agaricomycotina;Agaricomycetes;Corticiales;Corticiaceae;Hypochnicium;";"0.0";"0";"1";"1";"0";"1";"0";"430523";"5766"
"LOK1378_1mm";"SILVA (only NR);Eukaryota;Amorphea;Obazoa;Opisthokonta;Nucletmycea;Fungi;Dikarya;Basidiomycota;Agaricomycotina;Agaricomycetes;Corticiales;Corticiaceae;Laetisaria;";"0.0";"0";"1";"1";"0";"1";"0";"430523";"5766"
"LOK1378_1mm";"SILVA (only NR);Eukaryota;Amorphea;Obazoa;Opisthokonta;Nucletmycea;Fungi;Dikarya;Basidiomycota;Agaricomycotina;Agaricomycetes;Corticiales;Corticiaceae;Limonomyces;";"0.0";"0";"3";"3";"0";"3";"0";"430521";"5766"
"LOK1378_1mm";"SILVA (only NR);Eukaryota;Amorphea;Obazoa;Opisthokonta;Nucletmycea;Fungi;Dikarya;Basidiomycota;Agaricomycotina;Agaricomycetes;Corticiales;Corticiaceae;Lindtneria;";"0.0";"0";"1";"1";"0";"1";"0";"430523";"5766"
"LOK1378_1mm";"SILVA (only NR);Eukaryota;Amorphea;Obazoa;Opisthokonta;Nucletmycea;Fungi;Dikarya;Basidiomycota;Agaricomycotina;Agaricomycetes;Corticiales;Corticiaceae;Odonticium;";"0.0";"0";"1";"1";"0";"1";"0";"430523";"5766"
"LOK1378_1mm";"SILVA (only NR);Eukaryota;Amorphea;Obazoa;Opisthokonta;Nucletmycea;Fungi;Dikarya;Basidiomycota;Agaricomycotina;Agaricomycetes;Corticiales;Corticiaceae;Peniophorella;";"0.0";"0";"5";"3";"0";"3";"2";"430521";"5766"
"LOK1378_1mm";"SILVA (only NR);Eukaryota;Amorphea;Obazoa;Opisthokonta;Nucletmycea;Fungi;Dikarya;Basidiomycota;Agaricomycotina;Agaricomycetes;Corticiales;Corticiaceae;Phlebia;";"0.0";"0";"14";"12";"0";"12";"2";"430512";"5766"
"LOK1378_1mm";"SILVA (only NR);Eukaryota;Amorphea;Obazoa;Opisthokonta;Nucletmycea;Fungi;Dikarya;Basidiomycota;Agaricomycotina;Agaricomycetes;Corticiales;Corticiaceae;Pulcherricium;";"0.0";"0";"1";"1";"0";"1";"0";"430523";"5766"
"LOK1378_1mm";"SILVA (only NR);Eukaryota;Amorphea;Obazoa;Opisthokonta;Nucletmycea;Fungi;Dikarya;Basidiomycota;Agaricomycotina;Agaricomycetes;Corticiales;Corticiaceae;Repetobasidium;";"0.0";"0";"1";"1";"0";"1";"0";"430523";"5766"
"LOK1378_1mm";"SILVA (only NR);Eukaryota;Amorphea;Obazoa;Opisthokonta;Nucletmycea;Fungi;Dikarya;Basidiomycota;Agaricomycotina;Agaricomycetes;Corticiales;Corticiaceae;Rhizochaete;";"0.0";"0";"1";"1";"0";"1";"0";"430523";"5766"
"LOK1378_1mm";"SILVA (only NR);Eukaryota;Amorphea;Obazoa;Opisthokonta;Nucletmycea;Fungi;Dikarya;Basidiomycota;Agaricomycotina;Agaricomycetes;Corticiales;Corticiaceae;Rogersella;";"0.0";"0";"1";"1";"0";"1";"0";"430523";"5766"
"LOK1378_1mm";"SILVA (only NR);Eukaryota;Amorphea;Obazoa;Opisthokonta;Nucletmycea;Fungi;Dikarya;Basidiomycota;Agaricomycotina;Agaricomycetes;Corticiales;Corticiaceae;Schizopora;";"0.0";"0";"1";"1";"0";"1";"0";"430523";"5766"
"LOK1378_1mm";"SILVA (only NR);Eukaryota;Amorphea;Obazoa;Opisthokonta;Nucletmycea;Fungi;Dikarya;Basidiomycota;Agaricomycotina;Agaricomycetes;Corticiales;Corticiaceae;Sistotrema;";"0.0";"0";"23";"22";"0";"22";"1";"430502";"5766"
"LOK1378_1mm";"SILVA (only NR);Eukaryota;Amorphea;Obazoa;Opisthokonta;Nucletmycea;Fungi;Dikarya;Basidiomycota;Agaricomycotina;Agaricomycetes;Corticiales;Dendrocorticium;";"0.0";"0";"1";"1";"0";"1";"0";"430523";"5766"
"LOK1378_1mm";"SILVA (only NR);Eukaryota;Amorphea;Obazoa;Opisthokonta;Nucletmycea;Fungi;Dikarya;Basidiomycota;Agaricomycotina;Agaricomycetes;Corticiales;Vuilleminia;";"0.0";"0";"1";"1";"0";"1";"0";"430523";"5766"
"LOK1378_1mm";"SILVA (only NR);Eukaryota;Amorphea;Obazoa;Opisthokonta;Nucletmycea;Fungi;Dikarya;Basidiomycota;Agaricomycotina;Agaricomycetes;Geastrales;";"0.0";"0";"2";"2";"0";"2";"0";"430522";"5766"
"LOK1378_1mm";"SILVA (only NR);Eukaryota;Amorphea;Obazoa;Opisthokonta;Nucletmycea;Fungi;Dikarya;Basidiomycota;Agaricomycotina;Agaricomycetes;Geastrales;Geastraceae;";"0.0";"0";"2";"2";"0";"2";"0";"430522";"5766"
"LOK1378_1mm";"SILVA (only NR);Eukaryota;Amorphea;Obazoa;Opisthokonta;Nucletmycea;Fungi;Dikarya;Basidiomycota;Agaricomycotina;Agaricomycetes;Geastrales;Geastraceae;Geastrum;";"0.0";"0";"1";"1";"0";"1";"0";"430523";"5766"
"LOK1378_1mm";"SILVA (only NR);Eukaryota;Amorphea;Obazoa;Opisthokonta;Nucletmycea;Fungi;Dikarya;Basidiomycota;Agaricomycotina;Agaricomycetes;Geastrales;Geastraceae;Sphaerobolus;";"0.0";"0";"1";"1";"0";"1";"0";"430523";"5766"
"LOK1378_1mm";"SILVA (only NR);Eukaryota;Amorphea;Obazoa;Opisthokonta;Nucletmycea;Fungi;Dikarya;Basidiomycota;Agaricomycotina;Agaricomycetes;Gloeophyllales;";"0.0";"0";"8";"8";"0";"8";"0";"430516";"5766"
"LOK1378_1mm";"SILVA (only NR);Eukaryota;Amorphea;Obazoa;Opisthokonta;Nucletmycea;Fungi;Dikarya;Basidiomycota;Agaricomycotina;Agaricomycetes;Gloeophyllales;Gloeophyllaceae;";"0.0";"0";"8";"8";"0";"8";"0";"430516";"5766"
"LOK1378_1mm";"SILVA (only NR);Eukaryota;Amorphea;Obazoa;Opisthokonta;Nucletmycea;Fungi;Dikarya;Basidiomycota;Agaricomycotina;Agaricomycetes;Gloeophyllales;Gloeophyllaceae;Gloeophyllum;";"0.0";"0";"3";"3";"0";"3";"0";"430521";"5766"
"LOK1378_1mm";"SILVA (only NR);Eukaryota;Amorphea;Obazoa;Opisthokonta;Nucletmycea;Fungi;Dikarya;Basidiomycota;Agaricomycotina;Agaricomycetes;Gloeophyllales;Gloeophyllaceae;Griseoporia;";"0.0";"0";"1";"1";"0";"1";"0";"430523";"5766"
"LOK1378_1mm";"SILVA (only NR);Eukaryota;Amorphea;Obazoa;Opisthokonta;Nucletmycea;Fungi;Dikarya;Basidiomycota;Agaricomycotina;Agaricomycetes;Gloeophyllales;Gloeophyllaceae;Neolentinus;";"0.0";"0";"1";"1";"0";"1";"0";"430523";"5766"
"LOK1378_1mm";"SILVA (only NR);Eukaryota;Amorphea;Obazoa;Opisthokonta;Nucletmycea;Fungi;Dikarya;Basidiomycota;Agaricomycotina;Agaricomycetes;Gloeophyllales;Gloeophyllaceae;Veluticeps;";"0.0";"0";"3";"3";"0";"3";"0";"430521";"5766"
"LOK1378_1mm";"SILVA (only NR);Eukaryota;Amorphea;Obazoa;Opisthokonta;Nucletmycea;Fungi;Dikarya;Basidiomycota;Agaricomycotina;Agaricomycetes;Gomphales;";"0.0";"0";"5";"5";"0";"5";"0";"430519";"5766"
"LOK1378_1mm";"SILVA (only NR);Eukaryota;Amorphea;Obazoa;Opisthokonta;Nucletmycea;Fungi;Dikarya;Basidiomycota;Agaricomycotina;Agaricomycetes;Gomphales;Gautieria;";"0.0";"0";"1";"1";"0";"1";"0";"430523";"5766"
"LOK1378_1mm";"SILVA (only NR);Eukaryota;Amorphea;Obazoa;Opisthokonta;Nucletmycea;Fungi;Dikarya;Basidiomycota;Agaricomycotina;Agaricomycetes;Gomphales;Gomphaceae;";"0.0";"0";"4";"4";"0";"4";"0";"430520";"5766"
"LOK1378_1mm";"SILVA (only NR);Eukaryota;Amorphea;Obazoa;Opisthokonta;Nucletmycea;Fungi;Dikarya;Basidiomycota;Agaricomycotina;Agaricomycetes;Gomphales;Gomphaceae;Clavariadelphus;";"0.0";"0";"1";"1";"0";"1";"0";"430523";"5766"
"LOK1378_1mm";"SILVA (only NR);Eukaryota;Amorphea;Obazoa;Opisthokonta;Nucletmycea;Fungi;Dikarya;Basidiomycota;Agaricomycotina;Agaricomycetes;Gomphales;Gomphaceae;Kavinia;";"0.0";"0";"1";"1";"0";"1";"0";"430523";"5766"
"LOK1378_1mm";"SILVA (only NR);Eukaryota;Amorphea;Obazoa;Opisthokonta;Nucletmycea;Fungi;Dikarya;Basidiomycota;Agaricomycotina;Agaricomycetes;Gomphales;Gomphaceae;Ramaria;";"0.0";"0";"2";"2";"0";"2";"0";"430522";"5766"
"LOK1378_1mm";"SILVA (only NR);Eukaryota;Amorphea;Obazoa;Opisthokonta;Nucletmycea;Fungi;Dikarya;Basidiomycota;Agaricomycotina;Agaricomycetes;Hymenochaetales;";"0.0";"0";"19";"18";"0";"18";"1";"430506";"5766"
"LOK1378_1mm";"SILVA (only NR);Eukaryota;Amorphea;Obazoa;Opisthokonta;Nucletmycea;Fungi;Dikarya;Basidiomycota;Agaricomycotina;Agaricomycetes;Hymenochaetales;Basidioradulum;";"0.0";"0";"1";"1";"0";"1";"0";"430523";"5766"
"LOK1378_1mm";"SILVA (only NR);Eukaryota;Amorphea;Obazoa;Opisthokonta;Nucletmycea;Fungi;Dikarya;Basidiomycota;Agaricomycotina;Agaricomycetes;Hymenochaetales;Coltricia;";"0.0";"0";"1";"1";"0";"1";"0";"430523";"5766"
"LOK1378_1mm";"SILVA (only NR);Eukaryota;Amorphea;Obazoa;Opisthokonta;Nucletmycea;Fungi;Dikarya;Basidiomycota;Agaricomycotina;Agaricomycetes;Hymenochaetales;Hymenochaetaceae;";"0.0";"0";"11";"11";"0";"11";"0";"430513";"5766"
"LOK1378_1mm";"SILVA (only NR);Eukaryota;Amorphea;Obazoa;Opisthokonta;Nucletmycea;Fungi;Dikarya;Basidiomycota;Agaricomycotina;Agaricomycetes;Hymenochaetales;Hymenochaetaceae;Fomitiporia;";"0.0";"0";"1";"1";"0";"1";"0";"430523";"5766"
"LOK1378_1mm";"SILVA (only NR);Eukaryota;Amorphea;Obazoa;Opisthokonta;Nucletmycea;Fungi;Dikarya;Basidiomycota;Agaricomycotina;Agaricomycetes;Hymenochaetales;Hymenochaetaceae;Hydnochaete;";"0.0";"0";"1";"1";"0";"1";"0";"430523";"5766"
"LOK1378_1mm";"SILVA (only NR);Eukaryota;Amorphea;Obazoa;Opisthokonta;Nucletmycea;Fungi;Dikarya;Basidiomycota;Agaricomycotina;Agaricomycetes;Hymenochaetales;Hymenochaetaceae;Hymenochaetopsis;";"0.0";"0";"1";"1";"0";"1";"0";"430523";"5766"
"LOK1378_1mm";"SILVA (only NR);Eukaryota;Amorphea;Obazoa;Opisthokonta;Nucletmycea;Fungi;Dikarya;Basidiomycota;Agaricomycotina;Agaricomycetes;Hymenochaetales;Hymenochaetaceae;Inonotus;";"0.0";"0";"1";"1";"0";"1";"0";"430523";"5766"
"LOK1378_1mm";"SILVA (only NR);Eukaryota;Amorphea;Obazoa;Opisthokonta;Nucletmycea;Fungi;Dikarya;Basidiomycota;Agaricomycotina;Agaricomycetes;Hymenochaetales;Hymenochaetaceae;Phaeolus;";"0.0";"0";"1";"1";"0";"1";"0";"430523";"5766"
"LOK1378_1mm";"SILVA (only NR);Eukaryota;Amorphea;Obazoa;Opisthokonta;Nucletmycea;Fungi;Dikarya;Basidiomycota;Agaricomycotina;Agaricomycetes;Hymenochaetales;Hymenochaetaceae;Phellinus;";"0.0";"0";"2";"2";"0";"2";"0";"430522";"5766"
"LOK1378_1mm";"SILVA (only NR);Eukaryota;Amorphea;Obazoa;Opisthokonta;Nucletmycea;Fungi;Dikarya;Basidiomycota;Agaricomycotina;Agaricomycetes;Hymenochaetales;Hymenochaetaceae;Sanghuangporus;";"0.0";"0";"1";"1";"0";"1";"0";"430523";"5766"
"LOK1378_1mm";"SILVA (only NR);Eukaryota;Amorphea;Obazoa;Opisthokonta;Nucletmycea;Fungi;Dikarya;Basidiomycota;Agaricomycotina;Agaricomycetes;Hymenochaetales;Hymenochaetaceae;Tropicoporus;";"0.0";"0";"2";"2";"0";"2";"0";"430522";"5766"
"LOK1378_1mm";"SILVA (only NR);Eukaryota;Amorphea;Obazoa;Opisthokonta;Nucletmycea;Fungi;Dikarya;Basidiomycota;Agaricomycotina;Agaricomycetes;Hymenochaetales;Schizoporaceae;";"0.0";"0";"2";"2";"0";"2";"0";"430522";"5766"
"LOK1378_1mm";"SILVA (only NR);Eukaryota;Amorphea;Obazoa;Opisthokonta;Nucletmycea;Fungi;Dikarya;Basidiomycota;Agaricomycotina;Agaricomycetes;Hymenochaetales;Schizoporaceae;Xylodon;";"0.0";"0";"2";"2";"0";"2";"0";"430522";"5766"
"LOK1378_1mm";"SILVA (only NR);Eukaryota;Amorphea;Obazoa;Opisthokonta;Nucletmycea;Fungi;Dikarya;Basidiomycota;Agaricomycotina;Agaricomycetes;Hymenochaetales;Tubulicrinaceae;";"0.0";"0";"3";"2";"0";"2";"1";"430522";"5766"
"LOK1378_1mm";"SILVA (only NR);Eukaryota;Amorphea;Obazoa;Opisthokonta;Nucletmycea;Fungi;Dikarya;Basidiomycota;Agaricomycotina;Agaricomycetes;Hymenochaetales;Tubulicrinaceae;Tubulicrinis;";"0.0";"0";"3";"2";"0";"2";"1";"430522";"5766"
"LOK1378_1mm";"SILVA (only NR);Eukaryota;Amorphea;Obazoa;Opisthokonta;Nucletmycea;Fungi;Dikarya;Basidiomycota;Agaricomycotina;Agaricomycetes;Incertae Sedis;";"0.0";"0";"6";"5";"0";"5";"1";"430519";"5766"
"LOK1378_1mm";"SILVA (only NR);Eukaryota;Amorphea;Obazoa;Opisthokonta;Nucletmycea;Fungi;Dikarya;Basidiomycota;Agaricomycotina;Agaricomycetes;Incertae Sedis;Incertae Sedis;";"0.0";"0";"2";"1";"0";"1";"1";"430523";"5766"
"LOK1378_1mm";"SILVA (only NR);Eukaryota;Amorphea;Obazoa;Opisthokonta;Nucletmycea;Fungi;Dikarya;Basidiomycota;Agaricomycotina;Agaricomycetes;Incertae Sedis;Incertae Sedis;Giulia;";"0.0";"0";"1";"0";"0";"0";"1";"430524";"5766"
"LOK1378_1mm";"SILVA (only NR);Eukaryota;Amorphea;Obazoa;Opisthokonta;Nucletmycea;Fungi;Dikarya;Basidiomycota;Agaricomycotina;Agaricomycetes;Incertae Sedis;Incertae Sedis;Tremellodendropsis;";"0.0";"0";"1";"1";"0";"1";"0";"430523";"5766"
"LOK1378_1mm";"SILVA (only NR);Eukaryota;Amorphea;Obazoa;Opisthokonta;Nucletmycea;Fungi;Dikarya;Basidiomycota;Agaricomycotina;Agaricomycetes;Incertae Sedis;Resinicium;";"0.0";"0";"2";"2";"0";"2";"0";"430522";"5766"
"LOK1378_1mm";"SILVA (only NR);Eukaryota;Amorphea;Obazoa;Opisthokonta;Nucletmycea;Fungi;Dikarya;Basidiomycota;Agaricomycotina;Agaricomycetes;Incertae Sedis;Stereopsidaceae;";"0.0";"0";"2";"2";"0";"2";"0";"430522";"5766"
"LOK1378_1mm";"SILVA (only NR);Eukaryota;Amorphea;Obazoa;Opisthokonta;Nucletmycea;Fungi;Dikarya;Basidiomycota;Agaricomycotina;Agaricomycetes;Incertae Sedis;Stereopsidaceae;Stereopsis;";"0.0";"0";"2";"2";"0";"2";"0";"430522";"5766"
"LOK1378_1mm";"SILVA (only NR);Eukaryota;Amorphea;Obazoa;Opisthokonta;Nucletmycea;Fungi;Dikarya;Basidiomycota;Agaricomycotina;Agaricomycetes;Jaapiales;";"0.0";"0";"1";"1";"0";"1";"0";"430523";"5766"
"LOK1378_1mm";"SILVA (only NR);Eukaryota;Amorphea;Obazoa;Opisthokonta;Nucletmycea;Fungi;Dikarya;Basidiomycota;Agaricomycotina;Agaricomycetes;Jaapiales;Jaapiaceae;";"0.0";"0";"1";"1";"0";"1";"0";"430523";"5766"
"LOK1378_1mm";"SILVA (only NR);Eukaryota;Amorphea;Obazoa;Opisthokonta;Nucletmycea;Fungi;Dikarya;Basidiomycota;Agaricomycotina;Agaricomycetes;Jaapiales;Jaapiaceae;Jaapia;";"0.0";"0";"1";"1";"0";"1";"0";"430523";"5766"
"LOK1378_1mm";"SILVA (only NR);Eukaryota;Amorphea;Obazoa;Opisthokonta;Nucletmycea;Fungi;Dikarya;Basidiomycota;Agaricomycotina;Agaricomycetes;Lepidostromatales;";"0.0";"0";"2";"2";"0";"2";"0";"430522";"5766"
"LOK1378_1mm";"SILVA (only NR);Eukaryota;Amorphea;Obazoa;Opisthokonta;Nucletmycea;Fungi;Dikarya;Basidiomycota;Agaricomycotina;Agaricomycetes;Lepidostromatales;Lepidostromataceae;";"0.0";"0";"2";"2";"0";"2";"0";"430522";"5766"
"LOK1378_1mm";"SILVA (only NR);Eukaryota;Amorphea;Obazoa;Opisthokonta;Nucletmycea;Fungi;Dikarya;Basidiomycota;Agaricomycotina;Agaricomycetes;Lepidostromatales;Lepidostromataceae;Lepidostroma;";"0.0";"0";"2";"2";"0";"2";"0";"430522";"5766"
"LOK1378_1mm";"SILVA (only NR);Eukaryota;Amorphea;Obazoa;Opisthokonta;Nucletmycea;Fungi;Dikarya;Basidiomycota;Agaricomycotina;Agaricomycetes;Parmastomyces;";"0.0";"0";"1";"1";"0";"1";"0";"430523";"5766"
"LOK1378_1mm";"SILVA (only NR);Eukaryota;Amorphea;Obazoa;Opisthokonta;Nucletmycea;Fungi;Dikarya;Basidiomycota;Agaricomycotina;Agaricomycetes;Phallales;";"0.0";"0";"2";"2";"0";"2";"0";"430522";"5766"
"LOK1378_1mm";"SILVA (only NR);Eukaryota;Amorphea;Obazoa;Opisthokonta;Nucletmycea;Fungi;Dikarya;Basidiomycota;Agaricomycotina;Agaricomycetes;Phallales;Clathraceae;";"0.0";"0";"1";"1";"0";"1";"0";"430523";"5766"
"LOK1378_1mm";"SILVA (only NR);Eukaryota;Amorphea;Obazoa;Opisthokonta;Nucletmycea;Fungi;Dikarya;Basidiomycota;Agaricomycotina;Agaricomycetes;Phallales;Clathraceae;Pseudocolus;";"0.0";"0";"1";"1";"0";"1";"0";"430523";"5766"
"LOK1378_1mm";"SILVA (only NR);Eukaryota;Amorphea;Obazoa;Opisthokonta;Nucletmycea;Fungi;Dikarya;Basidiomycota;Agaricomycotina;Agaricomycetes;Phallales;Phallaceae;";"0.0";"0";"1";"1";"0";"1";"0";"430523";"5766"
"LOK1378_1mm";"SILVA (only NR);Eukaryota;Amorphea;Obazoa;Opisthokonta;Nucletmycea;Fungi;Dikarya;Basidiomycota;Agaricomycotina;Agaricomycetes;Phallales;Phallaceae;Phallus;";"0.0";"0";"1";"1";"0";"1";"0";"430523";"5766"
"LOK1378_1mm";"SILVA (only NR);Eukaryota;Amorphea;Obazoa;Opisthokonta;Nucletmycea;Fungi;Dikarya;Basidiomycota;Agaricomycotina;Agaricomycetes;Polyporales;";"0.0";"0";"156";"148";"0";"148";"8";"430376";"5766"
"LOK1378_1mm";"SILVA (only NR);Eukaryota;Amorphea;Obazoa;Opisthokonta;Nucletmycea;Fungi;Dikarya;Basidiomycota;Agaricomycotina;Agaricomycetes;Polyporales;Adustoporia;";"0.0";"0";"1";"1";"0";"1";"0";"430523";"5766"
"LOK1378_1mm";"SILVA (only NR);Eukaryota;Amorphea;Obazoa;Opisthokonta;Nucletmycea;Fungi;Dikarya;Basidiomycota;Agaricomycotina;Agaricomycetes;Polyporales;Amylocystis;";"0.0";"0";"1";"1";"0";"1";"0";"430523";"5766"
"LOK1378_1mm";"SILVA (only NR);Eukaryota;Amorphea;Obazoa;Opisthokonta;Nucletmycea;Fungi;Dikarya;Basidiomycota;Agaricomycotina;Agaricomycetes;Polyporales;Antrodiella;";"0.0";"0";"1";"1";"0";"1";"0";"430523";"5766"
"LOK1378_1mm";"SILVA (only NR);Eukaryota;Amorphea;Obazoa;Opisthokonta;Nucletmycea;Fungi;Dikarya;Basidiomycota;Agaricomycotina;Agaricomycetes;Polyporales;Auriporia;";"0.0";"0";"1";"1";"0";"1";"0";"430523";"5766"
"LOK1378_1mm";"SILVA (only NR);Eukaryota;Amorphea;Obazoa;Opisthokonta;Nucletmycea;Fungi;Dikarya;Basidiomycota;Agaricomycotina;Agaricomycetes;Polyporales;Brunneoporus;";"0.0";"0";"1";"1";"0";"1";"0";"430523";"5766"
"LOK1378_1mm";"SILVA (only NR);Eukaryota;Amorphea;Obazoa;Opisthokonta;Nucletmycea;Fungi;Dikarya;Basidiomycota;Agaricomycotina;Agaricomycetes;Polyporales;Ceriporiopsis;";"0.0";"0";"1";"1";"0";"1";"0";"430523";"5766"
"LOK1378_1mm";"SILVA (only NR);Eukaryota;Amorphea;Obazoa;Opisthokonta;Nucletmycea;Fungi;Dikarya;Basidiomycota;Agaricomycotina;Agaricomycetes;Polyporales;Climacodon;";"0.0";"0";"2";"2";"0";"2";"0";"430522";"5766"
"LOK1378_1mm";"SILVA (only NR);Eukaryota;Amorphea;Obazoa;Opisthokonta;Nucletmycea;Fungi;Dikarya;Basidiomycota;Agaricomycotina;Agaricomycetes;Polyporales;Coriolaceae;";"0.0";"0";"14";"14";"0";"14";"0";"430510";"5766"
"LOK1378_1mm";"SILVA (only NR);Eukaryota;Amorphea;Obazoa;Opisthokonta;Nucletmycea;Fungi;Dikarya;Basidiomycota;Agaricomycotina;Agaricomycetes;Polyporales;Coriolaceae;Abortiporus;";"0.0";"0";"1";"1";"0";"1";"0";"430523";"5766"
"LOK1378_1mm";"SILVA (only NR);Eukaryota;Amorphea;Obazoa;Opisthokonta;Nucletmycea;Fungi;Dikarya;Basidiomycota;Agaricomycotina;Agaricomycetes;Polyporales;Coriolaceae;Coriolopsis;";"0.0";"0";"8";"8";"0";"8";"0";"430516";"5766"
"LOK1378_1mm";"SILVA (only NR);Eukaryota;Amorphea;Obazoa;Opisthokonta;Nucletmycea;Fungi;Dikarya;Basidiomycota;Agaricomycotina;Agaricomycetes;Polyporales;Coriolaceae;Meripilus;";"0.0";"0";"1";"1";"0";"1";"0";"430523";"5766"
"LOK1378_1mm";"SILVA (only NR);Eukaryota;Amorphea;Obazoa;Opisthokonta;Nucletmycea;Fungi;Dikarya;Basidiomycota;Agaricomycotina;Agaricomycetes;Polyporales;Coriolaceae;Oxyporus;";"0.0";"0";"1";"1";"0";"1";"0";"430523";"5766"
"LOK1378_1mm";"SILVA (only NR);Eukaryota;Amorphea;Obazoa;Opisthokonta;Nucletmycea;Fungi;Dikarya;Basidiomycota;Agaricomycotina;Agaricomycetes;Polyporales;Coriolaceae;Rigidoporus;";"0.0";"0";"3";"3";"0";"3";"0";"430521";"5766"
"LOK1378_1mm";"SILVA (only NR);Eukaryota;Amorphea;Obazoa;Opisthokonta;Nucletmycea;Fungi;Dikarya;Basidiomycota;Agaricomycotina;Agaricomycetes;Polyporales;Dacryobolus;";"0.0";"0";"1";"1";"0";"1";"0";"430523";"5766"
"LOK1378_1mm";"SILVA (only NR);Eukaryota;Amorphea;Obazoa;Opisthokonta;Nucletmycea;Fungi;Dikarya;Basidiomycota;Agaricomycotina;Agaricomycetes;Polyporales;Daedalea;";"0.0";"0";"1";"1";"0";"1";"0";"430523";"5766"
"LOK1378_1mm";"SILVA (only NR);Eukaryota;Amorphea;Obazoa;Opisthokonta;Nucletmycea;Fungi;Dikarya;Basidiomycota;Agaricomycotina;Agaricomycetes;Polyporales;Donkia;";"0.0";"0";"1";"1";"0";"1";"0";"430523";"5766"
"LOK1378_1mm";"SILVA (only NR);Eukaryota;Amorphea;Obazoa;Opisthokonta;Nucletmycea;Fungi;Dikarya;Basidiomycota;Agaricomycotina;Agaricomycetes;Polyporales;Donkioporia;";"0.0";"0";"1";"1";"0";"1";"0";"430523";"5766"
"LOK1378_1mm";"SILVA (only NR);Eukaryota;Amorphea;Obazoa;Opisthokonta;Nucletmycea;Fungi;Dikarya;Basidiomycota;Agaricomycotina;Agaricomycetes;Polyporales;Emmia;";"0.0";"0";"1";"1";"0";"1";"0";"430523";"5766"
"LOK1378_1mm";"SILVA (only NR);Eukaryota;Amorphea;Obazoa;Opisthokonta;Nucletmycea;Fungi;Dikarya;Basidiomycota;Agaricomycotina;Agaricomycetes;Polyporales;Flaviporus;";"0.0";"0";"1";"1";"0";"1";"0";"430523";"5766"
"LOK1378_1mm";"SILVA (only NR);Eukaryota;Amorphea;Obazoa;Opisthokonta;Nucletmycea;Fungi;Dikarya;Basidiomycota;Agaricomycotina;Agaricomycetes;Polyporales;Fomes;";"0.0";"0";"1";"1";"0";"1";"0";"430523";"5766"
"LOK1378_1mm";"SILVA (only NR);Eukaryota;Amorphea;Obazoa;Opisthokonta;Nucletmycea;Fungi;Dikarya;Basidiomycota;Agaricomycotina;Agaricomycetes;Polyporales;Fomitopsidaceae;";"0.0";"0";"1";"1";"0";"1";"0";"430523";"5766"
"LOK1378_1mm";"SILVA (only NR);Eukaryota;Amorphea;Obazoa;Opisthokonta;Nucletmycea;Fungi;Dikarya;Basidiomycota;Agaricomycotina;Agaricomycetes;Polyporales;Fomitopsidaceae;Antrodia;";"0.0";"0";"1";"1";"0";"1";"0";"430523";"5766"
"LOK1378_1mm";"SILVA (only NR);Eukaryota;Amorphea;Obazoa;Opisthokonta;Nucletmycea;Fungi;Dikarya;Basidiomycota;Agaricomycotina;Agaricomycetes;Polyporales;Fomitopsis;";"0.0";"0";"2";"2";"0";"2";"0";"430522";"5766"
"LOK1378_1mm";"SILVA (only NR);Eukaryota;Amorphea;Obazoa;Opisthokonta;Nucletmycea;Fungi;Dikarya;Basidiomycota;Agaricomycotina;Agaricomycetes;Polyporales;Ganoderma;";"0.0";"0";"2";"2";"0";"2";"0";"430522";"5766"
"LOK1378_1mm";"SILVA (only NR);Eukaryota;Amorphea;Obazoa;Opisthokonta;Nucletmycea;Fungi;Dikarya;Basidiomycota;Agaricomycotina;Agaricomycetes;Polyporales;Hyphodermella;";"0.0";"0";"1";"1";"0";"1";"0";"430523";"5766"
"LOK1378_1mm";"SILVA (only NR);Eukaryota;Amorphea;Obazoa;Opisthokonta;Nucletmycea;Fungi;Dikarya;Basidiomycota;Agaricomycotina;Agaricomycetes;Polyporales;Incertae Sedis;";"0.0";"0";"41";"37";"0";"37";"4";"430487";"5766"
"LOK1378_1mm";"SILVA (only NR);Eukaryota;Amorphea;Obazoa;Opisthokonta;Nucletmycea;Fungi;Dikarya;Basidiomycota;Agaricomycotina;Agaricomycetes;Polyporales;Incertae Sedis;Burgoa;";"0.0";"0";"2";"2";"0";"2";"0";"430522";"5766"
"LOK1378_1mm";"SILVA (only NR);Eukaryota;Amorphea;Obazoa;Opisthokonta;Nucletmycea;Fungi;Dikarya;Basidiomycota;Agaricomycotina;Agaricomycetes;Polyporales;Incertae Sedis;Diplomitoporus;";"0.0";"0";"4";"0";"0";"0";"4";"430524";"5766"
"LOK1378_1mm";"SILVA (only NR);Eukaryota;Amorphea;Obazoa;Opisthokonta;Nucletmycea;Fungi;Dikarya;Basidiomycota;Agaricomycotina;Agaricomycetes;Polyporales;Incertae Sedis;Gelatoporiaceae;";"0.0";"0";"1";"1";"0";"1";"0";"430523";"5766"
"LOK1378_1mm";"SILVA (only NR);Eukaryota;Amorphea;Obazoa;Opisthokonta;Nucletmycea;Fungi;Dikarya;Basidiomycota;Agaricomycotina;Agaricomycetes;Polyporales;Incertae Sedis;Gelatoporiaceae;Gelatoporia;";"0.0";"0";"1";"1";"0";"1";"0";"430523";"5766"
"LOK1378_1mm";"SILVA (only NR);Eukaryota;Amorphea;Obazoa;Opisthokonta;Nucletmycea;Fungi;Dikarya;Basidiomycota;Agaricomycotina;Agaricomycetes;Polyporales;Incertae Sedis;Marchandiomyces;";"0.0";"0";"7";"7";"0";"7";"0";"430517";"5766"
"LOK1378_1mm";"SILVA (only NR);Eukaryota;Amorphea;Obazoa;Opisthokonta;Nucletmycea;Fungi;Dikarya;Basidiomycota;Agaricomycotina;Agaricomycetes;Polyporales;Incertae Sedis;Melanoporia;";"0.0";"0";"1";"1";"0";"1";"0";"430523";"5766"
"LOK1378_1mm";"SILVA (only NR);Eukaryota;Amorphea;Obazoa;Opisthokonta;Nucletmycea;Fungi;Dikarya;Basidiomycota;Agaricomycotina;Agaricomycetes;Polyporales;Incertae Sedis;Oligoporus;";"0.0";"0";"1";"1";"0";"1";"0";"430523";"5766"
"LOK1378_1mm";"SILVA (only NR);Eukaryota;Amorphea;Obazoa;Opisthokonta;Nucletmycea;Fungi;Dikarya;Basidiomycota;Agaricomycotina;Agaricomycetes;Polyporales;Incertae Sedis;Steccherinum;";"0.0";"0";"1";"1";"0";"1";"0";"430523";"5766"
"LOK1378_1mm";"SILVA (only NR);Eukaryota;Amorphea;Obazoa;Opisthokonta;Nucletmycea;Fungi;Dikarya;Basidiomycota;Agaricomycotina;Agaricomycetes;Polyporales;Incertae Sedis;Taiwanofungus;";"0.0";"0";"3";"3";"0";"3";"0";"430521";"5766"
"LOK1378_1mm";"SILVA (only NR);Eukaryota;Amorphea;Obazoa;Opisthokonta;Nucletmycea;Fungi;Dikarya;Basidiomycota;Agaricomycotina;Agaricomycetes;Polyporales;Incertae Sedis;Trametes;";"0.0";"0";"12";"12";"0";"12";"0";"430512";"5766"
"LOK1378_1mm";"SILVA (only NR);Eukaryota;Amorphea;Obazoa;Opisthokonta;Nucletmycea;Fungi;Dikarya;Basidiomycota;Agaricomycotina;Agaricomycetes;Polyporales;Incertae Sedis;Tretopileus;";"0.0";"0";"1";"1";"0";"1";"0";"430523";"5766"
"LOK1378_1mm";"SILVA (only NR);Eukaryota;Amorphea;Obazoa;Opisthokonta;Nucletmycea;Fungi;Dikarya;Basidiomycota;Agaricomycotina;Agaricomycetes;Polyporales;Incertae Sedis;Trichaptum;";"0.0";"0";"6";"6";"0";"6";"0";"430518";"5766"
"LOK1378_1mm";"SILVA (only NR);Eukaryota;Amorphea;Obazoa;Opisthokonta;Nucletmycea;Fungi;Dikarya;Basidiomycota;Agaricomycotina;Agaricomycetes;Polyporales;Irpex;";"0.0";"0";"1";"1";"0";"1";"0";"430523";"5766"
"LOK1378_1mm";"SILVA (only NR);Eukaryota;Amorphea;Obazoa;Opisthokonta;Nucletmycea;Fungi;Dikarya;Basidiomycota;Agaricomycotina;Agaricomycetes;Polyporales;Irpicaceae;";"0.0";"0";"5";"4";"0";"4";"1";"430520";"5766"
"LOK1378_1mm";"SILVA (only NR);Eukaryota;Amorphea;Obazoa;Opisthokonta;Nucletmycea;Fungi;Dikarya;Basidiomycota;Agaricomycotina;Agaricomycetes;Polyporales;Irpicaceae;Ceriporia;";"0.0";"0";"4";"4";"0";"4";"0";"430520";"5766"
"LOK1378_1mm";"SILVA (only NR);Eukaryota;Amorphea;Obazoa;Opisthokonta;Nucletmycea;Fungi;Dikarya;Basidiomycota;Agaricomycotina;Agaricomycetes;Polyporales;Irpicaceae;Leptoporus;";"0.0";"0";"1";"0";"0";"0";"1";"430524";"5766"
"LOK1378_1mm";"SILVA (only NR);Eukaryota;Amorphea;Obazoa;Opisthokonta;Nucletmycea;Fungi;Dikarya;Basidiomycota;Agaricomycotina;Agaricomycetes;Polyporales;Junghuhnia;";"0.0";"0";"1";"1";"0";"1";"0";"430523";"5766"
"LOK1378_1mm";"SILVA (only NR);Eukaryota;Amorphea;Obazoa;Opisthokonta;Nucletmycea;Fungi;Dikarya;Basidiomycota;Agaricomycotina;Agaricomycetes;Polyporales;Laetiporaceae;";"0.0";"0";"2";"2";"0";"2";"0";"430522";"5766"
"LOK1378_1mm";"SILVA (only NR);Eukaryota;Amorphea;Obazoa;Opisthokonta;Nucletmycea;Fungi;Dikarya;Basidiomycota;Agaricomycotina;Agaricomycetes;Polyporales;Laetiporaceae;Wolfiporia;";"0.0";"0";"2";"2";"0";"2";"0";"430522";"5766"
"LOK1378_1mm";"SILVA (only NR);Eukaryota;Amorphea;Obazoa;Opisthokonta;Nucletmycea;Fungi;Dikarya;Basidiomycota;Agaricomycotina;Agaricomycetes;Polyporales;Lentinus;";"0.0";"0";"1";"1";"0";"1";"0";"430523";"5766"
"LOK1378_1mm";"SILVA (only NR);Eukaryota;Amorphea;Obazoa;Opisthokonta;Nucletmycea;Fungi;Dikarya;Basidiomycota;Agaricomycotina;Agaricomycetes;Polyporales;Meruliaceae;";"0.0";"0";"5";"5";"0";"5";"0";"430519";"5766"
"LOK1378_1mm";"SILVA (only NR);Eukaryota;Amorphea;Obazoa;Opisthokonta;Nucletmycea;Fungi;Dikarya;Basidiomycota;Agaricomycotina;Agaricomycetes;Polyporales;Meruliaceae;Gloeoporus;";"0.0";"0";"3";"3";"0";"3";"0";"430521";"5766"
"LOK1378_1mm";"SILVA (only NR);Eukaryota;Amorphea;Obazoa;Opisthokonta;Nucletmycea;Fungi;Dikarya;Basidiomycota;Agaricomycotina;Agaricomycetes;Polyporales;Meruliaceae;Skvortzovia;";"0.0";"0";"1";"1";"0";"1";"0";"430523";"5766"
"LOK1378_1mm";"SILVA (only NR);Eukaryota;Amorphea;Obazoa;Opisthokonta;Nucletmycea;Fungi;Dikarya;Basidiomycota;Agaricomycotina;Agaricomycetes;Polyporales;Neolentiporus;";"0.0";"0";"1";"1";"0";"1";"0";"430523";"5766"
"LOK1378_1mm";"SILVA (only NR);Eukaryota;Amorphea;Obazoa;Opisthokonta;Nucletmycea;Fungi;Dikarya;Basidiomycota;Agaricomycotina;Agaricomycetes;Polyporales;Phanerochaetaceae;";"0.0";"0";"11";"10";"0";"10";"1";"430514";"5766"
"LOK1378_1mm";"SILVA (only NR);Eukaryota;Amorphea;Obazoa;Opisthokonta;Nucletmycea;Fungi;Dikarya;Basidiomycota;Agaricomycotina;Agaricomycetes;Polyporales;Phanerochaetaceae;Bjerkandera;";"0.0";"0";"6";"6";"0";"6";"0";"430518";"5766"
"LOK1378_1mm";"SILVA (only NR);Eukaryota;Amorphea;Obazoa;Opisthokonta;Nucletmycea;Fungi;Dikarya;Basidiomycota;Agaricomycotina;Agaricomycetes;Polyporales;Phanerochaetaceae;Hapalopilus;";"0.0";"0";"1";"1";"0";"1";"0";"430523";"5766"
"LOK1378_1mm";"SILVA (only NR);Eukaryota;Amorphea;Obazoa;Opisthokonta;Nucletmycea;Fungi;Dikarya;Basidiomycota;Agaricomycotina;Agaricomycetes;Polyporales;Phanerochaetaceae;Phanerochaete;";"0.0";"0";"2";"2";"0";"2";"0";"430522";"5766"
"LOK1378_1mm";"SILVA (only NR);Eukaryota;Amorphea;Obazoa;Opisthokonta;Nucletmycea;Fungi;Dikarya;Basidiomycota;Agaricomycotina;Agaricomycetes;Polyporales;Phanerochaetaceae;Phlebiopsis;";"0.0";"0";"2";"1";"0";"1";"1";"430523";"5766"
"LOK1378_1mm";"SILVA (only NR);Eukaryota;Amorphea;Obazoa;Opisthokonta;Nucletmycea;Fungi;Dikarya;Basidiomycota;Agaricomycotina;Agaricomycetes;Polyporales;Polyporaceae;";"0.0";"0";"21";"21";"0";"21";"0";"430503";"5766"
"LOK1378_1mm";"SILVA (only NR);Eukaryota;Amorphea;Obazoa;Opisthokonta;Nucletmycea;Fungi;Dikarya;Basidiomycota;Agaricomycotina;Agaricomycetes;Polyporales;Polyporaceae;Amyloporia;";"0.0";"0";"2";"2";"0";"2";"0";"430522";"5766"
"LOK1378_1mm";"SILVA (only NR);Eukaryota;Amorphea;Obazoa;Opisthokonta;Nucletmycea;Fungi;Dikarya;Basidiomycota;Agaricomycotina;Agaricomycetes;Polyporales;Polyporaceae;Cerrena;";"0.0";"0";"3";"3";"0";"3";"0";"430521";"5766"
"LOK1378_1mm";"SILVA (only NR);Eukaryota;Amorphea;Obazoa;Opisthokonta;Nucletmycea;Fungi;Dikarya;Basidiomycota;Agaricomycotina;Agaricomycetes;Polyporales;Polyporaceae;Datronia;";"0.0";"0";"1";"1";"0";"1";"0";"430523";"5766"
"LOK1378_1mm";"SILVA (only NR);Eukaryota;Amorphea;Obazoa;Opisthokonta;Nucletmycea;Fungi;Dikarya;Basidiomycota;Agaricomycotina;Agaricomycetes;Polyporales;Polyporaceae;Fibroporia;";"0.0";"0";"2";"2";"0";"2";"0";"430522";"5766"
"LOK1378_1mm";"SILVA (only NR);Eukaryota;Amorphea;Obazoa;Opisthokonta;Nucletmycea;Fungi;Dikarya;Basidiomycota;Agaricomycotina;Agaricomycetes;Polyporales;Polyporaceae;Haploporus;";"0.0";"0";"1";"1";"0";"1";"0";"430523";"5766"
"LOK1378_1mm";"SILVA (only NR);Eukaryota;Amorphea;Obazoa;Opisthokonta;Nucletmycea;Fungi;Dikarya;Basidiomycota;Agaricomycotina;Agaricomycetes;Polyporales;Polyporaceae;Hexagonia;";"0.0";"0";"2";"2";"0";"2";"0";"430522";"5766"
"LOK1378_1mm";"SILVA (only NR);Eukaryota;Amorphea;Obazoa;Opisthokonta;Nucletmycea;Fungi;Dikarya;Basidiomycota;Agaricomycotina;Agaricomycetes;Polyporales;Polyporaceae;Lignosus;";"0.0";"0";"2";"2";"0";"2";"0";"430522";"5766"
"LOK1378_1mm";"SILVA (only NR);Eukaryota;Amorphea;Obazoa;Opisthokonta;Nucletmycea;Fungi;Dikarya;Basidiomycota;Agaricomycotina;Agaricomycetes;Polyporales;Polyporaceae;Megasporoporiella;";"0.0";"0";"1";"1";"0";"1";"0";"430523";"5766"
"LOK1378_1mm";"SILVA (only NR);Eukaryota;Amorphea;Obazoa;Opisthokonta;Nucletmycea;Fungi;Dikarya;Basidiomycota;Agaricomycotina;Agaricomycetes;Polyporales;Polyporaceae;Perenniporia;";"0.0";"0";"4";"4";"0";"4";"0";"430520";"5766"
"LOK1378_1mm";"SILVA (only NR);Eukaryota;Amorphea;Obazoa;Opisthokonta;Nucletmycea;Fungi;Dikarya;Basidiomycota;Agaricomycotina;Agaricomycetes;Polyporales;Polyporaceae;Spongipellis;";"0.0";"0";"2";"2";"0";"2";"0";"430522";"5766"
"LOK1378_1mm";"SILVA (only NR);Eukaryota;Amorphea;Obazoa;Opisthokonta;Nucletmycea;Fungi;Dikarya;Basidiomycota;Agaricomycotina;Agaricomycetes;Polyporales;Polyporus;";"0.0";"0";"1";"1";"0";"1";"0";"430523";"5766"
"LOK1378_1mm";"SILVA (only NR);Eukaryota;Amorphea;Obazoa;Opisthokonta;Nucletmycea;Fungi;Dikarya;Basidiomycota;Agaricomycotina;Agaricomycetes;Polyporales;Poria;";"0.0";"0";"1";"1";"0";"1";"0";"430523";"5766"
"LOK1378_1mm";"SILVA (only NR);Eukaryota;Amorphea;Obazoa;Opisthokonta;Nucletmycea;Fungi;Dikarya;Basidiomycota;Agaricomycotina;Agaricomycetes;Polyporales;Porostereum;";"0.0";"0";"1";"1";"0";"1";"0";"430523";"5766"
"LOK1378_1mm";"SILVA (only NR);Eukaryota;Amorphea;Obazoa;Opisthokonta;Nucletmycea;Fungi;Dikarya;Basidiomycota;Agaricomycotina;Agaricomycetes;Polyporales;Postia;";"0.0";"0";"3";"3";"0";"3";"0";"430521";"5766"
"LOK1378_1mm";"SILVA (only NR);Eukaryota;Amorphea;Obazoa;Opisthokonta;Nucletmycea;Fungi;Dikarya;Basidiomycota;Agaricomycotina;Agaricomycetes;Polyporales;Sparassidaceae;";"0.0";"0";"11";"11";"0";"11";"0";"430513";"5766"
"LOK1378_1mm";"SILVA (only NR);Eukaryota;Amorphea;Obazoa;Opisthokonta;Nucletmycea;Fungi;Dikarya;Basidiomycota;Agaricomycotina;Agaricomycetes;Polyporales;Sparassidaceae;Sparassis;";"0.0";"0";"11";"11";"0";"11";"0";"430513";"5766"
"LOK1378_1mm";"SILVA (only NR);Eukaryota;Amorphea;Obazoa;Opisthokonta;Nucletmycea;Fungi;Dikarya;Basidiomycota;Agaricomycotina;Agaricomycetes;Polyporales;Tinctoporellus;";"0.0";"0";"1";"1";"0";"1";"0";"430523";"5766"
"LOK1378_1mm";"SILVA (only NR);Eukaryota;Amorphea;Obazoa;Opisthokonta;Nucletmycea;Fungi;Dikarya;Basidiomycota;Agaricomycotina;Agaricomycetes;Polyporales;Tyromyces;";"0.0";"0";"2";"2";"0";"2";"0";"430522";"5766"
"LOK1378_1mm";"SILVA (only NR);Eukaryota;Amorphea;Obazoa;Opisthokonta;Nucletmycea;Fungi;Dikarya;Basidiomycota;Agaricomycotina;Agaricomycetes;Polyporales;[Ceraceomyces];";"0.0";"0";"1";"1";"0";"1";"0";"430523";"5766"
"LOK1378_1mm";"SILVA (only NR);Eukaryota;Amorphea;Obazoa;Opisthokonta;Nucletmycea;Fungi;Dikarya;Basidiomycota;Agaricomycotina;Agaricomycetes;Polyporales;basidiomycete;";"0.0";"0";"1";"1";"0";"1";"0";"430523";"5766"
"LOK1378_1mm";"SILVA (only NR);Eukaryota;Amorphea;Obazoa;Opisthokonta;Nucletmycea;Fungi;Dikarya;Basidiomycota;Agaricomycotina;Agaricomycetes;Polyporales;uncultured;";"0.0";"0";"4";"3";"0";"3";"1";"430521";"5766"
"LOK1378_1mm";"SILVA (only NR);Eukaryota;Amorphea;Obazoa;Opisthokonta;Nucletmycea;Fungi;Dikarya;Basidiomycota;Agaricomycotina;Agaricomycetes;Russulales;";"0.0";"0";"77";"73";"0";"73";"4";"430451";"5766"
"LOK1378_1mm";"SILVA (only NR);Eukaryota;Amorphea;Obazoa;Opisthokonta;Nucletmycea;Fungi;Dikarya;Basidiomycota;Agaricomycotina;Agaricomycetes;Russulales;Albatrellaceae;";"0.0";"0";"2";"2";"0";"2";"0";"430522";"5766"
"LOK1378_1mm";"SILVA (only NR);Eukaryota;Amorphea;Obazoa;Opisthokonta;Nucletmycea;Fungi;Dikarya;Basidiomycota;Agaricomycotina;Agaricomycetes;Russulales;Albatrellaceae;Albatrellus;";"0.0";"0";"2";"2";"0";"2";"0";"430522";"5766"
"LOK1378_1mm";"SILVA (only NR);Eukaryota;Amorphea;Obazoa;Opisthokonta;Nucletmycea;Fungi;Dikarya;Basidiomycota;Agaricomycotina;Agaricomycetes;Russulales;Auriscalpiaceae;";"0.0";"0";"6";"6";"0";"6";"0";"430518";"5766"
"LOK1378_1mm";"SILVA (only NR);Eukaryota;Amorphea;Obazoa;Opisthokonta;Nucletmycea;Fungi;Dikarya;Basidiomycota;Agaricomycotina;Agaricomycetes;Russulales;Auriscalpiaceae;Artomyces;";"0.0";"0";"2";"2";"0";"2";"0";"430522";"5766"
"LOK1378_1mm";"SILVA (only NR);Eukaryota;Amorphea;Obazoa;Opisthokonta;Nucletmycea;Fungi;Dikarya;Basidiomycota;Agaricomycotina;Agaricomycetes;Russulales;Auriscalpiaceae;Auriscalpium;";"0.0";"0";"2";"2";"0";"2";"0";"430522";"5766"
"LOK1378_1mm";"SILVA (only NR);Eukaryota;Amorphea;Obazoa;Opisthokonta;Nucletmycea;Fungi;Dikarya;Basidiomycota;Agaricomycotina;Agaricomycetes;Russulales;Auriscalpiaceae;Lentinellus;";"0.0";"0";"2";"2";"0";"2";"0";"430522";"5766"
"LOK1378_1mm";"SILVA (only NR);Eukaryota;Amorphea;Obazoa;Opisthokonta;Nucletmycea;Fungi;Dikarya;Basidiomycota;Agaricomycotina;Agaricomycetes;Russulales;Bondarzewiaceae;";"0.0";"0";"5";"3";"0";"3";"2";"430521";"5766"
"LOK1378_1mm";"SILVA (only NR);Eukaryota;Amorphea;Obazoa;Opisthokonta;Nucletmycea;Fungi;Dikarya;Basidiomycota;Agaricomycotina;Agaricomycetes;Russulales;Bondarzewiaceae;Bondarzewia;";"0.0";"0";"1";"1";"0";"1";"0";"430523";"5766"
"LOK1378_1mm";"SILVA (only NR);Eukaryota;Amorphea;Obazoa;Opisthokonta;Nucletmycea;Fungi;Dikarya;Basidiomycota;Agaricomycotina;Agaricomycetes;Russulales;Bondarzewiaceae;Heterobasidion;";"0.0";"0";"4";"2";"0";"2";"2";"430522";"5766"
"LOK1378_1mm";"SILVA (only NR);Eukaryota;Amorphea;Obazoa;Opisthokonta;Nucletmycea;Fungi;Dikarya;Basidiomycota;Agaricomycotina;Agaricomycetes;Russulales;Dentipellis;";"0.0";"0";"1";"1";"0";"1";"0";"430523";"5766"
"LOK1378_1mm";"SILVA (only NR);Eukaryota;Amorphea;Obazoa;Opisthokonta;Nucletmycea;Fungi;Dikarya;Basidiomycota;Agaricomycotina;Agaricomycetes;Russulales;Echinodontiaceae;";"0.0";"0";"2";"2";"0";"2";"0";"430522";"5766"
"LOK1378_1mm";"SILVA (only NR);Eukaryota;Amorphea;Obazoa;Opisthokonta;Nucletmycea;Fungi;Dikarya;Basidiomycota;Agaricomycotina;Agaricomycetes;Russulales;Echinodontiaceae;Echinodontium;";"0.0";"0";"2";"2";"0";"2";"0";"430522";"5766"
"LOK1378_1mm";"SILVA (only NR);Eukaryota;Amorphea;Obazoa;Opisthokonta;Nucletmycea;Fungi;Dikarya;Basidiomycota;Agaricomycotina;Agaricomycetes;Russulales;Haloaleurodiscus;";"0.0";"0";"1";"1";"0";"1";"0";"430523";"5766"
"LOK1378_1mm";"SILVA (only NR);Eukaryota;Amorphea;Obazoa;Opisthokonta;Nucletmycea;Fungi;Dikarya;Basidiomycota;Agaricomycotina;Agaricomycetes;Russulales;Hericiaceae;";"0.0";"0";"4";"4";"0";"4";"0";"430520";"5766"
"LOK1378_1mm";"SILVA (only NR);Eukaryota;Amorphea;Obazoa;Opisthokonta;Nucletmycea;Fungi;Dikarya;Basidiomycota;Agaricomycotina;Agaricomycetes;Russulales;Hericiaceae;Hericium;";"0.0";"0";"4";"4";"0";"4";"0";"430520";"5766"
"LOK1378_1mm";"SILVA (only NR);Eukaryota;Amorphea;Obazoa;Opisthokonta;Nucletmycea;Fungi;Dikarya;Basidiomycota;Agaricomycotina;Agaricomycetes;Russulales;Hyphodermataceae;";"0.0";"0";"1";"1";"0";"1";"0";"430523";"5766"
"LOK1378_1mm";"SILVA (only NR);Eukaryota;Amorphea;Obazoa;Opisthokonta;Nucletmycea;Fungi;Dikarya;Basidiomycota;Agaricomycotina;Agaricomycetes;Russulales;Hyphodermataceae;Galzinia;";"0.0";"0";"1";"1";"0";"1";"0";"430523";"5766"
"LOK1378_1mm";"SILVA (only NR);Eukaryota;Amorphea;Obazoa;Opisthokonta;Nucletmycea;Fungi;Dikarya;Basidiomycota;Agaricomycotina;Agaricomycetes;Russulales;Lachnocladiaceae;";"0.0";"0";"7";"7";"0";"7";"0";"430517";"5766"
"LOK1378_1mm";"SILVA (only NR);Eukaryota;Amorphea;Obazoa;Opisthokonta;Nucletmycea;Fungi;Dikarya;Basidiomycota;Agaricomycotina;Agaricomycetes;Russulales;Lachnocladiaceae;Asterostroma;";"0.0";"0";"1";"1";"0";"1";"0";"430523";"5766"
"LOK1378_1mm";"SILVA (only NR);Eukaryota;Amorphea;Obazoa;Opisthokonta;Nucletmycea;Fungi;Dikarya;Basidiomycota;Agaricomycotina;Agaricomycetes;Russulales;Lachnocladiaceae;Baltazaria;";"0.0";"0";"1";"1";"0";"1";"0";"430523";"5766"
"LOK1378_1mm";"SILVA (only NR);Eukaryota;Amorphea;Obazoa;Opisthokonta;Nucletmycea;Fungi;Dikarya;Basidiomycota;Agaricomycotina;Agaricomycetes;Russulales;Lachnocladiaceae;Dichostereum;";"0.0";"0";"1";"1";"0";"1";"0";"430523";"5766"
"LOK1378_1mm";"SILVA (only NR);Eukaryota;Amorphea;Obazoa;Opisthokonta;Nucletmycea;Fungi;Dikarya;Basidiomycota;Agaricomycotina;Agaricomycetes;Russulales;Lachnocladiaceae;Scytinostroma;";"0.0";"0";"2";"2";"0";"2";"0";"430522";"5766"
"LOK1378_1mm";"SILVA (only NR);Eukaryota;Amorphea;Obazoa;Opisthokonta;Nucletmycea;Fungi;Dikarya;Basidiomycota;Agaricomycotina;Agaricomycetes;Russulales;Lachnocladiaceae;Vararia;";"0.0";"0";"1";"1";"0";"1";"0";"430523";"5766"
"LOK1378_1mm";"SILVA (only NR);Eukaryota;Amorphea;Obazoa;Opisthokonta;Nucletmycea;Fungi;Dikarya;Basidiomycota;Agaricomycotina;Agaricomycetes;Russulales;Laurilia;";"0.0";"0";"1";"1";"0";"1";"0";"430523";"5766"
"LOK1378_1mm";"SILVA (only NR);Eukaryota;Amorphea;Obazoa;Opisthokonta;Nucletmycea;Fungi;Dikarya;Basidiomycota;Agaricomycotina;Agaricomycetes;Russulales;Laxitextum;";"0.0";"0";"1";"1";"0";"1";"0";"430523";"5766"
"LOK1378_1mm";"SILVA (only NR);Eukaryota;Amorphea;Obazoa;Opisthokonta;Nucletmycea;Fungi;Dikarya;Basidiomycota;Agaricomycotina;Agaricomycetes;Russulales;Peniophora;";"0.0";"0";"1";"1";"0";"1";"0";"430523";"5766"
"LOK1378_1mm";"SILVA (only NR);Eukaryota;Amorphea;Obazoa;Opisthokonta;Nucletmycea;Fungi;Dikarya;Basidiomycota;Agaricomycotina;Agaricomycetes;Russulales;Podoscyphaceae;";"0.0";"0";"4";"4";"0";"4";"0";"430520";"5766"
"LOK1378_1mm";"SILVA (only NR);Eukaryota;Amorphea;Obazoa;Opisthokonta;Nucletmycea;Fungi;Dikarya;Basidiomycota;Agaricomycotina;Agaricomycetes;Russulales;Podoscyphaceae;Cymatoderma;";"0.0";"0";"1";"1";"0";"1";"0";"430523";"5766"
"LOK1378_1mm";"SILVA (only NR);Eukaryota;Amorphea;Obazoa;Opisthokonta;Nucletmycea;Fungi;Dikarya;Basidiomycota;Agaricomycotina;Agaricomycetes;Russulales;Podoscyphaceae;Podoscypha;";"0.0";"0";"3";"3";"0";"3";"0";"430521";"5766"
"LOK1378_1mm";"SILVA (only NR);Eukaryota;Amorphea;Obazoa;Opisthokonta;Nucletmycea;Fungi;Dikarya;Basidiomycota;Agaricomycotina;Agaricomycetes;Russulales;Russulaceae;";"0.0";"0";"14";"13";"0";"13";"1";"430511";"5766"
"LOK1378_1mm";"SILVA (only NR);Eukaryota;Amorphea;Obazoa;Opisthokonta;Nucletmycea;Fungi;Dikarya;Basidiomycota;Agaricomycotina;Agaricomycetes;Russulales;Russulaceae;Lactarius;";"0.0";"0";"6";"5";"0";"5";"1";"430519";"5766"
"LOK1378_1mm";"SILVA (only NR);Eukaryota;Amorphea;Obazoa;Opisthokonta;Nucletmycea;Fungi;Dikarya;Basidiomycota;Agaricomycotina;Agaricomycetes;Russulales;Russulaceae;Russula;";"0.0";"0";"8";"8";"0";"8";"0";"430516";"5766"
"LOK1378_1mm";"SILVA (only NR);Eukaryota;Amorphea;Obazoa;Opisthokonta;Nucletmycea;Fungi;Dikarya;Basidiomycota;Agaricomycotina;Agaricomycetes;Russulales;Stereaceae;";"0.0";"0";"20";"20";"0";"20";"0";"430504";"5766"
"LOK1378_1mm";"SILVA (only NR);Eukaryota;Amorphea;Obazoa;Opisthokonta;Nucletmycea;Fungi;Dikarya;Basidiomycota;Agaricomycotina;Agaricomycetes;Russulales;Stereaceae;Aleurobotrys;";"0.0";"0";"1";"1";"0";"1";"0";"430523";"5766"
"LOK1378_1mm";"SILVA (only NR);Eukaryota;Amorphea;Obazoa;Opisthokonta;Nucletmycea;Fungi;Dikarya;Basidiomycota;Agaricomycotina;Agaricomycetes;Russulales;Stereaceae;Amylostereum;";"0.0";"0";"3";"3";"0";"3";"0";"430521";"5766"
"LOK1378_1mm";"SILVA (only NR);Eukaryota;Amorphea;Obazoa;Opisthokonta;Nucletmycea;Fungi;Dikarya;Basidiomycota;Agaricomycotina;Agaricomycetes;Russulales;Stereaceae;Boreostereum;";"0.0";"0";"1";"1";"0";"1";"0";"430523";"5766"
"LOK1378_1mm";"SILVA (only NR);Eukaryota;Amorphea;Obazoa;Opisthokonta;Nucletmycea;Fungi;Dikarya;Basidiomycota;Agaricomycotina;Agaricomycetes;Russulales;Stereaceae;Lopharia;";"0.0";"0";"2";"2";"0";"2";"0";"430522";"5766"
"LOK1378_1mm";"SILVA (only NR);Eukaryota;Amorphea;Obazoa;Opisthokonta;Nucletmycea;Fungi;Dikarya;Basidiomycota;Agaricomycotina;Agaricomycetes;Russulales;Stereaceae;Megalocystidium;";"0.0";"0";"1";"1";"0";"1";"0";"430523";"5766"
"LOK1378_1mm";"SILVA (only NR);Eukaryota;Amorphea;Obazoa;Opisthokonta;Nucletmycea;Fungi;Dikarya;Basidiomycota;Agaricomycotina;Agaricomycetes;Russulales;Stereaceae;Stereum;";"0.0";"0";"3";"3";"0";"3";"0";"430521";"5766"
"LOK1378_1mm";"SILVA (only NR);Eukaryota;Amorphea;Obazoa;Opisthokonta;Nucletmycea;Fungi;Dikarya;Basidiomycota;Agaricomycotina;Agaricomycetes;Russulales;Stereaceae;Xylobolus;";"0.0";"0";"2";"2";"0";"2";"0";"430522";"5766"
"LOK1378_1mm";"SILVA (only NR);Eukaryota;Amorphea;Obazoa;Opisthokonta;Nucletmycea;Fungi;Dikarya;Basidiomycota;Agaricomycotina;Agaricomycetes;Russulales;Stereaceae;uncultured;";"0.0";"0";"6";"6";"0";"6";"0";"430518";"5766"
"LOK1378_1mm";"SILVA (only NR);Eukaryota;Amorphea;Obazoa;Opisthokonta;Nucletmycea;Fungi;Dikarya;Basidiomycota;Agaricomycotina;Agaricomycetes;Russulales;Xenasma;";"0.0";"0";"1";"1";"0";"1";"0";"430523";"5766"
"LOK1378_1mm";"SILVA (only NR);Eukaryota;Amorphea;Obazoa;Opisthokonta;Nucletmycea;Fungi;Dikarya;Basidiomycota;Agaricomycotina;Agaricomycetes;Russulales;uncultured;";"0.0";"0";"2";"1";"0";"1";"1";"430523";"5766"
"LOK1378_1mm";"SILVA (only NR);Eukaryota;Amorphea;Obazoa;Opisthokonta;Nucletmycea;Fungi;Dikarya;Basidiomycota;Agaricomycotina;Agaricomycetes;Sebacinales;";"0.0";"0";"7";"6";"0";"6";"1";"430518";"5766"
"LOK1378_1mm";"SILVA (only NR);Eukaryota;Amorphea;Obazoa;Opisthokonta;Nucletmycea;Fungi;Dikarya;Basidiomycota;Agaricomycotina;Agaricomycetes;Sebacinales;Chaetospermum;";"0.0";"0";"1";"0";"0";"0";"1";"430524";"5766"
"LOK1378_1mm";"SILVA (only NR);Eukaryota;Amorphea;Obazoa;Opisthokonta;Nucletmycea;Fungi;Dikarya;Basidiomycota;Agaricomycotina;Agaricomycetes;Sebacinales;Sebacinaceae;";"0.0";"0";"6";"6";"0";"6";"0";"430518";"5766"
"LOK1378_1mm";"SILVA (only NR);Eukaryota;Amorphea;Obazoa;Opisthokonta;Nucletmycea;Fungi;Dikarya;Basidiomycota;Agaricomycotina;Agaricomycetes;Sebacinales;Sebacinaceae;Craterocolla;";"0.0";"0";"1";"1";"0";"1";"0";"430523";"5766"
"LOK1378_1mm";"SILVA (only NR);Eukaryota;Amorphea;Obazoa;Opisthokonta;Nucletmycea;Fungi;Dikarya;Basidiomycota;Agaricomycotina;Agaricomycetes;Sebacinales;Sebacinaceae;Sebacina;";"0.0";"0";"4";"4";"0";"4";"0";"430520";"5766"
"LOK1378_1mm";"SILVA (only NR);Eukaryota;Amorphea;Obazoa;Opisthokonta;Nucletmycea;Fungi;Dikarya;Basidiomycota;Agaricomycotina;Agaricomycetes;Thelephorales;";"0.0";"0";"18";"18";"0";"18";"0";"430506";"5766"
"LOK1378_1mm";"SILVA (only NR);Eukaryota;Amorphea;Obazoa;Opisthokonta;Nucletmycea;Fungi;Dikarya;Basidiomycota;Agaricomycotina;Agaricomycetes;Thelephorales;Boletopsis;";"0.0";"0";"1";"1";"0";"1";"0";"430523";"5766"
"LOK1378_1mm";"SILVA (only NR);Eukaryota;Amorphea;Obazoa;Opisthokonta;Nucletmycea;Fungi;Dikarya;Basidiomycota;Agaricomycotina;Agaricomycetes;Thelephorales;Thelephoraceae;";"0.0";"0";"5";"5";"0";"5";"0";"430519";"5766"
"LOK1378_1mm";"SILVA (only NR);Eukaryota;Amorphea;Obazoa;Opisthokonta;Nucletmycea;Fungi;Dikarya;Basidiomycota;Agaricomycotina;Agaricomycetes;Thelephorales;Thelephoraceae;Hydnellum;";"0.0";"0";"2";"2";"0";"2";"0";"430522";"5766"
"LOK1378_1mm";"SILVA (only NR);Eukaryota;Amorphea;Obazoa;Opisthokonta;Nucletmycea;Fungi;Dikarya;Basidiomycota;Agaricomycotina;Agaricomycetes;Thelephorales;Thelephoraceae;Polyozellus;";"0.0";"0";"1";"1";"0";"1";"0";"430523";"5766"
"LOK1378_1mm";"SILVA (only NR);Eukaryota;Amorphea;Obazoa;Opisthokonta;Nucletmycea;Fungi;Dikarya;Basidiomycota;Agaricomycotina;Agaricomycetes;Thelephorales;Thelephoraceae;Sarcodon;";"0.0";"0";"1";"1";"0";"1";"0";"430523";"5766"
"LOK1378_1mm";"SILVA (only NR);Eukaryota;Amorphea;Obazoa;Opisthokonta;Nucletmycea;Fungi;Dikarya;Basidiomycota;Agaricomycotina;Agaricomycetes;Thelephorales;uncultured;";"0.0";"0";"9";"9";"0";"9";"0";"430515";"5766"
"LOK1378_1mm";"SILVA (only NR);Eukaryota;Amorphea;Obazoa;Opisthokonta;Nucletmycea;Fungi;Dikarya;Basidiomycota;Agaricomycotina;Agaricomycetes;Trechisporales;";"0.0";"0";"2";"2";"0";"2";"0";"430522";"5766"
"LOK1378_1mm";"SILVA (only NR);Eukaryota;Amorphea;Obazoa;Opisthokonta;Nucletmycea;Fungi;Dikarya;Basidiomycota;Agaricomycotina;Agaricomycetes;Trechisporales;Hydnodontaceae;";"0.0";"0";"2";"2";"0";"2";"0";"430522";"5766"
"LOK1378_1mm";"SILVA (only NR);Eukaryota;Amorphea;Obazoa;Opisthokonta;Nucletmycea;Fungi;Dikarya;Basidiomycota;Agaricomycotina;Agaricomycetes;Trechisporales;Hydnodontaceae;Trechispora;";"0.0";"0";"2";"2";"0";"2";"0";"430522";"5766"
"LOK1378_1mm";"SILVA (only NR);Eukaryota;Amorphea;Obazoa;Opisthokonta;Nucletmycea;Fungi;Dikarya;Basidiomycota;Agaricomycotina;Agaricomycetes;uncultured;";"0.0";"0";"13";"13";"0";"13";"0";"430511";"5766"
"LOK1378_1mm";"SILVA (only NR);Eukaryota;Amorphea;Obazoa;Opisthokonta;Nucletmycea;Fungi;Dikarya;Basidiomycota;Agaricomycotina;Dacrymycetes;";"0.0";"0";"50";"50";"0";"50";"0";"430474";"5766"
"LOK1378_1mm";"SILVA (only NR);Eukaryota;Amorphea;Obazoa;Opisthokonta;Nucletmycea;Fungi;Dikarya;Basidiomycota;Agaricomycotina;Dacrymycetes;Dacrymycetales;";"0.0";"0";"50";"50";"0";"50";"0";"430474";"5766"
"LOK1378_1mm";"SILVA (only NR);Eukaryota;Amorphea;Obazoa;Opisthokonta;Nucletmycea;Fungi;Dikarya;Basidiomycota;Agaricomycotina;Dacrymycetes;Dacrymycetales;Cerinomycetaceae;";"0.0";"0";"7";"7";"0";"7";"0";"430517";"5766"
"LOK1378_1mm";"SILVA (only NR);Eukaryota;Amorphea;Obazoa;Opisthokonta;Nucletmycea;Fungi;Dikarya;Basidiomycota;Agaricomycotina;Dacrymycetes;Dacrymycetales;Cerinomycetaceae;Cerinomyces;";"0.0";"0";"7";"7";"0";"7";"0";"430517";"5766"
"LOK1378_1mm";"SILVA (only NR);Eukaryota;Amorphea;Obazoa;Opisthokonta;Nucletmycea;Fungi;Dikarya;Basidiomycota;Agaricomycotina;Dacrymycetes;Dacrymycetales;Dacrymycetaceae;";"0.0";"0";"42";"42";"0";"42";"0";"430482";"5766"
"LOK1378_1mm";"SILVA (only NR);Eukaryota;Amorphea;Obazoa;Opisthokonta;Nucletmycea;Fungi;Dikarya;Basidiomycota;Agaricomycotina;Dacrymycetes;Dacrymycetales;Dacrymycetaceae;Calocera;";"0.0";"0";"4";"4";"0";"4";"0";"430520";"5766"
"LOK1378_1mm";"SILVA (only NR);Eukaryota;Amorphea;Obazoa;Opisthokonta;Nucletmycea;Fungi;Dikarya;Basidiomycota;Agaricomycotina;Dacrymycetes;Dacrymycetales;Dacrymycetaceae;Dacrymyces;";"0.0";"0";"30";"30";"0";"30";"0";"430494";"5766"
"LOK1378_1mm";"SILVA (only NR);Eukaryota;Amorphea;Obazoa;Opisthokonta;Nucletmycea;Fungi;Dikarya;Basidiomycota;Agaricomycotina;Dacrymycetes;Dacrymycetales;Dacrymycetaceae;Dacryopinax;";"0.0";"0";"1";"1";"0";"1";"0";"430523";"5766"
"LOK1378_1mm";"SILVA (only NR);Eukaryota;Amorphea;Obazoa;Opisthokonta;Nucletmycea;Fungi;Dikarya;Basidiomycota;Agaricomycotina;Dacrymycetes;Dacrymycetales;Dacrymycetaceae;Ditiola;";"0.0";"0";"1";"1";"0";"1";"0";"430523";"5766"
"LOK1378_1mm";"SILVA (only NR);Eukaryota;Amorphea;Obazoa;Opisthokonta;Nucletmycea;Fungi;Dikarya;Basidiomycota;Agaricomycotina;Dacrymycetes;Dacrymycetales;Dacrymycetaceae;Femsjonia;";"0.0";"0";"1";"1";"0";"1";"0";"430523";"5766"
"LOK1378_1mm";"SILVA (only NR);Eukaryota;Amorphea;Obazoa;Opisthokonta;Nucletmycea;Fungi;Dikarya;Basidiomycota;Agaricomycotina;Dacrymycetes;Dacrymycetales;Dacrymycetaceae;Guepiniopsis;";"0.0";"0";"1";"1";"0";"1";"0";"430523";"5766"
"LOK1378_1mm";"SILVA (only NR);Eukaryota;Amorphea;Obazoa;Opisthokonta;Nucletmycea;Fungi;Dikarya;Basidiomycota;Agaricomycotina;Dacrymycetes;Dacrymycetales;Dacrymycetaceae;Heterotextus;";"0.0";"0";"2";"2";"0";"2";"0";"430522";"5766"
"LOK1378_1mm";"SILVA (only NR);Eukaryota;Amorphea;Obazoa;Opisthokonta;Nucletmycea;Fungi;Dikarya;Basidiomycota;Agaricomycotina;Geminibasidiomycetes;";"0.0";"0";"2";"2";"0";"2";"0";"430522";"5766"
"LOK1378_1mm";"SILVA (only NR);Eukaryota;Amorphea;Obazoa;Opisthokonta;Nucletmycea;Fungi;Dikarya;Basidiomycota;Agaricomycotina;Geminibasidiomycetes;Geminibasidiales;";"0.0";"0";"2";"2";"0";"2";"0";"430522";"5766"
"LOK1378_1mm";"SILVA (only NR);Eukaryota;Amorphea;Obazoa;Opisthokonta;Nucletmycea;Fungi;Dikarya;Basidiomycota;Agaricomycotina;Geminibasidiomycetes;Geminibasidiales;Geminibasidiaceae;";"0.0";"0";"2";"2";"0";"2";"0";"430522";"5766"
"LOK1378_1mm";"SILVA (only NR);Eukaryota;Amorphea;Obazoa;Opisthokonta;Nucletmycea;Fungi;Dikarya;Basidiomycota;Agaricomycotina;Geminibasidiomycetes;Geminibasidiales;Geminibasidiaceae;Basidioascus;";"0.0";"0";"1";"1";"0";"1";"0";"430523";"5766"
"LOK1378_1mm";"SILVA (only NR);Eukaryota;Amorphea;Obazoa;Opisthokonta;Nucletmycea;Fungi;Dikarya;Basidiomycota;Agaricomycotina;Geminibasidiomycetes;Geminibasidiales;Geminibasidiaceae;Geminibasidium;";"0.0";"0";"1";"1";"0";"1";"0";"430523";"5766"
"LOK1378_1mm";"SILVA (only NR);Eukaryota;Amorphea;Obazoa;Opisthokonta;Nucletmycea;Fungi;Dikarya;Basidiomycota;Agaricomycotina;Tremellomycetes;";"0.0";"0";"444";"439";"0";"439";"5";"430085";"5766"
"LOK1378_1mm";"SILVA (only NR);Eukaryota;Amorphea;Obazoa;Opisthokonta;Nucletmycea;Fungi;Dikarya;Basidiomycota;Agaricomycotina;Tremellomycetes;Cystofilobasidiales;";"0.0";"0";"30";"29";"0";"29";"1";"430495";"5766"
"LOK1378_1mm";"SILVA (only NR);Eukaryota;Amorphea;Obazoa;Opisthokonta;Nucletmycea;Fungi;Dikarya;Basidiomycota;Agaricomycotina;Tremellomycetes;Cystofilobasidiales;Cystofilobasidiaceae;";"0.0";"0";"11";"10";"0";"10";"1";"430514";"5766"
"LOK1378_1mm";"SILVA (only NR);Eukaryota;Amorphea;Obazoa;Opisthokonta;Nucletmycea;Fungi;Dikarya;Basidiomycota;Agaricomycotina;Tremellomycetes;Cystofilobasidiales;Cystofilobasidiaceae;Cystofilobasidium;";"0.0";"0";"11";"10";"0";"10";"1";"430514";"5766"
"LOK1378_1mm";"SILVA (only NR);Eukaryota;Amorphea;Obazoa;Opisthokonta;Nucletmycea;Fungi;Dikarya;Basidiomycota;Agaricomycotina;Tremellomycetes;Cystofilobasidiales;Mrakiaceae;";"0.0";"0";"19";"19";"0";"19";"0";"430505";"5766"
"LOK1378_1mm";"SILVA (only NR);Eukaryota;Amorphea;Obazoa;Opisthokonta;Nucletmycea;Fungi;Dikarya;Basidiomycota;Agaricomycotina;Tremellomycetes;Cystofilobasidiales;Mrakiaceae;Itersonilia;";"0.0";"0";"3";"3";"0";"3";"0";"430521";"5766"
"LOK1378_1mm";"SILVA (only NR);Eukaryota;Amorphea;Obazoa;Opisthokonta;Nucletmycea;Fungi;Dikarya;Basidiomycota;Agaricomycotina;Tremellomycetes;Cystofilobasidiales;Mrakiaceae;Mrakia;";"0.0";"0";"6";"6";"0";"6";"0";"430518";"5766"
"LOK1378_1mm";"SILVA (only NR);Eukaryota;Amorphea;Obazoa;Opisthokonta;Nucletmycea;Fungi;Dikarya;Basidiomycota;Agaricomycotina;Tremellomycetes;Cystofilobasidiales;Mrakiaceae;Phaffia;";"0.0";"0";"1";"1";"0";"1";"0";"430523";"5766"
"LOK1378_1mm";"SILVA (only NR);Eukaryota;Amorphea;Obazoa;Opisthokonta;Nucletmycea;Fungi;Dikarya;Basidiomycota;Agaricomycotina;Tremellomycetes;Cystofilobasidiales;Mrakiaceae;Tausonia;";"0.0";"0";"1";"1";"0";"1";"0";"430523";"5766"
"LOK1378_1mm";"SILVA (only NR);Eukaryota;Amorphea;Obazoa;Opisthokonta;Nucletmycea;Fungi;Dikarya;Basidiomycota;Agaricomycotina;Tremellomycetes;Cystofilobasidiales;Mrakiaceae;Udeniomyces;";"0.0";"0";"4";"4";"0";"4";"0";"430520";"5766"
"LOK1378_1mm";"SILVA (only NR);Eukaryota;Amorphea;Obazoa;Opisthokonta;Nucletmycea;Fungi;Dikarya;Basidiomycota;Agaricomycotina;Tremellomycetes;Cystofilobasidiales;Mrakiaceae;Xanthophyllomyces;";"0.0";"0";"1";"1";"0";"1";"0";"430523";"5766"
"LOK1378_1mm";"SILVA (only NR);Eukaryota;Amorphea;Obazoa;Opisthokonta;Nucletmycea;Fungi;Dikarya;Basidiomycota;Agaricomycotina;Tremellomycetes;Filobasidiales;";"0.0";"0";"106";"105";"0";"105";"1";"430419";"5766"
"LOK1378_1mm";"SILVA (only NR);Eukaryota;Amorphea;Obazoa;Opisthokonta;Nucletmycea;Fungi;Dikarya;Basidiomycota;Agaricomycotina;Tremellomycetes;Filobasidiales;Filobasidiaceae;";"0.0";"0";"94";"93";"0";"93";"1";"430431";"5766"
"LOK1378_1mm";"SILVA (only NR);Eukaryota;Amorphea;Obazoa;Opisthokonta;Nucletmycea;Fungi;Dikarya;Basidiomycota;Agaricomycotina;Tremellomycetes;Filobasidiales;Filobasidiaceae;Filobasidium;";"0.0";"0";"12";"11";"0";"11";"1";"430513";"5766"
"LOK1378_1mm";"SILVA (only NR);Eukaryota;Amorphea;Obazoa;Opisthokonta;Nucletmycea;Fungi;Dikarya;Basidiomycota;Agaricomycotina;Tremellomycetes;Filobasidiales;Filobasidiaceae;Goffeauzyma;";"0.0";"0";"7";"7";"0";"7";"0";"430517";"5766"
"LOK1378_1mm";"SILVA (only NR);Eukaryota;Amorphea;Obazoa;Opisthokonta;Nucletmycea;Fungi;Dikarya;Basidiomycota;Agaricomycotina;Tremellomycetes;Filobasidiales;Filobasidiaceae;Heterocephalacria;";"0.0";"0";"10";"10";"0";"10";"0";"430514";"5766"
"LOK1378_1mm";"SILVA (only NR);Eukaryota;Amorphea;Obazoa;Opisthokonta;Nucletmycea;Fungi;Dikarya;Basidiomycota;Agaricomycotina;Tremellomycetes;Filobasidiales;Filobasidiaceae;Naganishia;";"0.0";"0";"54";"54";"0";"54";"0";"430470";"5766"
"LOK1378_1mm";"SILVA (only NR);Eukaryota;Amorphea;Obazoa;Opisthokonta;Nucletmycea;Fungi;Dikarya;Basidiomycota;Agaricomycotina;Tremellomycetes;Filobasidiales;Filobasidiaceae;[Cryptococcus];";"0.0";"0";"1";"1";"0";"1";"0";"430523";"5766"
"LOK1378_1mm";"SILVA (only NR);Eukaryota;Amorphea;Obazoa;Opisthokonta;Nucletmycea;Fungi;Dikarya;Basidiomycota;Agaricomycotina;Tremellomycetes;Filobasidiales;Filobasidiaceae;uncultured;";"0.0";"0";"8";"8";"0";"8";"0";"430516";"5766"
"LOK1378_1mm";"SILVA (only NR);Eukaryota;Amorphea;Obazoa;Opisthokonta;Nucletmycea;Fungi;Dikarya;Basidiomycota;Agaricomycotina;Tremellomycetes;Filobasidiales;Piskurozymaceae;";"0.0";"0";"11";"11";"0";"11";"0";"430513";"5766"
"LOK1378_1mm";"SILVA (only NR);Eukaryota;Amorphea;Obazoa;Opisthokonta;Nucletmycea;Fungi;Dikarya;Basidiomycota;Agaricomycotina;Tremellomycetes;Filobasidiales;Piskurozymaceae;Piskurozyma;";"0.0";"0";"3";"3";"0";"3";"0";"430521";"5766"
"LOK1378_1mm";"SILVA (only NR);Eukaryota;Amorphea;Obazoa;Opisthokonta;Nucletmycea;Fungi;Dikarya;Basidiomycota;Agaricomycotina;Tremellomycetes;Filobasidiales;Piskurozymaceae;Solicoccozyma;";"0.0";"0";"8";"8";"0";"8";"0";"430516";"5766"
"LOK1378_1mm";"SILVA (only NR);Eukaryota;Amorphea;Obazoa;Opisthokonta;Nucletmycea;Fungi;Dikarya;Basidiomycota;Agaricomycotina;Tremellomycetes;Holtermanniales;";"0.0";"0";"2";"2";"0";"2";"0";"430522";"5766"
"LOK1378_1mm";"SILVA (only NR);Eukaryota;Amorphea;Obazoa;Opisthokonta;Nucletmycea;Fungi;Dikarya;Basidiomycota;Agaricomycotina;Tremellomycetes;Holtermanniales;Incertae Sedis;";"0.0";"0";"2";"2";"0";"2";"0";"430522";"5766"
"LOK1378_1mm";"SILVA (only NR);Eukaryota;Amorphea;Obazoa;Opisthokonta;Nucletmycea;Fungi;Dikarya;Basidiomycota;Agaricomycotina;Tremellomycetes;Holtermanniales;Incertae Sedis;Holtermanniella;";"0.0";"0";"2";"2";"0";"2";"0";"430522";"5766"
"LOK1378_1mm";"SILVA (only NR);Eukaryota;Amorphea;Obazoa;Opisthokonta;Nucletmycea;Fungi;Dikarya;Basidiomycota;Agaricomycotina;Tremellomycetes;Tremellales;";"0.0";"0";"209";"208";"0";"208";"1";"430316";"5766"
"LOK1378_1mm";"SILVA (only NR);Eukaryota;Amorphea;Obazoa;Opisthokonta;Nucletmycea;Fungi;Dikarya;Basidiomycota;Agaricomycotina;Tremellomycetes;Tremellales;Bulleraceae;";"0.0";"0";"9";"9";"0";"9";"0";"430515";"5766"
"LOK1378_1mm";"SILVA (only NR);Eukaryota;Amorphea;Obazoa;Opisthokonta;Nucletmycea;Fungi;Dikarya;Basidiomycota;Agaricomycotina;Tremellomycetes;Tremellales;Bulleraceae;Bullera;";"0.0";"0";"7";"7";"0";"7";"0";"430517";"5766"
"LOK1378_1mm";"SILVA (only NR);Eukaryota;Amorphea;Obazoa;Opisthokonta;Nucletmycea;Fungi;Dikarya;Basidiomycota;Agaricomycotina;Tremellomycetes;Tremellales;Bulleraceae;Pseudotremella;";"0.0";"0";"2";"2";"0";"2";"0";"430522";"5766"
"LOK1378_1mm";"SILVA (only NR);Eukaryota;Amorphea;Obazoa;Opisthokonta;Nucletmycea;Fungi;Dikarya;Basidiomycota;Agaricomycotina;Tremellomycetes;Tremellales;Bulleribasidiaceae;";"0.0";"0";"62";"62";"0";"62";"0";"430462";"5766"
"LOK1378_1mm";"SILVA (only NR);Eukaryota;Amorphea;Obazoa;Opisthokonta;Nucletmycea;Fungi;Dikarya;Basidiomycota;Agaricomycotina;Tremellomycetes;Tremellales;Bulleribasidiaceae;Bulleribasidium;";"0.0";"0";"9";"9";"0";"9";"0";"430515";"5766"
"LOK1378_1mm";"SILVA (only NR);Eukaryota;Amorphea;Obazoa;Opisthokonta;Nucletmycea;Fungi;Dikarya;Basidiomycota;Agaricomycotina;Tremellomycetes;Tremellales;Bulleribasidiaceae;Derxomyces;";"0.0";"0";"22";"22";"0";"22";"0";"430502";"5766"
"LOK1378_1mm";"SILVA (only NR);Eukaryota;Amorphea;Obazoa;Opisthokonta;Nucletmycea;Fungi;Dikarya;Basidiomycota;Agaricomycotina;Tremellomycetes;Tremellales;Bulleribasidiaceae;Dioszegia;";"0.0";"0";"9";"9";"0";"9";"0";"430515";"5766"
"LOK1378_1mm";"SILVA (only NR);Eukaryota;Amorphea;Obazoa;Opisthokonta;Nucletmycea;Fungi;Dikarya;Basidiomycota;Agaricomycotina;Tremellomycetes;Tremellales;Bulleribasidiaceae;Hannaella;";"0.0";"0";"10";"10";"0";"10";"0";"430514";"5766"
"LOK1378_1mm";"SILVA (only NR);Eukaryota;Amorphea;Obazoa;Opisthokonta;Nucletmycea;Fungi;Dikarya;Basidiomycota;Agaricomycotina;Tremellomycetes;Tremellales;Bulleribasidiaceae;Nielozyma;";"0.0";"0";"1";"1";"0";"1";"0";"430523";"5766"
"LOK1378_1mm";"SILVA (only NR);Eukaryota;Amorphea;Obazoa;Opisthokonta;Nucletmycea;Fungi;Dikarya;Basidiomycota;Agaricomycotina;Tremellomycetes;Tremellales;Bulleribasidiaceae;Vishniacozyma;";"0.0";"0";"11";"11";"0";"11";"0";"430513";"5766"
"LOK1378_1mm";"SILVA (only NR);Eukaryota;Amorphea;Obazoa;Opisthokonta;Nucletmycea;Fungi;Dikarya;Basidiomycota;Agaricomycotina;Tremellomycetes;Tremellales;Carcinomycetaceae;";"0.0";"0";"6";"6";"0";"6";"0";"430518";"5766"
"LOK1378_1mm";"SILVA (only NR);Eukaryota;Amorphea;Obazoa;Opisthokonta;Nucletmycea;Fungi;Dikarya;Basidiomycota;Agaricomycotina;Tremellomycetes;Tremellales;Carcinomycetaceae;Carcinomyces;";"0.0";"0";"6";"6";"0";"6";"0";"430518";"5766"
"LOK1378_1mm";"SILVA (only NR);Eukaryota;Amorphea;Obazoa;Opisthokonta;Nucletmycea;Fungi;Dikarya;Basidiomycota;Agaricomycotina;Tremellomycetes;Tremellales;Cryptococcaceae;";"0.0";"0";"26";"25";"0";"25";"1";"430499";"5766"
"LOK1378_1mm";"SILVA (only NR);Eukaryota;Amorphea;Obazoa;Opisthokonta;Nucletmycea;Fungi;Dikarya;Basidiomycota;Agaricomycotina;Tremellomycetes;Tremellales;Cryptococcaceae;Cryptococcus;";"0.0";"0";"24";"23";"0";"23";"1";"430501";"5766"
"LOK1378_1mm";"SILVA (only NR);Eukaryota;Amorphea;Obazoa;Opisthokonta;Nucletmycea;Fungi;Dikarya;Basidiomycota;Agaricomycotina;Tremellomycetes;Tremellales;Cryptococcaceae;Kwoniella;";"0.0";"0";"2";"2";"0";"2";"0";"430522";"5766"
"LOK1378_1mm";"SILVA (only NR);Eukaryota;Amorphea;Obazoa;Opisthokonta;Nucletmycea;Fungi;Dikarya;Basidiomycota;Agaricomycotina;Tremellomycetes;Tremellales;Cuniculitremaceae;";"0.0";"0";"27";"27";"0";"27";"0";"430497";"5766"
"LOK1378_1mm";"SILVA (only NR);Eukaryota;Amorphea;Obazoa;Opisthokonta;Nucletmycea;Fungi;Dikarya;Basidiomycota;Agaricomycotina;Tremellomycetes;Tremellales;Cuniculitremaceae;Fellomyces;";"0.0";"0";"4";"4";"0";"4";"0";"430520";"5766"
"LOK1378_1mm";"SILVA (only NR);Eukaryota;Amorphea;Obazoa;Opisthokonta;Nucletmycea;Fungi;Dikarya;Basidiomycota;Agaricomycotina;Tremellomycetes;Tremellales;Cuniculitremaceae;Kockovaella;";"0.0";"0";"23";"23";"0";"23";"0";"430501";"5766"
"LOK1378_1mm";"SILVA (only NR);Eukaryota;Amorphea;Obazoa;Opisthokonta;Nucletmycea;Fungi;Dikarya;Basidiomycota;Agaricomycotina;Tremellomycetes;Tremellales;Dimennazyma;";"0.0";"0";"1";"1";"0";"1";"0";"430523";"5766"
"LOK1378_1mm";"SILVA (only NR);Eukaryota;Amorphea;Obazoa;Opisthokonta;Nucletmycea;Fungi;Dikarya;Basidiomycota;Agaricomycotina;Tremellomycetes;Tremellales;Genolevuria;";"0.0";"0";"1";"1";"0";"1";"0";"430523";"5766"
"LOK1378_1mm";"SILVA (only NR);Eukaryota;Amorphea;Obazoa;Opisthokonta;Nucletmycea;Fungi;Dikarya;Basidiomycota;Agaricomycotina;Tremellomycetes;Tremellales;Phaeotremellaceae;";"0.0";"0";"3";"3";"0";"3";"0";"430521";"5766"
"LOK1378_1mm";"SILVA (only NR);Eukaryota;Amorphea;Obazoa;Opisthokonta;Nucletmycea;Fungi;Dikarya;Basidiomycota;Agaricomycotina;Tremellomycetes;Tremellales;Phaeotremellaceae;Phaeotremella;";"0.0";"0";"3";"3";"0";"3";"0";"430521";"5766"
"LOK1378_1mm";"SILVA (only NR);Eukaryota;Amorphea;Obazoa;Opisthokonta;Nucletmycea;Fungi;Dikarya;Basidiomycota;Agaricomycotina;Tremellomycetes;Tremellales;Rhynchogastrema;";"0.0";"0";"1";"1";"0";"1";"0";"430523";"5766"
"LOK1378_1mm";"SILVA (only NR);Eukaryota;Amorphea;Obazoa;Opisthokonta;Nucletmycea;Fungi;Dikarya;Basidiomycota;Agaricomycotina;Tremellomycetes;Tremellales;Rhynchogastremataceae;";"0.0";"0";"16";"16";"0";"16";"0";"430508";"5766"
"LOK1378_1mm";"SILVA (only NR);Eukaryota;Amorphea;Obazoa;Opisthokonta;Nucletmycea;Fungi;Dikarya;Basidiomycota;Agaricomycotina;Tremellomycetes;Tremellales;Rhynchogastremataceae;Papiliotrema;";"0.0";"0";"12";"12";"0";"12";"0";"430512";"5766"
"LOK1378_1mm";"SILVA (only NR);Eukaryota;Amorphea;Obazoa;Opisthokonta;Nucletmycea;Fungi;Dikarya;Basidiomycota;Agaricomycotina;Tremellomycetes;Tremellales;Rhynchogastremataceae;Rhynchogastrema;";"0.0";"0";"3";"3";"0";"3";"0";"430521";"5766"
"LOK1378_1mm";"SILVA (only NR);Eukaryota;Amorphea;Obazoa;Opisthokonta;Nucletmycea;Fungi;Dikarya;Basidiomycota;Agaricomycotina;Tremellomycetes;Tremellales;Sirobasidiaceae;";"0.0";"0";"9";"9";"0";"9";"0";"430515";"5766"
"LOK1378_1mm";"SILVA (only NR);Eukaryota;Amorphea;Obazoa;Opisthokonta;Nucletmycea;Fungi;Dikarya;Basidiomycota;Agaricomycotina;Tremellomycetes;Tremellales;Sirobasidiaceae;Fibulobasidium;";"0.0";"0";"3";"3";"0";"3";"0";"430521";"5766"
"LOK1378_1mm";"SILVA (only NR);Eukaryota;Amorphea;Obazoa;Opisthokonta;Nucletmycea;Fungi;Dikarya;Basidiomycota;Agaricomycotina;Tremellomycetes;Tremellales;Sirobasidiaceae;Sirobasidium;";"0.0";"0";"6";"6";"0";"6";"0";"430518";"5766"
"LOK1378_1mm";"SILVA (only NR);Eukaryota;Amorphea;Obazoa;Opisthokonta;Nucletmycea;Fungi;Dikarya;Basidiomycota;Agaricomycotina;Tremellomycetes;Tremellales;Sterigmatosporidium;";"0.0";"0";"1";"1";"0";"1";"0";"430523";"5766"
"LOK1378_1mm";"SILVA (only NR);Eukaryota;Amorphea;Obazoa;Opisthokonta;Nucletmycea;Fungi;Dikarya;Basidiomycota;Agaricomycotina;Tremellomycetes;Tremellales;Sugitazyma;";"0.0";"0";"1";"1";"0";"1";"0";"430523";"5766"
"LOK1378_1mm";"SILVA (only NR);Eukaryota;Amorphea;Obazoa;Opisthokonta;Nucletmycea;Fungi;Dikarya;Basidiomycota;Agaricomycotina;Tremellomycetes;Tremellales;Syzygosporaceae;";"0.0";"0";"2";"2";"0";"2";"0";"430522";"5766"
"LOK1378_1mm";"SILVA (only NR);Eukaryota;Amorphea;Obazoa;Opisthokonta;Nucletmycea;Fungi;Dikarya;Basidiomycota;Agaricomycotina;Tremellomycetes;Tremellales;Syzygosporaceae;Syzygospora;";"0.0";"0";"2";"2";"0";"2";"0";"430522";"5766"
"LOK1378_1mm";"SILVA (only NR);Eukaryota;Amorphea;Obazoa;Opisthokonta;Nucletmycea;Fungi;Dikarya;Basidiomycota;Agaricomycotina;Tremellomycetes;Tremellales;Tremellaceae;";"0.0";"0";"26";"26";"0";"26";"0";"430498";"5766"
"LOK1378_1mm";"SILVA (only NR);Eukaryota;Amorphea;Obazoa;Opisthokonta;Nucletmycea;Fungi;Dikarya;Basidiomycota;Agaricomycotina;Tremellomycetes;Tremellales;Tremellaceae;Biatoropsis;";"0.0";"0";"1";"1";"0";"1";"0";"430523";"5766"
"LOK1378_1mm";"SILVA (only NR);Eukaryota;Amorphea;Obazoa;Opisthokonta;Nucletmycea;Fungi;Dikarya;Basidiomycota;Agaricomycotina;Tremellomycetes;Tremellales;Tremellaceae;Tremella;";"0.0";"0";"25";"25";"0";"25";"0";"430499";"5766"
"LOK1378_1mm";"SILVA (only NR);Eukaryota;Amorphea;Obazoa;Opisthokonta;Nucletmycea;Fungi;Dikarya;Basidiomycota;Agaricomycotina;Tremellomycetes;Tremellales;Trimorphomycetaceae;";"0.0";"0";"6";"6";"0";"6";"0";"430518";"5766"
"LOK1378_1mm";"SILVA (only NR);Eukaryota;Amorphea;Obazoa;Opisthokonta;Nucletmycea;Fungi;Dikarya;Basidiomycota;Agaricomycotina;Tremellomycetes;Tremellales;Trimorphomycetaceae;Saitozyma;";"0.0";"0";"4";"4";"0";"4";"0";"430520";"5766"
"LOK1378_1mm";"SILVA (only NR);Eukaryota;Amorphea;Obazoa;Opisthokonta;Nucletmycea;Fungi;Dikarya;Basidiomycota;Agaricomycotina;Tremellomycetes;Tremellales;Trimorphomycetaceae;Trimorphomyces;";"0.0";"0";"2";"2";"0";"2";"0";"430522";"5766"
"LOK1378_1mm";"SILVA (only NR);Eukaryota;Amorphea;Obazoa;Opisthokonta;Nucletmycea;Fungi;Dikarya;Basidiomycota;Agaricomycotina;Tremellomycetes;Tremellales;uncultured;";"0.0";"0";"7";"7";"0";"7";"0";"430517";"5766"
"LOK1378_1mm";"SILVA (only NR);Eukaryota;Amorphea;Obazoa;Opisthokonta;Nucletmycea;Fungi;Dikarya;Basidiomycota;Agaricomycotina;Tremellomycetes;Trichosporonales;";"0.0";"0";"92";"90";"0";"90";"2";"430434";"5766"
"LOK1378_1mm";"SILVA (only NR);Eukaryota;Amorphea;Obazoa;Opisthokonta;Nucletmycea;Fungi;Dikarya;Basidiomycota;Agaricomycotina;Tremellomycetes;Trichosporonales;Cryptotrichosporon;";"0.0";"0";"1";"1";"0";"1";"0";"430523";"5766"
"LOK1378_1mm";"SILVA (only NR);Eukaryota;Amorphea;Obazoa;Opisthokonta;Nucletmycea;Fungi;Dikarya;Basidiomycota;Agaricomycotina;Tremellomycetes;Trichosporonales;Tetragoniomycetaceae;";"0.0";"0";"1";"1";"0";"1";"0";"430523";"5766"
"LOK1378_1mm";"SILVA (only NR);Eukaryota;Amorphea;Obazoa;Opisthokonta;Nucletmycea;Fungi;Dikarya;Basidiomycota;Agaricomycotina;Tremellomycetes;Trichosporonales;Tetragoniomycetaceae;Bandonia;";"0.0";"0";"1";"1";"0";"1";"0";"430523";"5766"
"LOK1378_1mm";"SILVA (only NR);Eukaryota;Amorphea;Obazoa;Opisthokonta;Nucletmycea;Fungi;Dikarya;Basidiomycota;Agaricomycotina;Tremellomycetes;Trichosporonales;Trichosporonaceae;";"0.0";"0";"88";"86";"0";"86";"2";"430438";"5766"
"LOK1378_1mm";"SILVA (only NR);Eukaryota;Amorphea;Obazoa;Opisthokonta;Nucletmycea;Fungi;Dikarya;Basidiomycota;Agaricomycotina;Tremellomycetes;Trichosporonales;Trichosporonaceae;Apiotrichum;";"0.0";"0";"38";"38";"0";"38";"0";"430486";"5766"
"LOK1378_1mm";"SILVA (only NR);Eukaryota;Amorphea;Obazoa;Opisthokonta;Nucletmycea;Fungi;Dikarya;Basidiomycota;Agaricomycotina;Tremellomycetes;Trichosporonales;Trichosporonaceae;Cutaneotrichosporon;";"0.0";"0";"12";"12";"0";"12";"0";"430512";"5766"
"LOK1378_1mm";"SILVA (only NR);Eukaryota;Amorphea;Obazoa;Opisthokonta;Nucletmycea;Fungi;Dikarya;Basidiomycota;Agaricomycotina;Tremellomycetes;Trichosporonales;Trichosporonaceae;Haglerozyma;";"0.0";"0";"1";"1";"0";"1";"0";"430523";"5766"
"LOK1378_1mm";"SILVA (only NR);Eukaryota;Amorphea;Obazoa;Opisthokonta;Nucletmycea;Fungi;Dikarya;Basidiomycota;Agaricomycotina;Tremellomycetes;Trichosporonales;Trichosporonaceae;Trichosporon;";"0.0";"0";"24";"23";"0";"23";"1";"430501";"5766"
"LOK1378_1mm";"SILVA (only NR);Eukaryota;Amorphea;Obazoa;Opisthokonta;Nucletmycea;Fungi;Dikarya;Basidiomycota;Agaricomycotina;Tremellomycetes;Trichosporonales;Trichosporonaceae;Vanrija;";"0.0";"0";"13";"12";"0";"12";"1";"430512";"5766"
"LOK1378_1mm";"SILVA (only NR);Eukaryota;Amorphea;Obazoa;Opisthokonta;Nucletmycea;Fungi;Dikarya;Basidiomycota;Agaricomycotina;Wallemiomycetes;";"0.0";"0";"6";"6";"0";"6";"0";"430518";"5766"
"LOK1378_1mm";"SILVA (only NR);Eukaryota;Amorphea;Obazoa;Opisthokonta;Nucletmycea;Fungi;Dikarya;Basidiomycota;Agaricomycotina;Wallemiomycetes;Wallemiales;";"0.0";"0";"6";"6";"0";"6";"0";"430518";"5766"
"LOK1378_1mm";"SILVA (only NR);Eukaryota;Amorphea;Obazoa;Opisthokonta;Nucletmycea;Fungi;Dikarya;Basidiomycota;Agaricomycotina;Wallemiomycetes;Wallemiales;Incertae Sedis;";"0.0";"0";"6";"6";"0";"6";"0";"430518";"5766"
"LOK1378_1mm";"SILVA (only NR);Eukaryota;Amorphea;Obazoa;Opisthokonta;Nucletmycea;Fungi;Dikarya;Basidiomycota;Agaricomycotina;Wallemiomycetes;Wallemiales;Incertae Sedis;Wallemia;";"0.0";"0";"6";"6";"0";"6";"0";"430518";"5766"
"LOK1378_1mm";"SILVA (only NR);Eukaryota;Amorphea;Obazoa;Opisthokonta;Nucletmycea;Fungi;Dikarya;Basidiomycota;Pucciniomycotina;";"0.0";"0";"570";"534";"0";"534";"36";"429990";"5766"
"LOK1378_1mm";"SILVA (only NR);Eukaryota;Amorphea;Obazoa;Opisthokonta;Nucletmycea;Fungi;Dikarya;Basidiomycota;Pucciniomycotina;Agaricostilbomycetes;";"0.0";"0";"48";"44";"0";"44";"4";"430480";"5766"
"LOK1378_1mm";"SILVA (only NR);Eukaryota;Amorphea;Obazoa;Opisthokonta;Nucletmycea;Fungi;Dikarya;Basidiomycota;Pucciniomycotina;Agaricostilbomycetes;Agaricostilbales;";"0.0";"0";"46";"42";"0";"42";"4";"430482";"5766"
"LOK1378_1mm";"SILVA (only NR);Eukaryota;Amorphea;Obazoa;Opisthokonta;Nucletmycea;Fungi;Dikarya;Basidiomycota;Pucciniomycotina;Agaricostilbomycetes;Agaricostilbales;Agaricostilbaceae;";"0.0";"0";"11";"8";"0";"8";"3";"430516";"5766"
"LOK1378_1mm";"SILVA (only NR);Eukaryota;Amorphea;Obazoa;Opisthokonta;Nucletmycea;Fungi;Dikarya;Basidiomycota;Pucciniomycotina;Agaricostilbomycetes;Agaricostilbales;Agaricostilbaceae;Pseudobensingtonia;";"0.0";"0";"3";"3";"0";"3";"0";"430521";"5766"
"LOK1378_1mm";"SILVA (only NR);Eukaryota;Amorphea;Obazoa;Opisthokonta;Nucletmycea;Fungi;Dikarya;Basidiomycota;Pucciniomycotina;Agaricostilbomycetes;Agaricostilbales;Agaricostilbaceae;Sterigmatomyces;";"0.0";"0";"8";"5";"0";"5";"3";"430519";"5766"
"LOK1378_1mm";"SILVA (only NR);Eukaryota;Amorphea;Obazoa;Opisthokonta;Nucletmycea;Fungi;Dikarya;Basidiomycota;Pucciniomycotina;Agaricostilbomycetes;Agaricostilbales;Chionosphaeraceae;";"0.0";"0";"12";"11";"0";"11";"1";"430513";"5766"
"LOK1378_1mm";"SILVA (only NR);Eukaryota;Amorphea;Obazoa;Opisthokonta;Nucletmycea;Fungi;Dikarya;Basidiomycota;Pucciniomycotina;Agaricostilbomycetes;Agaricostilbales;Chionosphaeraceae;Ballistosporomyces;";"0.0";"0";"4";"4";"0";"4";"0";"430520";"5766"
"LOK1378_1mm";"SILVA (only NR);Eukaryota;Amorphea;Obazoa;Opisthokonta;Nucletmycea;Fungi;Dikarya;Basidiomycota;Pucciniomycotina;Agaricostilbomycetes;Agaricostilbales;Chionosphaeraceae;Chionosphaera;";"0.0";"0";"3";"3";"0";"3";"0";"430521";"5766"
"LOK1378_1mm";"SILVA (only NR);Eukaryota;Amorphea;Obazoa;Opisthokonta;Nucletmycea;Fungi;Dikarya;Basidiomycota;Pucciniomycotina;Agaricostilbomycetes;Agaricostilbales;Chionosphaeraceae;Cystobasidiopsis;";"0.0";"0";"1";"1";"0";"1";"0";"430523";"5766"
"LOK1378_1mm";"SILVA (only NR);Eukaryota;Amorphea;Obazoa;Opisthokonta;Nucletmycea;Fungi;Dikarya;Basidiomycota;Pucciniomycotina;Agaricostilbomycetes;Agaricostilbales;Chionosphaeraceae;Kurtzmanomyces;";"0.0";"0";"3";"2";"0";"2";"1";"430522";"5766"
"LOK1378_1mm";"SILVA (only NR);Eukaryota;Amorphea;Obazoa;Opisthokonta;Nucletmycea;Fungi;Dikarya;Basidiomycota;Pucciniomycotina;Agaricostilbomycetes;Agaricostilbales;Incertae Sedis;";"0.0";"0";"2";"2";"0";"2";"0";"430522";"5766"
"LOK1378_1mm";"SILVA (only NR);Eukaryota;Amorphea;Obazoa;Opisthokonta;Nucletmycea;Fungi;Dikarya;Basidiomycota;Pucciniomycotina;Agaricostilbomycetes;Agaricostilbales;Incertae Sedis;Jianyunia;";"0.0";"0";"2";"2";"0";"2";"0";"430522";"5766"
"LOK1378_1mm";"SILVA (only NR);Eukaryota;Amorphea;Obazoa;Opisthokonta;Nucletmycea;Fungi;Dikarya;Basidiomycota;Pucciniomycotina;Agaricostilbomycetes;Agaricostilbales;Kondoaceae;";"0.0";"0";"14";"14";"0";"14";"0";"430510";"5766"
"LOK1378_1mm";"SILVA (only NR);Eukaryota;Amorphea;Obazoa;Opisthokonta;Nucletmycea;Fungi;Dikarya;Basidiomycota;Pucciniomycotina;Agaricostilbomycetes;Agaricostilbales;Kondoaceae;Bensingtonia;";"0.0";"0";"3";"3";"0";"3";"0";"430521";"5766"
"LOK1378_1mm";"SILVA (only NR);Eukaryota;Amorphea;Obazoa;Opisthokonta;Nucletmycea;Fungi;Dikarya;Basidiomycota;Pucciniomycotina;Agaricostilbomycetes;Agaricostilbales;Kondoaceae;Kondoa;";"0.0";"0";"10";"10";"0";"10";"0";"430514";"5766"
"LOK1378_1mm";"SILVA (only NR);Eukaryota;Amorphea;Obazoa;Opisthokonta;Nucletmycea;Fungi;Dikarya;Basidiomycota;Pucciniomycotina;Agaricostilbomycetes;Agaricostilbales;Ruineniaceae;";"0.0";"0";"6";"6";"0";"6";"0";"430518";"5766"
"LOK1378_1mm";"SILVA (only NR);Eukaryota;Amorphea;Obazoa;Opisthokonta;Nucletmycea;Fungi;Dikarya;Basidiomycota;Pucciniomycotina;Agaricostilbomycetes;Agaricostilbales;Ruineniaceae;Ruinenia;";"0.0";"0";"6";"6";"0";"6";"0";"430518";"5766"
"LOK1378_1mm";"SILVA (only NR);Eukaryota;Amorphea;Obazoa;Opisthokonta;Nucletmycea;Fungi;Dikarya;Basidiomycota;Pucciniomycotina;Agaricostilbomycetes;Incertae Sedis;";"0.0";"0";"2";"2";"0";"2";"0";"430522";"5766"
"LOK1378_1mm";"SILVA (only NR);Eukaryota;Amorphea;Obazoa;Opisthokonta;Nucletmycea;Fungi;Dikarya;Basidiomycota;Pucciniomycotina;Agaricostilbomycetes;Incertae Sedis;Incertae Sedis;";"0.0";"0";"2";"2";"0";"2";"0";"430522";"5766"
"LOK1378_1mm";"SILVA (only NR);Eukaryota;Amorphea;Obazoa;Opisthokonta;Nucletmycea;Fungi;Dikarya;Basidiomycota;Pucciniomycotina;Agaricostilbomycetes;Incertae Sedis;Incertae Sedis;[Sporobolomyces] group;";"0.0";"0";"2";"2";"0";"2";"0";"430522";"5766"
"LOK1378_1mm";"SILVA (only NR);Eukaryota;Amorphea;Obazoa;Opisthokonta;Nucletmycea;Fungi;Dikarya;Basidiomycota;Pucciniomycotina;Atractiellomycetes;";"0.0";"0";"9";"7";"0";"7";"2";"430517";"5766"
"LOK1378_1mm";"SILVA (only NR);Eukaryota;Amorphea;Obazoa;Opisthokonta;Nucletmycea;Fungi;Dikarya;Basidiomycota;Pucciniomycotina;Atractiellomycetes;Atractiellales;";"0.0";"0";"9";"7";"0";"7";"2";"430517";"5766"
"LOK1378_1mm";"SILVA (only NR);Eukaryota;Amorphea;Obazoa;Opisthokonta;Nucletmycea;Fungi;Dikarya;Basidiomycota;Pucciniomycotina;Atractiellomycetes;Atractiellales;Atractidochium;";"0.0";"0";"1";"0";"0";"0";"1";"430524";"5766"
"LOK1378_1mm";"SILVA (only NR);Eukaryota;Amorphea;Obazoa;Opisthokonta;Nucletmycea;Fungi;Dikarya;Basidiomycota;Pucciniomycotina;Atractiellomycetes;Atractiellales;Atractiella;";"0.0";"0";"1";"1";"0";"1";"0";"430523";"5766"
"LOK1378_1mm";"SILVA (only NR);Eukaryota;Amorphea;Obazoa;Opisthokonta;Nucletmycea;Fungi;Dikarya;Basidiomycota;Pucciniomycotina;Atractiellomycetes;Atractiellales;Helicogloea;";"0.0";"0";"1";"1";"0";"1";"0";"430523";"5766"
"LOK1378_1mm";"SILVA (only NR);Eukaryota;Amorphea;Obazoa;Opisthokonta;Nucletmycea;Fungi;Dikarya;Basidiomycota;Pucciniomycotina;Atractiellomycetes;Atractiellales;Hobsonia;";"0.0";"0";"1";"1";"0";"1";"0";"430523";"5766"
"LOK1378_1mm";"SILVA (only NR);Eukaryota;Amorphea;Obazoa;Opisthokonta;Nucletmycea;Fungi;Dikarya;Basidiomycota;Pucciniomycotina;Atractiellomycetes;Atractiellales;Neogloea;";"0.0";"0";"2";"2";"0";"2";"0";"430522";"5766"
"LOK1378_1mm";"SILVA (only NR);Eukaryota;Amorphea;Obazoa;Opisthokonta;Nucletmycea;Fungi;Dikarya;Basidiomycota;Pucciniomycotina;Atractiellomycetes;Atractiellales;Phleogena;";"0.0";"0";"1";"1";"0";"1";"0";"430523";"5766"
"LOK1378_1mm";"SILVA (only NR);Eukaryota;Amorphea;Obazoa;Opisthokonta;Nucletmycea;Fungi;Dikarya;Basidiomycota;Pucciniomycotina;Atractiellomycetes;Atractiellales;Proceropycnis;";"0.0";"0";"1";"1";"0";"1";"0";"430523";"5766"
"LOK1378_1mm";"SILVA (only NR);Eukaryota;Amorphea;Obazoa;Opisthokonta;Nucletmycea;Fungi;Dikarya;Basidiomycota;Pucciniomycotina;Classiculomycetes;";"0.0";"0";"3";"3";"0";"3";"0";"430521";"5766"
"LOK1378_1mm";"SILVA (only NR);Eukaryota;Amorphea;Obazoa;Opisthokonta;Nucletmycea;Fungi;Dikarya;Basidiomycota;Pucciniomycotina;Classiculomycetes;Classiculales;";"0.0";"0";"3";"3";"0";"3";"0";"430521";"5766"
"LOK1378_1mm";"SILVA (only NR);Eukaryota;Amorphea;Obazoa;Opisthokonta;Nucletmycea;Fungi;Dikarya;Basidiomycota;Pucciniomycotina;Classiculomycetes;Classiculales;Classiculaceae;";"0.0";"0";"3";"3";"0";"3";"0";"430521";"5766"
"LOK1378_1mm";"SILVA (only NR);Eukaryota;Amorphea;Obazoa;Opisthokonta;Nucletmycea;Fungi;Dikarya;Basidiomycota;Pucciniomycotina;Classiculomycetes;Classiculales;Classiculaceae;Classicula;";"0.0";"0";"2";"2";"0";"2";"0";"430522";"5766"
"LOK1378_1mm";"SILVA (only NR);Eukaryota;Amorphea;Obazoa;Opisthokonta;Nucletmycea;Fungi;Dikarya;Basidiomycota;Pucciniomycotina;Classiculomycetes;Classiculales;Classiculaceae;Jaculispora;";"0.0";"0";"1";"1";"0";"1";"0";"430523";"5766"
"LOK1378_1mm";"SILVA (only NR);Eukaryota;Amorphea;Obazoa;Opisthokonta;Nucletmycea;Fungi;Dikarya;Basidiomycota;Pucciniomycotina;Cystobasidiomycetes;";"0.0";"0";"70";"67";"0";"67";"3";"430457";"5766"
"LOK1378_1mm";"SILVA (only NR);Eukaryota;Amorphea;Obazoa;Opisthokonta;Nucletmycea;Fungi;Dikarya;Basidiomycota;Pucciniomycotina;Cystobasidiomycetes;Cyphobasidiales;";"0.0";"0";"1";"1";"0";"1";"0";"430523";"5766"
"LOK1378_1mm";"SILVA (only NR);Eukaryota;Amorphea;Obazoa;Opisthokonta;Nucletmycea;Fungi;Dikarya;Basidiomycota;Pucciniomycotina;Cystobasidiomycetes;Cyphobasidiales;Cyphobasidiaceae;";"0.0";"0";"1";"1";"0";"1";"0";"430523";"5766"
"LOK1378_1mm";"SILVA (only NR);Eukaryota;Amorphea;Obazoa;Opisthokonta;Nucletmycea;Fungi;Dikarya;Basidiomycota;Pucciniomycotina;Cystobasidiomycetes;Cyphobasidiales;Cyphobasidiaceae;Cyphobasidium;";"0.0";"0";"1";"1";"0";"1";"0";"430523";"5766"
"LOK1378_1mm";"SILVA (only NR);Eukaryota;Amorphea;Obazoa;Opisthokonta;Nucletmycea;Fungi;Dikarya;Basidiomycota;Pucciniomycotina;Cystobasidiomycetes;Cystobasidiales;";"0.0";"0";"9";"8";"0";"8";"1";"430516";"5766"
"LOK1378_1mm";"SILVA (only NR);Eukaryota;Amorphea;Obazoa;Opisthokonta;Nucletmycea;Fungi;Dikarya;Basidiomycota;Pucciniomycotina;Cystobasidiomycetes;Cystobasidiales;Cystobasidiaceae;";"0.0";"0";"7";"6";"0";"6";"1";"430518";"5766"
"LOK1378_1mm";"SILVA (only NR);Eukaryota;Amorphea;Obazoa;Opisthokonta;Nucletmycea;Fungi;Dikarya;Basidiomycota;Pucciniomycotina;Cystobasidiomycetes;Cystobasidiales;Cystobasidiaceae;Cystobasidium;";"0.0";"0";"7";"6";"0";"6";"1";"430518";"5766"
"LOK1378_1mm";"SILVA (only NR);Eukaryota;Amorphea;Obazoa;Opisthokonta;Nucletmycea;Fungi;Dikarya;Basidiomycota;Pucciniomycotina;Cystobasidiomycetes;Cystobasidiales;Incertae Sedis;";"0.0";"0";"2";"2";"0";"2";"0";"430522";"5766"
"LOK1378_1mm";"SILVA (only NR);Eukaryota;Amorphea;Obazoa;Opisthokonta;Nucletmycea;Fungi;Dikarya;Basidiomycota;Pucciniomycotina;Cystobasidiomycetes;Cystobasidiales;Incertae Sedis;Occultifur;";"0.0";"0";"2";"2";"0";"2";"0";"430522";"5766"
"LOK1378_1mm";"SILVA (only NR);Eukaryota;Amorphea;Obazoa;Opisthokonta;Nucletmycea;Fungi;Dikarya;Basidiomycota;Pucciniomycotina;Cystobasidiomycetes;Erythrobasidiales;";"0.0";"0";"20";"20";"0";"20";"0";"430504";"5766"
"LOK1378_1mm";"SILVA (only NR);Eukaryota;Amorphea;Obazoa;Opisthokonta;Nucletmycea;Fungi;Dikarya;Basidiomycota;Pucciniomycotina;Cystobasidiomycetes;Erythrobasidiales;Erythrobasidiaceae;";"0.0";"0";"18";"18";"0";"18";"0";"430506";"5766"
"LOK1378_1mm";"SILVA (only NR);Eukaryota;Amorphea;Obazoa;Opisthokonta;Nucletmycea;Fungi;Dikarya;Basidiomycota;Pucciniomycotina;Cystobasidiomycetes;Erythrobasidiales;Erythrobasidiaceae;Bannoa;";"0.0";"0";"14";"14";"0";"14";"0";"430510";"5766"
"LOK1378_1mm";"SILVA (only NR);Eukaryota;Amorphea;Obazoa;Opisthokonta;Nucletmycea;Fungi;Dikarya;Basidiomycota;Pucciniomycotina;Cystobasidiomycetes;Erythrobasidiales;Erythrobasidiaceae;Erythrobasidium;";"0.0";"0";"4";"4";"0";"4";"0";"430520";"5766"
"LOK1378_1mm";"SILVA (only NR);Eukaryota;Amorphea;Obazoa;Opisthokonta;Nucletmycea;Fungi;Dikarya;Basidiomycota;Pucciniomycotina;Cystobasidiomycetes;Erythrobasidiales;Incertae Sedis;";"0.0";"0";"2";"2";"0";"2";"0";"430522";"5766"
"LOK1378_1mm";"SILVA (only NR);Eukaryota;Amorphea;Obazoa;Opisthokonta;Nucletmycea;Fungi;Dikarya;Basidiomycota;Pucciniomycotina;Cystobasidiomycetes;Erythrobasidiales;Incertae Sedis;Hasegawazyma;";"0.0";"0";"2";"2";"0";"2";"0";"430522";"5766"
"LOK1378_1mm";"SILVA (only NR);Eukaryota;Amorphea;Obazoa;Opisthokonta;Nucletmycea;Fungi;Dikarya;Basidiomycota;Pucciniomycotina;Cystobasidiomycetes;Incertae Sedis;";"0.0";"0";"35";"33";"0";"33";"2";"430491";"5766"
"LOK1378_1mm";"SILVA (only NR);Eukaryota;Amorphea;Obazoa;Opisthokonta;Nucletmycea;Fungi;Dikarya;Basidiomycota;Pucciniomycotina;Cystobasidiomycetes;Incertae Sedis;Incertae Sedis;";"0.0";"0";"35";"33";"0";"33";"2";"430491";"5766"
"LOK1378_1mm";"SILVA (only NR);Eukaryota;Amorphea;Obazoa;Opisthokonta;Nucletmycea;Fungi;Dikarya;Basidiomycota;Pucciniomycotina;Cystobasidiomycetes;Incertae Sedis;Incertae Sedis;Buckleyzyma;";"0.0";"0";"9";"8";"0";"8";"1";"430516";"5766"
"LOK1378_1mm";"SILVA (only NR);Eukaryota;Amorphea;Obazoa;Opisthokonta;Nucletmycea;Fungi;Dikarya;Basidiomycota;Pucciniomycotina;Cystobasidiomycetes;Incertae Sedis;Incertae Sedis;Cyrenella;";"0.0";"0";"1";"1";"0";"1";"0";"430523";"5766"
"LOK1378_1mm";"SILVA (only NR);Eukaryota;Amorphea;Obazoa;Opisthokonta;Nucletmycea;Fungi;Dikarya;Basidiomycota;Pucciniomycotina;Cystobasidiomycetes;Incertae Sedis;Incertae Sedis;Microsporomyces;";"0.0";"0";"2";"2";"0";"2";"0";"430522";"5766"
"LOK1378_1mm";"SILVA (only NR);Eukaryota;Amorphea;Obazoa;Opisthokonta;Nucletmycea;Fungi;Dikarya;Basidiomycota;Pucciniomycotina;Cystobasidiomycetes;Incertae Sedis;Incertae Sedis;Sakaguchia;";"0.0";"0";"7";"6";"0";"6";"1";"430518";"5766"
"LOK1378_1mm";"SILVA (only NR);Eukaryota;Amorphea;Obazoa;Opisthokonta;Nucletmycea;Fungi;Dikarya;Basidiomycota;Pucciniomycotina;Cystobasidiomycetes;Incertae Sedis;Incertae Sedis;Symmetrospora;";"0.0";"0";"9";"9";"0";"9";"0";"430515";"5766"
"LOK1378_1mm";"SILVA (only NR);Eukaryota;Amorphea;Obazoa;Opisthokonta;Nucletmycea;Fungi;Dikarya;Basidiomycota;Pucciniomycotina;Cystobasidiomycetes;Incertae Sedis;Incertae Sedis;uncultured;";"0.0";"0";"3";"3";"0";"3";"0";"430521";"5766"
"LOK1378_1mm";"SILVA (only NR);Eukaryota;Amorphea;Obazoa;Opisthokonta;Nucletmycea;Fungi;Dikarya;Basidiomycota;Pucciniomycotina;Cystobasidiomycetes;Naohideales;";"0.0";"0";"2";"2";"0";"2";"0";"430522";"5766"
"LOK1378_1mm";"SILVA (only NR);Eukaryota;Amorphea;Obazoa;Opisthokonta;Nucletmycea;Fungi;Dikarya;Basidiomycota;Pucciniomycotina;Cystobasidiomycetes;Naohideales;Naohideaceae;";"0.0";"0";"2";"2";"0";"2";"0";"430522";"5766"
"LOK1378_1mm";"SILVA (only NR);Eukaryota;Amorphea;Obazoa;Opisthokonta;Nucletmycea;Fungi;Dikarya;Basidiomycota;Pucciniomycotina;Cystobasidiomycetes;Naohideales;Naohideaceae;Naohidea;";"0.0";"0";"2";"2";"0";"2";"0";"430522";"5766"
"LOK1378_1mm";"SILVA (only NR);Eukaryota;Amorphea;Obazoa;Opisthokonta;Nucletmycea;Fungi;Dikarya;Basidiomycota;Pucciniomycotina;Microbotryomycetes;";"0.0";"0";"236";"219";"0";"219";"17";"430305";"5766"
"LOK1378_1mm";"SILVA (only NR);Eukaryota;Amorphea;Obazoa;Opisthokonta;Nucletmycea;Fungi;Dikarya;Basidiomycota;Pucciniomycotina;Microbotryomycetes;Heterogastridiales;";"0.0";"0";"1";"1";"0";"1";"0";"430523";"5766"
"LOK1378_1mm";"SILVA (only NR);Eukaryota;Amorphea;Obazoa;Opisthokonta;Nucletmycea;Fungi;Dikarya;Basidiomycota;Pucciniomycotina;Microbotryomycetes;Heterogastridiales;Heterogastridiaceae;";"0.0";"0";"1";"1";"0";"1";"0";"430523";"5766"
"LOK1378_1mm";"SILVA (only NR);Eukaryota;Amorphea;Obazoa;Opisthokonta;Nucletmycea;Fungi;Dikarya;Basidiomycota;Pucciniomycotina;Microbotryomycetes;Heterogastridiales;Heterogastridiaceae;Heterogastridium;";"0.0";"0";"1";"1";"0";"1";"0";"430523";"5766"
"LOK1378_1mm";"SILVA (only NR);Eukaryota;Amorphea;Obazoa;Opisthokonta;Nucletmycea;Fungi;Dikarya;Basidiomycota;Pucciniomycotina;Microbotryomycetes;Incertae Sedis;";"0.0";"0";"40";"38";"0";"38";"2";"430486";"5766"
"LOK1378_1mm";"SILVA (only NR);Eukaryota;Amorphea;Obazoa;Opisthokonta;Nucletmycea;Fungi;Dikarya;Basidiomycota;Pucciniomycotina;Microbotryomycetes;Incertae Sedis;Chrysozymaceae;";"0.0";"0";"25";"24";"0";"24";"1";"430500";"5766"
"LOK1378_1mm";"SILVA (only NR);Eukaryota;Amorphea;Obazoa;Opisthokonta;Nucletmycea;Fungi;Dikarya;Basidiomycota;Pucciniomycotina;Microbotryomycetes;Incertae Sedis;Chrysozymaceae;Bannozyma;";"0.0";"0";"2";"2";"0";"2";"0";"430522";"5766"
"LOK1378_1mm";"SILVA (only NR);Eukaryota;Amorphea;Obazoa;Opisthokonta;Nucletmycea;Fungi;Dikarya;Basidiomycota;Pucciniomycotina;Microbotryomycetes;Incertae Sedis;Chrysozymaceae;Chrysozyma;";"0.0";"0";"2";"2";"0";"2";"0";"430522";"5766"
"LOK1378_1mm";"SILVA (only NR);Eukaryota;Amorphea;Obazoa;Opisthokonta;Nucletmycea;Fungi;Dikarya;Basidiomycota;Pucciniomycotina;Microbotryomycetes;Incertae Sedis;Chrysozymaceae;Fellozyma;";"0.0";"0";"1";"1";"0";"1";"0";"430523";"5766"
"LOK1378_1mm";"SILVA (only NR);Eukaryota;Amorphea;Obazoa;Opisthokonta;Nucletmycea;Fungi;Dikarya;Basidiomycota;Pucciniomycotina;Microbotryomycetes;Incertae Sedis;Chrysozymaceae;Hamamotoa;";"0.0";"0";"2";"2";"0";"2";"0";"430522";"5766"
"LOK1378_1mm";"SILVA (only NR);Eukaryota;Amorphea;Obazoa;Opisthokonta;Nucletmycea;Fungi;Dikarya;Basidiomycota;Pucciniomycotina;Microbotryomycetes;Incertae Sedis;Chrysozymaceae;Oberwinklerozyma;";"0.0";"0";"2";"2";"0";"2";"0";"430522";"5766"
"LOK1378_1mm";"SILVA (only NR);Eukaryota;Amorphea;Obazoa;Opisthokonta;Nucletmycea;Fungi;Dikarya;Basidiomycota;Pucciniomycotina;Microbotryomycetes;Incertae Sedis;Chrysozymaceae;Pseudohyphozyma;";"0.0";"0";"1";"1";"0";"1";"0";"430523";"5766"
"LOK1378_1mm";"SILVA (only NR);Eukaryota;Amorphea;Obazoa;Opisthokonta;Nucletmycea;Fungi;Dikarya;Basidiomycota;Pucciniomycotina;Microbotryomycetes;Incertae Sedis;Chrysozymaceae;Sampaiozyma;";"0.0";"0";"2";"2";"0";"2";"0";"430522";"5766"
"LOK1378_1mm";"SILVA (only NR);Eukaryota;Amorphea;Obazoa;Opisthokonta;Nucletmycea;Fungi;Dikarya;Basidiomycota;Pucciniomycotina;Microbotryomycetes;Incertae Sedis;Chrysozymaceae;Slooffia;";"0.0";"0";"3";"3";"0";"3";"0";"430521";"5766"
"LOK1378_1mm";"SILVA (only NR);Eukaryota;Amorphea;Obazoa;Opisthokonta;Nucletmycea;Fungi;Dikarya;Basidiomycota;Pucciniomycotina;Microbotryomycetes;Incertae Sedis;Chrysozymaceae;Spencerozyma;";"0.0";"0";"1";"1";"0";"1";"0";"430523";"5766"
"LOK1378_1mm";"SILVA (only NR);Eukaryota;Amorphea;Obazoa;Opisthokonta;Nucletmycea;Fungi;Dikarya;Basidiomycota;Pucciniomycotina;Microbotryomycetes;Incertae Sedis;Chrysozymaceae;Trigonosporomyces;";"0.0";"0";"1";"1";"0";"1";"0";"430523";"5766"
"LOK1378_1mm";"SILVA (only NR);Eukaryota;Amorphea;Obazoa;Opisthokonta;Nucletmycea;Fungi;Dikarya;Basidiomycota;Pucciniomycotina;Microbotryomycetes;Incertae Sedis;Chrysozymaceae;Udeniozyma;";"0.0";"0";"1";"1";"0";"1";"0";"430523";"5766"
"LOK1378_1mm";"SILVA (only NR);Eukaryota;Amorphea;Obazoa;Opisthokonta;Nucletmycea;Fungi;Dikarya;Basidiomycota;Pucciniomycotina;Microbotryomycetes;Incertae Sedis;Chrysozymaceae;Vonarxula;";"0.0";"0";"1";"1";"0";"1";"0";"430523";"5766"
"LOK1378_1mm";"SILVA (only NR);Eukaryota;Amorphea;Obazoa;Opisthokonta;Nucletmycea;Fungi;Dikarya;Basidiomycota;Pucciniomycotina;Microbotryomycetes;Incertae Sedis;Chrysozymaceae;Yunzhangia;";"0.0";"0";"2";"2";"0";"2";"0";"430522";"5766"
"LOK1378_1mm";"SILVA (only NR);Eukaryota;Amorphea;Obazoa;Opisthokonta;Nucletmycea;Fungi;Dikarya;Basidiomycota;Pucciniomycotina;Microbotryomycetes;Incertae Sedis;Incertae Sedis;";"0.0";"0";"15";"14";"0";"14";"1";"430510";"5766"
"LOK1378_1mm";"SILVA (only NR);Eukaryota;Amorphea;Obazoa;Opisthokonta;Nucletmycea;Fungi;Dikarya;Basidiomycota;Pucciniomycotina;Microbotryomycetes;Incertae Sedis;Incertae Sedis;Colacogloea;";"0.0";"0";"11";"10";"0";"10";"1";"430514";"5766"
"LOK1378_1mm";"SILVA (only NR);Eukaryota;Amorphea;Obazoa;Opisthokonta;Nucletmycea;Fungi;Dikarya;Basidiomycota;Pucciniomycotina;Microbotryomycetes;Incertae Sedis;Incertae Sedis;Curvibasidium;";"0.0";"0";"3";"3";"0";"3";"0";"430521";"5766"
"LOK1378_1mm";"SILVA (only NR);Eukaryota;Amorphea;Obazoa;Opisthokonta;Nucletmycea;Fungi;Dikarya;Basidiomycota;Pucciniomycotina;Microbotryomycetes;Incertae Sedis;Incertae Sedis;Reniforma;";"0.0";"0";"1";"1";"0";"1";"0";"430523";"5766"
"LOK1378_1mm";"SILVA (only NR);Eukaryota;Amorphea;Obazoa;Opisthokonta;Nucletmycea;Fungi;Dikarya;Basidiomycota;Pucciniomycotina;Microbotryomycetes;Kriegeriales;";"0.0";"0";"11";"11";"0";"11";"0";"430513";"5766"
"LOK1378_1mm";"SILVA (only NR);Eukaryota;Amorphea;Obazoa;Opisthokonta;Nucletmycea;Fungi;Dikarya;Basidiomycota;Pucciniomycotina;Microbotryomycetes;Kriegeriales;Camptobasidiaceae;";"0.0";"0";"4";"4";"0";"4";"0";"430520";"5766"
"LOK1378_1mm";"SILVA (only NR);Eukaryota;Amorphea;Obazoa;Opisthokonta;Nucletmycea;Fungi;Dikarya;Basidiomycota;Pucciniomycotina;Microbotryomycetes;Kriegeriales;Camptobasidiaceae;Camptobasidium;";"0.0";"0";"3";"3";"0";"3";"0";"430521";"5766"
"LOK1378_1mm";"SILVA (only NR);Eukaryota;Amorphea;Obazoa;Opisthokonta;Nucletmycea;Fungi;Dikarya;Basidiomycota;Pucciniomycotina;Microbotryomycetes;Kriegeriales;Kriegeriaceae;";"0.0";"0";"6";"6";"0";"6";"0";"430518";"5766"
"LOK1378_1mm";"SILVA (only NR);Eukaryota;Amorphea;Obazoa;Opisthokonta;Nucletmycea;Fungi;Dikarya;Basidiomycota;Pucciniomycotina;Microbotryomycetes;Kriegeriales;Kriegeriaceae;Kriegeria;";"0.0";"0";"1";"1";"0";"1";"0";"430523";"5766"
"LOK1378_1mm";"SILVA (only NR);Eukaryota;Amorphea;Obazoa;Opisthokonta;Nucletmycea;Fungi;Dikarya;Basidiomycota;Pucciniomycotina;Microbotryomycetes;Kriegeriales;Kriegeriaceae;Phenoliferia;";"0.0";"0";"2";"2";"0";"2";"0";"430522";"5766"
"LOK1378_1mm";"SILVA (only NR);Eukaryota;Amorphea;Obazoa;Opisthokonta;Nucletmycea;Fungi;Dikarya;Basidiomycota;Pucciniomycotina;Microbotryomycetes;Kriegeriales;Kriegeriaceae;Yamadamyces;";"0.0";"0";"1";"1";"0";"1";"0";"430523";"5766"
"LOK1378_1mm";"SILVA (only NR);Eukaryota;Amorphea;Obazoa;Opisthokonta;Nucletmycea;Fungi;Dikarya;Basidiomycota;Pucciniomycotina;Microbotryomycetes;Leucosporidiales;";"0.0";"0";"10";"9";"0";"9";"1";"430515";"5766"
"LOK1378_1mm";"SILVA (only NR);Eukaryota;Amorphea;Obazoa;Opisthokonta;Nucletmycea;Fungi;Dikarya;Basidiomycota;Pucciniomycotina;Microbotryomycetes;Leucosporidiales;Leucosporidiaceae;";"0.0";"0";"10";"9";"0";"9";"1";"430515";"5766"
"LOK1378_1mm";"SILVA (only NR);Eukaryota;Amorphea;Obazoa;Opisthokonta;Nucletmycea;Fungi;Dikarya;Basidiomycota;Pucciniomycotina;Microbotryomycetes;Leucosporidiales;Leucosporidiaceae;Leucosporidium;";"0.0";"0";"10";"9";"0";"9";"1";"430515";"5766"
"LOK1378_1mm";"SILVA (only NR);Eukaryota;Amorphea;Obazoa;Opisthokonta;Nucletmycea;Fungi;Dikarya;Basidiomycota;Pucciniomycotina;Microbotryomycetes;Microbotryales;";"0.0";"0";"64";"57";"0";"57";"7";"430467";"5766"
"LOK1378_1mm";"SILVA (only NR);Eukaryota;Amorphea;Obazoa;Opisthokonta;Nucletmycea;Fungi;Dikarya;Basidiomycota;Pucciniomycotina;Microbotryomycetes;Microbotryales;Microbotryaceae;";"0.0";"0";"61";"54";"0";"54";"7";"430470";"5766"
"LOK1378_1mm";"SILVA (only NR);Eukaryota;Amorphea;Obazoa;Opisthokonta;Nucletmycea;Fungi;Dikarya;Basidiomycota;Pucciniomycotina;Microbotryomycetes;Microbotryales;Microbotryaceae;Microbotryum;";"0.0";"0";"60";"53";"0";"53";"7";"430471";"5766"
"LOK1378_1mm";"SILVA (only NR);Eukaryota;Amorphea;Obazoa;Opisthokonta;Nucletmycea;Fungi;Dikarya;Basidiomycota;Pucciniomycotina;Microbotryomycetes;Microbotryales;Microbotryaceae;Sphacelotheca;";"0.0";"0";"1";"1";"0";"1";"0";"430523";"5766"
"LOK1378_1mm";"SILVA (only NR);Eukaryota;Amorphea;Obazoa;Opisthokonta;Nucletmycea;Fungi;Dikarya;Basidiomycota;Pucciniomycotina;Microbotryomycetes;Microbotryales;Ustilentylomataceae;";"0.0";"0";"3";"3";"0";"3";"0";"430521";"5766"
"LOK1378_1mm";"SILVA (only NR);Eukaryota;Amorphea;Obazoa;Opisthokonta;Nucletmycea;Fungi;Dikarya;Basidiomycota;Pucciniomycotina;Microbotryomycetes;Microbotryales;Ustilentylomataceae;Ustilentyloma;";"0.0";"0";"3";"3";"0";"3";"0";"430521";"5766"
"LOK1378_1mm";"SILVA (only NR);Eukaryota;Amorphea;Obazoa;Opisthokonta;Nucletmycea;Fungi;Dikarya;Basidiomycota;Pucciniomycotina;Microbotryomycetes;Sporidiobolales;";"0.0";"0";"106";"99";"0";"99";"7";"430425";"5766"
"LOK1378_1mm";"SILVA (only NR);Eukaryota;Amorphea;Obazoa;Opisthokonta;Nucletmycea;Fungi;Dikarya;Basidiomycota;Pucciniomycotina;Microbotryomycetes;Sporidiobolales;Sporidiobolaceae;";"0.0";"0";"106";"99";"0";"99";"7";"430425";"5766"
"LOK1378_1mm";"SILVA (only NR);Eukaryota;Amorphea;Obazoa;Opisthokonta;Nucletmycea;Fungi;Dikarya;Basidiomycota;Pucciniomycotina;Microbotryomycetes;Sporidiobolales;Sporidiobolaceae;Rhodosporidiobolus;";"0.0";"0";"9";"9";"0";"9";"0";"430515";"5766"
"LOK1378_1mm";"SILVA (only NR);Eukaryota;Amorphea;Obazoa;Opisthokonta;Nucletmycea;Fungi;Dikarya;Basidiomycota;Pucciniomycotina;Microbotryomycetes;Sporidiobolales;Sporidiobolaceae;Rhodotorula;";"0.0";"0";"83";"76";"0";"76";"7";"430448";"5766"
"LOK1378_1mm";"SILVA (only NR);Eukaryota;Amorphea;Obazoa;Opisthokonta;Nucletmycea;Fungi;Dikarya;Basidiomycota;Pucciniomycotina;Microbotryomycetes;Sporidiobolales;Sporidiobolaceae;Sporidiobolus;";"0.0";"0";"2";"2";"0";"2";"0";"430522";"5766"
"LOK1378_1mm";"SILVA (only NR);Eukaryota;Amorphea;Obazoa;Opisthokonta;Nucletmycea;Fungi;Dikarya;Basidiomycota;Pucciniomycotina;Microbotryomycetes;Sporidiobolales;Sporidiobolaceae;Sporobolomyces;";"0.0";"0";"8";"8";"0";"8";"0";"430516";"5766"
"LOK1378_1mm";"SILVA (only NR);Eukaryota;Amorphea;Obazoa;Opisthokonta;Nucletmycea;Fungi;Dikarya;Basidiomycota;Pucciniomycotina;Microbotryomycetes;Sporidiobolales;Sporidiobolaceae;uncultured;";"0.0";"0";"4";"4";"0";"4";"0";"430520";"5766"
"LOK1378_1mm";"SILVA (only NR);Eukaryota;Amorphea;Obazoa;Opisthokonta;Nucletmycea;Fungi;Dikarya;Basidiomycota;Pucciniomycotina;Microbotryomycetes;uncultured;";"0.0";"0";"2";"2";"0";"2";"0";"430522";"5766"
"LOK1378_1mm";"SILVA (only NR);Eukaryota;Amorphea;Obazoa;Opisthokonta;Nucletmycea;Fungi;Dikarya;Basidiomycota;Pucciniomycotina;Mixiomycetes;";"0.0";"0";"2";"2";"0";"2";"0";"430522";"5766"
"LOK1378_1mm";"SILVA (only NR);Eukaryota;Amorphea;Obazoa;Opisthokonta;Nucletmycea;Fungi;Dikarya;Basidiomycota;Pucciniomycotina;Mixiomycetes;Mixiales;";"0.0";"0";"2";"2";"0";"2";"0";"430522";"5766"
"LOK1378_1mm";"SILVA (only NR);Eukaryota;Amorphea;Obazoa;Opisthokonta;Nucletmycea;Fungi;Dikarya;Basidiomycota;Pucciniomycotina;Mixiomycetes;Mixiales;Mixiaceae;";"0.0";"0";"2";"2";"0";"2";"0";"430522";"5766"
"LOK1378_1mm";"SILVA (only NR);Eukaryota;Amorphea;Obazoa;Opisthokonta;Nucletmycea;Fungi;Dikarya;Basidiomycota;Pucciniomycotina;Mixiomycetes;Mixiales;Mixiaceae;Mixia;";"0.0";"0";"2";"2";"0";"2";"0";"430522";"5766"
"LOK1378_1mm";"SILVA (only NR);Eukaryota;Amorphea;Obazoa;Opisthokonta;Nucletmycea;Fungi;Dikarya;Basidiomycota;Pucciniomycotina;Pucciniomycetes;";"0.0";"0";"181";"172";"0";"172";"9";"430352";"5766"
"LOK1378_1mm";"SILVA (only NR);Eukaryota;Amorphea;Obazoa;Opisthokonta;Nucletmycea;Fungi;Dikarya;Basidiomycota;Pucciniomycotina;Pucciniomycetes;Helicobasidiales;";"0.0";"0";"2";"2";"0";"2";"0";"430522";"5766"
"LOK1378_1mm";"SILVA (only NR);Eukaryota;Amorphea;Obazoa;Opisthokonta;Nucletmycea;Fungi;Dikarya;Basidiomycota;Pucciniomycotina;Pucciniomycetes;Helicobasidiales;Helicobasidiaceae;";"0.0";"0";"2";"2";"0";"2";"0";"430522";"5766"
"LOK1378_1mm";"SILVA (only NR);Eukaryota;Amorphea;Obazoa;Opisthokonta;Nucletmycea;Fungi;Dikarya;Basidiomycota;Pucciniomycotina;Pucciniomycetes;Helicobasidiales;Helicobasidiaceae;Helicobasidium;";"0.0";"0";"2";"2";"0";"2";"0";"430522";"5766"
"LOK1378_1mm";"SILVA (only NR);Eukaryota;Amorphea;Obazoa;Opisthokonta;Nucletmycea;Fungi;Dikarya;Basidiomycota;Pucciniomycotina;Pucciniomycetes;Platygloeaceae;";"0.0";"0";"4";"4";"0";"4";"0";"430520";"5766"
"LOK1378_1mm";"SILVA (only NR);Eukaryota;Amorphea;Obazoa;Opisthokonta;Nucletmycea;Fungi;Dikarya;Basidiomycota;Pucciniomycotina;Pucciniomycetes;Platygloeaceae;Insolibasidium;";"0.0";"0";"1";"1";"0";"1";"0";"430523";"5766"
"LOK1378_1mm";"SILVA (only NR);Eukaryota;Amorphea;Obazoa;Opisthokonta;Nucletmycea;Fungi;Dikarya;Basidiomycota;Pucciniomycotina;Pucciniomycetes;Platygloeaceae;Jola;";"0.0";"0";"1";"1";"0";"1";"0";"430523";"5766"
"LOK1378_1mm";"SILVA (only NR);Eukaryota;Amorphea;Obazoa;Opisthokonta;Nucletmycea;Fungi;Dikarya;Basidiomycota;Pucciniomycotina;Pucciniomycetes;Platygloeaceae;Platygloea;";"0.0";"0";"1";"1";"0";"1";"0";"430523";"5766"
"LOK1378_1mm";"SILVA (only NR);Eukaryota;Amorphea;Obazoa;Opisthokonta;Nucletmycea;Fungi;Dikarya;Basidiomycota;Pucciniomycotina;Pucciniomycetes;Pucciniales;";"0.0";"0";"166";"158";"0";"158";"8";"430366";"5766"
"LOK1378_1mm";"SILVA (only NR);Eukaryota;Amorphea;Obazoa;Opisthokonta;Nucletmycea;Fungi;Dikarya;Basidiomycota;Pucciniomycotina;Pucciniomycetes;Pucciniales;Achrotelium;";"0.0";"0";"1";"1";"0";"1";"0";"430523";"5766"
"LOK1378_1mm";"SILVA (only NR);Eukaryota;Amorphea;Obazoa;Opisthokonta;Nucletmycea;Fungi;Dikarya;Basidiomycota;Pucciniomycotina;Pucciniomycetes;Pucciniales;Aecidium;";"0.0";"0";"2";"2";"0";"2";"0";"430522";"5766"
"LOK1378_1mm";"SILVA (only NR);Eukaryota;Amorphea;Obazoa;Opisthokonta;Nucletmycea;Fungi;Dikarya;Basidiomycota;Pucciniomycotina;Pucciniomycetes;Pucciniales;Blastospora;";"0.0";"0";"1";"1";"0";"1";"0";"430523";"5766"
"LOK1378_1mm";"SILVA (only NR);Eukaryota;Amorphea;Obazoa;Opisthokonta;Nucletmycea;Fungi;Dikarya;Basidiomycota;Pucciniomycotina;Pucciniomycetes;Pucciniales;Coleosporiaceae;";"0.0";"0";"3";"2";"0";"2";"1";"430522";"5766"
"LOK1378_1mm";"SILVA (only NR);Eukaryota;Amorphea;Obazoa;Opisthokonta;Nucletmycea;Fungi;Dikarya;Basidiomycota;Pucciniomycotina;Pucciniomycetes;Pucciniales;Coleosporiaceae;Chrysomyxa;";"0.0";"0";"1";"1";"0";"1";"0";"430523";"5766"
"LOK1378_1mm";"SILVA (only NR);Eukaryota;Amorphea;Obazoa;Opisthokonta;Nucletmycea;Fungi;Dikarya;Basidiomycota;Pucciniomycotina;Pucciniomycetes;Pucciniales;Coleosporiaceae;Coleosporium;";"0.0";"0";"2";"1";"0";"1";"1";"430523";"5766"
"LOK1378_1mm";"SILVA (only NR);Eukaryota;Amorphea;Obazoa;Opisthokonta;Nucletmycea;Fungi;Dikarya;Basidiomycota;Pucciniomycotina;Pucciniomycetes;Pucciniales;Cronartium;";"0.0";"0";"1";"1";"0";"1";"0";"430523";"5766"
"LOK1378_1mm";"SILVA (only NR);Eukaryota;Amorphea;Obazoa;Opisthokonta;Nucletmycea;Fungi;Dikarya;Basidiomycota;Pucciniomycotina;Pucciniomycetes;Pucciniales;Dasturella;";"0.0";"0";"1";"0";"0";"0";"1";"430524";"5766"
"LOK1378_1mm";"SILVA (only NR);Eukaryota;Amorphea;Obazoa;Opisthokonta;Nucletmycea;Fungi;Dikarya;Basidiomycota;Pucciniomycotina;Pucciniomycetes;Pucciniales;Hemileia;";"0.0";"0";"1";"1";"0";"1";"0";"430523";"5766"
"LOK1378_1mm";"SILVA (only NR);Eukaryota;Amorphea;Obazoa;Opisthokonta;Nucletmycea;Fungi;Dikarya;Basidiomycota;Pucciniomycotina;Pucciniomycetes;Pucciniales;Incertae Sedis;";"0.0";"0";"2";"2";"0";"2";"0";"430522";"5766"
"LOK1378_1mm";"SILVA (only NR);Eukaryota;Amorphea;Obazoa;Opisthokonta;Nucletmycea;Fungi;Dikarya;Basidiomycota;Pucciniomycotina;Pucciniomycetes;Pucciniales;Incertae Sedis;Caeoma;";"0.0";"0";"1";"1";"0";"1";"0";"430523";"5766"
"LOK1378_1mm";"SILVA (only NR);Eukaryota;Amorphea;Obazoa;Opisthokonta;Nucletmycea;Fungi;Dikarya;Basidiomycota;Pucciniomycotina;Pucciniomycetes;Pucciniales;Incertae Sedis;Uredo;";"0.0";"0";"1";"1";"0";"1";"0";"430523";"5766"
"LOK1378_1mm";"SILVA (only NR);Eukaryota;Amorphea;Obazoa;Opisthokonta;Nucletmycea;Fungi;Dikarya;Basidiomycota;Pucciniomycotina;Pucciniomycetes;Pucciniales;Macruropyxis;";"0.0";"0";"1";"1";"0";"1";"0";"430523";"5766"
"LOK1378_1mm";"SILVA (only NR);Eukaryota;Amorphea;Obazoa;Opisthokonta;Nucletmycea;Fungi;Dikarya;Basidiomycota;Pucciniomycotina;Pucciniomycetes;Pucciniales;Melampsoraceae;";"0.0";"0";"5";"4";"0";"4";"1";"430520";"5766"
"LOK1378_1mm";"SILVA (only NR);Eukaryota;Amorphea;Obazoa;Opisthokonta;Nucletmycea;Fungi;Dikarya;Basidiomycota;Pucciniomycotina;Pucciniomycetes;Pucciniales;Melampsoraceae;Melampsora;";"0.0";"0";"5";"4";"0";"4";"1";"430520";"5766"
"LOK1378_1mm";"SILVA (only NR);Eukaryota;Amorphea;Obazoa;Opisthokonta;Nucletmycea;Fungi;Dikarya;Basidiomycota;Pucciniomycotina;Pucciniomycetes;Pucciniales;Mikronegeriaceae;";"0.0";"0";"1";"1";"0";"1";"0";"430523";"5766"
"LOK1378_1mm";"SILVA (only NR);Eukaryota;Amorphea;Obazoa;Opisthokonta;Nucletmycea;Fungi;Dikarya;Basidiomycota;Pucciniomycotina;Pucciniomycetes;Pucciniales;Mikronegeriaceae;Mikronegeria;";"0.0";"0";"1";"1";"0";"1";"0";"430523";"5766"
"LOK1378_1mm";"SILVA (only NR);Eukaryota;Amorphea;Obazoa;Opisthokonta;Nucletmycea;Fungi;Dikarya;Basidiomycota;Pucciniomycotina;Pucciniomycetes;Pucciniales;Milesina;";"0.0";"0";"1";"1";"0";"1";"0";"430523";"5766"
"LOK1378_1mm";"SILVA (only NR);Eukaryota;Amorphea;Obazoa;Opisthokonta;Nucletmycea;Fungi;Dikarya;Basidiomycota;Pucciniomycotina;Pucciniomycetes;Pucciniales;Nyssopsora;";"0.0";"0";"1";"1";"0";"1";"0";"430523";"5766"
"LOK1378_1mm";"SILVA (only NR);Eukaryota;Amorphea;Obazoa;Opisthokonta;Nucletmycea;Fungi;Dikarya;Basidiomycota;Pucciniomycotina;Pucciniomycetes;Pucciniales;Olivea;";"0.0";"0";"1";"1";"0";"1";"0";"430523";"5766"
"LOK1378_1mm";"SILVA (only NR);Eukaryota;Amorphea;Obazoa;Opisthokonta;Nucletmycea;Fungi;Dikarya;Basidiomycota;Pucciniomycotina;Pucciniomycetes;Pucciniales;Phakopsora;";"0.0";"0";"3";"3";"0";"3";"0";"430521";"5766"
"LOK1378_1mm";"SILVA (only NR);Eukaryota;Amorphea;Obazoa;Opisthokonta;Nucletmycea;Fungi;Dikarya;Basidiomycota;Pucciniomycotina;Pucciniomycetes;Pucciniales;Phakopsoraceae;";"0.0";"0";"2";"2";"0";"2";"0";"430522";"5766"
"LOK1378_1mm";"SILVA (only NR);Eukaryota;Amorphea;Obazoa;Opisthokonta;Nucletmycea;Fungi;Dikarya;Basidiomycota;Pucciniomycotina;Pucciniomycetes;Pucciniales;Phakopsoraceae;Prospodium;";"0.0";"0";"2";"2";"0";"2";"0";"430522";"5766"
"LOK1378_1mm";"SILVA (only NR);Eukaryota;Amorphea;Obazoa;Opisthokonta;Nucletmycea;Fungi;Dikarya;Basidiomycota;Pucciniomycotina;Pucciniomycetes;Pucciniales;Phragmidiaceae;";"0.0";"0";"68";"67";"0";"67";"1";"430457";"5766"
"LOK1378_1mm";"SILVA (only NR);Eukaryota;Amorphea;Obazoa;Opisthokonta;Nucletmycea;Fungi;Dikarya;Basidiomycota;Pucciniomycotina;Pucciniomycetes;Pucciniales;Phragmidiaceae;Gymnoconia;";"0.0";"0";"1";"1";"0";"1";"0";"430523";"5766"
"LOK1378_1mm";"SILVA (only NR);Eukaryota;Amorphea;Obazoa;Opisthokonta;Nucletmycea;Fungi;Dikarya;Basidiomycota;Pucciniomycotina;Pucciniomycetes;Pucciniales;Phragmidiaceae;Hamaspora;";"0.0";"0";"1";"1";"0";"1";"0";"430523";"5766"
"LOK1378_1mm";"SILVA (only NR);Eukaryota;Amorphea;Obazoa;Opisthokonta;Nucletmycea;Fungi;Dikarya;Basidiomycota;Pucciniomycotina;Pucciniomycetes;Pucciniales;Phragmidiaceae;Kuehneola;";"0.0";"0";"2";"1";"0";"1";"1";"430523";"5766"
"LOK1378_1mm";"SILVA (only NR);Eukaryota;Amorphea;Obazoa;Opisthokonta;Nucletmycea;Fungi;Dikarya;Basidiomycota;Pucciniomycotina;Pucciniomycetes;Pucciniales;Phragmidiaceae;Phragmidium;";"0.0";"0";"63";"63";"0";"63";"0";"430461";"5766"
"LOK1378_1mm";"SILVA (only NR);Eukaryota;Amorphea;Obazoa;Opisthokonta;Nucletmycea;Fungi;Dikarya;Basidiomycota;Pucciniomycotina;Pucciniomycetes;Pucciniales;Physopella;";"0.0";"0";"1";"0";"0";"0";"1";"430524";"5766"
"LOK1378_1mm";"SILVA (only NR);Eukaryota;Amorphea;Obazoa;Opisthokonta;Nucletmycea;Fungi;Dikarya;Basidiomycota;Pucciniomycotina;Pucciniomycetes;Pucciniales;Pileolaria;";"0.0";"0";"1";"1";"0";"1";"0";"430523";"5766"
"LOK1378_1mm";"SILVA (only NR);Eukaryota;Amorphea;Obazoa;Opisthokonta;Nucletmycea;Fungi;Dikarya;Basidiomycota;Pucciniomycotina;Pucciniomycetes;Pucciniales;Pileolariaceae;";"0.0";"0";"1";"1";"0";"1";"0";"430523";"5766"
"LOK1378_1mm";"SILVA (only NR);Eukaryota;Amorphea;Obazoa;Opisthokonta;Nucletmycea;Fungi;Dikarya;Basidiomycota;Pucciniomycotina;Pucciniomycetes;Pucciniales;Pileolariaceae;Uromycladium;";"0.0";"0";"1";"1";"0";"1";"0";"430523";"5766"
"LOK1378_1mm";"SILVA (only NR);Eukaryota;Amorphea;Obazoa;Opisthokonta;Nucletmycea;Fungi;Dikarya;Basidiomycota;Pucciniomycotina;Pucciniomycetes;Pucciniales;Porotenus;";"0.0";"0";"1";"1";"0";"1";"0";"430523";"5766"
"LOK1378_1mm";"SILVA (only NR);Eukaryota;Amorphea;Obazoa;Opisthokonta;Nucletmycea;Fungi;Dikarya;Basidiomycota;Pucciniomycotina;Pucciniomycetes;Pucciniales;Pucciniaceae;";"0.0";"0";"44";"43";"0";"43";"1";"430481";"5766"
"LOK1378_1mm";"SILVA (only NR);Eukaryota;Amorphea;Obazoa;Opisthokonta;Nucletmycea;Fungi;Dikarya;Basidiomycota;Pucciniomycotina;Pucciniomycetes;Pucciniales;Pucciniaceae;Allodus;";"0.0";"0";"1";"1";"0";"1";"0";"430523";"5766"
"LOK1378_1mm";"SILVA (only NR);Eukaryota;Amorphea;Obazoa;Opisthokonta;Nucletmycea;Fungi;Dikarya;Basidiomycota;Pucciniomycotina;Pucciniomycetes;Pucciniales;Pucciniaceae;Ceratocoma;";"0.0";"0";"1";"1";"0";"1";"0";"430523";"5766"
"LOK1378_1mm";"SILVA (only NR);Eukaryota;Amorphea;Obazoa;Opisthokonta;Nucletmycea;Fungi;Dikarya;Basidiomycota;Pucciniomycotina;Pucciniomycetes;Pucciniales;Pucciniaceae;Gymnosporangium;";"0.0";"0";"6";"6";"0";"6";"0";"430518";"5766"
"LOK1378_1mm";"SILVA (only NR);Eukaryota;Amorphea;Obazoa;Opisthokonta;Nucletmycea;Fungi;Dikarya;Basidiomycota;Pucciniomycotina;Pucciniomycetes;Pucciniales;Pucciniaceae;Puccinia;";"0.0";"0";"31";"30";"0";"30";"1";"430494";"5766"
"LOK1378_1mm";"SILVA (only NR);Eukaryota;Amorphea;Obazoa;Opisthokonta;Nucletmycea;Fungi;Dikarya;Basidiomycota;Pucciniomycotina;Pucciniomycetes;Pucciniales;Pucciniaceae;Puccorchidium;";"0.0";"0";"3";"3";"0";"3";"0";"430521";"5766"
"LOK1378_1mm";"SILVA (only NR);Eukaryota;Amorphea;Obazoa;Opisthokonta;Nucletmycea;Fungi;Dikarya;Basidiomycota;Pucciniomycotina;Pucciniomycetes;Pucciniales;Pucciniaceae;Uromyces;";"0.0";"0";"1";"1";"0";"1";"0";"430523";"5766"
"LOK1378_1mm";"SILVA (only NR);Eukaryota;Amorphea;Obazoa;Opisthokonta;Nucletmycea;Fungi;Dikarya;Basidiomycota;Pucciniomycotina;Pucciniomycetes;Pucciniales;Pucciniastraceae;";"0.0";"0";"9";"8";"0";"8";"1";"430516";"5766"
"LOK1378_1mm";"SILVA (only NR);Eukaryota;Amorphea;Obazoa;Opisthokonta;Nucletmycea;Fungi;Dikarya;Basidiomycota;Pucciniomycotina;Pucciniomycetes;Pucciniales;Pucciniastraceae;Hyalopsora;";"0.0";"0";"3";"2";"0";"2";"1";"430522";"5766"
"LOK1378_1mm";"SILVA (only NR);Eukaryota;Amorphea;Obazoa;Opisthokonta;Nucletmycea;Fungi;Dikarya;Basidiomycota;Pucciniomycotina;Pucciniomycetes;Pucciniales;Pucciniastraceae;Melampsorella;";"0.0";"0";"1";"1";"0";"1";"0";"430523";"5766"
"LOK1378_1mm";"SILVA (only NR);Eukaryota;Amorphea;Obazoa;Opisthokonta;Nucletmycea;Fungi;Dikarya;Basidiomycota;Pucciniomycotina;Pucciniomycetes;Pucciniales;Pucciniastraceae;Naohidemyces;";"0.0";"0";"1";"1";"0";"1";"0";"430523";"5766"
"LOK1378_1mm";"SILVA (only NR);Eukaryota;Amorphea;Obazoa;Opisthokonta;Nucletmycea;Fungi;Dikarya;Basidiomycota;Pucciniomycotina;Pucciniomycetes;Pucciniales;Pucciniastraceae;Pucciniastrum;";"0.0";"0";"2";"2";"0";"2";"0";"430522";"5766"
"LOK1378_1mm";"SILVA (only NR);Eukaryota;Amorphea;Obazoa;Opisthokonta;Nucletmycea;Fungi;Dikarya;Basidiomycota;Pucciniomycotina;Pucciniomycetes;Pucciniales;Pucciniastraceae;Thekopsora;";"0.0";"0";"2";"2";"0";"2";"0";"430522";"5766"
"LOK1378_1mm";"SILVA (only NR);Eukaryota;Amorphea;Obazoa;Opisthokonta;Nucletmycea;Fungi;Dikarya;Basidiomycota;Pucciniomycotina;Pucciniomycetes;Pucciniales;Racospermyces;";"0.0";"0";"1";"1";"0";"1";"0";"430523";"5766"
"LOK1378_1mm";"SILVA (only NR);Eukaryota;Amorphea;Obazoa;Opisthokonta;Nucletmycea;Fungi;Dikarya;Basidiomycota;Pucciniomycotina;Pucciniomycetes;Pucciniales;Raveneliaceae;";"0.0";"0";"4";"4";"0";"4";"0";"430520";"5766"
"LOK1378_1mm";"SILVA (only NR);Eukaryota;Amorphea;Obazoa;Opisthokonta;Nucletmycea;Fungi;Dikarya;Basidiomycota;Pucciniomycotina;Pucciniomycetes;Pucciniales;Raveneliaceae;Diorchidium;";"0.0";"0";"1";"1";"0";"1";"0";"430523";"5766"
"LOK1378_1mm";"SILVA (only NR);Eukaryota;Amorphea;Obazoa;Opisthokonta;Nucletmycea;Fungi;Dikarya;Basidiomycota;Pucciniomycotina;Pucciniomycetes;Pucciniales;Raveneliaceae;Ravenelia;";"0.0";"0";"1";"1";"0";"1";"0";"430523";"5766"
"LOK1378_1mm";"SILVA (only NR);Eukaryota;Amorphea;Obazoa;Opisthokonta;Nucletmycea;Fungi;Dikarya;Basidiomycota;Pucciniomycotina;Pucciniomycetes;Pucciniales;Raveneliaceae;Sphenospora;";"0.0";"0";"2";"2";"0";"2";"0";"430522";"5766"
"LOK1378_1mm";"SILVA (only NR);Eukaryota;Amorphea;Obazoa;Opisthokonta;Nucletmycea;Fungi;Dikarya;Basidiomycota;Pucciniomycotina;Pucciniomycetes;Pucciniales;Sphenorchidium;";"0.0";"0";"1";"1";"0";"1";"0";"430523";"5766"
"LOK1378_1mm";"SILVA (only NR);Eukaryota;Amorphea;Obazoa;Opisthokonta;Nucletmycea;Fungi;Dikarya;Basidiomycota;Pucciniomycotina;Pucciniomycetes;Pucciniales;Trachyspora;";"0.0";"0";"1";"1";"0";"1";"0";"430523";"5766"
"LOK1378_1mm";"SILVA (only NR);Eukaryota;Amorphea;Obazoa;Opisthokonta;Nucletmycea;Fungi;Dikarya;Basidiomycota;Pucciniomycotina;Pucciniomycetes;Pucciniales;Uropyxidaceae;";"0.0";"0";"5";"5";"0";"5";"0";"430519";"5766"
"LOK1378_1mm";"SILVA (only NR);Eukaryota;Amorphea;Obazoa;Opisthokonta;Nucletmycea;Fungi;Dikarya;Basidiomycota;Pucciniomycotina;Pucciniomycetes;Pucciniales;Uropyxidaceae;Dasyspora;";"0.0";"0";"2";"2";"0";"2";"0";"430522";"5766"
"LOK1378_1mm";"SILVA (only NR);Eukaryota;Amorphea;Obazoa;Opisthokonta;Nucletmycea;Fungi;Dikarya;Basidiomycota;Pucciniomycotina;Pucciniomycetes;Pucciniales;Uropyxidaceae;Leucotelium;";"0.0";"0";"1";"1";"0";"1";"0";"430523";"5766"
"LOK1378_1mm";"SILVA (only NR);Eukaryota;Amorphea;Obazoa;Opisthokonta;Nucletmycea;Fungi;Dikarya;Basidiomycota;Pucciniomycotina;Pucciniomycetes;Pucciniales;Uropyxidaceae;Tranzschelia;";"0.0";"0";"2";"2";"0";"2";"0";"430522";"5766"
"LOK1378_1mm";"SILVA (only NR);Eukaryota;Amorphea;Obazoa;Opisthokonta;Nucletmycea;Fungi;Dikarya;Basidiomycota;Pucciniomycotina;Pucciniomycetes;Septobasidiales;";"0.0";"0";"2";"1";"0";"1";"1";"430523";"5766"
"LOK1378_1mm";"SILVA (only NR);Eukaryota;Amorphea;Obazoa;Opisthokonta;Nucletmycea;Fungi;Dikarya;Basidiomycota;Pucciniomycotina;Pucciniomycetes;Septobasidiales;Septobasidiaceae;";"0.0";"0";"2";"1";"0";"1";"1";"430523";"5766"
"LOK1378_1mm";"SILVA (only NR);Eukaryota;Amorphea;Obazoa;Opisthokonta;Nucletmycea;Fungi;Dikarya;Basidiomycota;Pucciniomycotina;Pucciniomycetes;Septobasidiales;Septobasidiaceae;Septobasidium;";"0.0";"0";"2";"1";"0";"1";"1";"430523";"5766"
"LOK1378_1mm";"SILVA (only NR);Eukaryota;Amorphea;Obazoa;Opisthokonta;Nucletmycea;Fungi;Dikarya;Basidiomycota;Pucciniomycotina;Spiculogloeomycetes;";"0.0";"0";"6";"6";"0";"6";"0";"430518";"5766"
"LOK1378_1mm";"SILVA (only NR);Eukaryota;Amorphea;Obazoa;Opisthokonta;Nucletmycea;Fungi;Dikarya;Basidiomycota;Pucciniomycotina;Spiculogloeomycetes;Spiculogloeales;";"0.0";"0";"6";"6";"0";"6";"0";"430518";"5766"
"LOK1378_1mm";"SILVA (only NR);Eukaryota;Amorphea;Obazoa;Opisthokonta;Nucletmycea;Fungi;Dikarya;Basidiomycota;Pucciniomycotina;Spiculogloeomycetes;Spiculogloeales;Spiculogloeaceae;";"0.0";"0";"6";"6";"0";"6";"0";"430518";"5766"
"LOK1378_1mm";"SILVA (only NR);Eukaryota;Amorphea;Obazoa;Opisthokonta;Nucletmycea;Fungi;Dikarya;Basidiomycota;Pucciniomycotina;Spiculogloeomycetes;Spiculogloeales;Spiculogloeaceae;Mycogloea;";"0.0";"0";"1";"1";"0";"1";"0";"430523";"5766"
"LOK1378_1mm";"SILVA (only NR);Eukaryota;Amorphea;Obazoa;Opisthokonta;Nucletmycea;Fungi;Dikarya;Basidiomycota;Pucciniomycotina;Spiculogloeomycetes;Spiculogloeales;Spiculogloeaceae;Phyllozyma;";"0.0";"0";"4";"4";"0";"4";"0";"430520";"5766"
"LOK1378_1mm";"SILVA (only NR);Eukaryota;Amorphea;Obazoa;Opisthokonta;Nucletmycea;Fungi;Dikarya;Basidiomycota;Pucciniomycotina;Tritirachiomycetes;";"0.0";"0";"11";"11";"0";"11";"0";"430513";"5766"
"LOK1378_1mm";"SILVA (only NR);Eukaryota;Amorphea;Obazoa;Opisthokonta;Nucletmycea;Fungi;Dikarya;Basidiomycota;Pucciniomycotina;Tritirachiomycetes;Tritirachiales;";"0.0";"0";"11";"11";"0";"11";"0";"430513";"5766"
"LOK1378_1mm";"SILVA (only NR);Eukaryota;Amorphea;Obazoa;Opisthokonta;Nucletmycea;Fungi;Dikarya;Basidiomycota;Pucciniomycotina;Tritirachiomycetes;Tritirachiales;Tritirachiaceae;";"0.0";"0";"11";"11";"0";"11";"0";"430513";"5766"
"LOK1378_1mm";"SILVA (only NR);Eukaryota;Amorphea;Obazoa;Opisthokonta;Nucletmycea;Fungi;Dikarya;Basidiomycota;Pucciniomycotina;Tritirachiomycetes;Tritirachiales;Tritirachiaceae;Paratritirachium;";"0.0";"0";"2";"2";"0";"2";"0";"430522";"5766"
"LOK1378_1mm";"SILVA (only NR);Eukaryota;Amorphea;Obazoa;Opisthokonta;Nucletmycea;Fungi;Dikarya;Basidiomycota;Pucciniomycotina;Tritirachiomycetes;Tritirachiales;Tritirachiaceae;Tritirachium;";"0.0";"0";"9";"9";"0";"9";"0";"430515";"5766"
"LOK1378_1mm";"SILVA (only NR);Eukaryota;Amorphea;Obazoa;Opisthokonta;Nucletmycea;Fungi;Dikarya;Basidiomycota;Pucciniomycotina;uncultured;";"0.0";"0";"2";"1";"0";"1";"1";"430523";"5766"
"LOK1378_1mm";"SILVA (only NR);Eukaryota;Amorphea;Obazoa;Opisthokonta;Nucletmycea;Fungi;Dikarya;Basidiomycota;Ustilaginomycotina;";"0.0";"0";"594";"590";"0";"590";"4";"429934";"5766"
"LOK1378_1mm";"SILVA (only NR);Eukaryota;Amorphea;Obazoa;Opisthokonta;Nucletmycea;Fungi;Dikarya;Basidiomycota;Ustilaginomycotina;Exobasidiomycetes;";"0.0";"0";"52";"51";"0";"51";"1";"430473";"5766"
"LOK1378_1mm";"SILVA (only NR);Eukaryota;Amorphea;Obazoa;Opisthokonta;Nucletmycea;Fungi;Dikarya;Basidiomycota;Ustilaginomycotina;Exobasidiomycetes;Ceraceosorales;";"0.0";"0";"2";"2";"0";"2";"0";"430522";"5766"
"LOK1378_1mm";"SILVA (only NR);Eukaryota;Amorphea;Obazoa;Opisthokonta;Nucletmycea;Fungi;Dikarya;Basidiomycota;Ustilaginomycotina;Exobasidiomycetes;Ceraceosorales;Ceraceosoraceae;";"0.0";"0";"2";"2";"0";"2";"0";"430522";"5766"
"LOK1378_1mm";"SILVA (only NR);Eukaryota;Amorphea;Obazoa;Opisthokonta;Nucletmycea;Fungi;Dikarya;Basidiomycota;Ustilaginomycotina;Exobasidiomycetes;Ceraceosorales;Ceraceosoraceae;Ceraceosorus;";"0.0";"0";"2";"2";"0";"2";"0";"430522";"5766"
"LOK1378_1mm";"SILVA (only NR);Eukaryota;Amorphea;Obazoa;Opisthokonta;Nucletmycea;Fungi;Dikarya;Basidiomycota;Ustilaginomycotina;Exobasidiomycetes;Doassansiales;";"0.0";"0";"2";"2";"0";"2";"0";"430522";"5766"
"LOK1378_1mm";"SILVA (only NR);Eukaryota;Amorphea;Obazoa;Opisthokonta;Nucletmycea;Fungi;Dikarya;Basidiomycota;Ustilaginomycotina;Exobasidiomycetes;Doassansiales;Heterodoassansia;";"0.0";"0";"1";"1";"0";"1";"0";"430523";"5766"
"LOK1378_1mm";"SILVA (only NR);Eukaryota;Amorphea;Obazoa;Opisthokonta;Nucletmycea;Fungi;Dikarya;Basidiomycota;Ustilaginomycotina;Exobasidiomycetes;Doassansiales;Rhamphospora;";"0.0";"0";"1";"1";"0";"1";"0";"430523";"5766"
"LOK1378_1mm";"SILVA (only NR);Eukaryota;Amorphea;Obazoa;Opisthokonta;Nucletmycea;Fungi;Dikarya;Basidiomycota;Ustilaginomycotina;Exobasidiomycetes;Entylomatales;";"0.0";"0";"8";"8";"0";"8";"0";"430516";"5766"
"LOK1378_1mm";"SILVA (only NR);Eukaryota;Amorphea;Obazoa;Opisthokonta;Nucletmycea;Fungi;Dikarya;Basidiomycota;Ustilaginomycotina;Exobasidiomycetes;Entylomatales;Entylomataceae;";"0.0";"0";"1";"1";"0";"1";"0";"430523";"5766"
"LOK1378_1mm";"SILVA (only NR);Eukaryota;Amorphea;Obazoa;Opisthokonta;Nucletmycea;Fungi;Dikarya;Basidiomycota;Ustilaginomycotina;Exobasidiomycetes;Entylomatales;Entylomataceae;Entyloma;";"0.0";"0";"1";"1";"0";"1";"0";"430523";"5766"
"LOK1378_1mm";"SILVA (only NR);Eukaryota;Amorphea;Obazoa;Opisthokonta;Nucletmycea;Fungi;Dikarya;Basidiomycota;Ustilaginomycotina;Exobasidiomycetes;Entylomatales;Incertae Sedis;";"0.0";"0";"7";"7";"0";"7";"0";"430517";"5766"
"LOK1378_1mm";"SILVA (only NR);Eukaryota;Amorphea;Obazoa;Opisthokonta;Nucletmycea;Fungi;Dikarya;Basidiomycota;Ustilaginomycotina;Exobasidiomycetes;Entylomatales;Incertae Sedis;Tilletiopsis;";"0.0";"0";"7";"7";"0";"7";"0";"430517";"5766"
"LOK1378_1mm";"SILVA (only NR);Eukaryota;Amorphea;Obazoa;Opisthokonta;Nucletmycea;Fungi;Dikarya;Basidiomycota;Ustilaginomycotina;Exobasidiomycetes;Exobasidiales;";"0.0";"0";"10";"10";"0";"10";"0";"430514";"5766"
"LOK1378_1mm";"SILVA (only NR);Eukaryota;Amorphea;Obazoa;Opisthokonta;Nucletmycea;Fungi;Dikarya;Basidiomycota;Ustilaginomycotina;Exobasidiomycetes;Exobasidiales;Acaromyces;";"0.0";"0";"1";"1";"0";"1";"0";"430523";"5766"
"LOK1378_1mm";"SILVA (only NR);Eukaryota;Amorphea;Obazoa;Opisthokonta;Nucletmycea;Fungi;Dikarya;Basidiomycota;Ustilaginomycotina;Exobasidiomycetes;Exobasidiales;Brachybasidiaceae;";"0.0";"0";"3";"3";"0";"3";"0";"430521";"5766"
"LOK1378_1mm";"SILVA (only NR);Eukaryota;Amorphea;Obazoa;Opisthokonta;Nucletmycea;Fungi;Dikarya;Basidiomycota;Ustilaginomycotina;Exobasidiomycetes;Exobasidiales;Brachybasidiaceae;Dicellomyces;";"0.0";"0";"1";"1";"0";"1";"0";"430523";"5766"
"LOK1378_1mm";"SILVA (only NR);Eukaryota;Amorphea;Obazoa;Opisthokonta;Nucletmycea;Fungi;Dikarya;Basidiomycota;Ustilaginomycotina;Exobasidiomycetes;Exobasidiales;Brachybasidiaceae;Meira;";"0.0";"0";"1";"1";"0";"1";"0";"430523";"5766"
"LOK1378_1mm";"SILVA (only NR);Eukaryota;Amorphea;Obazoa;Opisthokonta;Nucletmycea;Fungi;Dikarya;Basidiomycota;Ustilaginomycotina;Exobasidiomycetes;Exobasidiales;Exobasidiaceae;";"0.0";"0";"4";"4";"0";"4";"0";"430520";"5766"
"LOK1378_1mm";"SILVA (only NR);Eukaryota;Amorphea;Obazoa;Opisthokonta;Nucletmycea;Fungi;Dikarya;Basidiomycota;Ustilaginomycotina;Exobasidiomycetes;Exobasidiales;Exobasidiaceae;Exobasidium;";"0.0";"0";"4";"4";"0";"4";"0";"430520";"5766"
"LOK1378_1mm";"SILVA (only NR);Eukaryota;Amorphea;Obazoa;Opisthokonta;Nucletmycea;Fungi;Dikarya;Basidiomycota;Ustilaginomycotina;Exobasidiomycetes;Exobasidiales;Graphiola;";"0.0";"0";"1";"1";"0";"1";"0";"430523";"5766"
"LOK1378_1mm";"SILVA (only NR);Eukaryota;Amorphea;Obazoa;Opisthokonta;Nucletmycea;Fungi;Dikarya;Basidiomycota;Ustilaginomycotina;Exobasidiomycetes;Georgefischeriales;";"0.0";"0";"12";"12";"0";"12";"0";"430512";"5766"
"LOK1378_1mm";"SILVA (only NR);Eukaryota;Amorphea;Obazoa;Opisthokonta;Nucletmycea;Fungi;Dikarya;Basidiomycota;Ustilaginomycotina;Exobasidiomycetes;Georgefischeriales;Georgefischeriaceae;";"0.0";"0";"2";"2";"0";"2";"0";"430522";"5766"
"LOK1378_1mm";"SILVA (only NR);Eukaryota;Amorphea;Obazoa;Opisthokonta;Nucletmycea;Fungi;Dikarya;Basidiomycota;Ustilaginomycotina;Exobasidiomycetes;Georgefischeriales;Georgefischeriaceae;Georgefischeria;";"0.0";"0";"1";"1";"0";"1";"0";"430523";"5766"
"LOK1378_1mm";"SILVA (only NR);Eukaryota;Amorphea;Obazoa;Opisthokonta;Nucletmycea;Fungi;Dikarya;Basidiomycota;Ustilaginomycotina;Exobasidiomycetes;Georgefischeriales;Gjaerumiaceae;";"0.0";"0";"3";"3";"0";"3";"0";"430521";"5766"
"LOK1378_1mm";"SILVA (only NR);Eukaryota;Amorphea;Obazoa;Opisthokonta;Nucletmycea;Fungi;Dikarya;Basidiomycota;Ustilaginomycotina;Exobasidiomycetes;Georgefischeriales;Gjaerumiaceae;Gjaerumia;";"0.0";"0";"3";"3";"0";"3";"0";"430521";"5766"
"LOK1378_1mm";"SILVA (only NR);Eukaryota;Amorphea;Obazoa;Opisthokonta;Nucletmycea;Fungi;Dikarya;Basidiomycota;Ustilaginomycotina;Exobasidiomycetes;Georgefischeriales;Tilletiariaceae;";"0.0";"0";"7";"7";"0";"7";"0";"430517";"5766"
"LOK1378_1mm";"SILVA (only NR);Eukaryota;Amorphea;Obazoa;Opisthokonta;Nucletmycea;Fungi;Dikarya;Basidiomycota;Ustilaginomycotina;Exobasidiomycetes;Georgefischeriales;Tilletiariaceae;Phragmotaenium;";"0.0";"0";"5";"5";"0";"5";"0";"430519";"5766"
"LOK1378_1mm";"SILVA (only NR);Eukaryota;Amorphea;Obazoa;Opisthokonta;Nucletmycea;Fungi;Dikarya;Basidiomycota;Ustilaginomycotina;Exobasidiomycetes;Georgefischeriales;Tilletiariaceae;Tilletiaria;";"0.0";"0";"2";"2";"0";"2";"0";"430522";"5766"
"LOK1378_1mm";"SILVA (only NR);Eukaryota;Amorphea;Obazoa;Opisthokonta;Nucletmycea;Fungi;Dikarya;Basidiomycota;Ustilaginomycotina;Exobasidiomycetes;Microstromatales;";"0.0";"0";"8";"8";"0";"8";"0";"430516";"5766"
"LOK1378_1mm";"SILVA (only NR);Eukaryota;Amorphea;Obazoa;Opisthokonta;Nucletmycea;Fungi;Dikarya;Basidiomycota;Ustilaginomycotina;Exobasidiomycetes;Microstromatales;Incertae Sedis;";"0.0";"0";"2";"2";"0";"2";"0";"430522";"5766"
"LOK1378_1mm";"SILVA (only NR);Eukaryota;Amorphea;Obazoa;Opisthokonta;Nucletmycea;Fungi;Dikarya;Basidiomycota;Ustilaginomycotina;Exobasidiomycetes;Microstromatales;Incertae Sedis;Sympodiomycopsis;";"0.0";"0";"2";"2";"0";"2";"0";"430522";"5766"
"LOK1378_1mm";"SILVA (only NR);Eukaryota;Amorphea;Obazoa;Opisthokonta;Nucletmycea;Fungi;Dikarya;Basidiomycota;Ustilaginomycotina;Exobasidiomycetes;Microstromatales;Jaminaea;";"0.0";"0";"1";"1";"0";"1";"0";"430523";"5766"
"LOK1378_1mm";"SILVA (only NR);Eukaryota;Amorphea;Obazoa;Opisthokonta;Nucletmycea;Fungi;Dikarya;Basidiomycota;Ustilaginomycotina;Exobasidiomycetes;Microstromatales;Microstromataceae;";"0.0";"0";"3";"3";"0";"3";"0";"430521";"5766"
"LOK1378_1mm";"SILVA (only NR);Eukaryota;Amorphea;Obazoa;Opisthokonta;Nucletmycea;Fungi;Dikarya;Basidiomycota;Ustilaginomycotina;Exobasidiomycetes;Microstromatales;Microstromataceae;Microstroma;";"0.0";"0";"3";"3";"0";"3";"0";"430521";"5766"
"LOK1378_1mm";"SILVA (only NR);Eukaryota;Amorphea;Obazoa;Opisthokonta;Nucletmycea;Fungi;Dikarya;Basidiomycota;Ustilaginomycotina;Exobasidiomycetes;Microstromatales;Quambalaria;";"0.0";"0";"1";"1";"0";"1";"0";"430523";"5766"
"LOK1378_1mm";"SILVA (only NR);Eukaryota;Amorphea;Obazoa;Opisthokonta;Nucletmycea;Fungi;Dikarya;Basidiomycota;Ustilaginomycotina;Exobasidiomycetes;Robbauerales;";"0.0";"0";"3";"3";"0";"3";"0";"430521";"5766"
"LOK1378_1mm";"SILVA (only NR);Eukaryota;Amorphea;Obazoa;Opisthokonta;Nucletmycea;Fungi;Dikarya;Basidiomycota;Ustilaginomycotina;Exobasidiomycetes;Robbauerales;Robbaueraceae;";"0.0";"0";"3";"3";"0";"3";"0";"430521";"5766"
"LOK1378_1mm";"SILVA (only NR);Eukaryota;Amorphea;Obazoa;Opisthokonta;Nucletmycea;Fungi;Dikarya;Basidiomycota;Ustilaginomycotina;Exobasidiomycetes;Robbauerales;Robbaueraceae;Robbauera;";"0.0";"0";"3";"3";"0";"3";"0";"430521";"5766"
"LOK1378_1mm";"SILVA (only NR);Eukaryota;Amorphea;Obazoa;Opisthokonta;Nucletmycea;Fungi;Dikarya;Basidiomycota;Ustilaginomycotina;Exobasidiomycetes;Tilletiales;";"0.0";"0";"6";"6";"0";"6";"0";"430518";"5766"
"LOK1378_1mm";"SILVA (only NR);Eukaryota;Amorphea;Obazoa;Opisthokonta;Nucletmycea;Fungi;Dikarya;Basidiomycota;Ustilaginomycotina;Exobasidiomycetes;Tilletiales;Tilletiaceae;";"0.0";"0";"6";"6";"0";"6";"0";"430518";"5766"
"LOK1378_1mm";"SILVA (only NR);Eukaryota;Amorphea;Obazoa;Opisthokonta;Nucletmycea;Fungi;Dikarya;Basidiomycota;Ustilaginomycotina;Exobasidiomycetes;Tilletiales;Tilletiaceae;Erratomyces;";"0.0";"0";"1";"1";"0";"1";"0";"430523";"5766"
"LOK1378_1mm";"SILVA (only NR);Eukaryota;Amorphea;Obazoa;Opisthokonta;Nucletmycea;Fungi;Dikarya;Basidiomycota;Ustilaginomycotina;Exobasidiomycetes;Tilletiales;Tilletiaceae;Salmacisia;";"0.0";"0";"1";"1";"0";"1";"0";"430523";"5766"
"LOK1378_1mm";"SILVA (only NR);Eukaryota;Amorphea;Obazoa;Opisthokonta;Nucletmycea;Fungi;Dikarya;Basidiomycota;Ustilaginomycotina;Exobasidiomycetes;Tilletiales;Tilletiaceae;Tilletia;";"0.0";"0";"4";"4";"0";"4";"0";"430520";"5766"
"LOK1378_1mm";"SILVA (only NR);Eukaryota;Amorphea;Obazoa;Opisthokonta;Nucletmycea;Fungi;Dikarya;Basidiomycota;Ustilaginomycotina;Malasseziomycetes;";"0.0";"0";"496";"494";"0";"494";"2";"430030";"5766"
"LOK1378_1mm";"SILVA (only NR);Eukaryota;Amorphea;Obazoa;Opisthokonta;Nucletmycea;Fungi;Dikarya;Basidiomycota;Ustilaginomycotina;Malasseziomycetes;Malasseziales;";"0.0";"0";"496";"494";"0";"494";"2";"430030";"5766"
"LOK1378_1mm";"SILVA (only NR);Eukaryota;Amorphea;Obazoa;Opisthokonta;Nucletmycea;Fungi;Dikarya;Basidiomycota;Ustilaginomycotina;Malasseziomycetes;Malasseziales;Malasseziaceae;";"0.0";"0";"496";"494";"0";"494";"2";"430030";"5766"
"LOK1378_1mm";"SILVA (only NR);Eukaryota;Amorphea;Obazoa;Opisthokonta;Nucletmycea;Fungi;Dikarya;Basidiomycota;Ustilaginomycotina;Malasseziomycetes;Malasseziales;Malasseziaceae;Malassezia;";"0.0";"0";"496";"494";"0";"494";"2";"430030";"5766"
"LOK1378_1mm";"SILVA (only NR);Eukaryota;Amorphea;Obazoa;Opisthokonta;Nucletmycea;Fungi;Dikarya;Basidiomycota;Ustilaginomycotina;Moniliellomycetes;";"0.0";"0";"6";"6";"0";"6";"0";"430518";"5766"
"LOK1378_1mm";"SILVA (only NR);Eukaryota;Amorphea;Obazoa;Opisthokonta;Nucletmycea;Fungi;Dikarya;Basidiomycota;Ustilaginomycotina;Moniliellomycetes;Moniliellales;";"0.0";"0";"6";"6";"0";"6";"0";"430518";"5766"
"LOK1378_1mm";"SILVA (only NR);Eukaryota;Amorphea;Obazoa;Opisthokonta;Nucletmycea;Fungi;Dikarya;Basidiomycota;Ustilaginomycotina;Moniliellomycetes;Moniliellales;Moniliellaceae;";"0.0";"0";"6";"6";"0";"6";"0";"430518";"5766"
"LOK1378_1mm";"SILVA (only NR);Eukaryota;Amorphea;Obazoa;Opisthokonta;Nucletmycea;Fungi;Dikarya;Basidiomycota;Ustilaginomycotina;Moniliellomycetes;Moniliellales;Moniliellaceae;Moniliella;";"0.0";"0";"6";"6";"0";"6";"0";"430518";"5766"
"LOK1378_1mm";"SILVA (only NR);Eukaryota;Amorphea;Obazoa;Opisthokonta;Nucletmycea;Fungi;Dikarya;Basidiomycota;Ustilaginomycotina;Ustilaginomycetes;";"0.0";"0";"40";"39";"0";"39";"1";"430485";"5766"
"LOK1378_1mm";"SILVA (only NR);Eukaryota;Amorphea;Obazoa;Opisthokonta;Nucletmycea;Fungi;Dikarya;Basidiomycota;Ustilaginomycotina;Ustilaginomycetes;Urocystidales;";"0.0";"0";"3";"3";"0";"3";"0";"430521";"5766"
"LOK1378_1mm";"SILVA (only NR);Eukaryota;Amorphea;Obazoa;Opisthokonta;Nucletmycea;Fungi;Dikarya;Basidiomycota;Ustilaginomycotina;Ustilaginomycetes;Urocystidales;Fereydounia;";"0.0";"0";"1";"1";"0";"1";"0";"430523";"5766"
"LOK1378_1mm";"SILVA (only NR);Eukaryota;Amorphea;Obazoa;Opisthokonta;Nucletmycea;Fungi;Dikarya;Basidiomycota;Ustilaginomycotina;Ustilaginomycetes;Urocystidales;Melanotaeniaceae;";"0.0";"0";"2";"2";"0";"2";"0";"430522";"5766"
"LOK1378_1mm";"SILVA (only NR);Eukaryota;Amorphea;Obazoa;Opisthokonta;Nucletmycea;Fungi;Dikarya;Basidiomycota;Ustilaginomycotina;Ustilaginomycetes;Urocystidales;Melanotaeniaceae;Melanotaenium;";"0.0";"0";"2";"2";"0";"2";"0";"430522";"5766"
"LOK1378_1mm";"SILVA (only NR);Eukaryota;Amorphea;Obazoa;Opisthokonta;Nucletmycea;Fungi;Dikarya;Basidiomycota;Ustilaginomycotina;Ustilaginomycetes;Ustilaginales;";"0.0";"0";"36";"35";"0";"35";"1";"430489";"5766"
"LOK1378_1mm";"SILVA (only NR);Eukaryota;Amorphea;Obazoa;Opisthokonta;Nucletmycea;Fungi;Dikarya;Basidiomycota;Ustilaginomycotina;Ustilaginomycetes;Ustilaginales;Anthracoideaceae;";"0.0";"0";"2";"2";"0";"2";"0";"430522";"5766"
"LOK1378_1mm";"SILVA (only NR);Eukaryota;Amorphea;Obazoa;Opisthokonta;Nucletmycea;Fungi;Dikarya;Basidiomycota;Ustilaginomycotina;Ustilaginomycetes;Ustilaginales;Anthracoideaceae;Anthracoidea;";"0.0";"0";"2";"2";"0";"2";"0";"430522";"5766"
"LOK1378_1mm";"SILVA (only NR);Eukaryota;Amorphea;Obazoa;Opisthokonta;Nucletmycea;Fungi;Dikarya;Basidiomycota;Ustilaginomycotina;Ustilaginomycetes;Ustilaginales;Ustilaginaceae;";"0.0";"0";"34";"33";"0";"33";"1";"430491";"5766"
"LOK1378_1mm";"SILVA (only NR);Eukaryota;Amorphea;Obazoa;Opisthokonta;Nucletmycea;Fungi;Dikarya;Basidiomycota;Ustilaginomycotina;Ustilaginomycetes;Ustilaginales;Ustilaginaceae;Anthracocystis;";"0.0";"0";"1";"1";"0";"1";"0";"430523";"5766"
"LOK1378_1mm";"SILVA (only NR);Eukaryota;Amorphea;Obazoa;Opisthokonta;Nucletmycea;Fungi;Dikarya;Basidiomycota;Ustilaginomycotina;Ustilaginomycetes;Ustilaginales;Ustilaginaceae;Cintractia;";"0.0";"0";"1";"1";"0";"1";"0";"430523";"5766"
"LOK1378_1mm";"SILVA (only NR);Eukaryota;Amorphea;Obazoa;Opisthokonta;Nucletmycea;Fungi;Dikarya;Basidiomycota;Ustilaginomycotina;Ustilaginomycetes;Ustilaginales;Ustilaginaceae;Farysia;";"0.0";"0";"2";"2";"0";"2";"0";"430522";"5766"
"LOK1378_1mm";"SILVA (only NR);Eukaryota;Amorphea;Obazoa;Opisthokonta;Nucletmycea;Fungi;Dikarya;Basidiomycota;Ustilaginomycotina;Ustilaginomycetes;Ustilaginales;Ustilaginaceae;Leucocintractia;";"0.0";"0";"1";"1";"0";"1";"0";"430523";"5766"
"LOK1378_1mm";"SILVA (only NR);Eukaryota;Amorphea;Obazoa;Opisthokonta;Nucletmycea;Fungi;Dikarya;Basidiomycota;Ustilaginomycotina;Ustilaginomycetes;Ustilaginales;Ustilaginaceae;Melanopsichium;";"0.0";"0";"5";"5";"0";"5";"0";"430519";"5766"
"LOK1378_1mm";"SILVA (only NR);Eukaryota;Amorphea;Obazoa;Opisthokonta;Nucletmycea;Fungi;Dikarya;Basidiomycota;Ustilaginomycotina;Ustilaginomycetes;Ustilaginales;Ustilaginaceae;Moesziomyces;";"0.0";"0";"2";"2";"0";"2";"0";"430522";"5766"
"LOK1378_1mm";"SILVA (only NR);Eukaryota;Amorphea;Obazoa;Opisthokonta;Nucletmycea;Fungi;Dikarya;Basidiomycota;Ustilaginomycotina;Ustilaginomycetes;Ustilaginales;Ustilaginaceae;Pseudozyma;";"0.0";"0";"2";"2";"0";"2";"0";"430522";"5766"
"LOK1378_1mm";"SILVA (only NR);Eukaryota;Amorphea;Obazoa;Opisthokonta;Nucletmycea;Fungi;Dikarya;Basidiomycota;Ustilaginomycotina;Ustilaginomycetes;Ustilaginales;Ustilaginaceae;Schizonella;";"0.0";"0";"3";"3";"0";"3";"0";"430521";"5766"
"LOK1378_1mm";"SILVA (only NR);Eukaryota;Amorphea;Obazoa;Opisthokonta;Nucletmycea;Fungi;Dikarya;Basidiomycota;Ustilaginomycotina;Ustilaginomycetes;Ustilaginales;Ustilaginaceae;Sporisorium;";"0.0";"0";"7";"6";"0";"6";"1";"430518";"5766"
"LOK1378_1mm";"SILVA (only NR);Eukaryota;Amorphea;Obazoa;Opisthokonta;Nucletmycea;Fungi;Dikarya;Basidiomycota;Ustilaginomycotina;Ustilaginomycetes;Ustilaginales;Ustilaginaceae;Testicularia;";"0.0";"0";"1";"1";"0";"1";"0";"430523";"5766"
"LOK1378_1mm";"SILVA (only NR);Eukaryota;Amorphea;Obazoa;Opisthokonta;Nucletmycea;Fungi;Dikarya;Basidiomycota;Ustilaginomycotina;Ustilaginomycetes;Ustilaginales;Ustilaginaceae;Tranzscheliella;";"0.0";"0";"1";"1";"0";"1";"0";"430523";"5766"
"LOK1378_1mm";"SILVA (only NR);Eukaryota;Amorphea;Obazoa;Opisthokonta;Nucletmycea;Fungi;Dikarya;Basidiomycota;Ustilaginomycotina;Ustilaginomycetes;Ustilaginales;Ustilaginaceae;Ustanciosporium;";"0.0";"0";"1";"1";"0";"1";"0";"430523";"5766"
"LOK1378_1mm";"SILVA (only NR);Eukaryota;Amorphea;Obazoa;Opisthokonta;Nucletmycea;Fungi;Dikarya;Basidiomycota;Ustilaginomycotina;Ustilaginomycetes;Ustilaginales;Ustilaginaceae;Ustilago;";"0.0";"0";"6";"6";"0";"6";"0";"430518";"5766"
"LOK1378_1mm";"SILVA (only NR);Eukaryota;Amorphea;Obazoa;Opisthokonta;Nucletmycea;Fungi;Dikarya;Basidiomycota;Ustilaginomycotina;Ustilaginomycetes;Violaceomycetales;";"0.0";"0";"1";"1";"0";"1";"0";"430523";"5766"
"LOK1378_1mm";"SILVA (only NR);Eukaryota;Amorphea;Obazoa;Opisthokonta;Nucletmycea;Fungi;Dikarya;Basidiomycota;Ustilaginomycotina;Ustilaginomycetes;Violaceomycetales;Violaceomycetaceae;";"0.0";"0";"1";"1";"0";"1";"0";"430523";"5766"
"LOK1378_1mm";"SILVA (only NR);Eukaryota;Amorphea;Obazoa;Opisthokonta;Nucletmycea;Fungi;Dikarya;Basidiomycota;Ustilaginomycotina;Ustilaginomycetes;Violaceomycetales;Violaceomycetaceae;Violaceomyces;";"0.0";"0";"1";"1";"0";"1";"0";"430523";"5766"
"LOK1378_1mm";"SILVA (only NR);Eukaryota;Amorphea;Obazoa;Opisthokonta;Nucletmycea;Fungi;Dikarya;Basidiomycota;uncultured;";"0.0";"0";"2";"2";"0";"2";"0";"430522";"5766"
"LOK1378_1mm";"SILVA (only NR);Eukaryota;Amorphea;Obazoa;Opisthokonta;Nucletmycea;Fungi;Dikarya;Dikarya Incertae Sedis;";"0.0";"0";"2";"2";"0";"2";"0";"430522";"5766"
"LOK1378_1mm";"SILVA (only NR);Eukaryota;Amorphea;Obazoa;Opisthokonta;Nucletmycea;Fungi;Dikarya;Dikarya Incertae Sedis;Entorrhizomycetes;";"0.0";"0";"2";"2";"0";"2";"0";"430522";"5766"
"LOK1378_1mm";"SILVA (only NR);Eukaryota;Amorphea;Obazoa;Opisthokonta;Nucletmycea;Fungi;Dikarya;Dikarya Incertae Sedis;Entorrhizomycetes;Entorrhizales;";"0.0";"0";"2";"2";"0";"2";"0";"430522";"5766"
"LOK1378_1mm";"SILVA (only NR);Eukaryota;Amorphea;Obazoa;Opisthokonta;Nucletmycea;Fungi;Dikarya;Dikarya Incertae Sedis;Entorrhizomycetes;Entorrhizales;Entorrhizaceae;";"0.0";"0";"2";"2";"0";"2";"0";"430522";"5766"
"LOK1378_1mm";"SILVA (only NR);Eukaryota;Amorphea;Obazoa;Opisthokonta;Nucletmycea;Fungi;Dikarya;Dikarya Incertae Sedis;Entorrhizomycetes;Entorrhizales;Entorrhizaceae;Entorrhiza;";"0.0";"0";"2";"2";"0";"2";"0";"430522";"5766"
"LOK1378_1mm";"SILVA (only NR);Eukaryota;Amorphea;Obazoa;Opisthokonta;Nucletmycea;Fungi;Incertae Sedis;";"0.0";"0";"3";"3";"0";"3";"0";"430521";"5766"
"LOK1378_1mm";"SILVA (only NR);Eukaryota;Amorphea;Obazoa;Opisthokonta;Nucletmycea;Fungi;Incertae Sedis;Incertae Sedis;";"0.0";"0";"3";"3";"0";"3";"0";"430521";"5766"
"LOK1378_1mm";"SILVA (only NR);Eukaryota;Amorphea;Obazoa;Opisthokonta;Nucletmycea;Fungi;Incertae Sedis;Incertae Sedis;Incertae Sedis;";"0.0";"0";"3";"3";"0";"3";"0";"430521";"5766"
"LOK1378_1mm";"SILVA (only NR);Eukaryota;Amorphea;Obazoa;Opisthokonta;Nucletmycea;Fungi;Incertae Sedis;Incertae Sedis;Incertae Sedis;Incertae Sedis;";"0.0";"0";"3";"3";"0";"3";"0";"430521";"5766"
"LOK1378_1mm";"SILVA (only NR);Eukaryota;Amorphea;Obazoa;Opisthokonta;Nucletmycea;Fungi;Incertae Sedis;Incertae Sedis;Incertae Sedis;Incertae Sedis;Incertae Sedis;";"0.0";"0";"3";"3";"0";"3";"0";"430521";"5766"
"LOK1378_1mm";"SILVA (only NR);Eukaryota;Amorphea;Obazoa;Opisthokonta;Nucletmycea;Fungi;Incertae Sedis;Incertae Sedis;Incertae Sedis;Incertae Sedis;Incertae Sedis;Nephridiophaga;";"0.0";"0";"3";"3";"0";"3";"0";"430521";"5766"
"LOK1378_1mm";"SILVA (only NR);Eukaryota;Amorphea;Obazoa;Opisthokonta;Nucletmycea;Fungi;LKM15;";"0.0";"0";"23";"22";"0";"22";"1";"430502";"5766"
"LOK1378_1mm";"SILVA (only NR);Eukaryota;Amorphea;Obazoa;Opisthokonta;Nucletmycea;Fungi;Microsporidia;";"0.0";"0";"70";"70";"0";"70";"0";"430454";"5766"
"LOK1378_1mm";"SILVA (only NR);Eukaryota;Amorphea;Obazoa;Opisthokonta;Nucletmycea;Fungi;Microsporidia;Amblyosporidae;";"0.0";"0";"40";"40";"0";"40";"0";"430484";"5766"
"LOK1378_1mm";"SILVA (only NR);Eukaryota;Amorphea;Obazoa;Opisthokonta;Nucletmycea;Fungi;Microsporidia;Amblyosporidae;Amblyospora;";"0.0";"0";"31";"31";"0";"31";"0";"430493";"5766"
"LOK1378_1mm";"SILVA (only NR);Eukaryota;Amorphea;Obazoa;Opisthokonta;Nucletmycea;Fungi;Microsporidia;Amblyosporidae;Andreanna;";"0.0";"0";"1";"1";"0";"1";"0";"430523";"5766"
"LOK1378_1mm";"SILVA (only NR);Eukaryota;Amorphea;Obazoa;Opisthokonta;Nucletmycea;Fungi;Microsporidia;Amblyosporidae;Berwaldia;";"0.0";"0";"1";"1";"0";"1";"0";"430523";"5766"
"LOK1378_1mm";"SILVA (only NR);Eukaryota;Amorphea;Obazoa;Opisthokonta;Nucletmycea;Fungi;Microsporidia;Amblyosporidae;Intrapredatorus;";"0.0";"0";"1";"1";"0";"1";"0";"430523";"5766"
"LOK1378_1mm";"SILVA (only NR);Eukaryota;Amorphea;Obazoa;Opisthokonta;Nucletmycea;Fungi;Microsporidia;Amblyosporidae;Novothelohania;";"0.0";"0";"1";"1";"0";"1";"0";"430523";"5766"
"LOK1378_1mm";"SILVA (only NR);Eukaryota;Amorphea;Obazoa;Opisthokonta;Nucletmycea;Fungi;Microsporidia;Amblyosporidae;Parathelohania;";"0.0";"0";"4";"4";"0";"4";"0";"430520";"5766"
"LOK1378_1mm";"SILVA (only NR);Eukaryota;Amorphea;Obazoa;Opisthokonta;Nucletmycea;Fungi;Microsporidia;Amblyosporidae;Takaokaspora;";"0.0";"0";"1";"1";"0";"1";"0";"430523";"5766"
"LOK1378_1mm";"SILVA (only NR);Eukaryota;Amorphea;Obazoa;Opisthokonta;Nucletmycea;Fungi;Microsporidia;Caudosporidae;";"0.0";"0";"1";"1";"0";"1";"0";"430523";"5766"
"LOK1378_1mm";"SILVA (only NR);Eukaryota;Amorphea;Obazoa;Opisthokonta;Nucletmycea;Fungi;Microsporidia;Caudosporidae;Culicosporella;";"0.0";"0";"1";"1";"0";"1";"0";"430523";"5766"
"LOK1378_1mm";"SILVA (only NR);Eukaryota;Amorphea;Obazoa;Opisthokonta;Nucletmycea;Fungi;Microsporidia;Culicosporidae;";"0.0";"0";"1";"1";"0";"1";"0";"430523";"5766"
"LOK1378_1mm";"SILVA (only NR);Eukaryota;Amorphea;Obazoa;Opisthokonta;Nucletmycea;Fungi;Microsporidia;Culicosporidae;Edhazardia;";"0.0";"0";"1";"1";"0";"1";"0";"430523";"5766"
"LOK1378_1mm";"SILVA (only NR);Eukaryota;Amorphea;Obazoa;Opisthokonta;Nucletmycea;Fungi;Microsporidia;Gurleyidae;";"0.0";"0";"3";"3";"0";"3";"0";"430521";"5766"
"LOK1378_1mm";"SILVA (only NR);Eukaryota;Amorphea;Obazoa;Opisthokonta;Nucletmycea;Fungi;Microsporidia;Gurleyidae;Gurleya;";"0.0";"0";"1";"1";"0";"1";"0";"430523";"5766"
"LOK1378_1mm";"SILVA (only NR);Eukaryota;Amorphea;Obazoa;Opisthokonta;Nucletmycea;Fungi;Microsporidia;Gurleyidae;Hazardia;";"0.0";"0";"2";"2";"0";"2";"0";"430522";"5766"
"LOK1378_1mm";"SILVA (only NR);Eukaryota;Amorphea;Obazoa;Opisthokonta;Nucletmycea;Fungi;Microsporidia;Incertae Sedis;";"0.0";"0";"6";"6";"0";"6";"0";"430518";"5766"
"LOK1378_1mm";"SILVA (only NR);Eukaryota;Amorphea;Obazoa;Opisthokonta;Nucletmycea;Fungi;Microsporidia;Incertae Sedis;Binucleata;";"0.0";"0";"1";"1";"0";"1";"0";"430523";"5766"
"LOK1378_1mm";"SILVA (only NR);Eukaryota;Amorphea;Obazoa;Opisthokonta;Nucletmycea;Fungi;Microsporidia;Incertae Sedis;Lanatospora;";"0.0";"0";"1";"1";"0";"1";"0";"430523";"5766"
"LOK1378_1mm";"SILVA (only NR);Eukaryota;Amorphea;Obazoa;Opisthokonta;Nucletmycea;Fungi;Microsporidia;Incertae Sedis;Neoperezia;";"0.0";"0";"2";"2";"0";"2";"0";"430522";"5766"
"LOK1378_1mm";"SILVA (only NR);Eukaryota;Amorphea;Obazoa;Opisthokonta;Nucletmycea;Fungi;Microsporidia;Incertae Sedis;Senoma;";"0.0";"0";"1";"1";"0";"1";"0";"430523";"5766"
"LOK1378_1mm";"SILVA (only NR);Eukaryota;Amorphea;Obazoa;Opisthokonta;Nucletmycea;Fungi;Microsporidia;Incertae Sedis;Trichotosporea;";"0.0";"0";"1";"1";"0";"1";"0";"430523";"5766"
"LOK1378_1mm";"SILVA (only NR);Eukaryota;Amorphea;Obazoa;Opisthokonta;Nucletmycea;Fungi;Microsporidia;Mrazekiidae;";"0.0";"0";"4";"4";"0";"4";"0";"430520";"5766"
"LOK1378_1mm";"SILVA (only NR);Eukaryota;Amorphea;Obazoa;Opisthokonta;Nucletmycea;Fungi;Microsporidia;Mrazekiidae;Bacillidium;";"0.0";"0";"2";"2";"0";"2";"0";"430522";"5766"
"LOK1378_1mm";"SILVA (only NR);Eukaryota;Amorphea;Obazoa;Opisthokonta;Nucletmycea;Fungi;Microsporidia;Mrazekiidae;Schroedera;";"0.0";"0";"2";"2";"0";"2";"0";"430522";"5766"
"LOK1378_1mm";"SILVA (only NR);Eukaryota;Amorphea;Obazoa;Opisthokonta;Nucletmycea;Fungi;Microsporidia;Pseudonosematidae;";"0.0";"0";"5";"5";"0";"5";"0";"430519";"5766"
"LOK1378_1mm";"SILVA (only NR);Eukaryota;Amorphea;Obazoa;Opisthokonta;Nucletmycea;Fungi;Microsporidia;Pseudonosematidae;Bryonosema;";"0.0";"0";"3";"3";"0";"3";"0";"430521";"5766"
"LOK1378_1mm";"SILVA (only NR);Eukaryota;Amorphea;Obazoa;Opisthokonta;Nucletmycea;Fungi;Microsporidia;Pseudonosematidae;Pseudonosema;";"0.0";"0";"1";"1";"0";"1";"0";"430523";"5766"
"LOK1378_1mm";"SILVA (only NR);Eukaryota;Amorphea;Obazoa;Opisthokonta;Nucletmycea;Fungi;Microsporidia;Pseudonosematidae;Trichonosema;";"0.0";"0";"1";"1";"0";"1";"0";"430523";"5766"
"LOK1378_1mm";"SILVA (only NR);Eukaryota;Amorphea;Obazoa;Opisthokonta;Nucletmycea;Fungi;Microsporidia;Thelohaniidae;";"0.0";"0";"1";"1";"0";"1";"0";"430523";"5766"
"LOK1378_1mm";"SILVA (only NR);Eukaryota;Amorphea;Obazoa;Opisthokonta;Nucletmycea;Fungi;Microsporidia;Thelohaniidae;Hyalinocysta;";"0.0";"0";"1";"1";"0";"1";"0";"430523";"5766"
"LOK1378_1mm";"SILVA (only NR);Eukaryota;Amorphea;Obazoa;Opisthokonta;Nucletmycea;Fungi;Microsporidia;Tuzetiidae;";"0.0";"0";"3";"3";"0";"3";"0";"430521";"5766"
"LOK1378_1mm";"SILVA (only NR);Eukaryota;Amorphea;Obazoa;Opisthokonta;Nucletmycea;Fungi;Microsporidia;Tuzetiidae;Janacekia;";"0.0";"0";"2";"2";"0";"2";"0";"430522";"5766"
"LOK1378_1mm";"SILVA (only NR);Eukaryota;Amorphea;Obazoa;Opisthokonta;Nucletmycea;Fungi;Microsporidia;Tuzetiidae;Marssoniella;";"0.0";"0";"1";"1";"0";"1";"0";"430523";"5766"
"LOK1378_1mm";"SILVA (only NR);Eukaryota;Amorphea;Obazoa;Opisthokonta;Nucletmycea;Fungi;Mucoromycota;";"0.0";"0";"752";"669";"0";"669";"83";"429855";"5766"
"LOK1378_1mm";"SILVA (only NR);Eukaryota;Amorphea;Obazoa;Opisthokonta;Nucletmycea;Fungi;Mucoromycota;Glomeromycotina;";"0.0";"0";"433";"368";"0";"368";"65";"430156";"5766"
"LOK1378_1mm";"SILVA (only NR);Eukaryota;Amorphea;Obazoa;Opisthokonta;Nucletmycea;Fungi;Mucoromycota;Glomeromycotina;Glomeromycetes;";"0.0";"0";"433";"368";"0";"368";"65";"430156";"5766"
"LOK1378_1mm";"SILVA (only NR);Eukaryota;Amorphea;Obazoa;Opisthokonta;Nucletmycea;Fungi;Mucoromycota;Glomeromycotina;Glomeromycetes;Archaeosporales;";"0.0";"0";"31";"31";"0";"31";"0";"430493";"5766"
"LOK1378_1mm";"SILVA (only NR);Eukaryota;Amorphea;Obazoa;Opisthokonta;Nucletmycea;Fungi;Mucoromycota;Glomeromycotina;Glomeromycetes;Archaeosporales;Ambisporaceae;";"0.0";"0";"10";"10";"0";"10";"0";"430514";"5766"
"LOK1378_1mm";"SILVA (only NR);Eukaryota;Amorphea;Obazoa;Opisthokonta;Nucletmycea;Fungi;Mucoromycota;Glomeromycotina;Glomeromycetes;Archaeosporales;Ambisporaceae;Ambispora;";"0.0";"0";"10";"10";"0";"10";"0";"430514";"5766"
"LOK1378_1mm";"SILVA (only NR);Eukaryota;Amorphea;Obazoa;Opisthokonta;Nucletmycea;Fungi;Mucoromycota;Glomeromycotina;Glomeromycetes;Archaeosporales;Archaeosporaceae;";"0.0";"0";"19";"19";"0";"19";"0";"430505";"5766"
"LOK1378_1mm";"SILVA (only NR);Eukaryota;Amorphea;Obazoa;Opisthokonta;Nucletmycea;Fungi;Mucoromycota;Glomeromycotina;Glomeromycetes;Archaeosporales;Archaeosporaceae;Archaeospora;";"0.0";"0";"3";"3";"0";"3";"0";"430521";"5766"
"LOK1378_1mm";"SILVA (only NR);Eukaryota;Amorphea;Obazoa;Opisthokonta;Nucletmycea;Fungi;Mucoromycota;Glomeromycotina;Glomeromycetes;Archaeosporales;Geosiphonaceae;";"0.0";"0";"2";"2";"0";"2";"0";"430522";"5766"
"LOK1378_1mm";"SILVA (only NR);Eukaryota;Amorphea;Obazoa;Opisthokonta;Nucletmycea;Fungi;Mucoromycota;Glomeromycotina;Glomeromycetes;Archaeosporales;Geosiphonaceae;Geosiphon;";"0.0";"0";"2";"2";"0";"2";"0";"430522";"5766"
"LOK1378_1mm";"SILVA (only NR);Eukaryota;Amorphea;Obazoa;Opisthokonta;Nucletmycea;Fungi;Mucoromycota;Glomeromycotina;Glomeromycetes;Diversisporales;";"0.0";"0";"86";"85";"0";"85";"1";"430439";"5766"
"LOK1378_1mm";"SILVA (only NR);Eukaryota;Amorphea;Obazoa;Opisthokonta;Nucletmycea;Fungi;Mucoromycota;Glomeromycotina;Glomeromycetes;Diversisporales;Acaulosporaceae;";"0.0";"0";"23";"22";"0";"22";"1";"430502";"5766"
"LOK1378_1mm";"SILVA (only NR);Eukaryota;Amorphea;Obazoa;Opisthokonta;Nucletmycea;Fungi;Mucoromycota;Glomeromycotina;Glomeromycetes;Diversisporales;Acaulosporaceae;Acaulospora;";"0.0";"0";"23";"22";"0";"22";"1";"430502";"5766"
"LOK1378_1mm";"SILVA (only NR);Eukaryota;Amorphea;Obazoa;Opisthokonta;Nucletmycea;Fungi;Mucoromycota;Glomeromycotina;Glomeromycetes;Diversisporales;Diversisporaceae;";"0.0";"0";"11";"11";"0";"11";"0";"430513";"5766"
"LOK1378_1mm";"SILVA (only NR);Eukaryota;Amorphea;Obazoa;Opisthokonta;Nucletmycea;Fungi;Mucoromycota;Glomeromycotina;Glomeromycetes;Diversisporales;Diversisporaceae;Diversispora;";"0.0";"0";"9";"9";"0";"9";"0";"430515";"5766"
"LOK1378_1mm";"SILVA (only NR);Eukaryota;Amorphea;Obazoa;Opisthokonta;Nucletmycea;Fungi;Mucoromycota;Glomeromycotina;Glomeromycetes;Diversisporales;Diversisporaceae;Otospora;";"0.0";"0";"1";"1";"0";"1";"0";"430523";"5766"
"LOK1378_1mm";"SILVA (only NR);Eukaryota;Amorphea;Obazoa;Opisthokonta;Nucletmycea;Fungi;Mucoromycota;Glomeromycotina;Glomeromycetes;Diversisporales;Diversisporaceae;Redeckera;";"0.0";"0";"1";"1";"0";"1";"0";"430523";"5766"
"LOK1378_1mm";"SILVA (only NR);Eukaryota;Amorphea;Obazoa;Opisthokonta;Nucletmycea;Fungi;Mucoromycota;Glomeromycotina;Glomeromycetes;Diversisporales;Entrophospora;";"0.0";"0";"1";"1";"0";"1";"0";"430523";"5766"
"LOK1378_1mm";"SILVA (only NR);Eukaryota;Amorphea;Obazoa;Opisthokonta;Nucletmycea;Fungi;Mucoromycota;Glomeromycotina;Glomeromycetes;Diversisporales;Gigasporaceae;";"0.0";"0";"37";"37";"0";"37";"0";"430487";"5766"
"LOK1378_1mm";"SILVA (only NR);Eukaryota;Amorphea;Obazoa;Opisthokonta;Nucletmycea;Fungi;Mucoromycota;Glomeromycotina;Glomeromycetes;Diversisporales;Gigasporaceae;Cetraspora;";"0.0";"0";"2";"2";"0";"2";"0";"430522";"5766"
"LOK1378_1mm";"SILVA (only NR);Eukaryota;Amorphea;Obazoa;Opisthokonta;Nucletmycea;Fungi;Mucoromycota;Glomeromycotina;Glomeromycetes;Diversisporales;Gigasporaceae;Dentiscutata;";"0.0";"0";"4";"4";"0";"4";"0";"430520";"5766"
"LOK1378_1mm";"SILVA (only NR);Eukaryota;Amorphea;Obazoa;Opisthokonta;Nucletmycea;Fungi;Mucoromycota;Glomeromycotina;Glomeromycetes;Diversisporales;Gigasporaceae;Gigaspora;";"0.0";"0";"13";"13";"0";"13";"0";"430511";"5766"
"LOK1378_1mm";"SILVA (only NR);Eukaryota;Amorphea;Obazoa;Opisthokonta;Nucletmycea;Fungi;Mucoromycota;Glomeromycotina;Glomeromycetes;Diversisporales;Gigasporaceae;Racocetra;";"0.0";"0";"3";"3";"0";"3";"0";"430521";"5766"
"LOK1378_1mm";"SILVA (only NR);Eukaryota;Amorphea;Obazoa;Opisthokonta;Nucletmycea;Fungi;Mucoromycota;Glomeromycotina;Glomeromycetes;Diversisporales;Gigasporaceae;Scutellospora;";"0.0";"0";"14";"14";"0";"14";"0";"430510";"5766"
"LOK1378_1mm";"SILVA (only NR);Eukaryota;Amorphea;Obazoa;Opisthokonta;Nucletmycea;Fungi;Mucoromycota;Glomeromycotina;Glomeromycetes;Diversisporales;Pacispora;";"0.0";"0";"3";"3";"0";"3";"0";"430521";"5766"
"LOK1378_1mm";"SILVA (only NR);Eukaryota;Amorphea;Obazoa;Opisthokonta;Nucletmycea;Fungi;Mucoromycota;Glomeromycotina;Glomeromycetes;Diversisporales;Sacculosporaceae;";"0.0";"0";"3";"3";"0";"3";"0";"430521";"5766"
"LOK1378_1mm";"SILVA (only NR);Eukaryota;Amorphea;Obazoa;Opisthokonta;Nucletmycea;Fungi;Mucoromycota;Glomeromycotina;Glomeromycetes;Diversisporales;Sacculosporaceae;Sacculospora;";"0.0";"0";"3";"3";"0";"3";"0";"430521";"5766"
"LOK1378_1mm";"SILVA (only NR);Eukaryota;Amorphea;Obazoa;Opisthokonta;Nucletmycea;Fungi;Mucoromycota;Glomeromycotina;Glomeromycetes;Glomerales;";"0.0";"0";"257";"209";"0";"209";"48";"430315";"5766"
"LOK1378_1mm";"SILVA (only NR);Eukaryota;Amorphea;Obazoa;Opisthokonta;Nucletmycea;Fungi;Mucoromycota;Glomeromycotina;Glomeromycetes;Glomerales;Claroideoglomeraceae;";"0.0";"0";"11";"9";"0";"9";"2";"430515";"5766"
"LOK1378_1mm";"SILVA (only NR);Eukaryota;Amorphea;Obazoa;Opisthokonta;Nucletmycea;Fungi;Mucoromycota;Glomeromycotina;Glomeromycetes;Glomerales;Claroideoglomeraceae;Claroideoglomus;";"0.0";"0";"11";"9";"0";"9";"2";"430515";"5766"
"LOK1378_1mm";"SILVA (only NR);Eukaryota;Amorphea;Obazoa;Opisthokonta;Nucletmycea;Fungi;Mucoromycota;Glomeromycotina;Glomeromycetes;Glomerales;Glomeraceae;";"0.0";"0";"220";"186";"0";"186";"34";"430338";"5766"
"LOK1378_1mm";"SILVA (only NR);Eukaryota;Amorphea;Obazoa;Opisthokonta;Nucletmycea;Fungi;Mucoromycota;Glomeromycotina;Glomeromycetes;Glomerales;Glomeraceae;Funneliformis;";"0.0";"0";"13";"13";"0";"13";"0";"430511";"5766"
"LOK1378_1mm";"SILVA (only NR);Eukaryota;Amorphea;Obazoa;Opisthokonta;Nucletmycea;Fungi;Mucoromycota;Glomeromycotina;Glomeromycetes;Glomerales;Glomeraceae;Glomus;";"0.0";"0";"130";"110";"0";"110";"20";"430414";"5766"
"LOK1378_1mm";"SILVA (only NR);Eukaryota;Amorphea;Obazoa;Opisthokonta;Nucletmycea;Fungi;Mucoromycota;Glomeromycotina;Glomeromycetes;Glomerales;Glomeraceae;Rhizophagus;";"0.0";"0";"62";"55";"0";"55";"7";"430469";"5766"
"LOK1378_1mm";"SILVA (only NR);Eukaryota;Amorphea;Obazoa;Opisthokonta;Nucletmycea;Fungi;Mucoromycota;Glomeromycotina;Glomeromycetes;Glomerales;Glomeraceae;Sclerocystis;";"0.0";"0";"4";"3";"0";"3";"1";"430521";"5766"
"LOK1378_1mm";"SILVA (only NR);Eukaryota;Amorphea;Obazoa;Opisthokonta;Nucletmycea;Fungi;Mucoromycota;Glomeromycotina;Glomeromycetes;Glomerales;Glomeraceae;Septoglomus;";"0.0";"0";"9";"4";"0";"4";"5";"430520";"5766"
"LOK1378_1mm";"SILVA (only NR);Eukaryota;Amorphea;Obazoa;Opisthokonta;Nucletmycea;Fungi;Mucoromycota;Glomeromycotina;Glomeromycetes;Glomerales;uncultured;";"0.0";"0";"23";"11";"0";"11";"12";"430513";"5766"
"LOK1378_1mm";"SILVA (only NR);Eukaryota;Amorphea;Obazoa;Opisthokonta;Nucletmycea;Fungi;Mucoromycota;Glomeromycotina;Glomeromycetes;Paraglomerales;";"0.0";"0";"2";"2";"0";"2";"0";"430522";"5766"
"LOK1378_1mm";"SILVA (only NR);Eukaryota;Amorphea;Obazoa;Opisthokonta;Nucletmycea;Fungi;Mucoromycota;Glomeromycotina;Glomeromycetes;Paraglomerales;Paraglomeraceae;";"0.0";"0";"2";"2";"0";"2";"0";"430522";"5766"
"LOK1378_1mm";"SILVA (only NR);Eukaryota;Amorphea;Obazoa;Opisthokonta;Nucletmycea;Fungi;Mucoromycota;Glomeromycotina;Glomeromycetes;Paraglomerales;Paraglomeraceae;Paraglomus;";"0.0";"0";"2";"2";"0";"2";"0";"430522";"5766"
"LOK1378_1mm";"SILVA (only NR);Eukaryota;Amorphea;Obazoa;Opisthokonta;Nucletmycea;Fungi;Mucoromycota;Glomeromycotina;Glomeromycetes;uncultured;";"0.0";"0";"32";"16";"0";"16";"16";"430508";"5766"
"LOK1378_1mm";"SILVA (only NR);Eukaryota;Amorphea;Obazoa;Opisthokonta;Nucletmycea;Fungi;Mucoromycota;Mortierellomycotina;";"0.0";"0";"55";"49";"0";"49";"6";"430475";"5766"
"LOK1378_1mm";"SILVA (only NR);Eukaryota;Amorphea;Obazoa;Opisthokonta;Nucletmycea;Fungi;Mucoromycota;Mortierellomycotina;Incertae Sedis;";"0.0";"0";"55";"49";"0";"49";"6";"430475";"5766"
"LOK1378_1mm";"SILVA (only NR);Eukaryota;Amorphea;Obazoa;Opisthokonta;Nucletmycea;Fungi;Mucoromycota;Mortierellomycotina;Incertae Sedis;Mortierellales;";"0.0";"0";"55";"49";"0";"49";"6";"430475";"5766"
"LOK1378_1mm";"SILVA (only NR);Eukaryota;Amorphea;Obazoa;Opisthokonta;Nucletmycea;Fungi;Mucoromycota;Mortierellomycotina;Incertae Sedis;Mortierellales;Modicella;";"0.0";"0";"1";"0";"0";"0";"1";"430524";"5766"
"LOK1378_1mm";"SILVA (only NR);Eukaryota;Amorphea;Obazoa;Opisthokonta;Nucletmycea;Fungi;Mucoromycota;Mortierellomycotina;Incertae Sedis;Mortierellales;Mortierellaceae;";"0.0";"0";"45";"40";"0";"40";"5";"430484";"5766"
"LOK1378_1mm";"SILVA (only NR);Eukaryota;Amorphea;Obazoa;Opisthokonta;Nucletmycea;Fungi;Mucoromycota;Mortierellomycotina;Incertae Sedis;Mortierellales;Mortierellaceae;Mortierella;";"0.0";"0";"45";"40";"0";"40";"5";"430484";"5766"
"LOK1378_1mm";"SILVA (only NR);Eukaryota;Amorphea;Obazoa;Opisthokonta;Nucletmycea;Fungi;Mucoromycota;Mortierellomycotina;Incertae Sedis;Mortierellales;uncultured;";"0.0";"0";"5";"5";"0";"5";"0";"430519";"5766"
"LOK1378_1mm";"SILVA (only NR);Eukaryota;Amorphea;Obazoa;Opisthokonta;Nucletmycea;Fungi;Mucoromycota;Mucoromycotina;";"0.0";"0";"264";"252";"0";"252";"12";"430272";"5766"
"LOK1378_1mm";"SILVA (only NR);Eukaryota;Amorphea;Obazoa;Opisthokonta;Nucletmycea;Fungi;Mucoromycota;Mucoromycotina;Incertae Sedis;";"0.0";"0";"264";"252";"0";"252";"12";"430272";"5766"
"LOK1378_1mm";"SILVA (only NR);Eukaryota;Amorphea;Obazoa;Opisthokonta;Nucletmycea;Fungi;Mucoromycota;Mucoromycotina;Incertae Sedis;Endogonales;";"0.0";"0";"39";"36";"0";"36";"3";"430488";"5766"
"LOK1378_1mm";"SILVA (only NR);Eukaryota;Amorphea;Obazoa;Opisthokonta;Nucletmycea;Fungi;Mucoromycota;Mucoromycotina;Incertae Sedis;Endogonales;Endogonaceae;";"0.0";"0";"39";"36";"0";"36";"3";"430488";"5766"
"LOK1378_1mm";"SILVA (only NR);Eukaryota;Amorphea;Obazoa;Opisthokonta;Nucletmycea;Fungi;Mucoromycota;Mucoromycotina;Incertae Sedis;Endogonales;Endogonaceae;Endogone;";"0.0";"0";"22";"20";"0";"20";"2";"430504";"5766"
"LOK1378_1mm";"SILVA (only NR);Eukaryota;Amorphea;Obazoa;Opisthokonta;Nucletmycea;Fungi;Mucoromycota;Mucoromycotina;Incertae Sedis;Endogonales;Endogonaceae;uncultured;";"0.0";"0";"17";"16";"0";"16";"1";"430508";"5766"
"LOK1378_1mm";"SILVA (only NR);Eukaryota;Amorphea;Obazoa;Opisthokonta;Nucletmycea;Fungi;Mucoromycota;Mucoromycotina;Incertae Sedis;Mucorales;";"0.0";"0";"218";"210";"0";"210";"8";"430314";"5766"
"LOK1378_1mm";"SILVA (only NR);Eukaryota;Amorphea;Obazoa;Opisthokonta;Nucletmycea;Fungi;Mucoromycota;Mucoromycotina;Incertae Sedis;Mucorales;Apophysomyces;";"0.0";"0";"1";"1";"0";"1";"0";"430523";"5766"
"LOK1378_1mm";"SILVA (only NR);Eukaryota;Amorphea;Obazoa;Opisthokonta;Nucletmycea;Fungi;Mucoromycota;Mucoromycotina;Incertae Sedis;Mucorales;Backusellaceae;";"0.0";"0";"3";"3";"0";"3";"0";"430521";"5766"
"LOK1378_1mm";"SILVA (only NR);Eukaryota;Amorphea;Obazoa;Opisthokonta;Nucletmycea;Fungi;Mucoromycota;Mucoromycotina;Incertae Sedis;Mucorales;Backusellaceae;Backusella;";"0.0";"0";"3";"3";"0";"3";"0";"430521";"5766"
"LOK1378_1mm";"SILVA (only NR);Eukaryota;Amorphea;Obazoa;Opisthokonta;Nucletmycea;Fungi;Mucoromycota;Mucoromycotina;Incertae Sedis;Mucorales;Chaetocladiaceae;";"0.0";"0";"2";"2";"0";"2";"0";"430522";"5766"
"LOK1378_1mm";"SILVA (only NR);Eukaryota;Amorphea;Obazoa;Opisthokonta;Nucletmycea;Fungi;Mucoromycota;Mucoromycotina;Incertae Sedis;Mucorales;Chaetocladiaceae;Chaetocladium;";"0.0";"0";"2";"2";"0";"2";"0";"430522";"5766"
"LOK1378_1mm";"SILVA (only NR);Eukaryota;Amorphea;Obazoa;Opisthokonta;Nucletmycea;Fungi;Mucoromycota;Mucoromycotina;Incertae Sedis;Mucorales;Choanephoraceae;";"0.0";"0";"10";"10";"0";"10";"0";"430514";"5766"
"LOK1378_1mm";"SILVA (only NR);Eukaryota;Amorphea;Obazoa;Opisthokonta;Nucletmycea;Fungi;Mucoromycota;Mucoromycotina;Incertae Sedis;Mucorales;Choanephoraceae;Blakeslea;";"0.0";"0";"1";"1";"0";"1";"0";"430523";"5766"
"LOK1378_1mm";"SILVA (only NR);Eukaryota;Amorphea;Obazoa;Opisthokonta;Nucletmycea;Fungi;Mucoromycota;Mucoromycotina;Incertae Sedis;Mucorales;Choanephoraceae;Choanephora;";"0.0";"0";"1";"1";"0";"1";"0";"430523";"5766"
"LOK1378_1mm";"SILVA (only NR);Eukaryota;Amorphea;Obazoa;Opisthokonta;Nucletmycea;Fungi;Mucoromycota;Mucoromycotina;Incertae Sedis;Mucorales;Choanephoraceae;Gilbertella;";"0.0";"0";"1";"1";"0";"1";"0";"430523";"5766"
"LOK1378_1mm";"SILVA (only NR);Eukaryota;Amorphea;Obazoa;Opisthokonta;Nucletmycea;Fungi;Mucoromycota;Mucoromycotina;Incertae Sedis;Mucorales;Choanephoraceae;Poitrasia;";"0.0";"0";"1";"1";"0";"1";"0";"430523";"5766"
"LOK1378_1mm";"SILVA (only NR);Eukaryota;Amorphea;Obazoa;Opisthokonta;Nucletmycea;Fungi;Mucoromycota;Mucoromycotina;Incertae Sedis;Mucorales;Choanephoraceae;uncultured;";"0.0";"0";"6";"6";"0";"6";"0";"430518";"5766"
"LOK1378_1mm";"SILVA (only NR);Eukaryota;Amorphea;Obazoa;Opisthokonta;Nucletmycea;Fungi;Mucoromycota;Mucoromycotina;Incertae Sedis;Mucorales;Cunninghamellaceae;";"0.0";"0";"25";"22";"0";"22";"3";"430502";"5766"
"LOK1378_1mm";"SILVA (only NR);Eukaryota;Amorphea;Obazoa;Opisthokonta;Nucletmycea;Fungi;Mucoromycota;Mucoromycotina;Incertae Sedis;Mucorales;Cunninghamellaceae;Absidia;";"0.0";"0";"10";"9";"0";"9";"1";"430515";"5766"
"LOK1378_1mm";"SILVA (only NR);Eukaryota;Amorphea;Obazoa;Opisthokonta;Nucletmycea;Fungi;Mucoromycota;Mucoromycotina;Incertae Sedis;Mucorales;Cunninghamellaceae;Chlamydoabsidia;";"0.0";"0";"2";"1";"0";"1";"1";"430523";"5766"
"LOK1378_1mm";"SILVA (only NR);Eukaryota;Amorphea;Obazoa;Opisthokonta;Nucletmycea;Fungi;Mucoromycota;Mucoromycotina;Incertae Sedis;Mucorales;Cunninghamellaceae;Cunninghamella;";"0.0";"0";"4";"4";"0";"4";"0";"430520";"5766"
"LOK1378_1mm";"SILVA (only NR);Eukaryota;Amorphea;Obazoa;Opisthokonta;Nucletmycea;Fungi;Mucoromycota;Mucoromycotina;Incertae Sedis;Mucorales;Cunninghamellaceae;Gongronella;";"0.0";"0";"4";"3";"0";"3";"1";"430521";"5766"
"LOK1378_1mm";"SILVA (only NR);Eukaryota;Amorphea;Obazoa;Opisthokonta;Nucletmycea;Fungi;Mucoromycota;Mucoromycotina;Incertae Sedis;Mucorales;Cunninghamellaceae;Halteromyces;";"0.0";"0";"1";"1";"0";"1";"0";"430523";"5766"
"LOK1378_1mm";"SILVA (only NR);Eukaryota;Amorphea;Obazoa;Opisthokonta;Nucletmycea;Fungi;Mucoromycota;Mucoromycotina;Incertae Sedis;Mucorales;Cunninghamellaceae;Hesseltinella;";"0.0";"0";"3";"3";"0";"3";"0";"430521";"5766"
"LOK1378_1mm";"SILVA (only NR);Eukaryota;Amorphea;Obazoa;Opisthokonta;Nucletmycea;Fungi;Mucoromycota;Mucoromycotina;Incertae Sedis;Mucorales;Kirkomyces;";"0.0";"0";"1";"1";"0";"1";"0";"430523";"5766"
"LOK1378_1mm";"SILVA (only NR);Eukaryota;Amorphea;Obazoa;Opisthokonta;Nucletmycea;Fungi;Mucoromycota;Mucoromycotina;Incertae Sedis;Mucorales;Lichtheimiaceae;";"0.0";"0";"28";"28";"0";"28";"0";"430496";"5766"
"LOK1378_1mm";"SILVA (only NR);Eukaryota;Amorphea;Obazoa;Opisthokonta;Nucletmycea;Fungi;Mucoromycota;Mucoromycotina;Incertae Sedis;Mucorales;Lichtheimiaceae;Circinella;";"0.0";"0";"7";"7";"0";"7";"0";"430517";"5766"
"LOK1378_1mm";"SILVA (only NR);Eukaryota;Amorphea;Obazoa;Opisthokonta;Nucletmycea;Fungi;Mucoromycota;Mucoromycotina;Incertae Sedis;Mucorales;Lichtheimiaceae;Dichotomocladium;";"0.0";"0";"1";"1";"0";"1";"0";"430523";"5766"
"LOK1378_1mm";"SILVA (only NR);Eukaryota;Amorphea;Obazoa;Opisthokonta;Nucletmycea;Fungi;Mucoromycota;Mucoromycotina;Incertae Sedis;Mucorales;Lichtheimiaceae;Fennellomyces;";"0.0";"0";"1";"1";"0";"1";"0";"430523";"5766"
"LOK1378_1mm";"SILVA (only NR);Eukaryota;Amorphea;Obazoa;Opisthokonta;Nucletmycea;Fungi;Mucoromycota;Mucoromycotina;Incertae Sedis;Mucorales;Lichtheimiaceae;Lichtheimia;";"0.0";"0";"4";"4";"0";"4";"0";"430520";"5766"
"LOK1378_1mm";"SILVA (only NR);Eukaryota;Amorphea;Obazoa;Opisthokonta;Nucletmycea;Fungi;Mucoromycota;Mucoromycotina;Incertae Sedis;Mucorales;Lichtheimiaceae;Phascolomyces;";"0.0";"0";"1";"1";"0";"1";"0";"430523";"5766"
"LOK1378_1mm";"SILVA (only NR);Eukaryota;Amorphea;Obazoa;Opisthokonta;Nucletmycea;Fungi;Mucoromycota;Mucoromycotina;Incertae Sedis;Mucorales;Lichtheimiaceae;Rhizomucor;";"0.0";"0";"7";"7";"0";"7";"0";"430517";"5766"
"LOK1378_1mm";"SILVA (only NR);Eukaryota;Amorphea;Obazoa;Opisthokonta;Nucletmycea;Fungi;Mucoromycota;Mucoromycotina;Incertae Sedis;Mucorales;Lichtheimiaceae;Thamnostylum;";"0.0";"0";"4";"4";"0";"4";"0";"430520";"5766"
"LOK1378_1mm";"SILVA (only NR);Eukaryota;Amorphea;Obazoa;Opisthokonta;Nucletmycea;Fungi;Mucoromycota;Mucoromycotina;Incertae Sedis;Mucorales;Lichtheimiaceae;Thermomucor;";"0.0";"0";"1";"1";"0";"1";"0";"430523";"5766"
"LOK1378_1mm";"SILVA (only NR);Eukaryota;Amorphea;Obazoa;Opisthokonta;Nucletmycea;Fungi;Mucoromycota;Mucoromycotina;Incertae Sedis;Mucorales;Lichtheimiaceae;Zychaea;";"0.0";"0";"1";"1";"0";"1";"0";"430523";"5766"
"LOK1378_1mm";"SILVA (only NR);Eukaryota;Amorphea;Obazoa;Opisthokonta;Nucletmycea;Fungi;Mucoromycota;Mucoromycotina;Incertae Sedis;Mucorales;Mucoraceae;";"0.0";"0";"70";"68";"0";"68";"2";"430456";"5766"
"LOK1378_1mm";"SILVA (only NR);Eukaryota;Amorphea;Obazoa;Opisthokonta;Nucletmycea;Fungi;Mucoromycota;Mucoromycotina;Incertae Sedis;Mucorales;Mucoraceae;Actinomucor;";"0.0";"0";"1";"1";"0";"1";"0";"430523";"5766"
"LOK1378_1mm";"SILVA (only NR);Eukaryota;Amorphea;Obazoa;Opisthokonta;Nucletmycea;Fungi;Mucoromycota;Mucoromycotina;Incertae Sedis;Mucorales;Mucoraceae;Ambomucor;";"0.0";"0";"1";"1";"0";"1";"0";"430523";"5766"
"LOK1378_1mm";"SILVA (only NR);Eukaryota;Amorphea;Obazoa;Opisthokonta;Nucletmycea;Fungi;Mucoromycota;Mucoromycotina;Incertae Sedis;Mucorales;Mucoraceae;Benjaminiella;";"0.0";"0";"1";"1";"0";"1";"0";"430523";"5766"
"LOK1378_1mm";"SILVA (only NR);Eukaryota;Amorphea;Obazoa;Opisthokonta;Nucletmycea;Fungi;Mucoromycota;Mucoromycotina;Incertae Sedis;Mucorales;Mucoraceae;Circinomucor;";"0.0";"0";"1";"1";"0";"1";"0";"430523";"5766"
"LOK1378_1mm";"SILVA (only NR);Eukaryota;Amorphea;Obazoa;Opisthokonta;Nucletmycea;Fungi;Mucoromycota;Mucoromycotina;Incertae Sedis;Mucorales;Mucoraceae;Cokeromyces;";"0.0";"0";"2";"2";"0";"2";"0";"430522";"5766"
"LOK1378_1mm";"SILVA (only NR);Eukaryota;Amorphea;Obazoa;Opisthokonta;Nucletmycea;Fungi;Mucoromycota;Mucoromycotina;Incertae Sedis;Mucorales;Mucoraceae;Dicranophora;";"0.0";"0";"1";"1";"0";"1";"0";"430523";"5766"
"LOK1378_1mm";"SILVA (only NR);Eukaryota;Amorphea;Obazoa;Opisthokonta;Nucletmycea;Fungi;Mucoromycota;Mucoromycotina;Incertae Sedis;Mucorales;Mucoraceae;Ellisomyces;";"0.0";"0";"1";"1";"0";"1";"0";"430523";"5766"
"LOK1378_1mm";"SILVA (only NR);Eukaryota;Amorphea;Obazoa;Opisthokonta;Nucletmycea;Fungi;Mucoromycota;Mucoromycotina;Incertae Sedis;Mucorales;Mucoraceae;Hyphomucor;";"0.0";"0";"1";"1";"0";"1";"0";"430523";"5766"
"LOK1378_1mm";"SILVA (only NR);Eukaryota;Amorphea;Obazoa;Opisthokonta;Nucletmycea;Fungi;Mucoromycota;Mucoromycotina;Incertae Sedis;Mucorales;Mucoraceae;Mucor;";"0.0";"0";"52";"50";"0";"50";"2";"430474";"5766"
"LOK1378_1mm";"SILVA (only NR);Eukaryota;Amorphea;Obazoa;Opisthokonta;Nucletmycea;Fungi;Mucoromycota;Mucoromycotina;Incertae Sedis;Mucorales;Mucoraceae;Parasitella;";"0.0";"0";"3";"3";"0";"3";"0";"430521";"5766"
"LOK1378_1mm";"SILVA (only NR);Eukaryota;Amorphea;Obazoa;Opisthokonta;Nucletmycea;Fungi;Mucoromycota;Mucoromycotina;Incertae Sedis;Mucorales;Mucoraceae;Pilaira;";"0.0";"0";"3";"3";"0";"3";"0";"430521";"5766"
"LOK1378_1mm";"SILVA (only NR);Eukaryota;Amorphea;Obazoa;Opisthokonta;Nucletmycea;Fungi;Mucoromycota;Mucoromycotina;Incertae Sedis;Mucorales;Mucoraceae;Pirella;";"0.0";"0";"1";"1";"0";"1";"0";"430523";"5766"
"LOK1378_1mm";"SILVA (only NR);Eukaryota;Amorphea;Obazoa;Opisthokonta;Nucletmycea;Fungi;Mucoromycota;Mucoromycotina;Incertae Sedis;Mucorales;Mucoraceae;Thamnidium;";"0.0";"0";"1";"1";"0";"1";"0";"430523";"5766"
"LOK1378_1mm";"SILVA (only NR);Eukaryota;Amorphea;Obazoa;Opisthokonta;Nucletmycea;Fungi;Mucoromycota;Mucoromycotina;Incertae Sedis;Mucorales;Mycotyphaceae;";"0.0";"0";"3";"3";"0";"3";"0";"430521";"5766"
"LOK1378_1mm";"SILVA (only NR);Eukaryota;Amorphea;Obazoa;Opisthokonta;Nucletmycea;Fungi;Mucoromycota;Mucoromycotina;Incertae Sedis;Mucorales;Mycotyphaceae;Mycotypha;";"0.0";"0";"3";"3";"0";"3";"0";"430521";"5766"
"LOK1378_1mm";"SILVA (only NR);Eukaryota;Amorphea;Obazoa;Opisthokonta;Nucletmycea;Fungi;Mucoromycota;Mucoromycotina;Incertae Sedis;Mucorales;Phycomycetaceae;";"0.0";"0";"3";"3";"0";"3";"0";"430521";"5766"
"LOK1378_1mm";"SILVA (only NR);Eukaryota;Amorphea;Obazoa;Opisthokonta;Nucletmycea;Fungi;Mucoromycota;Mucoromycotina;Incertae Sedis;Mucorales;Phycomycetaceae;Phycomyces;";"0.0";"0";"2";"2";"0";"2";"0";"430522";"5766"
"LOK1378_1mm";"SILVA (only NR);Eukaryota;Amorphea;Obazoa;Opisthokonta;Nucletmycea;Fungi;Mucoromycota;Mucoromycotina;Incertae Sedis;Mucorales;Phycomycetaceae;Spinellus;";"0.0";"0";"1";"1";"0";"1";"0";"430523";"5766"
"LOK1378_1mm";"SILVA (only NR);Eukaryota;Amorphea;Obazoa;Opisthokonta;Nucletmycea;Fungi;Mucoromycota;Mucoromycotina;Incertae Sedis;Mucorales;Pilobolaceae;";"0.0";"0";"17";"17";"0";"17";"0";"430507";"5766"
"LOK1378_1mm";"SILVA (only NR);Eukaryota;Amorphea;Obazoa;Opisthokonta;Nucletmycea;Fungi;Mucoromycota;Mucoromycotina;Incertae Sedis;Mucorales;Pilobolaceae;Pilobolus;";"0.0";"0";"14";"14";"0";"14";"0";"430510";"5766"
"LOK1378_1mm";"SILVA (only NR);Eukaryota;Amorphea;Obazoa;Opisthokonta;Nucletmycea;Fungi;Mucoromycota;Mucoromycotina;Incertae Sedis;Mucorales;Pilobolaceae;Utharomyces;";"0.0";"0";"3";"3";"0";"3";"0";"430521";"5766"
"LOK1378_1mm";"SILVA (only NR);Eukaryota;Amorphea;Obazoa;Opisthokonta;Nucletmycea;Fungi;Mucoromycota;Mucoromycotina;Incertae Sedis;Mucorales;Protomycocladus;";"0.0";"0";"1";"1";"0";"1";"0";"430523";"5766"
"LOK1378_1mm";"SILVA (only NR);Eukaryota;Amorphea;Obazoa;Opisthokonta;Nucletmycea;Fungi;Mucoromycota;Mucoromycotina;Incertae Sedis;Mucorales;Radiomyces;";"0.0";"0";"1";"1";"0";"1";"0";"430523";"5766"
"LOK1378_1mm";"SILVA (only NR);Eukaryota;Amorphea;Obazoa;Opisthokonta;Nucletmycea;Fungi;Mucoromycota;Mucoromycotina;Incertae Sedis;Mucorales;Rhizopodaceae;";"0.0";"0";"45";"43";"0";"43";"2";"430481";"5766"
"LOK1378_1mm";"SILVA (only NR);Eukaryota;Amorphea;Obazoa;Opisthokonta;Nucletmycea;Fungi;Mucoromycota;Mucoromycotina;Incertae Sedis;Mucorales;Rhizopodaceae;Amylomyces;";"0.0";"0";"4";"2";"0";"2";"2";"430522";"5766"
"LOK1378_1mm";"SILVA (only NR);Eukaryota;Amorphea;Obazoa;Opisthokonta;Nucletmycea;Fungi;Mucoromycota;Mucoromycotina;Incertae Sedis;Mucorales;Rhizopodaceae;Rhizopus;";"0.0";"0";"39";"39";"0";"39";"0";"430485";"5766"
"LOK1378_1mm";"SILVA (only NR);Eukaryota;Amorphea;Obazoa;Opisthokonta;Nucletmycea;Fungi;Mucoromycota;Mucoromycotina;Incertae Sedis;Mucorales;Rhizopodaceae;Sporodiniella;";"0.0";"0";"1";"1";"0";"1";"0";"430523";"5766"
"LOK1378_1mm";"SILVA (only NR);Eukaryota;Amorphea;Obazoa;Opisthokonta;Nucletmycea;Fungi;Mucoromycota;Mucoromycotina;Incertae Sedis;Mucorales;Rhizopodaceae;Syzygites;";"0.0";"0";"1";"1";"0";"1";"0";"430523";"5766"
"LOK1378_1mm";"SILVA (only NR);Eukaryota;Amorphea;Obazoa;Opisthokonta;Nucletmycea;Fungi;Mucoromycota;Mucoromycotina;Incertae Sedis;Mucorales;Saksenaea;";"0.0";"0";"1";"1";"0";"1";"0";"430523";"5766"
"LOK1378_1mm";"SILVA (only NR);Eukaryota;Amorphea;Obazoa;Opisthokonta;Nucletmycea;Fungi;Mucoromycota;Mucoromycotina;Incertae Sedis;Mucorales;Syncephalastraceae;";"0.0";"0";"4";"4";"0";"4";"0";"430520";"5766"
"LOK1378_1mm";"SILVA (only NR);Eukaryota;Amorphea;Obazoa;Opisthokonta;Nucletmycea;Fungi;Mucoromycota;Mucoromycotina;Incertae Sedis;Mucorales;Syncephalastraceae;Syncephalastrum;";"0.0";"0";"4";"4";"0";"4";"0";"430520";"5766"
"LOK1378_1mm";"SILVA (only NR);Eukaryota;Amorphea;Obazoa;Opisthokonta;Nucletmycea;Fungi;Mucoromycota;Mucoromycotina;Incertae Sedis;Umbelopsidales;";"0.0";"0";"4";"4";"0";"4";"0";"430520";"5766"
"LOK1378_1mm";"SILVA (only NR);Eukaryota;Amorphea;Obazoa;Opisthokonta;Nucletmycea;Fungi;Mucoromycota;Mucoromycotina;Incertae Sedis;Umbelopsidales;Umbelopsidaceae;";"0.0";"0";"4";"4";"0";"4";"0";"430520";"5766"
"LOK1378_1mm";"SILVA (only NR);Eukaryota;Amorphea;Obazoa;Opisthokonta;Nucletmycea;Fungi;Mucoromycota;Mucoromycotina;Incertae Sedis;Umbelopsidales;Umbelopsidaceae;Umbelopsis;";"0.0";"0";"4";"4";"0";"4";"0";"430520";"5766"
"LOK1378_1mm";"SILVA (only NR);Eukaryota;Amorphea;Obazoa;Opisthokonta;Nucletmycea;Fungi;Neocallimastigomycota;";"0.0";"0";"21";"17";"0";"17";"4";"430507";"5766"
"LOK1378_1mm";"SILVA (only NR);Eukaryota;Amorphea;Obazoa;Opisthokonta;Nucletmycea;Fungi;Neocallimastigomycota;Incertae Sedis;";"0.0";"0";"21";"17";"0";"17";"4";"430507";"5766"
"LOK1378_1mm";"SILVA (only NR);Eukaryota;Amorphea;Obazoa;Opisthokonta;Nucletmycea;Fungi;Neocallimastigomycota;Incertae Sedis;Neocallimastigomycetes;";"0.0";"0";"21";"17";"0";"17";"4";"430507";"5766"
"LOK1378_1mm";"SILVA (only NR);Eukaryota;Amorphea;Obazoa;Opisthokonta;Nucletmycea;Fungi;Neocallimastigomycota;Incertae Sedis;Neocallimastigomycetes;Neocallimastigales;";"0.0";"0";"21";"17";"0";"17";"4";"430507";"5766"
"LOK1378_1mm";"SILVA (only NR);Eukaryota;Amorphea;Obazoa;Opisthokonta;Nucletmycea;Fungi;Neocallimastigomycota;Incertae Sedis;Neocallimastigomycetes;Neocallimastigales;Neocallimastigaceae;";"0.0";"0";"21";"17";"0";"17";"4";"430507";"5766"
"LOK1378_1mm";"SILVA (only NR);Eukaryota;Amorphea;Obazoa;Opisthokonta;Nucletmycea;Fungi;Neocallimastigomycota;Incertae Sedis;Neocallimastigomycetes;Neocallimastigales;Neocallimastigaceae;Cyllamyces;";"0.0";"0";"2";"2";"0";"2";"0";"430522";"5766"
"LOK1378_1mm";"SILVA (only NR);Eukaryota;Amorphea;Obazoa;Opisthokonta;Nucletmycea;Fungi;Neocallimastigomycota;Incertae Sedis;Neocallimastigomycetes;Neocallimastigales;Neocallimastigaceae;Neocallimastix;";"0.0";"0";"2";"2";"0";"2";"0";"430522";"5766"
"LOK1378_1mm";"SILVA (only NR);Eukaryota;Amorphea;Obazoa;Opisthokonta;Nucletmycea;Fungi;Neocallimastigomycota;Incertae Sedis;Neocallimastigomycetes;Neocallimastigales;Neocallimastigaceae;Pecoramyces;";"0.0";"0";"5";"2";"0";"2";"3";"430522";"5766"
"LOK1378_1mm";"SILVA (only NR);Eukaryota;Amorphea;Obazoa;Opisthokonta;Nucletmycea;Fungi;Neocallimastigomycota;Incertae Sedis;Neocallimastigomycetes;Neocallimastigales;Neocallimastigaceae;Piromyces;";"0.0";"0";"1";"1";"0";"1";"0";"430523";"5766"
"LOK1378_1mm";"SILVA (only NR);Eukaryota;Amorphea;Obazoa;Opisthokonta;Nucletmycea;Fungi;Neocallimastigomycota;Incertae Sedis;Neocallimastigomycetes;Neocallimastigales;Neocallimastigaceae;uncultured;";"0.0";"0";"4";"3";"0";"3";"1";"430521";"5766"
"LOK1378_1mm";"SILVA (only NR);Eukaryota;Amorphea;Obazoa;Opisthokonta;Nucletmycea;Fungi;Zoopagomycota;";"0.0";"0";"209";"188";"0";"188";"21";"430336";"5766"
"LOK1378_1mm";"SILVA (only NR);Eukaryota;Amorphea;Obazoa;Opisthokonta;Nucletmycea;Fungi;Zoopagomycota;Entomophthoromycotina;";"0.0";"0";"52";"49";"0";"49";"3";"430475";"5766"
"LOK1378_1mm";"SILVA (only NR);Eukaryota;Amorphea;Obazoa;Opisthokonta;Nucletmycea;Fungi;Zoopagomycota;Entomophthoromycotina;Basidiobolomycetes;";"0.0";"0";"7";"7";"0";"7";"0";"430517";"5766"
"LOK1378_1mm";"SILVA (only NR);Eukaryota;Amorphea;Obazoa;Opisthokonta;Nucletmycea;Fungi;Zoopagomycota;Entomophthoromycotina;Basidiobolomycetes;Basidiobolales;";"0.0";"0";"7";"7";"0";"7";"0";"430517";"5766"
"LOK1378_1mm";"SILVA (only NR);Eukaryota;Amorphea;Obazoa;Opisthokonta;Nucletmycea;Fungi;Zoopagomycota;Entomophthoromycotina;Basidiobolomycetes;Basidiobolales;Basidiobolaceae;";"0.0";"0";"7";"7";"0";"7";"0";"430517";"5766"
"LOK1378_1mm";"SILVA (only NR);Eukaryota;Amorphea;Obazoa;Opisthokonta;Nucletmycea;Fungi;Zoopagomycota;Entomophthoromycotina;Basidiobolomycetes;Basidiobolales;Basidiobolaceae;Basidiobolus;";"0.0";"0";"6";"6";"0";"6";"0";"430518";"5766"
"LOK1378_1mm";"SILVA (only NR);Eukaryota;Amorphea;Obazoa;Opisthokonta;Nucletmycea;Fungi;Zoopagomycota;Entomophthoromycotina;Basidiobolomycetes;Basidiobolales;Basidiobolaceae;Schizangiella;";"0.0";"0";"1";"1";"0";"1";"0";"430523";"5766"
"LOK1378_1mm";"SILVA (only NR);Eukaryota;Amorphea;Obazoa;Opisthokonta;Nucletmycea;Fungi;Zoopagomycota;Entomophthoromycotina;Entomophthoromycetes;";"0.0";"0";"45";"42";"0";"42";"3";"430482";"5766"
"LOK1378_1mm";"SILVA (only NR);Eukaryota;Amorphea;Obazoa;Opisthokonta;Nucletmycea;Fungi;Zoopagomycota;Entomophthoromycotina;Entomophthoromycetes;Entomophthorales;";"0.0";"0";"45";"42";"0";"42";"3";"430482";"5766"
"LOK1378_1mm";"SILVA (only NR);Eukaryota;Amorphea;Obazoa;Opisthokonta;Nucletmycea;Fungi;Zoopagomycota;Entomophthoromycotina;Entomophthoromycetes;Entomophthorales;Ancylistaceae;";"0.0";"0";"13";"11";"0";"11";"2";"430513";"5766"
"LOK1378_1mm";"SILVA (only NR);Eukaryota;Amorphea;Obazoa;Opisthokonta;Nucletmycea;Fungi;Zoopagomycota;Entomophthoromycotina;Entomophthoromycetes;Entomophthorales;Ancylistaceae;Conidiobolus;";"0.0";"0";"13";"11";"0";"11";"2";"430513";"5766"
"LOK1378_1mm";"SILVA (only NR);Eukaryota;Amorphea;Obazoa;Opisthokonta;Nucletmycea;Fungi;Zoopagomycota;Entomophthoromycotina;Entomophthoromycetes;Entomophthorales;Entomophthoraceae;";"0.0";"0";"28";"28";"0";"28";"0";"430496";"5766"
"LOK1378_1mm";"SILVA (only NR);Eukaryota;Amorphea;Obazoa;Opisthokonta;Nucletmycea;Fungi;Zoopagomycota;Entomophthoromycotina;Entomophthoromycetes;Entomophthorales;Entomophthoraceae;Entomophaga;";"0.0";"0";"1";"1";"0";"1";"0";"430523";"5766"
"LOK1378_1mm";"SILVA (only NR);Eukaryota;Amorphea;Obazoa;Opisthokonta;Nucletmycea;Fungi;Zoopagomycota;Entomophthoromycotina;Entomophthoromycetes;Entomophthorales;Entomophthoraceae;Entomophthora;";"0.0";"0";"6";"6";"0";"6";"0";"430518";"5766"
"LOK1378_1mm";"SILVA (only NR);Eukaryota;Amorphea;Obazoa;Opisthokonta;Nucletmycea;Fungi;Zoopagomycota;Entomophthoromycotina;Entomophthoromycetes;Entomophthorales;Entomophthoraceae;Erynia;";"0.0";"0";"3";"3";"0";"3";"0";"430521";"5766"
"LOK1378_1mm";"SILVA (only NR);Eukaryota;Amorphea;Obazoa;Opisthokonta;Nucletmycea;Fungi;Zoopagomycota;Entomophthoromycotina;Entomophthoromycetes;Entomophthorales;Entomophthoraceae;Eryniopsis;";"0.0";"0";"2";"2";"0";"2";"0";"430522";"5766"
"LOK1378_1mm";"SILVA (only NR);Eukaryota;Amorphea;Obazoa;Opisthokonta;Nucletmycea;Fungi;Zoopagomycota;Entomophthoromycotina;Entomophthoromycetes;Entomophthorales;Entomophthoraceae;Furia;";"0.0";"0";"3";"3";"0";"3";"0";"430521";"5766"
"LOK1378_1mm";"SILVA (only NR);Eukaryota;Amorphea;Obazoa;Opisthokonta;Nucletmycea;Fungi;Zoopagomycota;Entomophthoromycotina;Entomophthoromycetes;Entomophthorales;Entomophthoraceae;Pandora;";"0.0";"0";"5";"5";"0";"5";"0";"430519";"5766"
"LOK1378_1mm";"SILVA (only NR);Eukaryota;Amorphea;Obazoa;Opisthokonta;Nucletmycea;Fungi;Zoopagomycota;Entomophthoromycotina;Entomophthoromycetes;Entomophthorales;Entomophthoraceae;Strongwellsea;";"0.0";"0";"1";"1";"0";"1";"0";"430523";"5766"
"LOK1378_1mm";"SILVA (only NR);Eukaryota;Amorphea;Obazoa;Opisthokonta;Nucletmycea;Fungi;Zoopagomycota;Entomophthoromycotina;Entomophthoromycetes;Entomophthorales;Entomophthoraceae;Zoophthora;";"0.0";"0";"6";"6";"0";"6";"0";"430518";"5766"
"LOK1378_1mm";"SILVA (only NR);Eukaryota;Amorphea;Obazoa;Opisthokonta;Nucletmycea;Fungi;Zoopagomycota;Entomophthoromycotina;Entomophthoromycetes;Entomophthorales;uncultured;";"0.0";"0";"4";"3";"0";"3";"1";"430521";"5766"
"LOK1378_1mm";"SILVA (only NR);Eukaryota;Amorphea;Obazoa;Opisthokonta;Nucletmycea;Fungi;Zoopagomycota;Kickxellomycotina;";"0.0";"0";"127";"112";"0";"112";"15";"430412";"5766"
"LOK1378_1mm";"SILVA (only NR);Eukaryota;Amorphea;Obazoa;Opisthokonta;Nucletmycea;Fungi;Zoopagomycota;Kickxellomycotina;Incertae Sedis;";"0.0";"0";"127";"112";"0";"112";"15";"430412";"5766"
"LOK1378_1mm";"SILVA (only NR);Eukaryota;Amorphea;Obazoa;Opisthokonta;Nucletmycea;Fungi;Zoopagomycota;Kickxellomycotina;Incertae Sedis;Harpellales;";"0.0";"0";"89";"74";"0";"74";"15";"430450";"5766"
"LOK1378_1mm";"SILVA (only NR);Eukaryota;Amorphea;Obazoa;Opisthokonta;Nucletmycea;Fungi;Zoopagomycota;Kickxellomycotina;Incertae Sedis;Harpellales;Furculomyces;";"0.0";"0";"2";"2";"0";"2";"0";"430522";"5766"
"LOK1378_1mm";"SILVA (only NR);Eukaryota;Amorphea;Obazoa;Opisthokonta;Nucletmycea;Fungi;Zoopagomycota;Kickxellomycotina;Incertae Sedis;Harpellales;Harpellaceae;";"0.0";"0";"9";"7";"0";"7";"2";"430517";"5766"
"LOK1378_1mm";"SILVA (only NR);Eukaryota;Amorphea;Obazoa;Opisthokonta;Nucletmycea;Fungi;Zoopagomycota;Kickxellomycotina;Incertae Sedis;Harpellales;Harpellaceae;Harpella;";"0.0";"0";"4";"2";"0";"2";"2";"430522";"5766"
"LOK1378_1mm";"SILVA (only NR);Eukaryota;Amorphea;Obazoa;Opisthokonta;Nucletmycea;Fungi;Zoopagomycota;Kickxellomycotina;Incertae Sedis;Harpellales;Harpellaceae;Legeriomyces;";"0.0";"0";"1";"1";"0";"1";"0";"430523";"5766"
"LOK1378_1mm";"SILVA (only NR);Eukaryota;Amorphea;Obazoa;Opisthokonta;Nucletmycea;Fungi;Zoopagomycota;Kickxellomycotina;Incertae Sedis;Harpellales;Harpellaceae;Stachylina;";"0.0";"0";"1";"1";"0";"1";"0";"430523";"5766"
"LOK1378_1mm";"SILVA (only NR);Eukaryota;Amorphea;Obazoa;Opisthokonta;Nucletmycea;Fungi;Zoopagomycota;Kickxellomycotina;Incertae Sedis;Harpellales;Legeriomycetaceae;";"0.0";"0";"76";"63";"0";"63";"13";"430461";"5766"
"LOK1378_1mm";"SILVA (only NR);Eukaryota;Amorphea;Obazoa;Opisthokonta;Nucletmycea;Fungi;Zoopagomycota;Kickxellomycotina;Incertae Sedis;Harpellales;Legeriomycetaceae;Barbatospora;";"0.0";"0";"1";"1";"0";"1";"0";"430523";"5766"
"LOK1378_1mm";"SILVA (only NR);Eukaryota;Amorphea;Obazoa;Opisthokonta;Nucletmycea;Fungi;Zoopagomycota;Kickxellomycotina;Incertae Sedis;Harpellales;Legeriomycetaceae;Bojamyces;";"0.0";"0";"1";"0";"0";"0";"1";"430524";"5766"
"LOK1378_1mm";"SILVA (only NR);Eukaryota;Amorphea;Obazoa;Opisthokonta;Nucletmycea;Fungi;Zoopagomycota;Kickxellomycotina;Incertae Sedis;Harpellales;Legeriomycetaceae;Capniomyces;";"0.0";"0";"2";"2";"0";"2";"0";"430522";"5766"
"LOK1378_1mm";"SILVA (only NR);Eukaryota;Amorphea;Obazoa;Opisthokonta;Nucletmycea;Fungi;Zoopagomycota;Kickxellomycotina;Incertae Sedis;Harpellales;Legeriomycetaceae;Coleopteromyces;";"0.0";"0";"1";"1";"0";"1";"0";"430523";"5766"
"LOK1378_1mm";"SILVA (only NR);Eukaryota;Amorphea;Obazoa;Opisthokonta;Nucletmycea;Fungi;Zoopagomycota;Kickxellomycotina;Incertae Sedis;Harpellales;Legeriomycetaceae;Genistelloides;";"0.0";"0";"5";"1";"0";"1";"4";"430523";"5766"
"LOK1378_1mm";"SILVA (only NR);Eukaryota;Amorphea;Obazoa;Opisthokonta;Nucletmycea;Fungi;Zoopagomycota;Kickxellomycotina;Incertae Sedis;Harpellales;Legeriomycetaceae;Genistellospora;";"0.0";"0";"1";"0";"0";"0";"1";"430524";"5766"
"LOK1378_1mm";"SILVA (only NR);Eukaryota;Amorphea;Obazoa;Opisthokonta;Nucletmycea;Fungi;Zoopagomycota;Kickxellomycotina;Incertae Sedis;Harpellales;Legeriomycetaceae;Graminella;";"0.0";"0";"1";"1";"0";"1";"0";"430523";"5766"
"LOK1378_1mm";"SILVA (only NR);Eukaryota;Amorphea;Obazoa;Opisthokonta;Nucletmycea;Fungi;Zoopagomycota;Kickxellomycotina;Incertae Sedis;Harpellales;Legeriomycetaceae;Lancisporomyces;";"0.0";"0";"2";"2";"0";"2";"0";"430522";"5766"
"LOK1378_1mm";"SILVA (only NR);Eukaryota;Amorphea;Obazoa;Opisthokonta;Nucletmycea;Fungi;Zoopagomycota;Kickxellomycotina;Incertae Sedis;Harpellales;Legeriomycetaceae;Legerioides;";"0.0";"0";"1";"1";"0";"1";"0";"430523";"5766"
"LOK1378_1mm";"SILVA (only NR);Eukaryota;Amorphea;Obazoa;Opisthokonta;Nucletmycea;Fungi;Zoopagomycota;Kickxellomycotina;Incertae Sedis;Harpellales;Legeriomycetaceae;Orphella;";"0.0";"0";"5";"3";"0";"3";"2";"430521";"5766"
"LOK1378_1mm";"SILVA (only NR);Eukaryota;Amorphea;Obazoa;Opisthokonta;Nucletmycea;Fungi;Zoopagomycota;Kickxellomycotina;Incertae Sedis;Harpellales;Legeriomycetaceae;Pennella;";"0.0";"0";"1";"0";"0";"0";"1";"430524";"5766"
"LOK1378_1mm";"SILVA (only NR);Eukaryota;Amorphea;Obazoa;Opisthokonta;Nucletmycea;Fungi;Zoopagomycota;Kickxellomycotina;Incertae Sedis;Harpellales;Legeriomycetaceae;Plecopteromyces;";"0.0";"0";"3";"1";"0";"1";"2";"430523";"5766"
"LOK1378_1mm";"SILVA (only NR);Eukaryota;Amorphea;Obazoa;Opisthokonta;Nucletmycea;Fungi;Zoopagomycota;Kickxellomycotina;Incertae Sedis;Harpellales;Legeriomycetaceae;Pteromaktron;";"0.0";"0";"1";"1";"0";"1";"0";"430523";"5766"
"LOK1378_1mm";"SILVA (only NR);Eukaryota;Amorphea;Obazoa;Opisthokonta;Nucletmycea;Fungi;Zoopagomycota;Kickxellomycotina;Incertae Sedis;Harpellales;Legeriomycetaceae;Smittium;";"0.0";"0";"39";"37";"0";"37";"2";"430487";"5766"
"LOK1378_1mm";"SILVA (only NR);Eukaryota;Amorphea;Obazoa;Opisthokonta;Nucletmycea;Fungi;Zoopagomycota;Kickxellomycotina;Incertae Sedis;Harpellales;Legeriomycetaceae;Spartiella;";"0.0";"0";"1";"1";"0";"1";"0";"430523";"5766"
"LOK1378_1mm";"SILVA (only NR);Eukaryota;Amorphea;Obazoa;Opisthokonta;Nucletmycea;Fungi;Zoopagomycota;Kickxellomycotina;Incertae Sedis;Harpellales;Legeriomycetaceae;Zancudomyces;";"0.0";"0";"3";"3";"0";"3";"0";"430521";"5766"
"LOK1378_1mm";"SILVA (only NR);Eukaryota;Amorphea;Obazoa;Opisthokonta;Nucletmycea;Fungi;Zoopagomycota;Kickxellomycotina;Incertae Sedis;Harpellales;Legeriomycetaceae;Zygopolaris;";"0.0";"0";"1";"1";"0";"1";"0";"430523";"5766"
"LOK1378_1mm";"SILVA (only NR);Eukaryota;Amorphea;Obazoa;Opisthokonta;Nucletmycea;Fungi;Zoopagomycota;Kickxellomycotina;Incertae Sedis;Harpellales;Pseudoharpella;";"0.0";"0";"1";"1";"0";"1";"0";"430523";"5766"
"LOK1378_1mm";"SILVA (only NR);Eukaryota;Amorphea;Obazoa;Opisthokonta;Nucletmycea;Fungi;Zoopagomycota;Kickxellomycotina;Incertae Sedis;Kickxellales;";"0.0";"0";"34";"34";"0";"34";"0";"430490";"5766"
"LOK1378_1mm";"SILVA (only NR);Eukaryota;Amorphea;Obazoa;Opisthokonta;Nucletmycea;Fungi;Zoopagomycota;Kickxellomycotina;Incertae Sedis;Kickxellales;Kickxellaceae;";"0.0";"0";"34";"34";"0";"34";"0";"430490";"5766"
"LOK1378_1mm";"SILVA (only NR);Eukaryota;Amorphea;Obazoa;Opisthokonta;Nucletmycea;Fungi;Zoopagomycota;Kickxellomycotina;Incertae Sedis;Kickxellales;Kickxellaceae;Coemansia;";"0.0";"0";"16";"16";"0";"16";"0";"430508";"5766"
"LOK1378_1mm";"SILVA (only NR);Eukaryota;Amorphea;Obazoa;Opisthokonta;Nucletmycea;Fungi;Zoopagomycota;Kickxellomycotina;Incertae Sedis;Kickxellales;Kickxellaceae;Dipsacomyces;";"0.0";"0";"1";"1";"0";"1";"0";"430523";"5766"
"LOK1378_1mm";"SILVA (only NR);Eukaryota;Amorphea;Obazoa;Opisthokonta;Nucletmycea;Fungi;Zoopagomycota;Kickxellomycotina;Incertae Sedis;Kickxellales;Kickxellaceae;Kickxella;";"0.0";"0";"1";"1";"0";"1";"0";"430523";"5766"
"LOK1378_1mm";"SILVA (only NR);Eukaryota;Amorphea;Obazoa;Opisthokonta;Nucletmycea;Fungi;Zoopagomycota;Kickxellomycotina;Incertae Sedis;Kickxellales;Kickxellaceae;Linderina;";"0.0";"0";"4";"4";"0";"4";"0";"430520";"5766"
"LOK1378_1mm";"SILVA (only NR);Eukaryota;Amorphea;Obazoa;Opisthokonta;Nucletmycea;Fungi;Zoopagomycota;Kickxellomycotina;Incertae Sedis;Kickxellales;Kickxellaceae;Martensiomyces;";"0.0";"0";"1";"1";"0";"1";"0";"430523";"5766"
"LOK1378_1mm";"SILVA (only NR);Eukaryota;Amorphea;Obazoa;Opisthokonta;Nucletmycea;Fungi;Zoopagomycota;Kickxellomycotina;Incertae Sedis;Kickxellales;Kickxellaceae;Mycoemilia;";"0.0";"0";"1";"1";"0";"1";"0";"430523";"5766"
"LOK1378_1mm";"SILVA (only NR);Eukaryota;Amorphea;Obazoa;Opisthokonta;Nucletmycea;Fungi;Zoopagomycota;Kickxellomycotina;Incertae Sedis;Kickxellales;Kickxellaceae;Myconymphaea;";"0.0";"0";"1";"1";"0";"1";"0";"430523";"5766"
"LOK1378_1mm";"SILVA (only NR);Eukaryota;Amorphea;Obazoa;Opisthokonta;Nucletmycea;Fungi;Zoopagomycota;Kickxellomycotina;Incertae Sedis;Kickxellales;Kickxellaceae;Pinnaticoemansia;";"0.0";"0";"1";"1";"0";"1";"0";"430523";"5766"
"LOK1378_1mm";"SILVA (only NR);Eukaryota;Amorphea;Obazoa;Opisthokonta;Nucletmycea;Fungi;Zoopagomycota;Kickxellomycotina;Incertae Sedis;Kickxellales;Kickxellaceae;Ramicandelaber;";"0.0";"0";"4";"4";"0";"4";"0";"430520";"5766"
"LOK1378_1mm";"SILVA (only NR);Eukaryota;Amorphea;Obazoa;Opisthokonta;Nucletmycea;Fungi;Zoopagomycota;Kickxellomycotina;Incertae Sedis;Kickxellales;Kickxellaceae;Spirodactylon;";"0.0";"0";"1";"1";"0";"1";"0";"430523";"5766"
"LOK1378_1mm";"SILVA (only NR);Eukaryota;Amorphea;Obazoa;Opisthokonta;Nucletmycea;Fungi;Zoopagomycota;Kickxellomycotina;Incertae Sedis;Kickxellales;Kickxellaceae;Spiromyces;";"0.0";"0";"2";"2";"0";"2";"0";"430522";"5766"
"LOK1378_1mm";"SILVA (only NR);Eukaryota;Amorphea;Obazoa;Opisthokonta;Nucletmycea;Fungi;Zoopagomycota;Zoopagomycotina;";"0.0";"0";"29";"26";"0";"26";"3";"430498";"5766"
"LOK1378_1mm";"SILVA (only NR);Eukaryota;Amorphea;Obazoa;Opisthokonta;Nucletmycea;Fungi;Zoopagomycota;Zoopagomycotina;Incertae Sedis;";"0.0";"0";"29";"26";"0";"26";"3";"430498";"5766"
"LOK1378_1mm";"SILVA (only NR);Eukaryota;Amorphea;Obazoa;Opisthokonta;Nucletmycea;Fungi;Zoopagomycota;Zoopagomycotina;Incertae Sedis;Zoopagales;";"0.0";"0";"29";"26";"0";"26";"3";"430498";"5766"
"LOK1378_1mm";"SILVA (only NR);Eukaryota;Amorphea;Obazoa;Opisthokonta;Nucletmycea;Fungi;Zoopagomycota;Zoopagomycotina;Incertae Sedis;Zoopagales;Acaulopage;";"0.0";"0";"3";"2";"0";"2";"1";"430522";"5766"
"LOK1378_1mm";"SILVA (only NR);Eukaryota;Amorphea;Obazoa;Opisthokonta;Nucletmycea;Fungi;Zoopagomycota;Zoopagomycotina;Incertae Sedis;Zoopagales;Cochlonema;";"0.0";"0";"1";"1";"0";"1";"0";"430523";"5766"
"LOK1378_1mm";"SILVA (only NR);Eukaryota;Amorphea;Obazoa;Opisthokonta;Nucletmycea;Fungi;Zoopagomycota;Zoopagomycotina;Incertae Sedis;Zoopagales;Kuzuhaea;";"0.0";"0";"1";"1";"0";"1";"0";"430523";"5766"
"LOK1378_1mm";"SILVA (only NR);Eukaryota;Amorphea;Obazoa;Opisthokonta;Nucletmycea;Fungi;Zoopagomycota;Zoopagomycotina;Incertae Sedis;Zoopagales;Piptocephalidaceae;";"0.0";"0";"6";"6";"0";"6";"0";"430518";"5766"
"LOK1378_1mm";"SILVA (only NR);Eukaryota;Amorphea;Obazoa;Opisthokonta;Nucletmycea;Fungi;Zoopagomycota;Zoopagomycotina;Incertae Sedis;Zoopagales;Piptocephalidaceae;Piptocephalis;";"0.0";"0";"6";"6";"0";"6";"0";"430518";"5766"
"LOK1378_1mm";"SILVA (only NR);Eukaryota;Amorphea;Obazoa;Opisthokonta;Nucletmycea;Fungi;Zoopagomycota;Zoopagomycotina;Incertae Sedis;Zoopagales;Rhopalomyces;";"0.0";"0";"1";"1";"0";"1";"0";"430523";"5766"
"LOK1378_1mm";"SILVA (only NR);Eukaryota;Amorphea;Obazoa;Opisthokonta;Nucletmycea;Fungi;Zoopagomycota;Zoopagomycotina;Incertae Sedis;Zoopagales;Sigmoideomycetaceae;";"0.0";"0";"1";"1";"0";"1";"0";"430523";"5766"
"LOK1378_1mm";"SILVA (only NR);Eukaryota;Amorphea;Obazoa;Opisthokonta;Nucletmycea;Fungi;Zoopagomycota;Zoopagomycotina;Incertae Sedis;Zoopagales;Sigmoideomycetaceae;Thamnocephalis;";"0.0";"0";"1";"1";"0";"1";"0";"430523";"5766"
"LOK1378_1mm";"SILVA (only NR);Eukaryota;Amorphea;Obazoa;Opisthokonta;Nucletmycea;Fungi;Zoopagomycota;Zoopagomycotina;Incertae Sedis;Zoopagales;Stylopage;";"0.0";"0";"1";"0";"0";"0";"1";"430524";"5766"
"LOK1378_1mm";"SILVA (only NR);Eukaryota;Amorphea;Obazoa;Opisthokonta;Nucletmycea;Fungi;Zoopagomycota;Zoopagomycotina;Incertae Sedis;Zoopagales;Syncephalis;";"0.0";"0";"1";"1";"0";"1";"0";"430523";"5766"
"LOK1378_1mm";"SILVA (only NR);Eukaryota;Amorphea;Obazoa;Opisthokonta;Nucletmycea;Fungi;Zoopagomycota;Zoopagomycotina;Incertae Sedis;Zoopagales;Zoophagus;";"0.0";"0";"1";"1";"0";"1";"0";"430523";"5766"
"LOK1378_1mm";"SILVA (only NR);Eukaryota;Amorphea;Obazoa;Opisthokonta;Nucletmycea;Fungi;uncultured;";"0.0";"0";"27";"26";"0";"26";"1";"430498";"5766"
"LOK1378_1mm";"SILVA (only NR);Eukaryota;Amorphea;Obazoa;Opisthokonta;Nucletmycea;Nucleariidae and Fonticula group;";"0.0";"0";"29";"27";"0";"27";"2";"430497";"5766"
"LOK1378_1mm";"SILVA (only NR);Eukaryota;Amorphea;Obazoa;Opisthokonta;Nucletmycea;Nucleariidae and Fonticula group;Fonticula;";"0.0";"0";"1";"1";"0";"1";"0";"430523";"5766"
"LOK1378_1mm";"SILVA (only NR);Eukaryota;Amorphea;Obazoa;Opisthokonta;Nucletmycea;Nucleariidae and Fonticula group;Nucleariidae;";"0.0";"0";"28";"26";"0";"26";"2";"430498";"5766"
"LOK1378_1mm";"SILVA (only NR);Eukaryota;Amorphea;Obazoa;Opisthokonta;Nucletmycea;Nucleariidae and Fonticula group;Nucleariidae;Nuclearia;";"0.0";"0";"28";"26";"0";"26";"2";"430498";"5766"
"LOK1378_1mm";"SILVA (only NR);Eukaryota;Archaeplastida;";"0.0";"0";"7535";"7104";"0";"7104";"431";"423420";"5766"
"LOK1378_1mm";"SILVA (only NR);Eukaryota;Archaeplastida;Chloroplastida;";"0.0";"0";"6646";"6224";"0";"6224";"422";"424300";"5766"
"LOK1378_1mm";"SILVA (only NR);Eukaryota;Archaeplastida;Chloroplastida;Charophyta;";"0.0";"0";"4738";"4411";"0";"4411";"327";"426113";"5766"
"LOK1378_1mm";"SILVA (only NR);Eukaryota;Archaeplastida;Chloroplastida;Charophyta;Amb-18S-504;";"0.0";"0";"7";"7";"0";"7";"0";"430517";"5766"
"LOK1378_1mm";"SILVA (only NR);Eukaryota;Archaeplastida;Chloroplastida;Charophyta;Chlorokybophyceae;";"0.0";"0";"1";"1";"0";"1";"0";"430523";"5766"
"LOK1378_1mm";"SILVA (only NR);Eukaryota;Archaeplastida;Chloroplastida;Charophyta;Chlorokybophyceae;Chlorokybus;";"0.0";"0";"1";"1";"0";"1";"0";"430523";"5766"
"LOK1378_1mm";"SILVA (only NR);Eukaryota;Archaeplastida;Chloroplastida;Charophyta;Klebsormidiophyceae;";"0.0";"0";"8";"8";"0";"8";"0";"430516";"5766"
"LOK1378_1mm";"SILVA (only NR);Eukaryota;Archaeplastida;Chloroplastida;Charophyta;Klebsormidiophyceae;Klebsormidiales;";"0.0";"0";"5";"5";"0";"5";"0";"430519";"5766"
"LOK1378_1mm";"SILVA (only NR);Eukaryota;Archaeplastida;Chloroplastida;Charophyta;Klebsormidiophyceae;Klebsormidiales;Entransia;";"0.0";"0";"1";"1";"0";"1";"0";"430523";"5766"
"LOK1378_1mm";"SILVA (only NR);Eukaryota;Archaeplastida;Chloroplastida;Charophyta;Klebsormidiophyceae;Klebsormidiales;Hormidiella;";"0.0";"0";"1";"1";"0";"1";"0";"430523";"5766"
"LOK1378_1mm";"SILVA (only NR);Eukaryota;Archaeplastida;Chloroplastida;Charophyta;Klebsormidiophyceae;Klebsormidiales;Klebsormidium;";"0.0";"0";"3";"3";"0";"3";"0";"430521";"5766"
"LOK1378_1mm";"SILVA (only NR);Eukaryota;Archaeplastida;Chloroplastida;Charophyta;Mesostigmatophyceae;";"0.0";"0";"1";"1";"0";"1";"0";"430523";"5766"
"LOK1378_1mm";"SILVA (only NR);Eukaryota;Archaeplastida;Chloroplastida;Charophyta;Mesostigmatophyceae;Mesostigma;";"0.0";"0";"1";"1";"0";"1";"0";"430523";"5766"
"LOK1378_1mm";"SILVA (only NR);Eukaryota;Archaeplastida;Chloroplastida;Charophyta;Phragmoplastophyta;";"0.0";"0";"4720";"4393";"0";"4393";"327";"426131";"5766"
"LOK1378_1mm";"SILVA (only NR);Eukaryota;Archaeplastida;Chloroplastida;Charophyta;Phragmoplastophyta;Coleochaetophyceae;";"0.0";"0";"12";"12";"0";"12";"0";"430512";"5766"
"LOK1378_1mm";"SILVA (only NR);Eukaryota;Archaeplastida;Chloroplastida;Charophyta;Phragmoplastophyta;Coleochaetophyceae;Chaetosphaeridiales;";"0.0";"0";"6";"6";"0";"6";"0";"430518";"5766"
"LOK1378_1mm";"SILVA (only NR);Eukaryota;Archaeplastida;Chloroplastida;Charophyta;Phragmoplastophyta;Coleochaetophyceae;Chaetosphaeridiales;Chaetosphaeridium;";"0.0";"0";"6";"6";"0";"6";"0";"430518";"5766"
"LOK1378_1mm";"SILVA (only NR);Eukaryota;Archaeplastida;Chloroplastida;Charophyta;Phragmoplastophyta;Coleochaetophyceae;Coleochaete;";"0.0";"0";"6";"6";"0";"6";"0";"430518";"5766"
"LOK1378_1mm";"SILVA (only NR);Eukaryota;Archaeplastida;Chloroplastida;Charophyta;Phragmoplastophyta;Streptophyta;";"0.0";"0";"4538";"4211";"0";"4211";"327";"426313";"5766"
"LOK1378_1mm";"SILVA (only NR);Eukaryota;Archaeplastida;Chloroplastida;Charophyta;Phragmoplastophyta;Streptophyta;Charophyceae;";"0.0";"0";"36";"36";"0";"36";"0";"430488";"5766"
"LOK1378_1mm";"SILVA (only NR);Eukaryota;Archaeplastida;Chloroplastida;Charophyta;Phragmoplastophyta;Streptophyta;Charophyceae;Charales;";"0.0";"0";"36";"36";"0";"36";"0";"430488";"5766"
"LOK1378_1mm";"SILVA (only NR);Eukaryota;Archaeplastida;Chloroplastida;Charophyta;Phragmoplastophyta;Streptophyta;Charophyceae;Charales;Chara;";"0.0";"0";"28";"28";"0";"28";"0";"430496";"5766"
"LOK1378_1mm";"SILVA (only NR);Eukaryota;Archaeplastida;Chloroplastida;Charophyta;Phragmoplastophyta;Streptophyta;Charophyceae;Charales;Lychnothamnus;";"0.0";"0";"1";"1";"0";"1";"0";"430523";"5766"
"LOK1378_1mm";"SILVA (only NR);Eukaryota;Archaeplastida;Chloroplastida;Charophyta;Phragmoplastophyta;Streptophyta;Charophyceae;Charales;Nitellaceae;";"0.0";"0";"6";"6";"0";"6";"0";"430518";"5766"
"LOK1378_1mm";"SILVA (only NR);Eukaryota;Archaeplastida;Chloroplastida;Charophyta;Phragmoplastophyta;Streptophyta;Charophyceae;Charales;Nitellaceae;Nitella;";"0.0";"0";"4";"4";"0";"4";"0";"430520";"5766"
"LOK1378_1mm";"SILVA (only NR);Eukaryota;Archaeplastida;Chloroplastida;Charophyta;Phragmoplastophyta;Streptophyta;Charophyceae;Charales;Nitellaceae;Tolypella;";"0.0";"0";"2";"2";"0";"2";"0";"430522";"5766"
"LOK1378_1mm";"SILVA (only NR);Eukaryota;Archaeplastida;Chloroplastida;Charophyta;Phragmoplastophyta;Streptophyta;Charophyceae;Charales;Nitellopsis;";"0.0";"0";"1";"1";"0";"1";"0";"430523";"5766"
"LOK1378_1mm";"SILVA (only NR);Eukaryota;Archaeplastida;Chloroplastida;Charophyta;Phragmoplastophyta;Streptophyta;Embryophyta;";"0.0";"0";"4502";"4175";"0";"4175";"327";"426349";"5766"
"LOK1378_1mm";"SILVA (only NR);Eukaryota;Archaeplastida;Chloroplastida;Charophyta;Phragmoplastophyta;Streptophyta;Embryophyta;Anthocerotophyta;";"0.0";"0";"13";"13";"0";"13";"0";"430511";"5766"
"LOK1378_1mm";"SILVA (only NR);Eukaryota;Archaeplastida;Chloroplastida;Charophyta;Phragmoplastophyta;Streptophyta;Embryophyta;Anthocerotophyta;Anthocerotales;";"0.0";"0";"2";"2";"0";"2";"0";"430522";"5766"
"LOK1378_1mm";"SILVA (only NR);Eukaryota;Archaeplastida;Chloroplastida;Charophyta;Phragmoplastophyta;Streptophyta;Embryophyta;Anthocerotophyta;Anthocerotales;Anthoceros;";"0.0";"0";"1";"1";"0";"1";"0";"430523";"5766"
"LOK1378_1mm";"SILVA (only NR);Eukaryota;Archaeplastida;Chloroplastida;Charophyta;Phragmoplastophyta;Streptophyta;Embryophyta;Anthocerotophyta;Anthocerotales;Folioceros;";"0.0";"0";"1";"1";"0";"1";"0";"430523";"5766"
"LOK1378_1mm";"SILVA (only NR);Eukaryota;Archaeplastida;Chloroplastida;Charophyta;Phragmoplastophyta;Streptophyta;Embryophyta;Anthocerotophyta;Dendrocerotales;";"0.0";"0";"7";"7";"0";"7";"0";"430517";"5766"
"LOK1378_1mm";"SILVA (only NR);Eukaryota;Archaeplastida;Chloroplastida;Charophyta;Phragmoplastophyta;Streptophyta;Embryophyta;Anthocerotophyta;Dendrocerotales;Megaceros;";"0.0";"0";"2";"2";"0";"2";"0";"430522";"5766"
"LOK1378_1mm";"SILVA (only NR);Eukaryota;Archaeplastida;Chloroplastida;Charophyta;Phragmoplastophyta;Streptophyta;Embryophyta;Anthocerotophyta;Dendrocerotales;Nothoceros;";"0.0";"0";"3";"3";"0";"3";"0";"430521";"5766"
"LOK1378_1mm";"SILVA (only NR);Eukaryota;Archaeplastida;Chloroplastida;Charophyta;Phragmoplastophyta;Streptophyta;Embryophyta;Anthocerotophyta;Dendrocerotales;Phaeomegaceros;";"0.0";"0";"2";"2";"0";"2";"0";"430522";"5766"
"LOK1378_1mm";"SILVA (only NR);Eukaryota;Archaeplastida;Chloroplastida;Charophyta;Phragmoplastophyta;Streptophyta;Embryophyta;Anthocerotophyta;Notothyladales;";"0.0";"0";"3";"3";"0";"3";"0";"430521";"5766"
"LOK1378_1mm";"SILVA (only NR);Eukaryota;Archaeplastida;Chloroplastida;Charophyta;Phragmoplastophyta;Streptophyta;Embryophyta;Anthocerotophyta;Notothyladales;Notothylas;";"0.0";"0";"1";"1";"0";"1";"0";"430523";"5766"
"LOK1378_1mm";"SILVA (only NR);Eukaryota;Archaeplastida;Chloroplastida;Charophyta;Phragmoplastophyta;Streptophyta;Embryophyta;Anthocerotophyta;Notothyladales;Phaeoceros;";"0.0";"0";"2";"2";"0";"2";"0";"430522";"5766"
"LOK1378_1mm";"SILVA (only NR);Eukaryota;Archaeplastida;Chloroplastida;Charophyta;Phragmoplastophyta;Streptophyta;Embryophyta;Anthocerotophyta;Phymatocerotales;";"0.0";"0";"1";"1";"0";"1";"0";"430523";"5766"
"LOK1378_1mm";"SILVA (only NR);Eukaryota;Archaeplastida;Chloroplastida;Charophyta;Phragmoplastophyta;Streptophyta;Embryophyta;Anthocerotophyta;Phymatocerotales;Phymatoceros;";"0.0";"0";"1";"1";"0";"1";"0";"430523";"5766"
"LOK1378_1mm";"SILVA (only NR);Eukaryota;Archaeplastida;Chloroplastida;Charophyta;Phragmoplastophyta;Streptophyta;Embryophyta;Bryophyta;";"0.0";"0";"93";"91";"0";"91";"2";"430433";"5766"
"LOK1378_1mm";"SILVA (only NR);Eukaryota;Archaeplastida;Chloroplastida;Charophyta;Phragmoplastophyta;Streptophyta;Embryophyta;Bryophyta;Andreaeales;";"0.0";"0";"2";"2";"0";"2";"0";"430522";"5766"
"LOK1378_1mm";"SILVA (only NR);Eukaryota;Archaeplastida;Chloroplastida;Charophyta;Phragmoplastophyta;Streptophyta;Embryophyta;Bryophyta;Andreaeales;Andreaeaceae;";"0.0";"0";"2";"2";"0";"2";"0";"430522";"5766"
"LOK1378_1mm";"SILVA (only NR);Eukaryota;Archaeplastida;Chloroplastida;Charophyta;Phragmoplastophyta;Streptophyta;Embryophyta;Bryophyta;Andreaeales;Andreaeaceae;Andreaea;";"0.0";"0";"2";"2";"0";"2";"0";"430522";"5766"
"LOK1378_1mm";"SILVA (only NR);Eukaryota;Archaeplastida;Chloroplastida;Charophyta;Phragmoplastophyta;Streptophyta;Embryophyta;Bryophyta;Bryales;";"0.0";"0";"13";"13";"0";"13";"0";"430511";"5766"
"LOK1378_1mm";"SILVA (only NR);Eukaryota;Archaeplastida;Chloroplastida;Charophyta;Phragmoplastophyta;Streptophyta;Embryophyta;Bryophyta;Bryales;Bryum;";"0.0";"0";"1";"1";"0";"1";"0";"430523";"5766"
"LOK1378_1mm";"SILVA (only NR);Eukaryota;Archaeplastida;Chloroplastida;Charophyta;Phragmoplastophyta;Streptophyta;Embryophyta;Bryophyta;Bryales;Cinclidium;";"0.0";"0";"1";"1";"0";"1";"0";"430523";"5766"
"LOK1378_1mm";"SILVA (only NR);Eukaryota;Archaeplastida;Chloroplastida;Charophyta;Phragmoplastophyta;Streptophyta;Embryophyta;Bryophyta;Bryales;Leptostomum;";"0.0";"0";"1";"1";"0";"1";"0";"430523";"5766"
"LOK1378_1mm";"SILVA (only NR);Eukaryota;Archaeplastida;Chloroplastida;Charophyta;Phragmoplastophyta;Streptophyta;Embryophyta;Bryophyta;Bryales;Leucolepis;";"0.0";"0";"1";"1";"0";"1";"0";"430523";"5766"
"LOK1378_1mm";"SILVA (only NR);Eukaryota;Archaeplastida;Chloroplastida;Charophyta;Phragmoplastophyta;Streptophyta;Embryophyta;Bryophyta;Bryales;Mielichhoferia;";"0.0";"0";"1";"1";"0";"1";"0";"430523";"5766"
"LOK1378_1mm";"SILVA (only NR);Eukaryota;Archaeplastida;Chloroplastida;Charophyta;Phragmoplastophyta;Streptophyta;Embryophyta;Bryophyta;Bryales;Mnium;";"0.0";"0";"1";"1";"0";"1";"0";"430523";"5766"
"LOK1378_1mm";"SILVA (only NR);Eukaryota;Archaeplastida;Chloroplastida;Charophyta;Phragmoplastophyta;Streptophyta;Embryophyta;Bryophyta;Bryales;Plagiobryoides;";"0.0";"0";"1";"1";"0";"1";"0";"430523";"5766"
"LOK1378_1mm";"SILVA (only NR);Eukaryota;Archaeplastida;Chloroplastida;Charophyta;Phragmoplastophyta;Streptophyta;Embryophyta;Bryophyta;Bryales;Plagiomnium;";"0.0";"0";"1";"1";"0";"1";"0";"430523";"5766"
"LOK1378_1mm";"SILVA (only NR);Eukaryota;Archaeplastida;Chloroplastida;Charophyta;Phragmoplastophyta;Streptophyta;Embryophyta;Bryophyta;Bryales;Pohlia;";"0.0";"0";"2";"2";"0";"2";"0";"430522";"5766"
"LOK1378_1mm";"SILVA (only NR);Eukaryota;Archaeplastida;Chloroplastida;Charophyta;Phragmoplastophyta;Streptophyta;Embryophyta;Bryophyta;Bryales;Rosulabryum;";"0.0";"0";"1";"1";"0";"1";"0";"430523";"5766"
"LOK1378_1mm";"SILVA (only NR);Eukaryota;Archaeplastida;Chloroplastida;Charophyta;Phragmoplastophyta;Streptophyta;Embryophyta;Bryophyta;Bryales;Scouleria;";"0.0";"0";"1";"1";"0";"1";"0";"430523";"5766"
"LOK1378_1mm";"SILVA (only NR);Eukaryota;Archaeplastida;Chloroplastida;Charophyta;Phragmoplastophyta;Streptophyta;Embryophyta;Bryophyta;Bryoxiphiales;";"0.0";"0";"1";"1";"0";"1";"0";"430523";"5766"
"LOK1378_1mm";"SILVA (only NR);Eukaryota;Archaeplastida;Chloroplastida;Charophyta;Phragmoplastophyta;Streptophyta;Embryophyta;Bryophyta;Bryoxiphiales;Bryoxiphium;";"0.0";"0";"1";"1";"0";"1";"0";"430523";"5766"
"LOK1378_1mm";"SILVA (only NR);Eukaryota;Archaeplastida;Chloroplastida;Charophyta;Phragmoplastophyta;Streptophyta;Embryophyta;Bryophyta;Dicranales;";"0.0";"0";"7";"6";"0";"6";"1";"430518";"5766"
"LOK1378_1mm";"SILVA (only NR);Eukaryota;Archaeplastida;Chloroplastida;Charophyta;Phragmoplastophyta;Streptophyta;Embryophyta;Bryophyta;Dicranales;Archidium;";"0.0";"0";"1";"1";"0";"1";"0";"430523";"5766"
"LOK1378_1mm";"SILVA (only NR);Eukaryota;Archaeplastida;Chloroplastida;Charophyta;Phragmoplastophyta;Streptophyta;Embryophyta;Bryophyta;Dicranales;Calymperes;";"0.0";"0";"1";"1";"0";"1";"0";"430523";"5766"
"LOK1378_1mm";"SILVA (only NR);Eukaryota;Archaeplastida;Chloroplastida;Charophyta;Phragmoplastophyta;Streptophyta;Embryophyta;Bryophyta;Dicranales;Fissidens;";"0.0";"0";"2";"2";"0";"2";"0";"430522";"5766"
"LOK1378_1mm";"SILVA (only NR);Eukaryota;Archaeplastida;Chloroplastida;Charophyta;Phragmoplastophyta;Streptophyta;Embryophyta;Bryophyta;Dicranales;Leucobryum;";"0.0";"0";"1";"1";"0";"1";"0";"430523";"5766"
"LOK1378_1mm";"SILVA (only NR);Eukaryota;Archaeplastida;Chloroplastida;Charophyta;Phragmoplastophyta;Streptophyta;Embryophyta;Bryophyta;Dicranales;Micromitrium;";"0.0";"0";"1";"0";"0";"0";"1";"430524";"5766"
"LOK1378_1mm";"SILVA (only NR);Eukaryota;Archaeplastida;Chloroplastida;Charophyta;Phragmoplastophyta;Streptophyta;Embryophyta;Bryophyta;Dicranales;Syrrhopodon;";"0.0";"0";"1";"1";"0";"1";"0";"430523";"5766"
"LOK1378_1mm";"SILVA (only NR);Eukaryota;Archaeplastida;Chloroplastida;Charophyta;Phragmoplastophyta;Streptophyta;Embryophyta;Bryophyta;Diphysciales;";"0.0";"0";"1";"1";"0";"1";"0";"430523";"5766"
"LOK1378_1mm";"SILVA (only NR);Eukaryota;Archaeplastida;Chloroplastida;Charophyta;Phragmoplastophyta;Streptophyta;Embryophyta;Bryophyta;Diphysciales;Theriotia;";"0.0";"0";"1";"1";"0";"1";"0";"430523";"5766"
"LOK1378_1mm";"SILVA (only NR);Eukaryota;Archaeplastida;Chloroplastida;Charophyta;Phragmoplastophyta;Streptophyta;Embryophyta;Bryophyta;Encalyptales;";"0.0";"0";"5";"5";"0";"5";"0";"430519";"5766"
"LOK1378_1mm";"SILVA (only NR);Eukaryota;Archaeplastida;Chloroplastida;Charophyta;Phragmoplastophyta;Streptophyta;Embryophyta;Bryophyta;Encalyptales;Bryobrittonia;";"0.0";"0";"1";"1";"0";"1";"0";"430523";"5766"
"LOK1378_1mm";"SILVA (only NR);Eukaryota;Archaeplastida;Chloroplastida;Charophyta;Phragmoplastophyta;Streptophyta;Embryophyta;Bryophyta;Encalyptales;Encalyptaceae;";"0.0";"0";"4";"4";"0";"4";"0";"430520";"5766"
"LOK1378_1mm";"SILVA (only NR);Eukaryota;Archaeplastida;Chloroplastida;Charophyta;Phragmoplastophyta;Streptophyta;Embryophyta;Bryophyta;Encalyptales;Encalyptaceae;Encalypta;";"0.0";"0";"4";"4";"0";"4";"0";"430520";"5766"
"LOK1378_1mm";"SILVA (only NR);Eukaryota;Archaeplastida;Chloroplastida;Charophyta;Phragmoplastophyta;Streptophyta;Embryophyta;Bryophyta;Eurhynchium;";"0.0";"0";"1";"1";"0";"1";"0";"430523";"5766"
"LOK1378_1mm";"SILVA (only NR);Eukaryota;Archaeplastida;Chloroplastida;Charophyta;Phragmoplastophyta;Streptophyta;Embryophyta;Bryophyta;Funariales;";"0.0";"0";"5";"5";"0";"5";"0";"430519";"5766"
"LOK1378_1mm";"SILVA (only NR);Eukaryota;Archaeplastida;Chloroplastida;Charophyta;Phragmoplastophyta;Streptophyta;Embryophyta;Bryophyta;Funariales;Aphanorrhegma;";"0.0";"0";"1";"1";"0";"1";"0";"430523";"5766"
"LOK1378_1mm";"SILVA (only NR);Eukaryota;Archaeplastida;Chloroplastida;Charophyta;Phragmoplastophyta;Streptophyta;Embryophyta;Bryophyta;Funariales;Chamaebryum;";"0.0";"0";"1";"1";"0";"1";"0";"430523";"5766"
"LOK1378_1mm";"SILVA (only NR);Eukaryota;Archaeplastida;Chloroplastida;Charophyta;Phragmoplastophyta;Streptophyta;Embryophyta;Bryophyta;Funariales;Physcomitrella;";"0.0";"0";"2";"2";"0";"2";"0";"430522";"5766"
"LOK1378_1mm";"SILVA (only NR);Eukaryota;Archaeplastida;Chloroplastida;Charophyta;Phragmoplastophyta;Streptophyta;Embryophyta;Bryophyta;Funariales;Physcomitrium;";"0.0";"0";"1";"1";"0";"1";"0";"430523";"5766"
"LOK1378_1mm";"SILVA (only NR);Eukaryota;Archaeplastida;Chloroplastida;Charophyta;Phragmoplastophyta;Streptophyta;Embryophyta;Bryophyta;Gigaspermum;";"0.0";"0";"1";"1";"0";"1";"0";"430523";"5766"
"LOK1378_1mm";"SILVA (only NR);Eukaryota;Archaeplastida;Chloroplastida;Charophyta;Phragmoplastophyta;Streptophyta;Embryophyta;Bryophyta;Grimmiales;";"0.0";"0";"5";"4";"0";"4";"1";"430520";"5766"
"LOK1378_1mm";"SILVA (only NR);Eukaryota;Archaeplastida;Chloroplastida;Charophyta;Phragmoplastophyta;Streptophyta;Embryophyta;Bryophyta;Grimmiales;Drummondia;";"0.0";"0";"1";"1";"0";"1";"0";"430523";"5766"
"LOK1378_1mm";"SILVA (only NR);Eukaryota;Archaeplastida;Chloroplastida;Charophyta;Phragmoplastophyta;Streptophyta;Embryophyta;Bryophyta;Grimmiales;Grimmia;";"0.0";"0";"1";"1";"0";"1";"0";"430523";"5766"
"LOK1378_1mm";"SILVA (only NR);Eukaryota;Archaeplastida;Chloroplastida;Charophyta;Phragmoplastophyta;Streptophyta;Embryophyta;Bryophyta;Grimmiales;Ptychomitrium;";"0.0";"0";"2";"1";"0";"1";"1";"430523";"5766"
"LOK1378_1mm";"SILVA (only NR);Eukaryota;Archaeplastida;Chloroplastida;Charophyta;Phragmoplastophyta;Streptophyta;Embryophyta;Bryophyta;Hedwigiales;";"0.0";"0";"2";"2";"0";"2";"0";"430522";"5766"
"LOK1378_1mm";"SILVA (only NR);Eukaryota;Archaeplastida;Chloroplastida;Charophyta;Phragmoplastophyta;Streptophyta;Embryophyta;Bryophyta;Hedwigiales;Hedwigia;";"0.0";"0";"1";"1";"0";"1";"0";"430523";"5766"
"LOK1378_1mm";"SILVA (only NR);Eukaryota;Archaeplastida;Chloroplastida;Charophyta;Phragmoplastophyta;Streptophyta;Embryophyta;Bryophyta;Hedwigiales;Rhacocarpus;";"0.0";"0";"1";"1";"0";"1";"0";"430523";"5766"
"LOK1378_1mm";"SILVA (only NR);Eukaryota;Archaeplastida;Chloroplastida;Charophyta;Phragmoplastophyta;Streptophyta;Embryophyta;Bryophyta;Hypnales;";"0.0";"0";"2";"2";"0";"2";"0";"430522";"5766"
"LOK1378_1mm";"SILVA (only NR);Eukaryota;Archaeplastida;Chloroplastida;Charophyta;Phragmoplastophyta;Streptophyta;Embryophyta;Bryophyta;Hypnales;Buckiella;";"0.0";"0";"1";"1";"0";"1";"0";"430523";"5766"
"LOK1378_1mm";"SILVA (only NR);Eukaryota;Archaeplastida;Chloroplastida;Charophyta;Phragmoplastophyta;Streptophyta;Embryophyta;Bryophyta;Hypnales;Fontinalis;";"0.0";"0";"1";"1";"0";"1";"0";"430523";"5766"
"LOK1378_1mm";"SILVA (only NR);Eukaryota;Archaeplastida;Chloroplastida;Charophyta;Phragmoplastophyta;Streptophyta;Embryophyta;Bryophyta;Hypnodendrales;";"0.0";"0";"3";"3";"0";"3";"0";"430521";"5766"
"LOK1378_1mm";"SILVA (only NR);Eukaryota;Archaeplastida;Chloroplastida;Charophyta;Phragmoplastophyta;Streptophyta;Embryophyta;Bryophyta;Hypnodendrales;Bescherellia;";"0.0";"0";"1";"1";"0";"1";"0";"430523";"5766"
"LOK1378_1mm";"SILVA (only NR);Eukaryota;Archaeplastida;Chloroplastida;Charophyta;Phragmoplastophyta;Streptophyta;Embryophyta;Bryophyta;Hypnodendrales;Mniodendron;";"0.0";"0";"1";"1";"0";"1";"0";"430523";"5766"
"LOK1378_1mm";"SILVA (only NR);Eukaryota;Archaeplastida;Chloroplastida;Charophyta;Phragmoplastophyta;Streptophyta;Embryophyta;Bryophyta;Hypnodendrales;Racopilum;";"0.0";"0";"1";"1";"0";"1";"0";"430523";"5766"
"LOK1378_1mm";"SILVA (only NR);Eukaryota;Archaeplastida;Chloroplastida;Charophyta;Phragmoplastophyta;Streptophyta;Embryophyta;Bryophyta;Orthotrichales;";"0.0";"0";"4";"4";"0";"4";"0";"430520";"5766"
"LOK1378_1mm";"SILVA (only NR);Eukaryota;Archaeplastida;Chloroplastida;Charophyta;Phragmoplastophyta;Streptophyta;Embryophyta;Bryophyta;Orthotrichales;Niphotrichum;";"0.0";"0";"1";"1";"0";"1";"0";"430523";"5766"
"LOK1378_1mm";"SILVA (only NR);Eukaryota;Archaeplastida;Chloroplastida;Charophyta;Phragmoplastophyta;Streptophyta;Embryophyta;Bryophyta;Orthotrichales;Orthotrichum;";"0.0";"0";"2";"2";"0";"2";"0";"430522";"5766"
"LOK1378_1mm";"SILVA (only NR);Eukaryota;Archaeplastida;Chloroplastida;Charophyta;Phragmoplastophyta;Streptophyta;Embryophyta;Bryophyta;Orthotrichales;Ulota;";"0.0";"0";"1";"1";"0";"1";"0";"430523";"5766"
"LOK1378_1mm";"SILVA (only NR);Eukaryota;Archaeplastida;Chloroplastida;Charophyta;Phragmoplastophyta;Streptophyta;Embryophyta;Bryophyta;Polytrichales;";"0.0";"0";"18";"18";"0";"18";"0";"430506";"5766"
"LOK1378_1mm";"SILVA (only NR);Eukaryota;Archaeplastida;Chloroplastida;Charophyta;Phragmoplastophyta;Streptophyta;Embryophyta;Bryophyta;Polytrichales;Atrichum;";"0.0";"0";"2";"2";"0";"2";"0";"430522";"5766"
"LOK1378_1mm";"SILVA (only NR);Eukaryota;Archaeplastida;Chloroplastida;Charophyta;Phragmoplastophyta;Streptophyta;Embryophyta;Bryophyta;Polytrichales;Dawsonia;";"0.0";"0";"1";"1";"0";"1";"0";"430523";"5766"
"LOK1378_1mm";"SILVA (only NR);Eukaryota;Archaeplastida;Chloroplastida;Charophyta;Phragmoplastophyta;Streptophyta;Embryophyta;Bryophyta;Polytrichales;Lyellia;";"0.0";"0";"1";"1";"0";"1";"0";"430523";"5766"
"LOK1378_1mm";"SILVA (only NR);Eukaryota;Archaeplastida;Chloroplastida;Charophyta;Phragmoplastophyta;Streptophyta;Embryophyta;Bryophyta;Polytrichales;Notoligotrichum;";"0.0";"0";"1";"1";"0";"1";"0";"430523";"5766"
"LOK1378_1mm";"SILVA (only NR);Eukaryota;Archaeplastida;Chloroplastida;Charophyta;Phragmoplastophyta;Streptophyta;Embryophyta;Bryophyta;Polytrichales;Pogonatum;";"0.0";"0";"7";"7";"0";"7";"0";"430517";"5766"
"LOK1378_1mm";"SILVA (only NR);Eukaryota;Archaeplastida;Chloroplastida;Charophyta;Phragmoplastophyta;Streptophyta;Embryophyta;Bryophyta;Polytrichales;Polytrichadelphus;";"0.0";"0";"1";"1";"0";"1";"0";"430523";"5766"
"LOK1378_1mm";"SILVA (only NR);Eukaryota;Archaeplastida;Chloroplastida;Charophyta;Phragmoplastophyta;Streptophyta;Embryophyta;Bryophyta;Polytrichales;Polytrichum;";"0.0";"0";"2";"2";"0";"2";"0";"430522";"5766"
"LOK1378_1mm";"SILVA (only NR);Eukaryota;Archaeplastida;Chloroplastida;Charophyta;Phragmoplastophyta;Streptophyta;Embryophyta;Bryophyta;Pottiales;";"0.0";"0";"4";"4";"0";"4";"0";"430520";"5766"
"LOK1378_1mm";"SILVA (only NR);Eukaryota;Archaeplastida;Chloroplastida;Charophyta;Phragmoplastophyta;Streptophyta;Embryophyta;Bryophyta;Pottiales;Pottia;";"0.0";"0";"3";"3";"0";"3";"0";"430521";"5766"
"LOK1378_1mm";"SILVA (only NR);Eukaryota;Archaeplastida;Chloroplastida;Charophyta;Phragmoplastophyta;Streptophyta;Embryophyta;Bryophyta;Pottiales;Syntrichia;";"0.0";"0";"1";"1";"0";"1";"0";"430523";"5766"
"LOK1378_1mm";"SILVA (only NR);Eukaryota;Archaeplastida;Chloroplastida;Charophyta;Phragmoplastophyta;Streptophyta;Embryophyta;Bryophyta;Sphagnales;";"0.0";"0";"2";"2";"0";"2";"0";"430522";"5766"
"LOK1378_1mm";"SILVA (only NR);Eukaryota;Archaeplastida;Chloroplastida;Charophyta;Phragmoplastophyta;Streptophyta;Embryophyta;Bryophyta;Sphagnales;Sphagnum;";"0.0";"0";"2";"2";"0";"2";"0";"430522";"5766"
"LOK1378_1mm";"SILVA (only NR);Eukaryota;Archaeplastida;Chloroplastida;Charophyta;Phragmoplastophyta;Streptophyta;Embryophyta;Bryophyta;Splachnales;";"0.0";"0";"1";"1";"0";"1";"0";"430523";"5766"
"LOK1378_1mm";"SILVA (only NR);Eukaryota;Archaeplastida;Chloroplastida;Charophyta;Phragmoplastophyta;Streptophyta;Embryophyta;Bryophyta;Splachnales;Splachnum;";"0.0";"0";"1";"1";"0";"1";"0";"430523";"5766"
"LOK1378_1mm";"SILVA (only NR);Eukaryota;Archaeplastida;Chloroplastida;Charophyta;Phragmoplastophyta;Streptophyta;Embryophyta;Bryophyta;Takakiales;";"0.0";"0";"1";"1";"0";"1";"0";"430523";"5766"
"LOK1378_1mm";"SILVA (only NR);Eukaryota;Archaeplastida;Chloroplastida;Charophyta;Phragmoplastophyta;Streptophyta;Embryophyta;Bryophyta;Takakiales;Takakia;";"0.0";"0";"1";"1";"0";"1";"0";"430523";"5766"
"LOK1378_1mm";"SILVA (only NR);Eukaryota;Archaeplastida;Chloroplastida;Charophyta;Phragmoplastophyta;Streptophyta;Embryophyta;Bryophyta;Tetraphidales;";"0.0";"0";"2";"2";"0";"2";"0";"430522";"5766"
"LOK1378_1mm";"SILVA (only NR);Eukaryota;Archaeplastida;Chloroplastida;Charophyta;Phragmoplastophyta;Streptophyta;Embryophyta;Bryophyta;Tetraphidales;Tetraphis;";"0.0";"0";"2";"2";"0";"2";"0";"430522";"5766"
"LOK1378_1mm";"SILVA (only NR);Eukaryota;Archaeplastida;Chloroplastida;Charophyta;Phragmoplastophyta;Streptophyta;Embryophyta;Bryophyta;Timmiales;";"0.0";"0";"1";"1";"0";"1";"0";"430523";"5766"
"LOK1378_1mm";"SILVA (only NR);Eukaryota;Archaeplastida;Chloroplastida;Charophyta;Phragmoplastophyta;Streptophyta;Embryophyta;Bryophyta;Timmiales;Timmia;";"0.0";"0";"1";"1";"0";"1";"0";"430523";"5766"
"LOK1378_1mm";"SILVA (only NR);Eukaryota;Archaeplastida;Chloroplastida;Charophyta;Phragmoplastophyta;Streptophyta;Embryophyta;Buxbaumiales;";"0.0";"0";"1";"1";"0";"1";"0";"430523";"5766"
"LOK1378_1mm";"SILVA (only NR);Eukaryota;Archaeplastida;Chloroplastida;Charophyta;Phragmoplastophyta;Streptophyta;Embryophyta;Buxbaumiales;Buxbaumia;";"0.0";"0";"1";"1";"0";"1";"0";"430523";"5766"
"LOK1378_1mm";"SILVA (only NR);Eukaryota;Archaeplastida;Chloroplastida;Charophyta;Phragmoplastophyta;Streptophyta;Embryophyta;Marchantiophyta;";"0.0";"0";"47";"47";"0";"47";"0";"430477";"5766"
"LOK1378_1mm";"SILVA (only NR);Eukaryota;Archaeplastida;Chloroplastida;Charophyta;Phragmoplastophyta;Streptophyta;Embryophyta;Marchantiophyta;Blasiales;";"0.0";"0";"2";"2";"0";"2";"0";"430522";"5766"
"LOK1378_1mm";"SILVA (only NR);Eukaryota;Archaeplastida;Chloroplastida;Charophyta;Phragmoplastophyta;Streptophyta;Embryophyta;Marchantiophyta;Blasiales;Blasia;";"0.0";"0";"2";"2";"0";"2";"0";"430522";"5766"
"LOK1378_1mm";"SILVA (only NR);Eukaryota;Archaeplastida;Chloroplastida;Charophyta;Phragmoplastophyta;Streptophyta;Embryophyta;Marchantiophyta;Calobryales;";"0.0";"0";"4";"4";"0";"4";"0";"430520";"5766"
"LOK1378_1mm";"SILVA (only NR);Eukaryota;Archaeplastida;Chloroplastida;Charophyta;Phragmoplastophyta;Streptophyta;Embryophyta;Marchantiophyta;Calobryales;Haplomitrium;";"0.0";"0";"4";"4";"0";"4";"0";"430520";"5766"
"LOK1378_1mm";"SILVA (only NR);Eukaryota;Archaeplastida;Chloroplastida;Charophyta;Phragmoplastophyta;Streptophyta;Embryophyta;Marchantiophyta;Fossombroniales;";"0.0";"0";"2";"2";"0";"2";"0";"430522";"5766"
"LOK1378_1mm";"SILVA (only NR);Eukaryota;Archaeplastida;Chloroplastida;Charophyta;Phragmoplastophyta;Streptophyta;Embryophyta;Marchantiophyta;Fossombroniales;Fossombronia;";"0.0";"0";"1";"1";"0";"1";"0";"430523";"5766"
"LOK1378_1mm";"SILVA (only NR);Eukaryota;Archaeplastida;Chloroplastida;Charophyta;Phragmoplastophyta;Streptophyta;Embryophyta;Marchantiophyta;Fossombroniales;Petalophyllum;";"0.0";"0";"1";"1";"0";"1";"0";"430523";"5766"
"LOK1378_1mm";"SILVA (only NR);Eukaryota;Archaeplastida;Chloroplastida;Charophyta;Phragmoplastophyta;Streptophyta;Embryophyta;Marchantiophyta;Jungermanniales;";"0.0";"0";"7";"7";"0";"7";"0";"430517";"5766"
"LOK1378_1mm";"SILVA (only NR);Eukaryota;Archaeplastida;Chloroplastida;Charophyta;Phragmoplastophyta;Streptophyta;Embryophyta;Marchantiophyta;Jungermanniales;Jungermannia;";"0.0";"0";"1";"1";"0";"1";"0";"430523";"5766"
"LOK1378_1mm";"SILVA (only NR);Eukaryota;Archaeplastida;Chloroplastida;Charophyta;Phragmoplastophyta;Streptophyta;Embryophyta;Marchantiophyta;Jungermanniales;Lepidozia;";"0.0";"0";"1";"1";"0";"1";"0";"430523";"5766"
"LOK1378_1mm";"SILVA (only NR);Eukaryota;Archaeplastida;Chloroplastida;Charophyta;Phragmoplastophyta;Streptophyta;Embryophyta;Marchantiophyta;Jungermanniales;Lophozia;";"0.0";"0";"1";"1";"0";"1";"0";"430523";"5766"
"LOK1378_1mm";"SILVA (only NR);Eukaryota;Archaeplastida;Chloroplastida;Charophyta;Phragmoplastophyta;Streptophyta;Embryophyta;Marchantiophyta;Jungermanniales;Marsupella;";"0.0";"0";"1";"1";"0";"1";"0";"430523";"5766"
"LOK1378_1mm";"SILVA (only NR);Eukaryota;Archaeplastida;Chloroplastida;Charophyta;Phragmoplastophyta;Streptophyta;Embryophyta;Marchantiophyta;Jungermanniales;Nowellia;";"0.0";"0";"1";"1";"0";"1";"0";"430523";"5766"
"LOK1378_1mm";"SILVA (only NR);Eukaryota;Archaeplastida;Chloroplastida;Charophyta;Phragmoplastophyta;Streptophyta;Embryophyta;Marchantiophyta;Jungermanniales;Odontoschisma;";"0.0";"0";"1";"1";"0";"1";"0";"430523";"5766"
"LOK1378_1mm";"SILVA (only NR);Eukaryota;Archaeplastida;Chloroplastida;Charophyta;Phragmoplastophyta;Streptophyta;Embryophyta;Marchantiophyta;Jungermanniales;Tylimanthus;";"0.0";"0";"1";"1";"0";"1";"0";"430523";"5766"
"LOK1378_1mm";"SILVA (only NR);Eukaryota;Archaeplastida;Chloroplastida;Charophyta;Phragmoplastophyta;Streptophyta;Embryophyta;Marchantiophyta;Lunulariales;";"0.0";"0";"1";"1";"0";"1";"0";"430523";"5766"
"LOK1378_1mm";"SILVA (only NR);Eukaryota;Archaeplastida;Chloroplastida;Charophyta;Phragmoplastophyta;Streptophyta;Embryophyta;Marchantiophyta;Lunulariales;Lunularia;";"0.0";"0";"1";"1";"0";"1";"0";"430523";"5766"
"LOK1378_1mm";"SILVA (only NR);Eukaryota;Archaeplastida;Chloroplastida;Charophyta;Phragmoplastophyta;Streptophyta;Embryophyta;Marchantiophyta;Marchantiales;";"0.0";"0";"12";"12";"0";"12";"0";"430512";"5766"
"LOK1378_1mm";"SILVA (only NR);Eukaryota;Archaeplastida;Chloroplastida;Charophyta;Phragmoplastophyta;Streptophyta;Embryophyta;Marchantiophyta;Marchantiales;Conocephalum;";"0.0";"0";"2";"2";"0";"2";"0";"430522";"5766"
"LOK1378_1mm";"SILVA (only NR);Eukaryota;Archaeplastida;Chloroplastida;Charophyta;Phragmoplastophyta;Streptophyta;Embryophyta;Marchantiophyta;Marchantiales;Dumortiera;";"0.0";"0";"1";"1";"0";"1";"0";"430523";"5766"
"LOK1378_1mm";"SILVA (only NR);Eukaryota;Archaeplastida;Chloroplastida;Charophyta;Phragmoplastophyta;Streptophyta;Embryophyta;Marchantiophyta;Marchantiales;Marchantia;";"0.0";"0";"1";"1";"0";"1";"0";"430523";"5766"
"LOK1378_1mm";"SILVA (only NR);Eukaryota;Archaeplastida;Chloroplastida;Charophyta;Phragmoplastophyta;Streptophyta;Embryophyta;Marchantiophyta;Marchantiales;Monoclea;";"0.0";"0";"2";"2";"0";"2";"0";"430522";"5766"
"LOK1378_1mm";"SILVA (only NR);Eukaryota;Archaeplastida;Chloroplastida;Charophyta;Phragmoplastophyta;Streptophyta;Embryophyta;Marchantiophyta;Marchantiales;Plagiochasma;";"0.0";"0";"1";"1";"0";"1";"0";"430523";"5766"
"LOK1378_1mm";"SILVA (only NR);Eukaryota;Archaeplastida;Chloroplastida;Charophyta;Phragmoplastophyta;Streptophyta;Embryophyta;Marchantiophyta;Marchantiales;Reboulia;";"0.0";"0";"2";"2";"0";"2";"0";"430522";"5766"
"LOK1378_1mm";"SILVA (only NR);Eukaryota;Archaeplastida;Chloroplastida;Charophyta;Phragmoplastophyta;Streptophyta;Embryophyta;Marchantiophyta;Marchantiales;Riccia;";"0.0";"0";"2";"2";"0";"2";"0";"430522";"5766"
"LOK1378_1mm";"SILVA (only NR);Eukaryota;Archaeplastida;Chloroplastida;Charophyta;Phragmoplastophyta;Streptophyta;Embryophyta;Marchantiophyta;Marchantiales;Targionia;";"0.0";"0";"1";"1";"0";"1";"0";"430523";"5766"
"LOK1378_1mm";"SILVA (only NR);Eukaryota;Archaeplastida;Chloroplastida;Charophyta;Phragmoplastophyta;Streptophyta;Embryophyta;Marchantiophyta;Metzgeriales;";"0.0";"0";"4";"4";"0";"4";"0";"430520";"5766"
"LOK1378_1mm";"SILVA (only NR);Eukaryota;Archaeplastida;Chloroplastida;Charophyta;Phragmoplastophyta;Streptophyta;Embryophyta;Marchantiophyta;Metzgeriales;Aneura;";"0.0";"0";"1";"1";"0";"1";"0";"430523";"5766"
"LOK1378_1mm";"SILVA (only NR);Eukaryota;Archaeplastida;Chloroplastida;Charophyta;Phragmoplastophyta;Streptophyta;Embryophyta;Marchantiophyta;Metzgeriales;Metzgeria;";"0.0";"0";"2";"2";"0";"2";"0";"430522";"5766"
"LOK1378_1mm";"SILVA (only NR);Eukaryota;Archaeplastida;Chloroplastida;Charophyta;Phragmoplastophyta;Streptophyta;Embryophyta;Marchantiophyta;Metzgeriales;Moerckia;";"0.0";"0";"1";"1";"0";"1";"0";"430523";"5766"
"LOK1378_1mm";"SILVA (only NR);Eukaryota;Archaeplastida;Chloroplastida;Charophyta;Phragmoplastophyta;Streptophyta;Embryophyta;Marchantiophyta;Neohodgsoniales;";"0.0";"0";"1";"1";"0";"1";"0";"430523";"5766"
"LOK1378_1mm";"SILVA (only NR);Eukaryota;Archaeplastida;Chloroplastida;Charophyta;Phragmoplastophyta;Streptophyta;Embryophyta;Marchantiophyta;Neohodgsoniales;Neohodgsonia;";"0.0";"0";"1";"1";"0";"1";"0";"430523";"5766"
"LOK1378_1mm";"SILVA (only NR);Eukaryota;Archaeplastida;Chloroplastida;Charophyta;Phragmoplastophyta;Streptophyta;Embryophyta;Marchantiophyta;Pallaviciniales;";"0.0";"0";"4";"4";"0";"4";"0";"430520";"5766"
"LOK1378_1mm";"SILVA (only NR);Eukaryota;Archaeplastida;Chloroplastida;Charophyta;Phragmoplastophyta;Streptophyta;Embryophyta;Marchantiophyta;Pallaviciniales;Hymenophyton;";"0.0";"0";"1";"1";"0";"1";"0";"430523";"5766"
"LOK1378_1mm";"SILVA (only NR);Eukaryota;Archaeplastida;Chloroplastida;Charophyta;Phragmoplastophyta;Streptophyta;Embryophyta;Marchantiophyta;Pallaviciniales;Pallavicinia;";"0.0";"0";"1";"1";"0";"1";"0";"430523";"5766"
"LOK1378_1mm";"SILVA (only NR);Eukaryota;Archaeplastida;Chloroplastida;Charophyta;Phragmoplastophyta;Streptophyta;Embryophyta;Marchantiophyta;Pallaviciniales;Symphyogyna;";"0.0";"0";"2";"2";"0";"2";"0";"430522";"5766"
"LOK1378_1mm";"SILVA (only NR);Eukaryota;Archaeplastida;Chloroplastida;Charophyta;Phragmoplastophyta;Streptophyta;Embryophyta;Marchantiophyta;Porellales;";"0.0";"0";"5";"5";"0";"5";"0";"430519";"5766"
"LOK1378_1mm";"SILVA (only NR);Eukaryota;Archaeplastida;Chloroplastida;Charophyta;Phragmoplastophyta;Streptophyta;Embryophyta;Marchantiophyta;Porellales;Cheilolejeunea;";"0.0";"0";"1";"1";"0";"1";"0";"430523";"5766"
"LOK1378_1mm";"SILVA (only NR);Eukaryota;Archaeplastida;Chloroplastida;Charophyta;Phragmoplastophyta;Streptophyta;Embryophyta;Marchantiophyta;Porellales;Frullania;";"0.0";"0";"1";"1";"0";"1";"0";"430523";"5766"
"LOK1378_1mm";"SILVA (only NR);Eukaryota;Archaeplastida;Chloroplastida;Charophyta;Phragmoplastophyta;Streptophyta;Embryophyta;Marchantiophyta;Porellales;Lejeunea;";"0.0";"0";"1";"1";"0";"1";"0";"430523";"5766"
"LOK1378_1mm";"SILVA (only NR);Eukaryota;Archaeplastida;Chloroplastida;Charophyta;Phragmoplastophyta;Streptophyta;Embryophyta;Marchantiophyta;Porellales;Porella;";"0.0";"0";"2";"2";"0";"2";"0";"430522";"5766"
"LOK1378_1mm";"SILVA (only NR);Eukaryota;Archaeplastida;Chloroplastida;Charophyta;Phragmoplastophyta;Streptophyta;Embryophyta;Marchantiophyta;Sphaerocarpales;";"0.0";"0";"3";"3";"0";"3";"0";"430521";"5766"
"LOK1378_1mm";"SILVA (only NR);Eukaryota;Archaeplastida;Chloroplastida;Charophyta;Phragmoplastophyta;Streptophyta;Embryophyta;Marchantiophyta;Sphaerocarpales;Riella;";"0.0";"0";"1";"1";"0";"1";"0";"430523";"5766"
"LOK1378_1mm";"SILVA (only NR);Eukaryota;Archaeplastida;Chloroplastida;Charophyta;Phragmoplastophyta;Streptophyta;Embryophyta;Marchantiophyta;Sphaerocarpales;Sphaerocarpos;";"0.0";"0";"2";"2";"0";"2";"0";"430522";"5766"
"LOK1378_1mm";"SILVA (only NR);Eukaryota;Archaeplastida;Chloroplastida;Charophyta;Phragmoplastophyta;Streptophyta;Embryophyta;Marchantiophyta;Treubiales;";"0.0";"0";"1";"1";"0";"1";"0";"430523";"5766"
"LOK1378_1mm";"SILVA (only NR);Eukaryota;Archaeplastida;Chloroplastida;Charophyta;Phragmoplastophyta;Streptophyta;Embryophyta;Marchantiophyta;Treubiales;Treubia;";"0.0";"0";"1";"1";"0";"1";"0";"430523";"5766"
"LOK1378_1mm";"SILVA (only NR);Eukaryota;Archaeplastida;Chloroplastida;Charophyta;Phragmoplastophyta;Streptophyta;Embryophyta;Tracheophyta;";"0.0";"0";"4341";"4016";"0";"4016";"325";"426508";"5766"
"LOK1378_1mm";"SILVA (only NR);Eukaryota;Archaeplastida;Chloroplastida;Charophyta;Phragmoplastophyta;Streptophyta;Embryophyta;Tracheophyta;Lycopodiophyta;";"0.0";"0";"21";"19";"0";"19";"2";"430505";"5766"
"LOK1378_1mm";"SILVA (only NR);Eukaryota;Archaeplastida;Chloroplastida;Charophyta;Phragmoplastophyta;Streptophyta;Embryophyta;Tracheophyta;Lycopodiophyta;Isoetales;";"0.0";"0";"2";"2";"0";"2";"0";"430522";"5766"
"LOK1378_1mm";"SILVA (only NR);Eukaryota;Archaeplastida;Chloroplastida;Charophyta;Phragmoplastophyta;Streptophyta;Embryophyta;Tracheophyta;Lycopodiophyta;Isoetales;Isoetaceae;";"0.0";"0";"2";"2";"0";"2";"0";"430522";"5766"
"LOK1378_1mm";"SILVA (only NR);Eukaryota;Archaeplastida;Chloroplastida;Charophyta;Phragmoplastophyta;Streptophyta;Embryophyta;Tracheophyta;Lycopodiophyta;Isoetales;Isoetaceae;Isoetes;";"0.0";"0";"2";"2";"0";"2";"0";"430522";"5766"
"LOK1378_1mm";"SILVA (only NR);Eukaryota;Archaeplastida;Chloroplastida;Charophyta;Phragmoplastophyta;Streptophyta;Embryophyta;Tracheophyta;Lycopodiophyta;Lycopodiales;";"0.0";"0";"4";"4";"0";"4";"0";"430520";"5766"
"LOK1378_1mm";"SILVA (only NR);Eukaryota;Archaeplastida;Chloroplastida;Charophyta;Phragmoplastophyta;Streptophyta;Embryophyta;Tracheophyta;Lycopodiophyta;Lycopodiales;Diphasiastrum;";"0.0";"0";"1";"1";"0";"1";"0";"430523";"5766"
"LOK1378_1mm";"SILVA (only NR);Eukaryota;Archaeplastida;Chloroplastida;Charophyta;Phragmoplastophyta;Streptophyta;Embryophyta;Tracheophyta;Lycopodiophyta;Lycopodiales;Lycopodiella;";"0.0";"0";"1";"1";"0";"1";"0";"430523";"5766"
"LOK1378_1mm";"SILVA (only NR);Eukaryota;Archaeplastida;Chloroplastida;Charophyta;Phragmoplastophyta;Streptophyta;Embryophyta;Tracheophyta;Lycopodiophyta;Lycopodiales;Lycopodium;";"0.0";"0";"1";"1";"0";"1";"0";"430523";"5766"
"LOK1378_1mm";"SILVA (only NR);Eukaryota;Archaeplastida;Chloroplastida;Charophyta;Phragmoplastophyta;Streptophyta;Embryophyta;Tracheophyta;Lycopodiophyta;Lycopodiales;Phlegmariurus;";"0.0";"0";"1";"1";"0";"1";"0";"430523";"5766"
"LOK1378_1mm";"SILVA (only NR);Eukaryota;Archaeplastida;Chloroplastida;Charophyta;Phragmoplastophyta;Streptophyta;Embryophyta;Tracheophyta;Lycopodiophyta;Selaginellales;";"0.0";"0";"15";"13";"0";"13";"2";"430511";"5766"
"LOK1378_1mm";"SILVA (only NR);Eukaryota;Archaeplastida;Chloroplastida;Charophyta;Phragmoplastophyta;Streptophyta;Embryophyta;Tracheophyta;Lycopodiophyta;Selaginellales;Selaginella;";"0.0";"0";"15";"13";"0";"13";"2";"430511";"5766"
"LOK1378_1mm";"SILVA (only NR);Eukaryota;Archaeplastida;Chloroplastida;Charophyta;Phragmoplastophyta;Streptophyta;Embryophyta;Tracheophyta;Monilophyta;";"0.0";"0";"43";"42";"0";"42";"1";"430482";"5766"
"LOK1378_1mm";"SILVA (only NR);Eukaryota;Archaeplastida;Chloroplastida;Charophyta;Phragmoplastophyta;Streptophyta;Embryophyta;Tracheophyta;Monilophyta;Anemia;";"0.0";"0";"1";"1";"0";"1";"0";"430523";"5766"
"LOK1378_1mm";"SILVA (only NR);Eukaryota;Archaeplastida;Chloroplastida;Charophyta;Phragmoplastophyta;Streptophyta;Embryophyta;Tracheophyta;Monilophyta;Cyatheales;";"0.0";"0";"2";"2";"0";"2";"0";"430522";"5766"
"LOK1378_1mm";"SILVA (only NR);Eukaryota;Archaeplastida;Chloroplastida;Charophyta;Phragmoplastophyta;Streptophyta;Embryophyta;Tracheophyta;Monilophyta;Cyatheales;Cyathea;";"0.0";"0";"1";"1";"0";"1";"0";"430523";"5766"
"LOK1378_1mm";"SILVA (only NR);Eukaryota;Archaeplastida;Chloroplastida;Charophyta;Phragmoplastophyta;Streptophyta;Embryophyta;Tracheophyta;Monilophyta;Cyatheales;Metaxya;";"0.0";"0";"1";"1";"0";"1";"0";"430523";"5766"
"LOK1378_1mm";"SILVA (only NR);Eukaryota;Archaeplastida;Chloroplastida;Charophyta;Phragmoplastophyta;Streptophyta;Embryophyta;Tracheophyta;Monilophyta;Equisetales;";"0.0";"0";"2";"2";"0";"2";"0";"430522";"5766"
"LOK1378_1mm";"SILVA (only NR);Eukaryota;Archaeplastida;Chloroplastida;Charophyta;Phragmoplastophyta;Streptophyta;Embryophyta;Tracheophyta;Monilophyta;Equisetales;Equisetaceae;";"0.0";"0";"2";"2";"0";"2";"0";"430522";"5766"
"LOK1378_1mm";"SILVA (only NR);Eukaryota;Archaeplastida;Chloroplastida;Charophyta;Phragmoplastophyta;Streptophyta;Embryophyta;Tracheophyta;Monilophyta;Equisetales;Equisetaceae;Equisetum;";"0.0";"0";"2";"2";"0";"2";"0";"430522";"5766"
"LOK1378_1mm";"SILVA (only NR);Eukaryota;Archaeplastida;Chloroplastida;Charophyta;Phragmoplastophyta;Streptophyta;Embryophyta;Tracheophyta;Monilophyta;Gleicheniales;";"0.0";"0";"4";"4";"0";"4";"0";"430520";"5766"
"LOK1378_1mm";"SILVA (only NR);Eukaryota;Archaeplastida;Chloroplastida;Charophyta;Phragmoplastophyta;Streptophyta;Embryophyta;Tracheophyta;Monilophyta;Gleicheniales;Cheiropleuria;";"0.0";"0";"1";"1";"0";"1";"0";"430523";"5766"
"LOK1378_1mm";"SILVA (only NR);Eukaryota;Archaeplastida;Chloroplastida;Charophyta;Phragmoplastophyta;Streptophyta;Embryophyta;Tracheophyta;Monilophyta;Gleicheniales;Dicranopteris;";"0.0";"0";"1";"1";"0";"1";"0";"430523";"5766"
"LOK1378_1mm";"SILVA (only NR);Eukaryota;Archaeplastida;Chloroplastida;Charophyta;Phragmoplastophyta;Streptophyta;Embryophyta;Tracheophyta;Monilophyta;Gleicheniales;Gleichenia;";"0.0";"0";"1";"1";"0";"1";"0";"430523";"5766"
"LOK1378_1mm";"SILVA (only NR);Eukaryota;Archaeplastida;Chloroplastida;Charophyta;Phragmoplastophyta;Streptophyta;Embryophyta;Tracheophyta;Monilophyta;Gleicheniales;Phanerosorus;";"0.0";"0";"1";"1";"0";"1";"0";"430523";"5766"
"LOK1378_1mm";"SILVA (only NR);Eukaryota;Archaeplastida;Chloroplastida;Charophyta;Phragmoplastophyta;Streptophyta;Embryophyta;Tracheophyta;Monilophyta;Hymenophyllales;";"0.0";"0";"2";"2";"0";"2";"0";"430522";"5766"
"LOK1378_1mm";"SILVA (only NR);Eukaryota;Archaeplastida;Chloroplastida;Charophyta;Phragmoplastophyta;Streptophyta;Embryophyta;Tracheophyta;Monilophyta;Hymenophyllales;Hymenophyllum;";"0.0";"0";"1";"1";"0";"1";"0";"430523";"5766"
"LOK1378_1mm";"SILVA (only NR);Eukaryota;Archaeplastida;Chloroplastida;Charophyta;Phragmoplastophyta;Streptophyta;Embryophyta;Tracheophyta;Monilophyta;Hymenophyllales;Vandenboschia;";"0.0";"0";"1";"1";"0";"1";"0";"430523";"5766"
"LOK1378_1mm";"SILVA (only NR);Eukaryota;Archaeplastida;Chloroplastida;Charophyta;Phragmoplastophyta;Streptophyta;Embryophyta;Tracheophyta;Monilophyta;Marattiales;";"0.0";"0";"4";"4";"0";"4";"0";"430520";"5766"
"LOK1378_1mm";"SILVA (only NR);Eukaryota;Archaeplastida;Chloroplastida;Charophyta;Phragmoplastophyta;Streptophyta;Embryophyta;Tracheophyta;Monilophyta;Marattiales;Angiopteris;";"0.0";"0";"1";"1";"0";"1";"0";"430523";"5766"
"LOK1378_1mm";"SILVA (only NR);Eukaryota;Archaeplastida;Chloroplastida;Charophyta;Phragmoplastophyta;Streptophyta;Embryophyta;Tracheophyta;Monilophyta;Marattiales;Danaea;";"0.0";"0";"2";"2";"0";"2";"0";"430522";"5766"
"LOK1378_1mm";"SILVA (only NR);Eukaryota;Archaeplastida;Chloroplastida;Charophyta;Phragmoplastophyta;Streptophyta;Embryophyta;Tracheophyta;Monilophyta;Marattiales;Ptisana;";"0.0";"0";"1";"1";"0";"1";"0";"430523";"5766"
"LOK1378_1mm";"SILVA (only NR);Eukaryota;Archaeplastida;Chloroplastida;Charophyta;Phragmoplastophyta;Streptophyta;Embryophyta;Tracheophyta;Monilophyta;Ophioglossales;";"0.0";"0";"4";"4";"0";"4";"0";"430520";"5766"
"LOK1378_1mm";"SILVA (only NR);Eukaryota;Archaeplastida;Chloroplastida;Charophyta;Phragmoplastophyta;Streptophyta;Embryophyta;Tracheophyta;Monilophyta;Ophioglossales;Botrypus;";"0.0";"0";"1";"1";"0";"1";"0";"430523";"5766"
"LOK1378_1mm";"SILVA (only NR);Eukaryota;Archaeplastida;Chloroplastida;Charophyta;Phragmoplastophyta;Streptophyta;Embryophyta;Tracheophyta;Monilophyta;Ophioglossales;Helminthostachys;";"0.0";"0";"1";"1";"0";"1";"0";"430523";"5766"
"LOK1378_1mm";"SILVA (only NR);Eukaryota;Archaeplastida;Chloroplastida;Charophyta;Phragmoplastophyta;Streptophyta;Embryophyta;Tracheophyta;Monilophyta;Ophioglossales;Ophioglossum;";"0.0";"0";"1";"1";"0";"1";"0";"430523";"5766"
"LOK1378_1mm";"SILVA (only NR);Eukaryota;Archaeplastida;Chloroplastida;Charophyta;Phragmoplastophyta;Streptophyta;Embryophyta;Tracheophyta;Monilophyta;Osmundales;";"0.0";"0";"2";"2";"0";"2";"0";"430522";"5766"
"LOK1378_1mm";"SILVA (only NR);Eukaryota;Archaeplastida;Chloroplastida;Charophyta;Phragmoplastophyta;Streptophyta;Embryophyta;Tracheophyta;Monilophyta;Osmundales;Osmundastrum;";"0.0";"0";"2";"2";"0";"2";"0";"430522";"5766"
"LOK1378_1mm";"SILVA (only NR);Eukaryota;Archaeplastida;Chloroplastida;Charophyta;Phragmoplastophyta;Streptophyta;Embryophyta;Tracheophyta;Monilophyta;Polypodiales;";"0.0";"0";"9";"8";"0";"8";"1";"430516";"5766"
"LOK1378_1mm";"SILVA (only NR);Eukaryota;Archaeplastida;Chloroplastida;Charophyta;Phragmoplastophyta;Streptophyta;Embryophyta;Tracheophyta;Monilophyta;Polypodiales;Adiantum;";"0.0";"0";"1";"1";"0";"1";"0";"430523";"5766"
"LOK1378_1mm";"SILVA (only NR);Eukaryota;Archaeplastida;Chloroplastida;Charophyta;Phragmoplastophyta;Streptophyta;Embryophyta;Tracheophyta;Monilophyta;Polypodiales;Asplenium;";"0.0";"0";"1";"1";"0";"1";"0";"430523";"5766"
"LOK1378_1mm";"SILVA (only NR);Eukaryota;Archaeplastida;Chloroplastida;Charophyta;Phragmoplastophyta;Streptophyta;Embryophyta;Tracheophyta;Monilophyta;Polypodiales;Dryopteris;";"0.0";"0";"1";"1";"0";"1";"0";"430523";"5766"
"LOK1378_1mm";"SILVA (only NR);Eukaryota;Archaeplastida;Chloroplastida;Charophyta;Phragmoplastophyta;Streptophyta;Embryophyta;Tracheophyta;Monilophyta;Polypodiales;Lindsaea;";"0.0";"0";"1";"0";"0";"0";"1";"430524";"5766"
"LOK1378_1mm";"SILVA (only NR);Eukaryota;Archaeplastida;Chloroplastida;Charophyta;Phragmoplastophyta;Streptophyta;Embryophyta;Tracheophyta;Monilophyta;Polypodiales;Lonchitis;";"0.0";"0";"1";"1";"0";"1";"0";"430523";"5766"
"LOK1378_1mm";"SILVA (only NR);Eukaryota;Archaeplastida;Chloroplastida;Charophyta;Phragmoplastophyta;Streptophyta;Embryophyta;Tracheophyta;Monilophyta;Polypodiales;Odontosoria;";"0.0";"0";"1";"1";"0";"1";"0";"430523";"5766"
"LOK1378_1mm";"SILVA (only NR);Eukaryota;Archaeplastida;Chloroplastida;Charophyta;Phragmoplastophyta;Streptophyta;Embryophyta;Tracheophyta;Monilophyta;Polypodiales;Polypodium;";"0.0";"0";"1";"1";"0";"1";"0";"430523";"5766"
"LOK1378_1mm";"SILVA (only NR);Eukaryota;Archaeplastida;Chloroplastida;Charophyta;Phragmoplastophyta;Streptophyta;Embryophyta;Tracheophyta;Monilophyta;Polypodiales;Pteridium;";"0.0";"0";"1";"1";"0";"1";"0";"430523";"5766"
"LOK1378_1mm";"SILVA (only NR);Eukaryota;Archaeplastida;Chloroplastida;Charophyta;Phragmoplastophyta;Streptophyta;Embryophyta;Tracheophyta;Monilophyta;Polypodiales;Vittaria;";"0.0";"0";"1";"1";"0";"1";"0";"430523";"5766"
"LOK1378_1mm";"SILVA (only NR);Eukaryota;Archaeplastida;Chloroplastida;Charophyta;Phragmoplastophyta;Streptophyta;Embryophyta;Tracheophyta;Monilophyta;Psilotales;";"0.0";"0";"4";"4";"0";"4";"0";"430520";"5766"
"LOK1378_1mm";"SILVA (only NR);Eukaryota;Archaeplastida;Chloroplastida;Charophyta;Phragmoplastophyta;Streptophyta;Embryophyta;Tracheophyta;Monilophyta;Psilotales;Psilotum;";"0.0";"0";"3";"3";"0";"3";"0";"430521";"5766"
"LOK1378_1mm";"SILVA (only NR);Eukaryota;Archaeplastida;Chloroplastida;Charophyta;Phragmoplastophyta;Streptophyta;Embryophyta;Tracheophyta;Monilophyta;Psilotales;Tmesipteris;";"0.0";"0";"1";"1";"0";"1";"0";"430523";"5766"
"LOK1378_1mm";"SILVA (only NR);Eukaryota;Archaeplastida;Chloroplastida;Charophyta;Phragmoplastophyta;Streptophyta;Embryophyta;Tracheophyta;Monilophyta;Salviniales;";"0.0";"0";"5";"5";"0";"5";"0";"430519";"5766"
"LOK1378_1mm";"SILVA (only NR);Eukaryota;Archaeplastida;Chloroplastida;Charophyta;Phragmoplastophyta;Streptophyta;Embryophyta;Tracheophyta;Monilophyta;Salviniales;Azolla;";"0.0";"0";"1";"1";"0";"1";"0";"430523";"5766"
"LOK1378_1mm";"SILVA (only NR);Eukaryota;Archaeplastida;Chloroplastida;Charophyta;Phragmoplastophyta;Streptophyta;Embryophyta;Tracheophyta;Monilophyta;Salviniales;Marsilea;";"0.0";"0";"2";"2";"0";"2";"0";"430522";"5766"
"LOK1378_1mm";"SILVA (only NR);Eukaryota;Archaeplastida;Chloroplastida;Charophyta;Phragmoplastophyta;Streptophyta;Embryophyta;Tracheophyta;Monilophyta;Salviniales;Pilularia;";"0.0";"0";"1";"1";"0";"1";"0";"430523";"5766"
"LOK1378_1mm";"SILVA (only NR);Eukaryota;Archaeplastida;Chloroplastida;Charophyta;Phragmoplastophyta;Streptophyta;Embryophyta;Tracheophyta;Monilophyta;Salviniales;Salvinia;";"0.0";"0";"1";"1";"0";"1";"0";"430523";"5766"
"LOK1378_1mm";"SILVA (only NR);Eukaryota;Archaeplastida;Chloroplastida;Charophyta;Phragmoplastophyta;Streptophyta;Embryophyta;Tracheophyta;Monilophyta;Schizaeales;";"0.0";"0";"2";"2";"0";"2";"0";"430522";"5766"
"LOK1378_1mm";"SILVA (only NR);Eukaryota;Archaeplastida;Chloroplastida;Charophyta;Phragmoplastophyta;Streptophyta;Embryophyta;Tracheophyta;Monilophyta;Schizaeales;Lygodium;";"0.0";"0";"1";"1";"0";"1";"0";"430523";"5766"
"LOK1378_1mm";"SILVA (only NR);Eukaryota;Archaeplastida;Chloroplastida;Charophyta;Phragmoplastophyta;Streptophyta;Embryophyta;Tracheophyta;Monilophyta;Schizaeales;Schizaea;";"0.0";"0";"1";"1";"0";"1";"0";"430523";"5766"
"LOK1378_1mm";"SILVA (only NR);Eukaryota;Archaeplastida;Chloroplastida;Charophyta;Phragmoplastophyta;Streptophyta;Embryophyta;Tracheophyta;Spermatophyta;";"0.0";"0";"4277";"3955";"0";"3955";"322";"426569";"5766"
"LOK1378_1mm";"SILVA (only NR);Eukaryota;Archaeplastida;Chloroplastida;Charophyta;Phragmoplastophyta;Streptophyta;Embryophyta;Tracheophyta;Spermatophyta;Cycadophyta;";"0.0";"0";"9";"9";"0";"9";"0";"430515";"5766"
"LOK1378_1mm";"SILVA (only NR);Eukaryota;Archaeplastida;Chloroplastida;Charophyta;Phragmoplastophyta;Streptophyta;Embryophyta;Tracheophyta;Spermatophyta;Cycadophyta;Cycadales;";"0.0";"0";"9";"9";"0";"9";"0";"430515";"5766"
"LOK1378_1mm";"SILVA (only NR);Eukaryota;Archaeplastida;Chloroplastida;Charophyta;Phragmoplastophyta;Streptophyta;Embryophyta;Tracheophyta;Spermatophyta;Cycadophyta;Cycadales;Bowenia;";"0.0";"0";"1";"1";"0";"1";"0";"430523";"5766"
"LOK1378_1mm";"SILVA (only NR);Eukaryota;Archaeplastida;Chloroplastida;Charophyta;Phragmoplastophyta;Streptophyta;Embryophyta;Tracheophyta;Spermatophyta;Cycadophyta;Cycadales;Ceratozamia;";"0.0";"0";"1";"1";"0";"1";"0";"430523";"5766"
"LOK1378_1mm";"SILVA (only NR);Eukaryota;Archaeplastida;Chloroplastida;Charophyta;Phragmoplastophyta;Streptophyta;Embryophyta;Tracheophyta;Spermatophyta;Cycadophyta;Cycadales;Cycas;";"0.0";"0";"1";"1";"0";"1";"0";"430523";"5766"
"LOK1378_1mm";"SILVA (only NR);Eukaryota;Archaeplastida;Chloroplastida;Charophyta;Phragmoplastophyta;Streptophyta;Embryophyta;Tracheophyta;Spermatophyta;Cycadophyta;Cycadales;Dioon;";"0.0";"0";"1";"1";"0";"1";"0";"430523";"5766"
"LOK1378_1mm";"SILVA (only NR);Eukaryota;Archaeplastida;Chloroplastida;Charophyta;Phragmoplastophyta;Streptophyta;Embryophyta;Tracheophyta;Spermatophyta;Cycadophyta;Cycadales;Encephalartos;";"0.0";"0";"1";"1";"0";"1";"0";"430523";"5766"
"LOK1378_1mm";"SILVA (only NR);Eukaryota;Archaeplastida;Chloroplastida;Charophyta;Phragmoplastophyta;Streptophyta;Embryophyta;Tracheophyta;Spermatophyta;Cycadophyta;Cycadales;Lepidozamia;";"0.0";"0";"1";"1";"0";"1";"0";"430523";"5766"
"LOK1378_1mm";"SILVA (only NR);Eukaryota;Archaeplastida;Chloroplastida;Charophyta;Phragmoplastophyta;Streptophyta;Embryophyta;Tracheophyta;Spermatophyta;Cycadophyta;Cycadales;Macrozamia;";"0.0";"0";"1";"1";"0";"1";"0";"430523";"5766"
"LOK1378_1mm";"SILVA (only NR);Eukaryota;Archaeplastida;Chloroplastida;Charophyta;Phragmoplastophyta;Streptophyta;Embryophyta;Tracheophyta;Spermatophyta;Cycadophyta;Cycadales;Stangeria;";"0.0";"0";"1";"1";"0";"1";"0";"430523";"5766"
"LOK1378_1mm";"SILVA (only NR);Eukaryota;Archaeplastida;Chloroplastida;Charophyta;Phragmoplastophyta;Streptophyta;Embryophyta;Tracheophyta;Spermatophyta;Cycadophyta;Cycadales;Zamia;";"0.0";"0";"1";"1";"0";"1";"0";"430523";"5766"
"LOK1378_1mm";"SILVA (only NR);Eukaryota;Archaeplastida;Chloroplastida;Charophyta;Phragmoplastophyta;Streptophyta;Embryophyta;Tracheophyta;Spermatophyta;Ginkgoidae;";"0.0";"0";"1";"1";"0";"1";"0";"430523";"5766"
"LOK1378_1mm";"SILVA (only NR);Eukaryota;Archaeplastida;Chloroplastida;Charophyta;Phragmoplastophyta;Streptophyta;Embryophyta;Tracheophyta;Spermatophyta;Ginkgoidae;Ginkgoales;";"0.0";"0";"1";"1";"0";"1";"0";"430523";"5766"
"LOK1378_1mm";"SILVA (only NR);Eukaryota;Archaeplastida;Chloroplastida;Charophyta;Phragmoplastophyta;Streptophyta;Embryophyta;Tracheophyta;Spermatophyta;Ginkgoidae;Ginkgoales;Ginkgo;";"0.0";"0";"1";"1";"0";"1";"0";"430523";"5766"
"LOK1378_1mm";"SILVA (only NR);Eukaryota;Archaeplastida;Chloroplastida;Charophyta;Phragmoplastophyta;Streptophyta;Embryophyta;Tracheophyta;Spermatophyta;Gnetophyta;";"0.0";"0";"8";"7";"0";"7";"1";"430517";"5766"
"LOK1378_1mm";"SILVA (only NR);Eukaryota;Archaeplastida;Chloroplastida;Charophyta;Phragmoplastophyta;Streptophyta;Embryophyta;Tracheophyta;Spermatophyta;Gnetophyta;Ephedra;";"0.0";"0";"1";"1";"0";"1";"0";"430523";"5766"
"LOK1378_1mm";"SILVA (only NR);Eukaryota;Archaeplastida;Chloroplastida;Charophyta;Phragmoplastophyta;Streptophyta;Embryophyta;Tracheophyta;Spermatophyta;Gnetophyta;Gnetales;";"0.0";"0";"6";"5";"0";"5";"1";"430519";"5766"
"LOK1378_1mm";"SILVA (only NR);Eukaryota;Archaeplastida;Chloroplastida;Charophyta;Phragmoplastophyta;Streptophyta;Embryophyta;Tracheophyta;Spermatophyta;Gnetophyta;Gnetales;Gnetaceae;";"0.0";"0";"6";"5";"0";"5";"1";"430519";"5766"
"LOK1378_1mm";"SILVA (only NR);Eukaryota;Archaeplastida;Chloroplastida;Charophyta;Phragmoplastophyta;Streptophyta;Embryophyta;Tracheophyta;Spermatophyta;Gnetophyta;Gnetales;Gnetaceae;Gnetum;";"0.0";"0";"6";"5";"0";"5";"1";"430519";"5766"
"LOK1378_1mm";"SILVA (only NR);Eukaryota;Archaeplastida;Chloroplastida;Charophyta;Phragmoplastophyta;Streptophyta;Embryophyta;Tracheophyta;Spermatophyta;Gnetophyta;Welwitschiales;";"0.0";"0";"1";"1";"0";"1";"0";"430523";"5766"
"LOK1378_1mm";"SILVA (only NR);Eukaryota;Archaeplastida;Chloroplastida;Charophyta;Phragmoplastophyta;Streptophyta;Embryophyta;Tracheophyta;Spermatophyta;Gnetophyta;Welwitschiales;Welwitschia;";"0.0";"0";"1";"1";"0";"1";"0";"430523";"5766"
"LOK1378_1mm";"SILVA (only NR);Eukaryota;Archaeplastida;Chloroplastida;Charophyta;Phragmoplastophyta;Streptophyta;Embryophyta;Tracheophyta;Spermatophyta;Magnoliophyta;";"0.0";"0";"3572";"3313";"0";"3313";"259";"427211";"5766"
"LOK1378_1mm";"SILVA (only NR);Eukaryota;Archaeplastida;Chloroplastida;Charophyta;Phragmoplastophyta;Streptophyta;Embryophyta;Tracheophyta;Spermatophyta;Magnoliophyta;Amborellales;";"0.0";"0";"10";"9";"0";"9";"1";"430515";"5766"
"LOK1378_1mm";"SILVA (only NR);Eukaryota;Archaeplastida;Chloroplastida;Charophyta;Phragmoplastophyta;Streptophyta;Embryophyta;Tracheophyta;Spermatophyta;Magnoliophyta;Amborellales;Amborella;";"0.0";"0";"10";"9";"0";"9";"1";"430515";"5766"
"LOK1378_1mm";"SILVA (only NR);Eukaryota;Archaeplastida;Chloroplastida;Charophyta;Phragmoplastophyta;Streptophyta;Embryophyta;Tracheophyta;Spermatophyta;Magnoliophyta;Apiales;";"0.0";"0";"13";"13";"0";"13";"0";"430511";"5766"
"LOK1378_1mm";"SILVA (only NR);Eukaryota;Archaeplastida;Chloroplastida;Charophyta;Phragmoplastophyta;Streptophyta;Embryophyta;Tracheophyta;Spermatophyta;Magnoliophyta;Apiales;Azorella;";"0.0";"0";"1";"1";"0";"1";"0";"430523";"5766"
"LOK1378_1mm";"SILVA (only NR);Eukaryota;Archaeplastida;Chloroplastida;Charophyta;Phragmoplastophyta;Streptophyta;Embryophyta;Tracheophyta;Spermatophyta;Magnoliophyta;Apiales;Billardiera;";"0.0";"0";"1";"1";"0";"1";"0";"430523";"5766"
"LOK1378_1mm";"SILVA (only NR);Eukaryota;Archaeplastida;Chloroplastida;Charophyta;Phragmoplastophyta;Streptophyta;Embryophyta;Tracheophyta;Spermatophyta;Magnoliophyta;Apiales;Bupleurum;";"0.0";"0";"1";"1";"0";"1";"0";"430523";"5766"
"LOK1378_1mm";"SILVA (only NR);Eukaryota;Archaeplastida;Chloroplastida;Charophyta;Phragmoplastophyta;Streptophyta;Embryophyta;Tracheophyta;Spermatophyta;Magnoliophyta;Apiales;Cnidium;";"0.0";"0";"1";"1";"0";"1";"0";"430523";"5766"
"LOK1378_1mm";"SILVA (only NR);Eukaryota;Archaeplastida;Chloroplastida;Charophyta;Phragmoplastophyta;Streptophyta;Embryophyta;Tracheophyta;Spermatophyta;Magnoliophyta;Apiales;Daucus;";"0.0";"0";"1";"1";"0";"1";"0";"430523";"5766"
"LOK1378_1mm";"SILVA (only NR);Eukaryota;Archaeplastida;Chloroplastida;Charophyta;Phragmoplastophyta;Streptophyta;Embryophyta;Tracheophyta;Spermatophyta;Magnoliophyta;Apiales;Heracleum;";"0.0";"0";"1";"1";"0";"1";"0";"430523";"5766"
"LOK1378_1mm";"SILVA (only NR);Eukaryota;Archaeplastida;Chloroplastida;Charophyta;Phragmoplastophyta;Streptophyta;Embryophyta;Tracheophyta;Spermatophyta;Magnoliophyta;Apiales;Mackinlaya;";"0.0";"0";"1";"1";"0";"1";"0";"430523";"5766"
"LOK1378_1mm";"SILVA (only NR);Eukaryota;Archaeplastida;Chloroplastida;Charophyta;Phragmoplastophyta;Streptophyta;Embryophyta;Tracheophyta;Spermatophyta;Magnoliophyta;Apiales;Melanophylla;";"0.0";"0";"1";"1";"0";"1";"0";"430523";"5766"
"LOK1378_1mm";"SILVA (only NR);Eukaryota;Archaeplastida;Chloroplastida;Charophyta;Phragmoplastophyta;Streptophyta;Embryophyta;Tracheophyta;Spermatophyta;Magnoliophyta;Apiales;Panax;";"0.0";"0";"3";"3";"0";"3";"0";"430521";"5766"
"LOK1378_1mm";"SILVA (only NR);Eukaryota;Archaeplastida;Chloroplastida;Charophyta;Phragmoplastophyta;Streptophyta;Embryophyta;Tracheophyta;Spermatophyta;Magnoliophyta;Apiales;Peucedanum;";"0.0";"0";"1";"1";"0";"1";"0";"430523";"5766"
"LOK1378_1mm";"SILVA (only NR);Eukaryota;Archaeplastida;Chloroplastida;Charophyta;Phragmoplastophyta;Streptophyta;Embryophyta;Tracheophyta;Spermatophyta;Magnoliophyta;Apiales;Pimpinella;";"0.0";"0";"1";"1";"0";"1";"0";"430523";"5766"
"LOK1378_1mm";"SILVA (only NR);Eukaryota;Archaeplastida;Chloroplastida;Charophyta;Phragmoplastophyta;Streptophyta;Embryophyta;Tracheophyta;Spermatophyta;Magnoliophyta;Aquifoliales;";"0.0";"0";"5";"5";"0";"5";"0";"430519";"5766"
"LOK1378_1mm";"SILVA (only NR);Eukaryota;Archaeplastida;Chloroplastida;Charophyta;Phragmoplastophyta;Streptophyta;Embryophyta;Tracheophyta;Spermatophyta;Magnoliophyta;Aquifoliales;Cardiopteris;";"0.0";"0";"1";"1";"0";"1";"0";"430523";"5766"
"LOK1378_1mm";"SILVA (only NR);Eukaryota;Archaeplastida;Chloroplastida;Charophyta;Phragmoplastophyta;Streptophyta;Embryophyta;Tracheophyta;Spermatophyta;Magnoliophyta;Aquifoliales;Gonocaryum;";"0.0";"0";"1";"1";"0";"1";"0";"430523";"5766"
"LOK1378_1mm";"SILVA (only NR);Eukaryota;Archaeplastida;Chloroplastida;Charophyta;Phragmoplastophyta;Streptophyta;Embryophyta;Tracheophyta;Spermatophyta;Magnoliophyta;Aquifoliales;Helwingia;";"0.0";"0";"1";"1";"0";"1";"0";"430523";"5766"
"LOK1378_1mm";"SILVA (only NR);Eukaryota;Archaeplastida;Chloroplastida;Charophyta;Phragmoplastophyta;Streptophyta;Embryophyta;Tracheophyta;Spermatophyta;Magnoliophyta;Aquifoliales;Ilex;";"0.0";"0";"1";"1";"0";"1";"0";"430523";"5766"
"LOK1378_1mm";"SILVA (only NR);Eukaryota;Archaeplastida;Chloroplastida;Charophyta;Phragmoplastophyta;Streptophyta;Embryophyta;Tracheophyta;Spermatophyta;Magnoliophyta;Aquifoliales;Phyllonoma;";"0.0";"0";"1";"1";"0";"1";"0";"430523";"5766"
"LOK1378_1mm";"SILVA (only NR);Eukaryota;Archaeplastida;Chloroplastida;Charophyta;Phragmoplastophyta;Streptophyta;Embryophyta;Tracheophyta;Spermatophyta;Magnoliophyta;Asterales;";"0.0";"0";"80";"79";"0";"79";"1";"430445";"5766"
"LOK1378_1mm";"SILVA (only NR);Eukaryota;Archaeplastida;Chloroplastida;Charophyta;Phragmoplastophyta;Streptophyta;Embryophyta;Tracheophyta;Spermatophyta;Magnoliophyta;Asterales;Alseuosmia;";"0.0";"0";"1";"1";"0";"1";"0";"430523";"5766"
"LOK1378_1mm";"SILVA (only NR);Eukaryota;Archaeplastida;Chloroplastida;Charophyta;Phragmoplastophyta;Streptophyta;Embryophyta;Tracheophyta;Spermatophyta;Magnoliophyta;Asterales;Atractylodes;";"0.0";"0";"1";"1";"0";"1";"0";"430523";"5766"
"LOK1378_1mm";"SILVA (only NR);Eukaryota;Archaeplastida;Chloroplastida;Charophyta;Phragmoplastophyta;Streptophyta;Embryophyta;Tracheophyta;Spermatophyta;Magnoliophyta;Asterales;Barnadesia;";"0.0";"0";"1";"1";"0";"1";"0";"430523";"5766"
"LOK1378_1mm";"SILVA (only NR);Eukaryota;Archaeplastida;Chloroplastida;Charophyta;Phragmoplastophyta;Streptophyta;Embryophyta;Tracheophyta;Spermatophyta;Magnoliophyta;Asterales;Campanula;";"0.0";"0";"1";"1";"0";"1";"0";"430523";"5766"
"LOK1378_1mm";"SILVA (only NR);Eukaryota;Archaeplastida;Chloroplastida;Charophyta;Phragmoplastophyta;Streptophyta;Embryophyta;Tracheophyta;Spermatophyta;Magnoliophyta;Asterales;Carpodetus;";"0.0";"0";"1";"1";"0";"1";"0";"430523";"5766"
"LOK1378_1mm";"SILVA (only NR);Eukaryota;Archaeplastida;Chloroplastida;Charophyta;Phragmoplastophyta;Streptophyta;Embryophyta;Tracheophyta;Spermatophyta;Magnoliophyta;Asterales;Codonopsis;";"0.0";"0";"1";"1";"0";"1";"0";"430523";"5766"
"LOK1378_1mm";"SILVA (only NR);Eukaryota;Archaeplastida;Chloroplastida;Charophyta;Phragmoplastophyta;Streptophyta;Embryophyta;Tracheophyta;Spermatophyta;Magnoliophyta;Asterales;Cynara;";"0.0";"0";"3";"3";"0";"3";"0";"430521";"5766"
"LOK1378_1mm";"SILVA (only NR);Eukaryota;Archaeplastida;Chloroplastida;Charophyta;Phragmoplastophyta;Streptophyta;Embryophyta;Tracheophyta;Spermatophyta;Magnoliophyta;Asterales;Dahlia;";"0.0";"0";"1";"1";"0";"1";"0";"430523";"5766"
"LOK1378_1mm";"SILVA (only NR);Eukaryota;Archaeplastida;Chloroplastida;Charophyta;Phragmoplastophyta;Streptophyta;Embryophyta;Tracheophyta;Spermatophyta;Magnoliophyta;Asterales;Donatia;";"0.0";"0";"1";"1";"0";"1";"0";"430523";"5766"
"LOK1378_1mm";"SILVA (only NR);Eukaryota;Archaeplastida;Chloroplastida;Charophyta;Phragmoplastophyta;Streptophyta;Embryophyta;Tracheophyta;Spermatophyta;Magnoliophyta;Asterales;Helianthus;";"0.0";"0";"58";"57";"0";"57";"1";"430467";"5766"
"LOK1378_1mm";"SILVA (only NR);Eukaryota;Archaeplastida;Chloroplastida;Charophyta;Phragmoplastophyta;Streptophyta;Embryophyta;Tracheophyta;Spermatophyta;Magnoliophyta;Asterales;Heliopsis;";"0.0";"0";"1";"1";"0";"1";"0";"430523";"5766"
"LOK1378_1mm";"SILVA (only NR);Eukaryota;Archaeplastida;Chloroplastida;Charophyta;Phragmoplastophyta;Streptophyta;Embryophyta;Tracheophyta;Spermatophyta;Magnoliophyta;Asterales;Lactuca;";"0.0";"0";"1";"1";"0";"1";"0";"430523";"5766"
"LOK1378_1mm";"SILVA (only NR);Eukaryota;Archaeplastida;Chloroplastida;Charophyta;Phragmoplastophyta;Streptophyta;Embryophyta;Tracheophyta;Spermatophyta;Magnoliophyta;Asterales;Lobelia;";"0.0";"0";"1";"1";"0";"1";"0";"430523";"5766"
"LOK1378_1mm";"SILVA (only NR);Eukaryota;Archaeplastida;Chloroplastida;Charophyta;Phragmoplastophyta;Streptophyta;Embryophyta;Tracheophyta;Spermatophyta;Magnoliophyta;Asterales;Megalodonta;";"0.0";"0";"1";"1";"0";"1";"0";"430523";"5766"
"LOK1378_1mm";"SILVA (only NR);Eukaryota;Archaeplastida;Chloroplastida;Charophyta;Phragmoplastophyta;Streptophyta;Embryophyta;Tracheophyta;Spermatophyta;Magnoliophyta;Asterales;Menyanthes;";"0.0";"0";"1";"1";"0";"1";"0";"430523";"5766"
"LOK1378_1mm";"SILVA (only NR);Eukaryota;Archaeplastida;Chloroplastida;Charophyta;Phragmoplastophyta;Streptophyta;Embryophyta;Tracheophyta;Spermatophyta;Magnoliophyta;Asterales;Myodocarpus;";"0.0";"0";"1";"1";"0";"1";"0";"430523";"5766"
"LOK1378_1mm";"SILVA (only NR);Eukaryota;Archaeplastida;Chloroplastida;Charophyta;Phragmoplastophyta;Streptophyta;Embryophyta;Tracheophyta;Spermatophyta;Magnoliophyta;Asterales;Nymphoides;";"0.0";"0";"1";"1";"0";"1";"0";"430523";"5766"
"LOK1378_1mm";"SILVA (only NR);Eukaryota;Archaeplastida;Chloroplastida;Charophyta;Phragmoplastophyta;Streptophyta;Embryophyta;Tracheophyta;Spermatophyta;Magnoliophyta;Asterales;Pentaphragma;";"0.0";"0";"1";"1";"0";"1";"0";"430523";"5766"
"LOK1378_1mm";"SILVA (only NR);Eukaryota;Archaeplastida;Chloroplastida;Charophyta;Phragmoplastophyta;Streptophyta;Embryophyta;Tracheophyta;Spermatophyta;Magnoliophyta;Asterales;Roussea;";"0.0";"0";"1";"1";"0";"1";"0";"430523";"5766"
"LOK1378_1mm";"SILVA (only NR);Eukaryota;Archaeplastida;Chloroplastida;Charophyta;Phragmoplastophyta;Streptophyta;Embryophyta;Tracheophyta;Spermatophyta;Magnoliophyta;Asterales;Rudbeckia;";"0.0";"0";"1";"1";"0";"1";"0";"430523";"5766"
"LOK1378_1mm";"SILVA (only NR);Eukaryota;Archaeplastida;Chloroplastida;Charophyta;Phragmoplastophyta;Streptophyta;Embryophyta;Tracheophyta;Spermatophyta;Magnoliophyta;Asterales;Stylidium;";"0.0";"0";"1";"1";"0";"1";"0";"430523";"5766"
"LOK1378_1mm";"SILVA (only NR);Eukaryota;Archaeplastida;Chloroplastida;Charophyta;Phragmoplastophyta;Streptophyta;Embryophyta;Tracheophyta;Spermatophyta;Magnoliophyta;Austrobaileyales;";"0.0";"0";"2";"2";"0";"2";"0";"430522";"5766"
"LOK1378_1mm";"SILVA (only NR);Eukaryota;Archaeplastida;Chloroplastida;Charophyta;Phragmoplastophyta;Streptophyta;Embryophyta;Tracheophyta;Spermatophyta;Magnoliophyta;Austrobaileyales;Austrobaileya;";"0.0";"0";"1";"1";"0";"1";"0";"430523";"5766"
"LOK1378_1mm";"SILVA (only NR);Eukaryota;Archaeplastida;Chloroplastida;Charophyta;Phragmoplastophyta;Streptophyta;Embryophyta;Tracheophyta;Spermatophyta;Magnoliophyta;Austrobaileyales;Kadsura;";"0.0";"0";"1";"1";"0";"1";"0";"430523";"5766"
"LOK1378_1mm";"SILVA (only NR);Eukaryota;Archaeplastida;Chloroplastida;Charophyta;Phragmoplastophyta;Streptophyta;Embryophyta;Tracheophyta;Spermatophyta;Magnoliophyta;Berberidopsidales;";"0.0";"0";"1";"1";"0";"1";"0";"430523";"5766"
"LOK1378_1mm";"SILVA (only NR);Eukaryota;Archaeplastida;Chloroplastida;Charophyta;Phragmoplastophyta;Streptophyta;Embryophyta;Tracheophyta;Spermatophyta;Magnoliophyta;Berberidopsidales;Aextoxicon;";"0.0";"0";"1";"1";"0";"1";"0";"430523";"5766"
"LOK1378_1mm";"SILVA (only NR);Eukaryota;Archaeplastida;Chloroplastida;Charophyta;Phragmoplastophyta;Streptophyta;Embryophyta;Tracheophyta;Spermatophyta;Magnoliophyta;Boraginales;";"0.0";"0";"6";"6";"0";"6";"0";"430518";"5766"
"LOK1378_1mm";"SILVA (only NR);Eukaryota;Archaeplastida;Chloroplastida;Charophyta;Phragmoplastophyta;Streptophyta;Embryophyta;Tracheophyta;Spermatophyta;Magnoliophyta;Boraginales;Borago;";"0.0";"0";"1";"1";"0";"1";"0";"430523";"5766"
"LOK1378_1mm";"SILVA (only NR);Eukaryota;Archaeplastida;Chloroplastida;Charophyta;Phragmoplastophyta;Streptophyta;Embryophyta;Tracheophyta;Spermatophyta;Magnoliophyta;Boraginales;Cryptantha;";"0.0";"0";"1";"1";"0";"1";"0";"430523";"5766"
"LOK1378_1mm";"SILVA (only NR);Eukaryota;Archaeplastida;Chloroplastida;Charophyta;Phragmoplastophyta;Streptophyta;Embryophyta;Tracheophyta;Spermatophyta;Magnoliophyta;Boraginales;Ehretia;";"0.0";"0";"1";"1";"0";"1";"0";"430523";"5766"
"LOK1378_1mm";"SILVA (only NR);Eukaryota;Archaeplastida;Chloroplastida;Charophyta;Phragmoplastophyta;Streptophyta;Embryophyta;Tracheophyta;Spermatophyta;Magnoliophyta;Boraginales;Ellisia;";"0.0";"0";"1";"1";"0";"1";"0";"430523";"5766"
"LOK1378_1mm";"SILVA (only NR);Eukaryota;Archaeplastida;Chloroplastida;Charophyta;Phragmoplastophyta;Streptophyta;Embryophyta;Tracheophyta;Spermatophyta;Magnoliophyta;Boraginales;Lithospermum;";"0.0";"0";"1";"1";"0";"1";"0";"430523";"5766"
"LOK1378_1mm";"SILVA (only NR);Eukaryota;Archaeplastida;Chloroplastida;Charophyta;Phragmoplastophyta;Streptophyta;Embryophyta;Tracheophyta;Spermatophyta;Magnoliophyta;Boraginales;Pholisma;";"0.0";"0";"1";"1";"0";"1";"0";"430523";"5766"
"LOK1378_1mm";"SILVA (only NR);Eukaryota;Archaeplastida;Chloroplastida;Charophyta;Phragmoplastophyta;Streptophyta;Embryophyta;Tracheophyta;Spermatophyta;Magnoliophyta;Brassicales;";"0.0";"0";"232";"215";"0";"215";"17";"430309";"5766"
"LOK1378_1mm";"SILVA (only NR);Eukaryota;Archaeplastida;Chloroplastida;Charophyta;Phragmoplastophyta;Streptophyta;Embryophyta;Tracheophyta;Spermatophyta;Magnoliophyta;Brassicales;Aethionema;";"0.0";"0";"1";"1";"0";"1";"0";"430523";"5766"
"LOK1378_1mm";"SILVA (only NR);Eukaryota;Archaeplastida;Chloroplastida;Charophyta;Phragmoplastophyta;Streptophyta;Embryophyta;Tracheophyta;Spermatophyta;Magnoliophyta;Brassicales;Arabidopsis;";"0.0";"0";"99";"96";"0";"96";"3";"430428";"5766"
"LOK1378_1mm";"SILVA (only NR);Eukaryota;Archaeplastida;Chloroplastida;Charophyta;Phragmoplastophyta;Streptophyta;Embryophyta;Tracheophyta;Spermatophyta;Magnoliophyta;Brassicales;Arabis;";"0.0";"0";"1";"1";"0";"1";"0";"430523";"5766"
"LOK1378_1mm";"SILVA (only NR);Eukaryota;Archaeplastida;Chloroplastida;Charophyta;Phragmoplastophyta;Streptophyta;Embryophyta;Tracheophyta;Spermatophyta;Magnoliophyta;Brassicales;Batis;";"0.0";"0";"1";"1";"0";"1";"0";"430523";"5766"
"LOK1378_1mm";"SILVA (only NR);Eukaryota;Archaeplastida;Chloroplastida;Charophyta;Phragmoplastophyta;Streptophyta;Embryophyta;Tracheophyta;Spermatophyta;Magnoliophyta;Brassicales;Brassica;";"0.0";"0";"86";"74";"0";"74";"12";"430450";"5766"
"LOK1378_1mm";"SILVA (only NR);Eukaryota;Archaeplastida;Chloroplastida;Charophyta;Phragmoplastophyta;Streptophyta;Embryophyta;Tracheophyta;Spermatophyta;Magnoliophyta;Brassicales;Camelina;";"0.0";"0";"2";"2";"0";"2";"0";"430522";"5766"
"LOK1378_1mm";"SILVA (only NR);Eukaryota;Archaeplastida;Chloroplastida;Charophyta;Phragmoplastophyta;Streptophyta;Embryophyta;Tracheophyta;Spermatophyta;Magnoliophyta;Brassicales;Capparis;";"0.0";"0";"1";"1";"0";"1";"0";"430523";"5766"
"LOK1378_1mm";"SILVA (only NR);Eukaryota;Archaeplastida;Chloroplastida;Charophyta;Phragmoplastophyta;Streptophyta;Embryophyta;Tracheophyta;Spermatophyta;Magnoliophyta;Brassicales;Carica;";"0.0";"0";"1";"1";"0";"1";"0";"430523";"5766"
"LOK1378_1mm";"SILVA (only NR);Eukaryota;Archaeplastida;Chloroplastida;Charophyta;Phragmoplastophyta;Streptophyta;Embryophyta;Tracheophyta;Spermatophyta;Magnoliophyta;Brassicales;Chorispora;";"0.0";"0";"1";"1";"0";"1";"0";"430523";"5766"
"LOK1378_1mm";"SILVA (only NR);Eukaryota;Archaeplastida;Chloroplastida;Charophyta;Phragmoplastophyta;Streptophyta;Embryophyta;Tracheophyta;Spermatophyta;Magnoliophyta;Brassicales;Cleome;";"0.0";"0";"1";"1";"0";"1";"0";"430523";"5766"
"LOK1378_1mm";"SILVA (only NR);Eukaryota;Archaeplastida;Chloroplastida;Charophyta;Phragmoplastophyta;Streptophyta;Embryophyta;Tracheophyta;Spermatophyta;Magnoliophyta;Brassicales;Cleomella;";"0.0";"0";"1";"1";"0";"1";"0";"430523";"5766"
"LOK1378_1mm";"SILVA (only NR);Eukaryota;Archaeplastida;Chloroplastida;Charophyta;Phragmoplastophyta;Streptophyta;Embryophyta;Tracheophyta;Spermatophyta;Magnoliophyta;Brassicales;Conringia;";"0.0";"0";"6";"5";"0";"5";"1";"430519";"5766"
"LOK1378_1mm";"SILVA (only NR);Eukaryota;Archaeplastida;Chloroplastida;Charophyta;Phragmoplastophyta;Streptophyta;Embryophyta;Tracheophyta;Spermatophyta;Magnoliophyta;Brassicales;Descurainia;";"0.0";"0";"1";"1";"0";"1";"0";"430523";"5766"
"LOK1378_1mm";"SILVA (only NR);Eukaryota;Archaeplastida;Chloroplastida;Charophyta;Phragmoplastophyta;Streptophyta;Embryophyta;Tracheophyta;Spermatophyta;Magnoliophyta;Brassicales;Eutrema;";"0.0";"0";"1";"1";"0";"1";"0";"430523";"5766"
"LOK1378_1mm";"SILVA (only NR);Eukaryota;Archaeplastida;Chloroplastida;Charophyta;Phragmoplastophyta;Streptophyta;Embryophyta;Tracheophyta;Spermatophyta;Magnoliophyta;Brassicales;Floerkea;";"0.0";"0";"1";"1";"0";"1";"0";"430523";"5766"
"LOK1378_1mm";"SILVA (only NR);Eukaryota;Archaeplastida;Chloroplastida;Charophyta;Phragmoplastophyta;Streptophyta;Embryophyta;Tracheophyta;Spermatophyta;Magnoliophyta;Brassicales;Gyrostemon;";"0.0";"0";"1";"1";"0";"1";"0";"430523";"5766"
"LOK1378_1mm";"SILVA (only NR);Eukaryota;Archaeplastida;Chloroplastida;Charophyta;Phragmoplastophyta;Streptophyta;Embryophyta;Tracheophyta;Spermatophyta;Magnoliophyta;Brassicales;Koeberlinia;";"0.0";"0";"1";"1";"0";"1";"0";"430523";"5766"
"LOK1378_1mm";"SILVA (only NR);Eukaryota;Archaeplastida;Chloroplastida;Charophyta;Phragmoplastophyta;Streptophyta;Embryophyta;Tracheophyta;Spermatophyta;Magnoliophyta;Brassicales;Lepidium;";"0.0";"0";"1";"1";"0";"1";"0";"430523";"5766"
"LOK1378_1mm";"SILVA (only NR);Eukaryota;Archaeplastida;Chloroplastida;Charophyta;Phragmoplastophyta;Streptophyta;Embryophyta;Tracheophyta;Spermatophyta;Magnoliophyta;Brassicales;Moringa;";"0.0";"0";"1";"1";"0";"1";"0";"430523";"5766"
"LOK1378_1mm";"SILVA (only NR);Eukaryota;Archaeplastida;Chloroplastida;Charophyta;Phragmoplastophyta;Streptophyta;Embryophyta;Tracheophyta;Spermatophyta;Magnoliophyta;Brassicales;Nasturtium;";"0.0";"0";"2";"1";"0";"1";"1";"430523";"5766"
"LOK1378_1mm";"SILVA (only NR);Eukaryota;Archaeplastida;Chloroplastida;Charophyta;Phragmoplastophyta;Streptophyta;Embryophyta;Tracheophyta;Spermatophyta;Magnoliophyta;Brassicales;Noccaea;";"0.0";"0";"1";"1";"0";"1";"0";"430523";"5766"
"LOK1378_1mm";"SILVA (only NR);Eukaryota;Archaeplastida;Chloroplastida;Charophyta;Phragmoplastophyta;Streptophyta;Embryophyta;Tracheophyta;Spermatophyta;Magnoliophyta;Brassicales;Pentadiplandra;";"0.0";"0";"1";"1";"0";"1";"0";"430523";"5766"
"LOK1378_1mm";"SILVA (only NR);Eukaryota;Archaeplastida;Chloroplastida;Charophyta;Phragmoplastophyta;Streptophyta;Embryophyta;Tracheophyta;Spermatophyta;Magnoliophyta;Brassicales;Physaria;";"0.0";"0";"1";"1";"0";"1";"0";"430523";"5766"
"LOK1378_1mm";"SILVA (only NR);Eukaryota;Archaeplastida;Chloroplastida;Charophyta;Phragmoplastophyta;Streptophyta;Embryophyta;Tracheophyta;Spermatophyta;Magnoliophyta;Brassicales;Raphanus;";"0.0";"0";"1";"1";"0";"1";"0";"430523";"5766"
"LOK1378_1mm";"SILVA (only NR);Eukaryota;Archaeplastida;Chloroplastida;Charophyta;Phragmoplastophyta;Streptophyta;Embryophyta;Tracheophyta;Spermatophyta;Magnoliophyta;Brassicales;Reseda;";"0.0";"0";"1";"1";"0";"1";"0";"430523";"5766"
"LOK1378_1mm";"SILVA (only NR);Eukaryota;Archaeplastida;Chloroplastida;Charophyta;Phragmoplastophyta;Streptophyta;Embryophyta;Tracheophyta;Spermatophyta;Magnoliophyta;Brassicales;Salvadora;";"0.0";"0";"1";"1";"0";"1";"0";"430523";"5766"
"LOK1378_1mm";"SILVA (only NR);Eukaryota;Archaeplastida;Chloroplastida;Charophyta;Phragmoplastophyta;Streptophyta;Embryophyta;Tracheophyta;Spermatophyta;Magnoliophyta;Brassicales;Schrenkiella;";"0.0";"0";"1";"1";"0";"1";"0";"430523";"5766"
"LOK1378_1mm";"SILVA (only NR);Eukaryota;Archaeplastida;Chloroplastida;Charophyta;Phragmoplastophyta;Streptophyta;Embryophyta;Tracheophyta;Spermatophyta;Magnoliophyta;Brassicales;Sinapis;";"0.0";"0";"1";"1";"0";"1";"0";"430523";"5766"
"LOK1378_1mm";"SILVA (only NR);Eukaryota;Archaeplastida;Chloroplastida;Charophyta;Phragmoplastophyta;Streptophyta;Embryophyta;Tracheophyta;Spermatophyta;Magnoliophyta;Brassicales;Tarenaya;";"0.0";"0";"11";"11";"0";"11";"0";"430513";"5766"
"LOK1378_1mm";"SILVA (only NR);Eukaryota;Archaeplastida;Chloroplastida;Charophyta;Phragmoplastophyta;Streptophyta;Embryophyta;Tracheophyta;Spermatophyta;Magnoliophyta;Brassicales;Thlaspi;";"0.0";"0";"2";"2";"0";"2";"0";"430522";"5766"
"LOK1378_1mm";"SILVA (only NR);Eukaryota;Archaeplastida;Chloroplastida;Charophyta;Phragmoplastophyta;Streptophyta;Embryophyta;Tracheophyta;Spermatophyta;Magnoliophyta;Brassicales;Tropaeolum;";"0.0";"0";"1";"1";"0";"1";"0";"430523";"5766"
"LOK1378_1mm";"SILVA (only NR);Eukaryota;Archaeplastida;Chloroplastida;Charophyta;Phragmoplastophyta;Streptophyta;Embryophyta;Tracheophyta;Spermatophyta;Magnoliophyta;Bruniales;";"0.0";"0";"1";"1";"0";"1";"0";"430523";"5766"
"LOK1378_1mm";"SILVA (only NR);Eukaryota;Archaeplastida;Chloroplastida;Charophyta;Phragmoplastophyta;Streptophyta;Embryophyta;Tracheophyta;Spermatophyta;Magnoliophyta;Bruniales;Berzelia;";"0.0";"0";"1";"1";"0";"1";"0";"430523";"5766"
"LOK1378_1mm";"SILVA (only NR);Eukaryota;Archaeplastida;Chloroplastida;Charophyta;Phragmoplastophyta;Streptophyta;Embryophyta;Tracheophyta;Spermatophyta;Magnoliophyta;Buxales;";"0.0";"0";"3";"3";"0";"3";"0";"430521";"5766"
"LOK1378_1mm";"SILVA (only NR);Eukaryota;Archaeplastida;Chloroplastida;Charophyta;Phragmoplastophyta;Streptophyta;Embryophyta;Tracheophyta;Spermatophyta;Magnoliophyta;Buxales;Buxus;";"0.0";"0";"1";"1";"0";"1";"0";"430523";"5766"
"LOK1378_1mm";"SILVA (only NR);Eukaryota;Archaeplastida;Chloroplastida;Charophyta;Phragmoplastophyta;Streptophyta;Embryophyta;Tracheophyta;Spermatophyta;Magnoliophyta;Buxales;Didymeles;";"0.0";"0";"1";"1";"0";"1";"0";"430523";"5766"
"LOK1378_1mm";"SILVA (only NR);Eukaryota;Archaeplastida;Chloroplastida;Charophyta;Phragmoplastophyta;Streptophyta;Embryophyta;Tracheophyta;Spermatophyta;Magnoliophyta;Buxales;Sarcococca;";"0.0";"0";"1";"1";"0";"1";"0";"430523";"5766"
"LOK1378_1mm";"SILVA (only NR);Eukaryota;Archaeplastida;Chloroplastida;Charophyta;Phragmoplastophyta;Streptophyta;Embryophyta;Tracheophyta;Spermatophyta;Magnoliophyta;Canellales;";"0.0";"0";"3";"3";"0";"3";"0";"430521";"5766"
"LOK1378_1mm";"SILVA (only NR);Eukaryota;Archaeplastida;Chloroplastida;Charophyta;Phragmoplastophyta;Streptophyta;Embryophyta;Tracheophyta;Spermatophyta;Magnoliophyta;Canellales;Canella;";"0.0";"0";"1";"1";"0";"1";"0";"430523";"5766"
"LOK1378_1mm";"SILVA (only NR);Eukaryota;Archaeplastida;Chloroplastida;Charophyta;Phragmoplastophyta;Streptophyta;Embryophyta;Tracheophyta;Spermatophyta;Magnoliophyta;Canellales;Cinnamodendron;";"0.0";"0";"1";"1";"0";"1";"0";"430523";"5766"
"LOK1378_1mm";"SILVA (only NR);Eukaryota;Archaeplastida;Chloroplastida;Charophyta;Phragmoplastophyta;Streptophyta;Embryophyta;Tracheophyta;Spermatophyta;Magnoliophyta;Canellales;Takhtajania;";"0.0";"0";"1";"1";"0";"1";"0";"430523";"5766"
"LOK1378_1mm";"SILVA (only NR);Eukaryota;Archaeplastida;Chloroplastida;Charophyta;Phragmoplastophyta;Streptophyta;Embryophyta;Tracheophyta;Spermatophyta;Magnoliophyta;Caryophyllales;";"0.0";"0";"106";"97";"0";"97";"9";"430427";"5766"
"LOK1378_1mm";"SILVA (only NR);Eukaryota;Archaeplastida;Chloroplastida;Charophyta;Phragmoplastophyta;Streptophyta;Embryophyta;Tracheophyta;Spermatophyta;Magnoliophyta;Caryophyllales;Aegialitis;";"0.0";"0";"1";"1";"0";"1";"0";"430523";"5766"
"LOK1378_1mm";"SILVA (only NR);Eukaryota;Archaeplastida;Chloroplastida;Charophyta;Phragmoplastophyta;Streptophyta;Embryophyta;Tracheophyta;Spermatophyta;Magnoliophyta;Caryophyllales;Aldrovanda;";"0.0";"0";"1";"1";"0";"1";"0";"430523";"5766"
"LOK1378_1mm";"SILVA (only NR);Eukaryota;Archaeplastida;Chloroplastida;Charophyta;Phragmoplastophyta;Streptophyta;Embryophyta;Tracheophyta;Spermatophyta;Magnoliophyta;Caryophyllales;Amaranthus;";"0.0";"0";"1";"1";"0";"1";"0";"430523";"5766"
"LOK1378_1mm";"SILVA (only NR);Eukaryota;Archaeplastida;Chloroplastida;Charophyta;Phragmoplastophyta;Streptophyta;Embryophyta;Tracheophyta;Spermatophyta;Magnoliophyta;Caryophyllales;Ancistrocladus;";"0.0";"0";"1";"1";"0";"1";"0";"430523";"5766"
"LOK1378_1mm";"SILVA (only NR);Eukaryota;Archaeplastida;Chloroplastida;Charophyta;Phragmoplastophyta;Streptophyta;Embryophyta;Tracheophyta;Spermatophyta;Magnoliophyta;Caryophyllales;Asteropeia;";"0.0";"0";"1";"1";"0";"1";"0";"430523";"5766"
"LOK1378_1mm";"SILVA (only NR);Eukaryota;Archaeplastida;Chloroplastida;Charophyta;Phragmoplastophyta;Streptophyta;Embryophyta;Tracheophyta;Spermatophyta;Magnoliophyta;Caryophyllales;Beta;";"0.0";"0";"10";"8";"0";"8";"2";"430516";"5766"
"LOK1378_1mm";"SILVA (only NR);Eukaryota;Archaeplastida;Chloroplastida;Charophyta;Phragmoplastophyta;Streptophyta;Embryophyta;Tracheophyta;Spermatophyta;Magnoliophyta;Caryophyllales;Chenopodium;";"0.0";"0";"12";"12";"0";"12";"0";"430512";"5766"
"LOK1378_1mm";"SILVA (only NR);Eukaryota;Archaeplastida;Chloroplastida;Charophyta;Phragmoplastophyta;Streptophyta;Embryophyta;Tracheophyta;Spermatophyta;Magnoliophyta;Caryophyllales;Coccoloba;";"0.0";"0";"1";"1";"0";"1";"0";"430523";"5766"
"LOK1378_1mm";"SILVA (only NR);Eukaryota;Archaeplastida;Chloroplastida;Charophyta;Phragmoplastophyta;Streptophyta;Embryophyta;Tracheophyta;Spermatophyta;Magnoliophyta;Caryophyllales;Delosperma;";"0.0";"0";"1";"1";"0";"1";"0";"430523";"5766"
"LOK1378_1mm";"SILVA (only NR);Eukaryota;Archaeplastida;Chloroplastida;Charophyta;Phragmoplastophyta;Streptophyta;Embryophyta;Tracheophyta;Spermatophyta;Magnoliophyta;Caryophyllales;Dianthus;";"0.0";"0";"3";"3";"0";"3";"0";"430521";"5766"
"LOK1378_1mm";"SILVA (only NR);Eukaryota;Archaeplastida;Chloroplastida;Charophyta;Phragmoplastophyta;Streptophyta;Embryophyta;Tracheophyta;Spermatophyta;Magnoliophyta;Caryophyllales;Dionaea;";"0.0";"0";"1";"1";"0";"1";"0";"430523";"5766"
"LOK1378_1mm";"SILVA (only NR);Eukaryota;Archaeplastida;Chloroplastida;Charophyta;Phragmoplastophyta;Streptophyta;Embryophyta;Tracheophyta;Spermatophyta;Magnoliophyta;Caryophyllales;Drosera;";"0.0";"0";"10";"10";"0";"10";"0";"430514";"5766"
"LOK1378_1mm";"SILVA (only NR);Eukaryota;Archaeplastida;Chloroplastida;Charophyta;Phragmoplastophyta;Streptophyta;Embryophyta;Tracheophyta;Spermatophyta;Magnoliophyta;Caryophyllales;Drosophyllum;";"0.0";"0";"1";"1";"0";"1";"0";"430523";"5766"
"LOK1378_1mm";"SILVA (only NR);Eukaryota;Archaeplastida;Chloroplastida;Charophyta;Phragmoplastophyta;Streptophyta;Embryophyta;Tracheophyta;Spermatophyta;Magnoliophyta;Caryophyllales;Fagopyrum;";"0.0";"0";"2";"1";"0";"1";"1";"430523";"5766"
"LOK1378_1mm";"SILVA (only NR);Eukaryota;Archaeplastida;Chloroplastida;Charophyta;Phragmoplastophyta;Streptophyta;Embryophyta;Tracheophyta;Spermatophyta;Magnoliophyta;Caryophyllales;Fallopia;";"0.0";"0";"1";"1";"0";"1";"0";"430523";"5766"
"LOK1378_1mm";"SILVA (only NR);Eukaryota;Archaeplastida;Chloroplastida;Charophyta;Phragmoplastophyta;Streptophyta;Embryophyta;Tracheophyta;Spermatophyta;Magnoliophyta;Caryophyllales;Frankenia;";"0.0";"0";"1";"1";"0";"1";"0";"430523";"5766"
"LOK1378_1mm";"SILVA (only NR);Eukaryota;Archaeplastida;Chloroplastida;Charophyta;Phragmoplastophyta;Streptophyta;Embryophyta;Tracheophyta;Spermatophyta;Magnoliophyta;Caryophyllales;Limeum;";"0.0";"0";"1";"1";"0";"1";"0";"430523";"5766"
"LOK1378_1mm";"SILVA (only NR);Eukaryota;Archaeplastida;Chloroplastida;Charophyta;Phragmoplastophyta;Streptophyta;Embryophyta;Tracheophyta;Spermatophyta;Magnoliophyta;Caryophyllales;Limonium;";"0.0";"0";"2";"2";"0";"2";"0";"430522";"5766"
"LOK1378_1mm";"SILVA (only NR);Eukaryota;Archaeplastida;Chloroplastida;Charophyta;Phragmoplastophyta;Streptophyta;Embryophyta;Tracheophyta;Spermatophyta;Magnoliophyta;Caryophyllales;Mirabilis;";"0.0";"0";"1";"1";"0";"1";"0";"430523";"5766"
"LOK1378_1mm";"SILVA (only NR);Eukaryota;Archaeplastida;Chloroplastida;Charophyta;Phragmoplastophyta;Streptophyta;Embryophyta;Tracheophyta;Spermatophyta;Magnoliophyta;Caryophyllales;Mollugo;";"0.0";"0";"1";"1";"0";"1";"0";"430523";"5766"
"LOK1378_1mm";"SILVA (only NR);Eukaryota;Archaeplastida;Chloroplastida;Charophyta;Phragmoplastophyta;Streptophyta;Embryophyta;Tracheophyta;Spermatophyta;Magnoliophyta;Caryophyllales;Nepenthes;";"0.0";"0";"1";"1";"0";"1";"0";"430523";"5766"
"LOK1378_1mm";"SILVA (only NR);Eukaryota;Archaeplastida;Chloroplastida;Charophyta;Phragmoplastophyta;Streptophyta;Embryophyta;Tracheophyta;Spermatophyta;Magnoliophyta;Caryophyllales;Opuntia;";"0.0";"0";"28";"27";"0";"27";"1";"430497";"5766"
"LOK1378_1mm";"SILVA (only NR);Eukaryota;Archaeplastida;Chloroplastida;Charophyta;Phragmoplastophyta;Streptophyta;Embryophyta;Tracheophyta;Spermatophyta;Magnoliophyta;Caryophyllales;Persicaria;";"0.0";"0";"6";"3";"0";"3";"3";"430521";"5766"
"LOK1378_1mm";"SILVA (only NR);Eukaryota;Archaeplastida;Chloroplastida;Charophyta;Phragmoplastophyta;Streptophyta;Embryophyta;Tracheophyta;Spermatophyta;Magnoliophyta;Caryophyllales;Phaulothamnus;";"0.0";"0";"1";"0";"0";"0";"1";"430524";"5766"
"LOK1378_1mm";"SILVA (only NR);Eukaryota;Archaeplastida;Chloroplastida;Charophyta;Phragmoplastophyta;Streptophyta;Embryophyta;Tracheophyta;Spermatophyta;Magnoliophyta;Caryophyllales;Phytolacca;";"0.0";"0";"1";"1";"0";"1";"0";"430523";"5766"
"LOK1378_1mm";"SILVA (only NR);Eukaryota;Archaeplastida;Chloroplastida;Charophyta;Phragmoplastophyta;Streptophyta;Embryophyta;Tracheophyta;Spermatophyta;Magnoliophyta;Caryophyllales;Plumbago;";"0.0";"0";"1";"1";"0";"1";"0";"430523";"5766"
"LOK1378_1mm";"SILVA (only NR);Eukaryota;Archaeplastida;Chloroplastida;Charophyta;Phragmoplastophyta;Streptophyta;Embryophyta;Tracheophyta;Spermatophyta;Magnoliophyta;Caryophyllales;Rhabdodendron;";"0.0";"0";"1";"1";"0";"1";"0";"430523";"5766"
"LOK1378_1mm";"SILVA (only NR);Eukaryota;Archaeplastida;Chloroplastida;Charophyta;Phragmoplastophyta;Streptophyta;Embryophyta;Tracheophyta;Spermatophyta;Magnoliophyta;Caryophyllales;Rheum;";"0.0";"0";"1";"1";"0";"1";"0";"430523";"5766"
"LOK1378_1mm";"SILVA (only NR);Eukaryota;Archaeplastida;Chloroplastida;Charophyta;Phragmoplastophyta;Streptophyta;Embryophyta;Tracheophyta;Spermatophyta;Magnoliophyta;Caryophyllales;Rivina;";"0.0";"0";"1";"0";"0";"0";"1";"430524";"5766"
"LOK1378_1mm";"SILVA (only NR);Eukaryota;Archaeplastida;Chloroplastida;Charophyta;Phragmoplastophyta;Streptophyta;Embryophyta;Tracheophyta;Spermatophyta;Magnoliophyta;Caryophyllales;Rumex;";"0.0";"0";"2";"2";"0";"2";"0";"430522";"5766"
"LOK1378_1mm";"SILVA (only NR);Eukaryota;Archaeplastida;Chloroplastida;Charophyta;Phragmoplastophyta;Streptophyta;Embryophyta;Tracheophyta;Spermatophyta;Magnoliophyta;Caryophyllales;Sarcobatus;";"0.0";"0";"1";"1";"0";"1";"0";"430523";"5766"
"LOK1378_1mm";"SILVA (only NR);Eukaryota;Archaeplastida;Chloroplastida;Charophyta;Phragmoplastophyta;Streptophyta;Embryophyta;Tracheophyta;Spermatophyta;Magnoliophyta;Caryophyllales;Silene;";"0.0";"0";"5";"5";"0";"5";"0";"430519";"5766"
"LOK1378_1mm";"SILVA (only NR);Eukaryota;Archaeplastida;Chloroplastida;Charophyta;Phragmoplastophyta;Streptophyta;Embryophyta;Tracheophyta;Spermatophyta;Magnoliophyta;Caryophyllales;Simmondsia;";"0.0";"0";"1";"1";"0";"1";"0";"430523";"5766"
"LOK1378_1mm";"SILVA (only NR);Eukaryota;Archaeplastida;Chloroplastida;Charophyta;Phragmoplastophyta;Streptophyta;Embryophyta;Tracheophyta;Spermatophyta;Magnoliophyta;Caryophyllales;Stellaria;";"0.0";"0";"1";"1";"0";"1";"0";"430523";"5766"
"LOK1378_1mm";"SILVA (only NR);Eukaryota;Archaeplastida;Chloroplastida;Charophyta;Phragmoplastophyta;Streptophyta;Embryophyta;Tracheophyta;Spermatophyta;Magnoliophyta;Caryophyllales;Tamarix;";"0.0";"0";"1";"1";"0";"1";"0";"430523";"5766"
"LOK1378_1mm";"SILVA (only NR);Eukaryota;Archaeplastida;Chloroplastida;Charophyta;Phragmoplastophyta;Streptophyta;Embryophyta;Tracheophyta;Spermatophyta;Magnoliophyta;Caryophyllales;Triphyophyllum;";"0.0";"0";"1";"1";"0";"1";"0";"430523";"5766"
"LOK1378_1mm";"SILVA (only NR);Eukaryota;Archaeplastida;Chloroplastida;Charophyta;Phragmoplastophyta;Streptophyta;Embryophyta;Tracheophyta;Spermatophyta;Magnoliophyta;Celastrales;";"0.0";"0";"14";"14";"0";"14";"0";"430510";"5766"
"LOK1378_1mm";"SILVA (only NR);Eukaryota;Archaeplastida;Chloroplastida;Charophyta;Phragmoplastophyta;Streptophyta;Embryophyta;Tracheophyta;Spermatophyta;Magnoliophyta;Celastrales;Canotia;";"0.0";"0";"1";"1";"0";"1";"0";"430523";"5766"
"LOK1378_1mm";"SILVA (only NR);Eukaryota;Archaeplastida;Chloroplastida;Charophyta;Phragmoplastophyta;Streptophyta;Embryophyta;Tracheophyta;Spermatophyta;Magnoliophyta;Celastrales;Celastrus;";"0.0";"0";"1";"1";"0";"1";"0";"430523";"5766"
"LOK1378_1mm";"SILVA (only NR);Eukaryota;Archaeplastida;Chloroplastida;Charophyta;Phragmoplastophyta;Streptophyta;Embryophyta;Tracheophyta;Spermatophyta;Magnoliophyta;Celastrales;Dicarpellum;";"0.0";"0";"1";"1";"0";"1";"0";"430523";"5766"
"LOK1378_1mm";"SILVA (only NR);Eukaryota;Archaeplastida;Chloroplastida;Charophyta;Phragmoplastophyta;Streptophyta;Embryophyta;Tracheophyta;Spermatophyta;Magnoliophyta;Celastrales;Euonymus;";"0.0";"0";"1";"1";"0";"1";"0";"430523";"5766"
"LOK1378_1mm";"SILVA (only NR);Eukaryota;Archaeplastida;Chloroplastida;Charophyta;Phragmoplastophyta;Streptophyta;Embryophyta;Tracheophyta;Spermatophyta;Magnoliophyta;Celastrales;Gymnosporia;";"0.0";"0";"1";"1";"0";"1";"0";"430523";"5766"
"LOK1378_1mm";"SILVA (only NR);Eukaryota;Archaeplastida;Chloroplastida;Charophyta;Phragmoplastophyta;Streptophyta;Embryophyta;Tracheophyta;Spermatophyta;Magnoliophyta;Celastrales;Lepidobotrys;";"0.0";"0";"1";"1";"0";"1";"0";"430523";"5766"
"LOK1378_1mm";"SILVA (only NR);Eukaryota;Archaeplastida;Chloroplastida;Charophyta;Phragmoplastophyta;Streptophyta;Embryophyta;Tracheophyta;Spermatophyta;Magnoliophyta;Celastrales;Lepuropetalon;";"0.0";"0";"1";"1";"0";"1";"0";"430523";"5766"
"LOK1378_1mm";"SILVA (only NR);Eukaryota;Archaeplastida;Chloroplastida;Charophyta;Phragmoplastophyta;Streptophyta;Embryophyta;Tracheophyta;Spermatophyta;Magnoliophyta;Celastrales;Mortonia;";"0.0";"0";"1";"1";"0";"1";"0";"430523";"5766"
"LOK1378_1mm";"SILVA (only NR);Eukaryota;Archaeplastida;Chloroplastida;Charophyta;Phragmoplastophyta;Streptophyta;Embryophyta;Tracheophyta;Spermatophyta;Magnoliophyta;Celastrales;Parnassia;";"0.0";"0";"1";"1";"0";"1";"0";"430523";"5766"
"LOK1378_1mm";"SILVA (only NR);Eukaryota;Archaeplastida;Chloroplastida;Charophyta;Phragmoplastophyta;Streptophyta;Embryophyta;Tracheophyta;Spermatophyta;Magnoliophyta;Celastrales;Plagiopteron;";"0.0";"0";"1";"1";"0";"1";"0";"430523";"5766"
"LOK1378_1mm";"SILVA (only NR);Eukaryota;Archaeplastida;Chloroplastida;Charophyta;Phragmoplastophyta;Streptophyta;Embryophyta;Tracheophyta;Spermatophyta;Magnoliophyta;Celastrales;Ruptiliocarpon;";"0.0";"0";"1";"1";"0";"1";"0";"430523";"5766"
"LOK1378_1mm";"SILVA (only NR);Eukaryota;Archaeplastida;Chloroplastida;Charophyta;Phragmoplastophyta;Streptophyta;Embryophyta;Tracheophyta;Spermatophyta;Magnoliophyta;Celastrales;Siphonodon;";"0.0";"0";"1";"1";"0";"1";"0";"430523";"5766"
"LOK1378_1mm";"SILVA (only NR);Eukaryota;Archaeplastida;Chloroplastida;Charophyta;Phragmoplastophyta;Streptophyta;Embryophyta;Tracheophyta;Spermatophyta;Magnoliophyta;Celastrales;Stackhousia;";"0.0";"0";"1";"1";"0";"1";"0";"430523";"5766"
"LOK1378_1mm";"SILVA (only NR);Eukaryota;Archaeplastida;Chloroplastida;Charophyta;Phragmoplastophyta;Streptophyta;Embryophyta;Tracheophyta;Spermatophyta;Magnoliophyta;Celastrales;Zinowiewia;";"0.0";"0";"1";"1";"0";"1";"0";"430523";"5766"
"LOK1378_1mm";"SILVA (only NR);Eukaryota;Archaeplastida;Chloroplastida;Charophyta;Phragmoplastophyta;Streptophyta;Embryophyta;Tracheophyta;Spermatophyta;Magnoliophyta;Ceratophyllales;";"0.0";"0";"1";"1";"0";"1";"0";"430523";"5766"
"LOK1378_1mm";"SILVA (only NR);Eukaryota;Archaeplastida;Chloroplastida;Charophyta;Phragmoplastophyta;Streptophyta;Embryophyta;Tracheophyta;Spermatophyta;Magnoliophyta;Ceratophyllales;Ceratophyllum;";"0.0";"0";"1";"1";"0";"1";"0";"430523";"5766"
"LOK1378_1mm";"SILVA (only NR);Eukaryota;Archaeplastida;Chloroplastida;Charophyta;Phragmoplastophyta;Streptophyta;Embryophyta;Tracheophyta;Spermatophyta;Magnoliophyta;Chloranthales;";"0.0";"0";"3";"3";"0";"3";"0";"430521";"5766"
"LOK1378_1mm";"SILVA (only NR);Eukaryota;Archaeplastida;Chloroplastida;Charophyta;Phragmoplastophyta;Streptophyta;Embryophyta;Tracheophyta;Spermatophyta;Magnoliophyta;Chloranthales;Chloranthus;";"0.0";"0";"1";"1";"0";"1";"0";"430523";"5766"
"LOK1378_1mm";"SILVA (only NR);Eukaryota;Archaeplastida;Chloroplastida;Charophyta;Phragmoplastophyta;Streptophyta;Embryophyta;Tracheophyta;Spermatophyta;Magnoliophyta;Chloranthales;Hedyosmum;";"0.0";"0";"1";"1";"0";"1";"0";"430523";"5766"
"LOK1378_1mm";"SILVA (only NR);Eukaryota;Archaeplastida;Chloroplastida;Charophyta;Phragmoplastophyta;Streptophyta;Embryophyta;Tracheophyta;Spermatophyta;Magnoliophyta;Chloranthales;Sarcandra;";"0.0";"0";"1";"1";"0";"1";"0";"430523";"5766"
"LOK1378_1mm";"SILVA (only NR);Eukaryota;Archaeplastida;Chloroplastida;Charophyta;Phragmoplastophyta;Streptophyta;Embryophyta;Tracheophyta;Spermatophyta;Magnoliophyta;Cornales;";"0.0";"0";"4";"4";"0";"4";"0";"430520";"5766"
"LOK1378_1mm";"SILVA (only NR);Eukaryota;Archaeplastida;Chloroplastida;Charophyta;Phragmoplastophyta;Streptophyta;Embryophyta;Tracheophyta;Spermatophyta;Magnoliophyta;Cornales;Alangium;";"0.0";"0";"1";"1";"0";"1";"0";"430523";"5766"
"LOK1378_1mm";"SILVA (only NR);Eukaryota;Archaeplastida;Chloroplastida;Charophyta;Phragmoplastophyta;Streptophyta;Embryophyta;Tracheophyta;Spermatophyta;Magnoliophyta;Cornales;Hydrostachys;";"0.0";"0";"1";"1";"0";"1";"0";"430523";"5766"
"LOK1378_1mm";"SILVA (only NR);Eukaryota;Archaeplastida;Chloroplastida;Charophyta;Phragmoplastophyta;Streptophyta;Embryophyta;Tracheophyta;Spermatophyta;Magnoliophyta;Cornales;Nasa;";"0.0";"0";"1";"1";"0";"1";"0";"430523";"5766"
"LOK1378_1mm";"SILVA (only NR);Eukaryota;Archaeplastida;Chloroplastida;Charophyta;Phragmoplastophyta;Streptophyta;Embryophyta;Tracheophyta;Spermatophyta;Magnoliophyta;Cornales;Philadelphus;";"0.0";"0";"1";"1";"0";"1";"0";"430523";"5766"
"LOK1378_1mm";"SILVA (only NR);Eukaryota;Archaeplastida;Chloroplastida;Charophyta;Phragmoplastophyta;Streptophyta;Embryophyta;Tracheophyta;Spermatophyta;Magnoliophyta;Crossosomatales;";"0.0";"0";"4";"4";"0";"4";"0";"430520";"5766"
"LOK1378_1mm";"SILVA (only NR);Eukaryota;Archaeplastida;Chloroplastida;Charophyta;Phragmoplastophyta;Streptophyta;Embryophyta;Tracheophyta;Spermatophyta;Magnoliophyta;Crossosomatales;Aphloia;";"0.0";"0";"1";"1";"0";"1";"0";"430523";"5766"
"LOK1378_1mm";"SILVA (only NR);Eukaryota;Archaeplastida;Chloroplastida;Charophyta;Phragmoplastophyta;Streptophyta;Embryophyta;Tracheophyta;Spermatophyta;Magnoliophyta;Crossosomatales;Crossosoma;";"0.0";"0";"1";"1";"0";"1";"0";"430523";"5766"
"LOK1378_1mm";"SILVA (only NR);Eukaryota;Archaeplastida;Chloroplastida;Charophyta;Phragmoplastophyta;Streptophyta;Embryophyta;Tracheophyta;Spermatophyta;Magnoliophyta;Crossosomatales;Stachyurus;";"0.0";"0";"1";"1";"0";"1";"0";"430523";"5766"
"LOK1378_1mm";"SILVA (only NR);Eukaryota;Archaeplastida;Chloroplastida;Charophyta;Phragmoplastophyta;Streptophyta;Embryophyta;Tracheophyta;Spermatophyta;Magnoliophyta;Crossosomatales;Strasburgeria;";"0.0";"0";"1";"1";"0";"1";"0";"430523";"5766"
"LOK1378_1mm";"SILVA (only NR);Eukaryota;Archaeplastida;Chloroplastida;Charophyta;Phragmoplastophyta;Streptophyta;Embryophyta;Tracheophyta;Spermatophyta;Magnoliophyta;Cucurbitales;";"0.0";"0";"292";"269";"0";"269";"23";"430255";"5766"
"LOK1378_1mm";"SILVA (only NR);Eukaryota;Archaeplastida;Chloroplastida;Charophyta;Phragmoplastophyta;Streptophyta;Embryophyta;Tracheophyta;Spermatophyta;Magnoliophyta;Cucurbitales;Abobra;";"0.0";"0";"1";"1";"0";"1";"0";"430523";"5766"
"LOK1378_1mm";"SILVA (only NR);Eukaryota;Archaeplastida;Chloroplastida;Charophyta;Phragmoplastophyta;Streptophyta;Embryophyta;Tracheophyta;Spermatophyta;Magnoliophyta;Cucurbitales;Anisophyllea;";"0.0";"0";"1";"1";"0";"1";"0";"430523";"5766"
"LOK1378_1mm";"SILVA (only NR);Eukaryota;Archaeplastida;Chloroplastida;Charophyta;Phragmoplastophyta;Streptophyta;Embryophyta;Tracheophyta;Spermatophyta;Magnoliophyta;Cucurbitales;Apodanthes;";"0.0";"0";"1";"0";"0";"0";"1";"430524";"5766"
"LOK1378_1mm";"SILVA (only NR);Eukaryota;Archaeplastida;Chloroplastida;Charophyta;Phragmoplastophyta;Streptophyta;Embryophyta;Tracheophyta;Spermatophyta;Magnoliophyta;Cucurbitales;Begonia;";"0.0";"0";"10";"10";"0";"10";"0";"430514";"5766"
"LOK1378_1mm";"SILVA (only NR);Eukaryota;Archaeplastida;Chloroplastida;Charophyta;Phragmoplastophyta;Streptophyta;Embryophyta;Tracheophyta;Spermatophyta;Magnoliophyta;Cucurbitales;Cephalopentandra;";"0.0";"0";"1";"1";"0";"1";"0";"430523";"5766"
"LOK1378_1mm";"SILVA (only NR);Eukaryota;Archaeplastida;Chloroplastida;Charophyta;Phragmoplastophyta;Streptophyta;Embryophyta;Tracheophyta;Spermatophyta;Magnoliophyta;Cucurbitales;Citrullus;";"0.0";"0";"2";"2";"0";"2";"0";"430522";"5766"
"LOK1378_1mm";"SILVA (only NR);Eukaryota;Archaeplastida;Chloroplastida;Charophyta;Phragmoplastophyta;Streptophyta;Embryophyta;Tracheophyta;Spermatophyta;Magnoliophyta;Cucurbitales;Coccinia;";"0.0";"0";"1";"1";"0";"1";"0";"430523";"5766"
"LOK1378_1mm";"SILVA (only NR);Eukaryota;Archaeplastida;Chloroplastida;Charophyta;Phragmoplastophyta;Streptophyta;Embryophyta;Tracheophyta;Spermatophyta;Magnoliophyta;Cucurbitales;Combretocarpus;";"0.0";"0";"1";"1";"0";"1";"0";"430523";"5766"
"LOK1378_1mm";"SILVA (only NR);Eukaryota;Archaeplastida;Chloroplastida;Charophyta;Phragmoplastophyta;Streptophyta;Embryophyta;Tracheophyta;Spermatophyta;Magnoliophyta;Cucurbitales;Corallocarpus;";"0.0";"0";"1";"1";"0";"1";"0";"430523";"5766"
"LOK1378_1mm";"SILVA (only NR);Eukaryota;Archaeplastida;Chloroplastida;Charophyta;Phragmoplastophyta;Streptophyta;Embryophyta;Tracheophyta;Spermatophyta;Magnoliophyta;Cucurbitales;Coriaria;";"0.0";"0";"2";"2";"0";"2";"0";"430522";"5766"
"LOK1378_1mm";"SILVA (only NR);Eukaryota;Archaeplastida;Chloroplastida;Charophyta;Phragmoplastophyta;Streptophyta;Embryophyta;Tracheophyta;Spermatophyta;Magnoliophyta;Cucurbitales;Corynocarpus;";"0.0";"0";"1";"1";"0";"1";"0";"430523";"5766"
"LOK1378_1mm";"SILVA (only NR);Eukaryota;Archaeplastida;Chloroplastida;Charophyta;Phragmoplastophyta;Streptophyta;Embryophyta;Tracheophyta;Spermatophyta;Magnoliophyta;Cucurbitales;Cucumis;";"0.0";"0";"246";"224";"0";"224";"22";"430300";"5766"
"LOK1378_1mm";"SILVA (only NR);Eukaryota;Archaeplastida;Chloroplastida;Charophyta;Phragmoplastophyta;Streptophyta;Embryophyta;Tracheophyta;Spermatophyta;Magnoliophyta;Cucurbitales;Datisca;";"0.0";"0";"2";"2";"0";"2";"0";"430522";"5766"
"LOK1378_1mm";"SILVA (only NR);Eukaryota;Archaeplastida;Chloroplastida;Charophyta;Phragmoplastophyta;Streptophyta;Embryophyta;Tracheophyta;Spermatophyta;Magnoliophyta;Cucurbitales;Ecballium;";"0.0";"0";"1";"1";"0";"1";"0";"430523";"5766"
"LOK1378_1mm";"SILVA (only NR);Eukaryota;Archaeplastida;Chloroplastida;Charophyta;Phragmoplastophyta;Streptophyta;Embryophyta;Tracheophyta;Spermatophyta;Magnoliophyta;Cucurbitales;Gurania;";"0.0";"0";"1";"1";"0";"1";"0";"430523";"5766"
"LOK1378_1mm";"SILVA (only NR);Eukaryota;Archaeplastida;Chloroplastida;Charophyta;Phragmoplastophyta;Streptophyta;Embryophyta;Tracheophyta;Spermatophyta;Magnoliophyta;Cucurbitales;Gynostemma;";"0.0";"0";"1";"1";"0";"1";"0";"430523";"5766"
"LOK1378_1mm";"SILVA (only NR);Eukaryota;Archaeplastida;Chloroplastida;Charophyta;Phragmoplastophyta;Streptophyta;Embryophyta;Tracheophyta;Spermatophyta;Magnoliophyta;Cucurbitales;Hillebrandia;";"0.0";"0";"1";"1";"0";"1";"0";"430523";"5766"
"LOK1378_1mm";"SILVA (only NR);Eukaryota;Archaeplastida;Chloroplastida;Charophyta;Phragmoplastophyta;Streptophyta;Embryophyta;Tracheophyta;Spermatophyta;Magnoliophyta;Cucurbitales;Lagenaria;";"0.0";"0";"2";"2";"0";"2";"0";"430522";"5766"
"LOK1378_1mm";"SILVA (only NR);Eukaryota;Archaeplastida;Chloroplastida;Charophyta;Phragmoplastophyta;Streptophyta;Embryophyta;Tracheophyta;Spermatophyta;Magnoliophyta;Cucurbitales;Luffa;";"0.0";"0";"1";"1";"0";"1";"0";"430523";"5766"
"LOK1378_1mm";"SILVA (only NR);Eukaryota;Archaeplastida;Chloroplastida;Charophyta;Phragmoplastophyta;Streptophyta;Embryophyta;Tracheophyta;Spermatophyta;Magnoliophyta;Cucurbitales;Marah;";"0.0";"0";"1";"1";"0";"1";"0";"430523";"5766"
"LOK1378_1mm";"SILVA (only NR);Eukaryota;Archaeplastida;Chloroplastida;Charophyta;Phragmoplastophyta;Streptophyta;Embryophyta;Tracheophyta;Spermatophyta;Magnoliophyta;Cucurbitales;Neoalsomitra;";"0.0";"0";"1";"1";"0";"1";"0";"430523";"5766"
"LOK1378_1mm";"SILVA (only NR);Eukaryota;Archaeplastida;Chloroplastida;Charophyta;Phragmoplastophyta;Streptophyta;Embryophyta;Tracheophyta;Spermatophyta;Magnoliophyta;Cucurbitales;Octomeles;";"0.0";"0";"1";"1";"0";"1";"0";"430523";"5766"
"LOK1378_1mm";"SILVA (only NR);Eukaryota;Archaeplastida;Chloroplastida;Charophyta;Phragmoplastophyta;Streptophyta;Embryophyta;Tracheophyta;Spermatophyta;Magnoliophyta;Cucurbitales;Pilostyles;";"0.0";"0";"8";"8";"0";"8";"0";"430516";"5766"
"LOK1378_1mm";"SILVA (only NR);Eukaryota;Archaeplastida;Chloroplastida;Charophyta;Phragmoplastophyta;Streptophyta;Embryophyta;Tracheophyta;Spermatophyta;Magnoliophyta;Cucurbitales;Symbegonia;";"0.0";"0";"1";"1";"0";"1";"0";"430523";"5766"
"LOK1378_1mm";"SILVA (only NR);Eukaryota;Archaeplastida;Chloroplastida;Charophyta;Phragmoplastophyta;Streptophyta;Embryophyta;Tracheophyta;Spermatophyta;Magnoliophyta;Cucurbitales;Tetrameles;";"0.0";"0";"1";"1";"0";"1";"0";"430523";"5766"
"LOK1378_1mm";"SILVA (only NR);Eukaryota;Archaeplastida;Chloroplastida;Charophyta;Phragmoplastophyta;Streptophyta;Embryophyta;Tracheophyta;Spermatophyta;Magnoliophyta;Cucurbitales;Trochomeria;";"0.0";"0";"1";"1";"0";"1";"0";"430523";"5766"
"LOK1378_1mm";"SILVA (only NR);Eukaryota;Archaeplastida;Chloroplastida;Charophyta;Phragmoplastophyta;Streptophyta;Embryophyta;Tracheophyta;Spermatophyta;Magnoliophyta;Cucurbitales;Xerosicyos;";"0.0";"0";"1";"1";"0";"1";"0";"430523";"5766"
"LOK1378_1mm";"SILVA (only NR);Eukaryota;Archaeplastida;Chloroplastida;Charophyta;Phragmoplastophyta;Streptophyta;Embryophyta;Tracheophyta;Spermatophyta;Magnoliophyta;Dilleniales;";"0.0";"0";"4";"4";"0";"4";"0";"430520";"5766"
"LOK1378_1mm";"SILVA (only NR);Eukaryota;Archaeplastida;Chloroplastida;Charophyta;Phragmoplastophyta;Streptophyta;Embryophyta;Tracheophyta;Spermatophyta;Magnoliophyta;Dilleniales;Dillenia;";"0.0";"0";"1";"1";"0";"1";"0";"430523";"5766"
"LOK1378_1mm";"SILVA (only NR);Eukaryota;Archaeplastida;Chloroplastida;Charophyta;Phragmoplastophyta;Streptophyta;Embryophyta;Tracheophyta;Spermatophyta;Magnoliophyta;Dilleniales;Hibbertia;";"0.0";"0";"1";"1";"0";"1";"0";"430523";"5766"
"LOK1378_1mm";"SILVA (only NR);Eukaryota;Archaeplastida;Chloroplastida;Charophyta;Phragmoplastophyta;Streptophyta;Embryophyta;Tracheophyta;Spermatophyta;Magnoliophyta;Dilleniales;Schumacheria;";"0.0";"0";"1";"1";"0";"1";"0";"430523";"5766"
"LOK1378_1mm";"SILVA (only NR);Eukaryota;Archaeplastida;Chloroplastida;Charophyta;Phragmoplastophyta;Streptophyta;Embryophyta;Tracheophyta;Spermatophyta;Magnoliophyta;Dilleniales;Tetracera;";"0.0";"0";"1";"1";"0";"1";"0";"430523";"5766"
"LOK1378_1mm";"SILVA (only NR);Eukaryota;Archaeplastida;Chloroplastida;Charophyta;Phragmoplastophyta;Streptophyta;Embryophyta;Tracheophyta;Spermatophyta;Magnoliophyta;Dipsacales;";"0.0";"0";"2";"2";"0";"2";"0";"430522";"5766"
"LOK1378_1mm";"SILVA (only NR);Eukaryota;Archaeplastida;Chloroplastida;Charophyta;Phragmoplastophyta;Streptophyta;Embryophyta;Tracheophyta;Spermatophyta;Magnoliophyta;Dipsacales;Lonicera;";"0.0";"0";"1";"1";"0";"1";"0";"430523";"5766"
"LOK1378_1mm";"SILVA (only NR);Eukaryota;Archaeplastida;Chloroplastida;Charophyta;Phragmoplastophyta;Streptophyta;Embryophyta;Tracheophyta;Spermatophyta;Magnoliophyta;Dipsacales;Valeriana;";"0.0";"0";"1";"1";"0";"1";"0";"430523";"5766"
"LOK1378_1mm";"SILVA (only NR);Eukaryota;Archaeplastida;Chloroplastida;Charophyta;Phragmoplastophyta;Streptophyta;Embryophyta;Tracheophyta;Spermatophyta;Magnoliophyta;Ericales;";"0.0";"0";"49";"49";"0";"49";"0";"430475";"5766"
"LOK1378_1mm";"SILVA (only NR);Eukaryota;Archaeplastida;Chloroplastida;Charophyta;Phragmoplastophyta;Streptophyta;Embryophyta;Tracheophyta;Spermatophyta;Magnoliophyta;Ericales;Actinidia;";"0.0";"0";"6";"6";"0";"6";"0";"430518";"5766"
"LOK1378_1mm";"SILVA (only NR);Eukaryota;Archaeplastida;Chloroplastida;Charophyta;Phragmoplastophyta;Streptophyta;Embryophyta;Tracheophyta;Spermatophyta;Magnoliophyta;Ericales;Anagallis;";"0.0";"0";"1";"1";"0";"1";"0";"430523";"5766"
"LOK1378_1mm";"SILVA (only NR);Eukaryota;Archaeplastida;Chloroplastida;Charophyta;Phragmoplastophyta;Streptophyta;Embryophyta;Tracheophyta;Spermatophyta;Magnoliophyta;Ericales;Androsace;";"0.0";"0";"1";"1";"0";"1";"0";"430523";"5766"
"LOK1378_1mm";"SILVA (only NR);Eukaryota;Archaeplastida;Chloroplastida;Charophyta;Phragmoplastophyta;Streptophyta;Embryophyta;Tracheophyta;Spermatophyta;Magnoliophyta;Ericales;Arbutus;";"0.0";"0";"1";"1";"0";"1";"0";"430523";"5766"
"LOK1378_1mm";"SILVA (only NR);Eukaryota;Archaeplastida;Chloroplastida;Charophyta;Phragmoplastophyta;Streptophyta;Embryophyta;Tracheophyta;Spermatophyta;Magnoliophyta;Ericales;Ardisia;";"0.0";"0";"1";"1";"0";"1";"0";"430523";"5766"
"LOK1378_1mm";"SILVA (only NR);Eukaryota;Archaeplastida;Chloroplastida;Charophyta;Phragmoplastophyta;Streptophyta;Embryophyta;Tracheophyta;Spermatophyta;Magnoliophyta;Ericales;Bonplandia;";"0.0";"0";"1";"1";"0";"1";"0";"430523";"5766"
"LOK1378_1mm";"SILVA (only NR);Eukaryota;Archaeplastida;Chloroplastida;Charophyta;Phragmoplastophyta;Streptophyta;Embryophyta;Tracheophyta;Spermatophyta;Magnoliophyta;Ericales;Calluna;";"0.0";"0";"1";"1";"0";"1";"0";"430523";"5766"
"LOK1378_1mm";"SILVA (only NR);Eukaryota;Archaeplastida;Chloroplastida;Charophyta;Phragmoplastophyta;Streptophyta;Embryophyta;Tracheophyta;Spermatophyta;Magnoliophyta;Ericales;Camellia;";"0.0";"0";"1";"1";"0";"1";"0";"430523";"5766"
"LOK1378_1mm";"SILVA (only NR);Eukaryota;Archaeplastida;Chloroplastida;Charophyta;Phragmoplastophyta;Streptophyta;Embryophyta;Tracheophyta;Spermatophyta;Magnoliophyta;Ericales;Cantua;";"0.0";"0";"1";"1";"0";"1";"0";"430523";"5766"
"LOK1378_1mm";"SILVA (only NR);Eukaryota;Archaeplastida;Chloroplastida;Charophyta;Phragmoplastophyta;Streptophyta;Embryophyta;Tracheophyta;Spermatophyta;Magnoliophyta;Ericales;Ceratiola;";"0.0";"0";"1";"1";"0";"1";"0";"430523";"5766"
"LOK1378_1mm";"SILVA (only NR);Eukaryota;Archaeplastida;Chloroplastida;Charophyta;Phragmoplastophyta;Streptophyta;Embryophyta;Tracheophyta;Spermatophyta;Magnoliophyta;Ericales;Chamaedaphne;";"0.0";"0";"1";"1";"0";"1";"0";"430523";"5766"
"LOK1378_1mm";"SILVA (only NR);Eukaryota;Archaeplastida;Chloroplastida;Charophyta;Phragmoplastophyta;Streptophyta;Embryophyta;Tracheophyta;Spermatophyta;Magnoliophyta;Ericales;Clavija;";"0.0";"0";"1";"1";"0";"1";"0";"430523";"5766"
"LOK1378_1mm";"SILVA (only NR);Eukaryota;Archaeplastida;Chloroplastida;Charophyta;Phragmoplastophyta;Streptophyta;Embryophyta;Tracheophyta;Spermatophyta;Magnoliophyta;Ericales;Clethra;";"0.0";"0";"1";"1";"0";"1";"0";"430523";"5766"
"LOK1378_1mm";"SILVA (only NR);Eukaryota;Archaeplastida;Chloroplastida;Charophyta;Phragmoplastophyta;Streptophyta;Embryophyta;Tracheophyta;Spermatophyta;Magnoliophyta;Ericales;Cosmelia;";"0.0";"0";"1";"1";"0";"1";"0";"430523";"5766"
"LOK1378_1mm";"SILVA (only NR);Eukaryota;Archaeplastida;Chloroplastida;Charophyta;Phragmoplastophyta;Streptophyta;Embryophyta;Tracheophyta;Spermatophyta;Magnoliophyta;Ericales;Couroupita;";"0.0";"0";"1";"1";"0";"1";"0";"430523";"5766"
"LOK1378_1mm";"SILVA (only NR);Eukaryota;Archaeplastida;Chloroplastida;Charophyta;Phragmoplastophyta;Streptophyta;Embryophyta;Tracheophyta;Spermatophyta;Magnoliophyta;Ericales;Cyrilla;";"0.0";"0";"1";"1";"0";"1";"0";"430523";"5766"
"LOK1378_1mm";"SILVA (only NR);Eukaryota;Archaeplastida;Chloroplastida;Charophyta;Phragmoplastophyta;Streptophyta;Embryophyta;Tracheophyta;Spermatophyta;Magnoliophyta;Ericales;Diospyros;";"0.0";"0";"2";"2";"0";"2";"0";"430522";"5766"
"LOK1378_1mm";"SILVA (only NR);Eukaryota;Archaeplastida;Chloroplastida;Charophyta;Phragmoplastophyta;Streptophyta;Embryophyta;Tracheophyta;Spermatophyta;Magnoliophyta;Ericales;Dracophyllum;";"0.0";"0";"1";"1";"0";"1";"0";"430523";"5766"
"LOK1378_1mm";"SILVA (only NR);Eukaryota;Archaeplastida;Chloroplastida;Charophyta;Phragmoplastophyta;Streptophyta;Embryophyta;Tracheophyta;Spermatophyta;Magnoliophyta;Ericales;Fouquieria;";"0.0";"0";"1";"1";"0";"1";"0";"430523";"5766"
"LOK1378_1mm";"SILVA (only NR);Eukaryota;Archaeplastida;Chloroplastida;Charophyta;Phragmoplastophyta;Streptophyta;Embryophyta;Tracheophyta;Spermatophyta;Magnoliophyta;Ericales;Galax;";"0.0";"0";"1";"1";"0";"1";"0";"430523";"5766"
"LOK1378_1mm";"SILVA (only NR);Eukaryota;Archaeplastida;Chloroplastida;Charophyta;Phragmoplastophyta;Streptophyta;Embryophyta;Tracheophyta;Spermatophyta;Magnoliophyta;Ericales;Gaultheria;";"0.0";"0";"1";"1";"0";"1";"0";"430523";"5766"
"LOK1378_1mm";"SILVA (only NR);Eukaryota;Archaeplastida;Chloroplastida;Charophyta;Phragmoplastophyta;Streptophyta;Embryophyta;Tracheophyta;Spermatophyta;Magnoliophyta;Ericales;Gilia;";"0.0";"0";"1";"1";"0";"1";"0";"430523";"5766"
"LOK1378_1mm";"SILVA (only NR);Eukaryota;Archaeplastida;Chloroplastida;Charophyta;Phragmoplastophyta;Streptophyta;Embryophyta;Tracheophyta;Spermatophyta;Magnoliophyta;Ericales;Halesia;";"0.0";"0";"1";"1";"0";"1";"0";"430523";"5766"
"LOK1378_1mm";"SILVA (only NR);Eukaryota;Archaeplastida;Chloroplastida;Charophyta;Phragmoplastophyta;Streptophyta;Embryophyta;Tracheophyta;Spermatophyta;Magnoliophyta;Ericales;Impatiens;";"0.0";"0";"1";"1";"0";"1";"0";"430523";"5766"
"LOK1378_1mm";"SILVA (only NR);Eukaryota;Archaeplastida;Chloroplastida;Charophyta;Phragmoplastophyta;Streptophyta;Embryophyta;Tracheophyta;Spermatophyta;Magnoliophyta;Ericales;Maesa;";"0.0";"0";"1";"1";"0";"1";"0";"430523";"5766"
"LOK1378_1mm";"SILVA (only NR);Eukaryota;Archaeplastida;Chloroplastida;Charophyta;Phragmoplastophyta;Streptophyta;Embryophyta;Tracheophyta;Spermatophyta;Magnoliophyta;Ericales;Manilkara;";"0.0";"0";"2";"2";"0";"2";"0";"430522";"5766"
"LOK1378_1mm";"SILVA (only NR);Eukaryota;Archaeplastida;Chloroplastida;Charophyta;Phragmoplastophyta;Streptophyta;Embryophyta;Tracheophyta;Spermatophyta;Magnoliophyta;Ericales;Mitrastemon;";"0.0";"0";"1";"1";"0";"1";"0";"430523";"5766"
"LOK1378_1mm";"SILVA (only NR);Eukaryota;Archaeplastida;Chloroplastida;Charophyta;Phragmoplastophyta;Streptophyta;Embryophyta;Tracheophyta;Spermatophyta;Magnoliophyta;Ericales;Monotropa;";"0.0";"0";"1";"1";"0";"1";"0";"430523";"5766"
"LOK1378_1mm";"SILVA (only NR);Eukaryota;Archaeplastida;Chloroplastida;Charophyta;Phragmoplastophyta;Streptophyta;Embryophyta;Tracheophyta;Spermatophyta;Magnoliophyta;Ericales;Pityopus;";"0.0";"0";"1";"1";"0";"1";"0";"430523";"5766"
"LOK1378_1mm";"SILVA (only NR);Eukaryota;Archaeplastida;Chloroplastida;Charophyta;Phragmoplastophyta;Streptophyta;Embryophyta;Tracheophyta;Spermatophyta;Magnoliophyta;Ericales;Primula;";"0.0";"0";"2";"2";"0";"2";"0";"430522";"5766"
"LOK1378_1mm";"SILVA (only NR);Eukaryota;Archaeplastida;Chloroplastida;Charophyta;Phragmoplastophyta;Streptophyta;Embryophyta;Tracheophyta;Spermatophyta;Magnoliophyta;Ericales;Prionotes;";"0.0";"0";"1";"1";"0";"1";"0";"430523";"5766"
"LOK1378_1mm";"SILVA (only NR);Eukaryota;Archaeplastida;Chloroplastida;Charophyta;Phragmoplastophyta;Streptophyta;Embryophyta;Tracheophyta;Spermatophyta;Magnoliophyta;Ericales;Pyrola;";"0.0";"0";"1";"1";"0";"1";"0";"430523";"5766"
"LOK1378_1mm";"SILVA (only NR);Eukaryota;Archaeplastida;Chloroplastida;Charophyta;Phragmoplastophyta;Streptophyta;Embryophyta;Tracheophyta;Spermatophyta;Magnoliophyta;Ericales;Rhododendron;";"0.0";"0";"1";"1";"0";"1";"0";"430523";"5766"
"LOK1378_1mm";"SILVA (only NR);Eukaryota;Archaeplastida;Chloroplastida;Charophyta;Phragmoplastophyta;Streptophyta;Embryophyta;Tracheophyta;Spermatophyta;Magnoliophyta;Ericales;Sarcodes;";"0.0";"0";"1";"1";"0";"1";"0";"430523";"5766"
"LOK1378_1mm";"SILVA (only NR);Eukaryota;Archaeplastida;Chloroplastida;Charophyta;Phragmoplastophyta;Streptophyta;Embryophyta;Tracheophyta;Spermatophyta;Magnoliophyta;Ericales;Sarracenia;";"0.0";"0";"1";"1";"0";"1";"0";"430523";"5766"
"LOK1378_1mm";"SILVA (only NR);Eukaryota;Archaeplastida;Chloroplastida;Charophyta;Phragmoplastophyta;Streptophyta;Embryophyta;Tracheophyta;Spermatophyta;Magnoliophyta;Ericales;Styrax;";"0.0";"0";"2";"2";"0";"2";"0";"430522";"5766"
"LOK1378_1mm";"SILVA (only NR);Eukaryota;Archaeplastida;Chloroplastida;Charophyta;Phragmoplastophyta;Streptophyta;Embryophyta;Tracheophyta;Spermatophyta;Magnoliophyta;Ericales;Symplocos;";"0.0";"0";"1";"1";"0";"1";"0";"430523";"5766"
"LOK1378_1mm";"SILVA (only NR);Eukaryota;Archaeplastida;Chloroplastida;Charophyta;Phragmoplastophyta;Streptophyta;Embryophyta;Tracheophyta;Spermatophyta;Magnoliophyta;Ericales;Tetramerista;";"0.0";"0";"1";"1";"0";"1";"0";"430523";"5766"
"LOK1378_1mm";"SILVA (only NR);Eukaryota;Archaeplastida;Chloroplastida;Charophyta;Phragmoplastophyta;Streptophyta;Embryophyta;Tracheophyta;Spermatophyta;Magnoliophyta;Ericales;Vaccinium;";"0.0";"0";"2";"2";"0";"2";"0";"430522";"5766"
"LOK1378_1mm";"SILVA (only NR);Eukaryota;Archaeplastida;Chloroplastida;Charophyta;Phragmoplastophyta;Streptophyta;Embryophyta;Tracheophyta;Spermatophyta;Magnoliophyta;Escalloniales;";"0.0";"0";"2";"2";"0";"2";"0";"430522";"5766"
"LOK1378_1mm";"SILVA (only NR);Eukaryota;Archaeplastida;Chloroplastida;Charophyta;Phragmoplastophyta;Streptophyta;Embryophyta;Tracheophyta;Spermatophyta;Magnoliophyta;Escalloniales;Eremosyne;";"0.0";"0";"1";"1";"0";"1";"0";"430523";"5766"
"LOK1378_1mm";"SILVA (only NR);Eukaryota;Archaeplastida;Chloroplastida;Charophyta;Phragmoplastophyta;Streptophyta;Embryophyta;Tracheophyta;Spermatophyta;Magnoliophyta;Escalloniales;Escallonia;";"0.0";"0";"1";"1";"0";"1";"0";"430523";"5766"
"LOK1378_1mm";"SILVA (only NR);Eukaryota;Archaeplastida;Chloroplastida;Charophyta;Phragmoplastophyta;Streptophyta;Embryophyta;Tracheophyta;Spermatophyta;Magnoliophyta;Fabales;";"0.0";"0";"209";"177";"0";"177";"32";"430347";"5766"
"LOK1378_1mm";"SILVA (only NR);Eukaryota;Archaeplastida;Chloroplastida;Charophyta;Phragmoplastophyta;Streptophyta;Embryophyta;Tracheophyta;Spermatophyta;Magnoliophyta;Fabales;Ammopiptanthus;";"0.0";"0";"15";"9";"0";"9";"6";"430515";"5766"
"LOK1378_1mm";"SILVA (only NR);Eukaryota;Archaeplastida;Chloroplastida;Charophyta;Phragmoplastophyta;Streptophyta;Embryophyta;Tracheophyta;Spermatophyta;Magnoliophyta;Fabales;Apios;";"0.0";"0";"1";"1";"0";"1";"0";"430523";"5766"
"LOK1378_1mm";"SILVA (only NR);Eukaryota;Archaeplastida;Chloroplastida;Charophyta;Phragmoplastophyta;Streptophyta;Embryophyta;Tracheophyta;Spermatophyta;Magnoliophyta;Fabales;Arachis;";"0.0";"0";"31";"29";"0";"29";"2";"430495";"5766"
"LOK1378_1mm";"SILVA (only NR);Eukaryota;Archaeplastida;Chloroplastida;Charophyta;Phragmoplastophyta;Streptophyta;Embryophyta;Tracheophyta;Spermatophyta;Magnoliophyta;Fabales;Astragalus;";"0.0";"0";"4";"4";"0";"4";"0";"430520";"5766"
"LOK1378_1mm";"SILVA (only NR);Eukaryota;Archaeplastida;Chloroplastida;Charophyta;Phragmoplastophyta;Streptophyta;Embryophyta;Tracheophyta;Spermatophyta;Magnoliophyta;Fabales;Bauhinia;";"0.0";"0";"1";"1";"0";"1";"0";"430523";"5766"
"LOK1378_1mm";"SILVA (only NR);Eukaryota;Archaeplastida;Chloroplastida;Charophyta;Phragmoplastophyta;Streptophyta;Embryophyta;Tracheophyta;Spermatophyta;Magnoliophyta;Fabales;Cajanus;";"0.0";"0";"6";"5";"0";"5";"1";"430519";"5766"
"LOK1378_1mm";"SILVA (only NR);Eukaryota;Archaeplastida;Chloroplastida;Charophyta;Phragmoplastophyta;Streptophyta;Embryophyta;Tracheophyta;Spermatophyta;Magnoliophyta;Fabales;Cercis;";"0.0";"0";"1";"1";"0";"1";"0";"430523";"5766"
"LOK1378_1mm";"SILVA (only NR);Eukaryota;Archaeplastida;Chloroplastida;Charophyta;Phragmoplastophyta;Streptophyta;Embryophyta;Tracheophyta;Spermatophyta;Magnoliophyta;Fabales;Chamaecrista;";"0.0";"0";"1";"1";"0";"1";"0";"430523";"5766"
"LOK1378_1mm";"SILVA (only NR);Eukaryota;Archaeplastida;Chloroplastida;Charophyta;Phragmoplastophyta;Streptophyta;Embryophyta;Tracheophyta;Spermatophyta;Magnoliophyta;Fabales;Cicer;";"0.0";"0";"11";"11";"0";"11";"0";"430513";"5766"
"LOK1378_1mm";"SILVA (only NR);Eukaryota;Archaeplastida;Chloroplastida;Charophyta;Phragmoplastophyta;Streptophyta;Embryophyta;Tracheophyta;Spermatophyta;Magnoliophyta;Fabales;Cynometra;";"0.0";"0";"1";"1";"0";"1";"0";"430523";"5766"
"LOK1378_1mm";"SILVA (only NR);Eukaryota;Archaeplastida;Chloroplastida;Charophyta;Phragmoplastophyta;Streptophyta;Embryophyta;Tracheophyta;Spermatophyta;Magnoliophyta;Fabales;Erythrina;";"0.0";"0";"1";"1";"0";"1";"0";"430523";"5766"
"LOK1378_1mm";"SILVA (only NR);Eukaryota;Archaeplastida;Chloroplastida;Charophyta;Phragmoplastophyta;Streptophyta;Embryophyta;Tracheophyta;Spermatophyta;Magnoliophyta;Fabales;Glycine;";"0.0";"0";"2";"1";"0";"1";"1";"430523";"5766"
"LOK1378_1mm";"SILVA (only NR);Eukaryota;Archaeplastida;Chloroplastida;Charophyta;Phragmoplastophyta;Streptophyta;Embryophyta;Tracheophyta;Spermatophyta;Magnoliophyta;Fabales;Lotus;";"0.0";"0";"2";"2";"0";"2";"0";"430522";"5766"
"LOK1378_1mm";"SILVA (only NR);Eukaryota;Archaeplastida;Chloroplastida;Charophyta;Phragmoplastophyta;Streptophyta;Embryophyta;Tracheophyta;Spermatophyta;Magnoliophyta;Fabales;Lupinus;";"0.0";"0";"31";"31";"0";"31";"0";"430493";"5766"
"LOK1378_1mm";"SILVA (only NR);Eukaryota;Archaeplastida;Chloroplastida;Charophyta;Phragmoplastophyta;Streptophyta;Embryophyta;Tracheophyta;Spermatophyta;Magnoliophyta;Fabales;Medicago;";"0.0";"0";"10";"7";"0";"7";"3";"430517";"5766"
"LOK1378_1mm";"SILVA (only NR);Eukaryota;Archaeplastida;Chloroplastida;Charophyta;Phragmoplastophyta;Streptophyta;Embryophyta;Tracheophyta;Spermatophyta;Magnoliophyta;Fabales;Mezoneuron;";"0.0";"0";"1";"1";"0";"1";"0";"430523";"5766"
"LOK1378_1mm";"SILVA (only NR);Eukaryota;Archaeplastida;Chloroplastida;Charophyta;Phragmoplastophyta;Streptophyta;Embryophyta;Tracheophyta;Spermatophyta;Magnoliophyta;Fabales;Oxytropis;";"0.0";"0";"2";"2";"0";"2";"0";"430522";"5766"
"LOK1378_1mm";"SILVA (only NR);Eukaryota;Archaeplastida;Chloroplastida;Charophyta;Phragmoplastophyta;Streptophyta;Embryophyta;Tracheophyta;Spermatophyta;Magnoliophyta;Fabales;Phaseolus;";"0.0";"0";"36";"21";"0";"21";"15";"430503";"5766"
"LOK1378_1mm";"SILVA (only NR);Eukaryota;Archaeplastida;Chloroplastida;Charophyta;Phragmoplastophyta;Streptophyta;Embryophyta;Tracheophyta;Spermatophyta;Magnoliophyta;Fabales;Polygala;";"0.0";"0";"2";"2";"0";"2";"0";"430522";"5766"
"LOK1378_1mm";"SILVA (only NR);Eukaryota;Archaeplastida;Chloroplastida;Charophyta;Phragmoplastophyta;Streptophyta;Embryophyta;Tracheophyta;Spermatophyta;Magnoliophyta;Fabales;Robinia;";"0.0";"0";"1";"0";"0";"0";"1";"430524";"5766"
"LOK1378_1mm";"SILVA (only NR);Eukaryota;Archaeplastida;Chloroplastida;Charophyta;Phragmoplastophyta;Streptophyta;Embryophyta;Tracheophyta;Spermatophyta;Magnoliophyta;Fabales;Securidaca;";"0.0";"0";"1";"1";"0";"1";"0";"430523";"5766"
"LOK1378_1mm";"SILVA (only NR);Eukaryota;Archaeplastida;Chloroplastida;Charophyta;Phragmoplastophyta;Streptophyta;Embryophyta;Tracheophyta;Spermatophyta;Magnoliophyta;Fabales;Senna;";"0.0";"0";"1";"1";"0";"1";"0";"430523";"5766"
"LOK1378_1mm";"SILVA (only NR);Eukaryota;Archaeplastida;Chloroplastida;Charophyta;Phragmoplastophyta;Streptophyta;Embryophyta;Tracheophyta;Spermatophyta;Magnoliophyta;Fabales;Stylobasium;";"0.0";"0";"1";"1";"0";"1";"0";"430523";"5766"
"LOK1378_1mm";"SILVA (only NR);Eukaryota;Archaeplastida;Chloroplastida;Charophyta;Phragmoplastophyta;Streptophyta;Embryophyta;Tracheophyta;Spermatophyta;Magnoliophyta;Fabales;Trifolium;";"0.0";"0";"1";"0";"0";"0";"1";"430524";"5766"
"LOK1378_1mm";"SILVA (only NR);Eukaryota;Archaeplastida;Chloroplastida;Charophyta;Phragmoplastophyta;Streptophyta;Embryophyta;Tracheophyta;Spermatophyta;Magnoliophyta;Fabales;Vigna;";"0.0";"0";"44";"42";"0";"42";"2";"430482";"5766"
"LOK1378_1mm";"SILVA (only NR);Eukaryota;Archaeplastida;Chloroplastida;Charophyta;Phragmoplastophyta;Streptophyta;Embryophyta;Tracheophyta;Spermatophyta;Magnoliophyta;Fabales;Wisteria;";"0.0";"0";"1";"1";"0";"1";"0";"430523";"5766"
"LOK1378_1mm";"SILVA (only NR);Eukaryota;Archaeplastida;Chloroplastida;Charophyta;Phragmoplastophyta;Streptophyta;Embryophyta;Tracheophyta;Spermatophyta;Magnoliophyta;Fagales;";"0.0";"0";"27";"24";"0";"24";"3";"430500";"5766"
"LOK1378_1mm";"SILVA (only NR);Eukaryota;Archaeplastida;Chloroplastida;Charophyta;Phragmoplastophyta;Streptophyta;Embryophyta;Tracheophyta;Spermatophyta;Magnoliophyta;Fagales;Alnus;";"0.0";"0";"1";"1";"0";"1";"0";"430523";"5766"
"LOK1378_1mm";"SILVA (only NR);Eukaryota;Archaeplastida;Chloroplastida;Charophyta;Phragmoplastophyta;Streptophyta;Embryophyta;Tracheophyta;Spermatophyta;Magnoliophyta;Fagales;Betula;";"0.0";"0";"5";"4";"0";"4";"1";"430520";"5766"
"LOK1378_1mm";"SILVA (only NR);Eukaryota;Archaeplastida;Chloroplastida;Charophyta;Phragmoplastophyta;Streptophyta;Embryophyta;Tracheophyta;Spermatophyta;Magnoliophyta;Fagales;Carya;";"0.0";"0";"1";"1";"0";"1";"0";"430523";"5766"
"LOK1378_1mm";"SILVA (only NR);Eukaryota;Archaeplastida;Chloroplastida;Charophyta;Phragmoplastophyta;Streptophyta;Embryophyta;Tracheophyta;Spermatophyta;Magnoliophyta;Fagales;Castanea;";"0.0";"0";"2";"2";"0";"2";"0";"430522";"5766"
"LOK1378_1mm";"SILVA (only NR);Eukaryota;Archaeplastida;Chloroplastida;Charophyta;Phragmoplastophyta;Streptophyta;Embryophyta;Tracheophyta;Spermatophyta;Magnoliophyta;Fagales;Castanopsis;";"0.0";"0";"1";"1";"0";"1";"0";"430523";"5766"
"LOK1378_1mm";"SILVA (only NR);Eukaryota;Archaeplastida;Chloroplastida;Charophyta;Phragmoplastophyta;Streptophyta;Embryophyta;Tracheophyta;Spermatophyta;Magnoliophyta;Fagales;Casuarina;";"0.0";"0";"1";"1";"0";"1";"0";"430523";"5766"
"LOK1378_1mm";"SILVA (only NR);Eukaryota;Archaeplastida;Chloroplastida;Charophyta;Phragmoplastophyta;Streptophyta;Embryophyta;Tracheophyta;Spermatophyta;Magnoliophyta;Fagales;Lithocarpus;";"0.0";"0";"1";"1";"0";"1";"0";"430523";"5766"
"LOK1378_1mm";"SILVA (only NR);Eukaryota;Archaeplastida;Chloroplastida;Charophyta;Phragmoplastophyta;Streptophyta;Embryophyta;Tracheophyta;Spermatophyta;Magnoliophyta;Fagales;Myrica;";"0.0";"0";"3";"2";"0";"2";"1";"430522";"5766"
"LOK1378_1mm";"SILVA (only NR);Eukaryota;Archaeplastida;Chloroplastida;Charophyta;Phragmoplastophyta;Streptophyta;Embryophyta;Tracheophyta;Spermatophyta;Magnoliophyta;Fagales;Nothofagus;";"0.0";"0";"1";"1";"0";"1";"0";"430523";"5766"
"LOK1378_1mm";"SILVA (only NR);Eukaryota;Archaeplastida;Chloroplastida;Charophyta;Phragmoplastophyta;Streptophyta;Embryophyta;Tracheophyta;Spermatophyta;Magnoliophyta;Fagales;Quercus;";"0.0";"0";"9";"8";"0";"8";"1";"430516";"5766"
"LOK1378_1mm";"SILVA (only NR);Eukaryota;Archaeplastida;Chloroplastida;Charophyta;Phragmoplastophyta;Streptophyta;Embryophyta;Tracheophyta;Spermatophyta;Magnoliophyta;Fagales;Ticodendron;";"0.0";"0";"1";"1";"0";"1";"0";"430523";"5766"
"LOK1378_1mm";"SILVA (only NR);Eukaryota;Archaeplastida;Chloroplastida;Charophyta;Phragmoplastophyta;Streptophyta;Embryophyta;Tracheophyta;Spermatophyta;Magnoliophyta;Fagales;Trigonobalanus;";"0.0";"0";"1";"1";"0";"1";"0";"430523";"5766"
"LOK1378_1mm";"SILVA (only NR);Eukaryota;Archaeplastida;Chloroplastida;Charophyta;Phragmoplastophyta;Streptophyta;Embryophyta;Tracheophyta;Spermatophyta;Magnoliophyta;Garryales;";"0.0";"0";"2";"2";"0";"2";"0";"430522";"5766"
"LOK1378_1mm";"SILVA (only NR);Eukaryota;Archaeplastida;Chloroplastida;Charophyta;Phragmoplastophyta;Streptophyta;Embryophyta;Tracheophyta;Spermatophyta;Magnoliophyta;Garryales;Eucommia;";"0.0";"0";"1";"1";"0";"1";"0";"430523";"5766"
"LOK1378_1mm";"SILVA (only NR);Eukaryota;Archaeplastida;Chloroplastida;Charophyta;Phragmoplastophyta;Streptophyta;Embryophyta;Tracheophyta;Spermatophyta;Magnoliophyta;Garryales;Garrya;";"0.0";"0";"1";"1";"0";"1";"0";"430523";"5766"
"LOK1378_1mm";"SILVA (only NR);Eukaryota;Archaeplastida;Chloroplastida;Charophyta;Phragmoplastophyta;Streptophyta;Embryophyta;Tracheophyta;Spermatophyta;Magnoliophyta;Gentianales;";"0.0";"0";"45";"44";"0";"44";"1";"430480";"5766"
"LOK1378_1mm";"SILVA (only NR);Eukaryota;Archaeplastida;Chloroplastida;Charophyta;Phragmoplastophyta;Streptophyta;Embryophyta;Tracheophyta;Spermatophyta;Magnoliophyta;Gentianales;Asclepias;";"0.0";"0";"1";"1";"0";"1";"0";"430523";"5766"
"LOK1378_1mm";"SILVA (only NR);Eukaryota;Archaeplastida;Chloroplastida;Charophyta;Phragmoplastophyta;Streptophyta;Embryophyta;Tracheophyta;Spermatophyta;Magnoliophyta;Gentianales;Catharanthus;";"0.0";"0";"8";"7";"0";"7";"1";"430517";"5766"
"LOK1378_1mm";"SILVA (only NR);Eukaryota;Archaeplastida;Chloroplastida;Charophyta;Phragmoplastophyta;Streptophyta;Embryophyta;Tracheophyta;Spermatophyta;Magnoliophyta;Gentianales;Chelonanthus;";"0.0";"0";"1";"1";"0";"1";"0";"430523";"5766"
"LOK1378_1mm";"SILVA (only NR);Eukaryota;Archaeplastida;Chloroplastida;Charophyta;Phragmoplastophyta;Streptophyta;Embryophyta;Tracheophyta;Spermatophyta;Magnoliophyta;Gentianales;Coffea;";"0.0";"0";"1";"1";"0";"1";"0";"430523";"5766"
"LOK1378_1mm";"SILVA (only NR);Eukaryota;Archaeplastida;Chloroplastida;Charophyta;Phragmoplastophyta;Streptophyta;Embryophyta;Tracheophyta;Spermatophyta;Magnoliophyta;Gentianales;Dialypetalanthus;";"0.0";"0";"1";"1";"0";"1";"0";"430523";"5766"
"LOK1378_1mm";"SILVA (only NR);Eukaryota;Archaeplastida;Chloroplastida;Charophyta;Phragmoplastophyta;Streptophyta;Embryophyta;Tracheophyta;Spermatophyta;Magnoliophyta;Gentianales;Erithalis;";"0.0";"0";"1";"1";"0";"1";"0";"430523";"5766"
"LOK1378_1mm";"SILVA (only NR);Eukaryota;Archaeplastida;Chloroplastida;Charophyta;Phragmoplastophyta;Streptophyta;Embryophyta;Tracheophyta;Spermatophyta;Magnoliophyta;Gentianales;Exacum;";"0.0";"0";"2";"2";"0";"2";"0";"430522";"5766"
"LOK1378_1mm";"SILVA (only NR);Eukaryota;Archaeplastida;Chloroplastida;Charophyta;Phragmoplastophyta;Streptophyta;Embryophyta;Tracheophyta;Spermatophyta;Magnoliophyta;Gentianales;Exochaenium;";"0.0";"0";"2";"2";"0";"2";"0";"430522";"5766"
"LOK1378_1mm";"SILVA (only NR);Eukaryota;Archaeplastida;Chloroplastida;Charophyta;Phragmoplastophyta;Streptophyta;Embryophyta;Tracheophyta;Spermatophyta;Magnoliophyta;Gentianales;Galium;";"0.0";"0";"1";"1";"0";"1";"0";"430523";"5766"
"LOK1378_1mm";"SILVA (only NR);Eukaryota;Archaeplastida;Chloroplastida;Charophyta;Phragmoplastophyta;Streptophyta;Embryophyta;Tracheophyta;Spermatophyta;Magnoliophyta;Gentianales;Gelsemium;";"0.0";"0";"1";"1";"0";"1";"0";"430523";"5766"
"LOK1378_1mm";"SILVA (only NR);Eukaryota;Archaeplastida;Chloroplastida;Charophyta;Phragmoplastophyta;Streptophyta;Embryophyta;Tracheophyta;Spermatophyta;Magnoliophyta;Gentianales;Geniostoma;";"0.0";"0";"1";"1";"0";"1";"0";"430523";"5766"
"LOK1378_1mm";"SILVA (only NR);Eukaryota;Archaeplastida;Chloroplastida;Charophyta;Phragmoplastophyta;Streptophyta;Embryophyta;Tracheophyta;Spermatophyta;Magnoliophyta;Gentianales;Gentianella;";"0.0";"0";"1";"1";"0";"1";"0";"430523";"5766"
"LOK1378_1mm";"SILVA (only NR);Eukaryota;Archaeplastida;Chloroplastida;Charophyta;Phragmoplastophyta;Streptophyta;Embryophyta;Tracheophyta;Spermatophyta;Magnoliophyta;Gentianales;Lisianthius;";"0.0";"0";"1";"1";"0";"1";"0";"430523";"5766"
"LOK1378_1mm";"SILVA (only NR);Eukaryota;Archaeplastida;Chloroplastida;Charophyta;Phragmoplastophyta;Streptophyta;Embryophyta;Tracheophyta;Spermatophyta;Magnoliophyta;Gentianales;Lomatogonium;";"0.0";"0";"1";"1";"0";"1";"0";"430523";"5766"
"LOK1378_1mm";"SILVA (only NR);Eukaryota;Archaeplastida;Chloroplastida;Charophyta;Phragmoplastophyta;Streptophyta;Embryophyta;Tracheophyta;Spermatophyta;Magnoliophyta;Gentianales;Macrocarpaea;";"0.0";"0";"1";"1";"0";"1";"0";"430523";"5766"
"LOK1378_1mm";"SILVA (only NR);Eukaryota;Archaeplastida;Chloroplastida;Charophyta;Phragmoplastophyta;Streptophyta;Embryophyta;Tracheophyta;Spermatophyta;Magnoliophyta;Gentianales;Mitchella;";"0.0";"0";"1";"1";"0";"1";"0";"430523";"5766"
"LOK1378_1mm";"SILVA (only NR);Eukaryota;Archaeplastida;Chloroplastida;Charophyta;Phragmoplastophyta;Streptophyta;Embryophyta;Tracheophyta;Spermatophyta;Magnoliophyta;Gentianales;Neolamarckia;";"0.0";"0";"1";"1";"0";"1";"0";"430523";"5766"
"LOK1378_1mm";"SILVA (only NR);Eukaryota;Archaeplastida;Chloroplastida;Charophyta;Phragmoplastophyta;Streptophyta;Embryophyta;Tracheophyta;Spermatophyta;Magnoliophyta;Gentianales;Nertera;";"0.0";"0";"1";"1";"0";"1";"0";"430523";"5766"
"LOK1378_1mm";"SILVA (only NR);Eukaryota;Archaeplastida;Chloroplastida;Charophyta;Phragmoplastophyta;Streptophyta;Embryophyta;Tracheophyta;Spermatophyta;Magnoliophyta;Gentianales;Ophiorrhiza;";"0.0";"0";"1";"1";"0";"1";"0";"430523";"5766"
"LOK1378_1mm";"SILVA (only NR);Eukaryota;Archaeplastida;Chloroplastida;Charophyta;Phragmoplastophyta;Streptophyta;Embryophyta;Tracheophyta;Spermatophyta;Magnoliophyta;Gentianales;Orphium;";"0.0";"0";"1";"1";"0";"1";"0";"430523";"5766"
"LOK1378_1mm";"SILVA (only NR);Eukaryota;Archaeplastida;Chloroplastida;Charophyta;Phragmoplastophyta;Streptophyta;Embryophyta;Tracheophyta;Spermatophyta;Magnoliophyta;Gentianales;Pentas;";"0.0";"0";"1";"1";"0";"1";"0";"430523";"5766"
"LOK1378_1mm";"SILVA (only NR);Eukaryota;Archaeplastida;Chloroplastida;Charophyta;Phragmoplastophyta;Streptophyta;Embryophyta;Tracheophyta;Spermatophyta;Magnoliophyta;Gentianales;Rhazya;";"0.0";"0";"1";"1";"0";"1";"0";"430523";"5766"
"LOK1378_1mm";"SILVA (only NR);Eukaryota;Archaeplastida;Chloroplastida;Charophyta;Phragmoplastophyta;Streptophyta;Embryophyta;Tracheophyta;Spermatophyta;Magnoliophyta;Gentianales;Rogiera;";"0.0";"0";"1";"1";"0";"1";"0";"430523";"5766"
"LOK1378_1mm";"SILVA (only NR);Eukaryota;Archaeplastida;Chloroplastida;Charophyta;Phragmoplastophyta;Streptophyta;Embryophyta;Tracheophyta;Spermatophyta;Magnoliophyta;Gentianales;Schinziella;";"0.0";"0";"1";"1";"0";"1";"0";"430523";"5766"
"LOK1378_1mm";"SILVA (only NR);Eukaryota;Archaeplastida;Chloroplastida;Charophyta;Phragmoplastophyta;Streptophyta;Embryophyta;Tracheophyta;Spermatophyta;Magnoliophyta;Gentianales;Schultesia;";"0.0";"0";"1";"1";"0";"1";"0";"430523";"5766"
"LOK1378_1mm";"SILVA (only NR);Eukaryota;Archaeplastida;Chloroplastida;Charophyta;Phragmoplastophyta;Streptophyta;Embryophyta;Tracheophyta;Spermatophyta;Magnoliophyta;Gentianales;Spigelia;";"0.0";"0";"1";"1";"0";"1";"0";"430523";"5766"
"LOK1378_1mm";"SILVA (only NR);Eukaryota;Archaeplastida;Chloroplastida;Charophyta;Phragmoplastophyta;Streptophyta;Embryophyta;Tracheophyta;Spermatophyta;Magnoliophyta;Gentianales;Swertia;";"0.0";"0";"1";"1";"0";"1";"0";"430523";"5766"
"LOK1378_1mm";"SILVA (only NR);Eukaryota;Archaeplastida;Chloroplastida;Charophyta;Phragmoplastophyta;Streptophyta;Embryophyta;Tracheophyta;Spermatophyta;Magnoliophyta;Gentianales;Voyria;";"0.0";"0";"8";"8";"0";"8";"0";"430516";"5766"
"LOK1378_1mm";"SILVA (only NR);Eukaryota;Archaeplastida;Chloroplastida;Charophyta;Phragmoplastophyta;Streptophyta;Embryophyta;Tracheophyta;Spermatophyta;Magnoliophyta;Gentianales;Voyriella;";"0.0";"0";"1";"1";"0";"1";"0";"430523";"5766"
"LOK1378_1mm";"SILVA (only NR);Eukaryota;Archaeplastida;Chloroplastida;Charophyta;Phragmoplastophyta;Streptophyta;Embryophyta;Tracheophyta;Spermatophyta;Magnoliophyta;Geraniales;";"0.0";"0";"5";"5";"0";"5";"0";"430519";"5766"
"LOK1378_1mm";"SILVA (only NR);Eukaryota;Archaeplastida;Chloroplastida;Charophyta;Phragmoplastophyta;Streptophyta;Embryophyta;Tracheophyta;Spermatophyta;Magnoliophyta;Geraniales;Bersama;";"0.0";"0";"1";"1";"0";"1";"0";"430523";"5766"
"LOK1378_1mm";"SILVA (only NR);Eukaryota;Archaeplastida;Chloroplastida;Charophyta;Phragmoplastophyta;Streptophyta;Embryophyta;Tracheophyta;Spermatophyta;Magnoliophyta;Geraniales;Francoa;";"0.0";"0";"1";"1";"0";"1";"0";"430523";"5766"
"LOK1378_1mm";"SILVA (only NR);Eukaryota;Archaeplastida;Chloroplastida;Charophyta;Phragmoplastophyta;Streptophyta;Embryophyta;Tracheophyta;Spermatophyta;Magnoliophyta;Geraniales;Geranium;";"0.0";"0";"1";"1";"0";"1";"0";"430523";"5766"
"LOK1378_1mm";"SILVA (only NR);Eukaryota;Archaeplastida;Chloroplastida;Charophyta;Phragmoplastophyta;Streptophyta;Embryophyta;Tracheophyta;Spermatophyta;Magnoliophyta;Geraniales;Greyia;";"0.0";"0";"1";"1";"0";"1";"0";"430523";"5766"
"LOK1378_1mm";"SILVA (only NR);Eukaryota;Archaeplastida;Chloroplastida;Charophyta;Phragmoplastophyta;Streptophyta;Embryophyta;Tracheophyta;Spermatophyta;Magnoliophyta;Geraniales;Viviania;";"0.0";"0";"1";"1";"0";"1";"0";"430523";"5766"
"LOK1378_1mm";"SILVA (only NR);Eukaryota;Archaeplastida;Chloroplastida;Charophyta;Phragmoplastophyta;Streptophyta;Embryophyta;Tracheophyta;Spermatophyta;Magnoliophyta;Gunnerales;";"0.0";"0";"2";"2";"0";"2";"0";"430522";"5766"
"LOK1378_1mm";"SILVA (only NR);Eukaryota;Archaeplastida;Chloroplastida;Charophyta;Phragmoplastophyta;Streptophyta;Embryophyta;Tracheophyta;Spermatophyta;Magnoliophyta;Gunnerales;Gunnera;";"0.0";"0";"1";"1";"0";"1";"0";"430523";"5766"
"LOK1378_1mm";"SILVA (only NR);Eukaryota;Archaeplastida;Chloroplastida;Charophyta;Phragmoplastophyta;Streptophyta;Embryophyta;Tracheophyta;Spermatophyta;Magnoliophyta;Gunnerales;Myrothamnus;";"0.0";"0";"1";"1";"0";"1";"0";"430523";"5766"
"LOK1378_1mm";"SILVA (only NR);Eukaryota;Archaeplastida;Chloroplastida;Charophyta;Phragmoplastophyta;Streptophyta;Embryophyta;Tracheophyta;Spermatophyta;Magnoliophyta;Huerteales;";"0.0";"0";"1";"1";"0";"1";"0";"430523";"5766"
"LOK1378_1mm";"SILVA (only NR);Eukaryota;Archaeplastida;Chloroplastida;Charophyta;Phragmoplastophyta;Streptophyta;Embryophyta;Tracheophyta;Spermatophyta;Magnoliophyta;Huerteales;Tapiscia;";"0.0";"0";"1";"1";"0";"1";"0";"430523";"5766"
"LOK1378_1mm";"SILVA (only NR);Eukaryota;Archaeplastida;Chloroplastida;Charophyta;Phragmoplastophyta;Streptophyta;Embryophyta;Tracheophyta;Spermatophyta;Magnoliophyta;Icacinales;";"0.0";"0";"1";"1";"0";"1";"0";"430523";"5766"
"LOK1378_1mm";"SILVA (only NR);Eukaryota;Archaeplastida;Chloroplastida;Charophyta;Phragmoplastophyta;Streptophyta;Embryophyta;Tracheophyta;Spermatophyta;Magnoliophyta;Icacinales;Nothapodytes;";"0.0";"0";"1";"1";"0";"1";"0";"430523";"5766"
"LOK1378_1mm";"SILVA (only NR);Eukaryota;Archaeplastida;Chloroplastida;Charophyta;Phragmoplastophyta;Streptophyta;Embryophyta;Tracheophyta;Spermatophyta;Magnoliophyta;Incertae Sedis;";"0.0";"0";"2";"2";"0";"2";"0";"430522";"5766"
"LOK1378_1mm";"SILVA (only NR);Eukaryota;Archaeplastida;Chloroplastida;Charophyta;Phragmoplastophyta;Streptophyta;Embryophyta;Tracheophyta;Spermatophyta;Magnoliophyta;Incertae Sedis;Oncotheca;";"0.0";"0";"1";"1";"0";"1";"0";"430523";"5766"
"LOK1378_1mm";"SILVA (only NR);Eukaryota;Archaeplastida;Chloroplastida;Charophyta;Phragmoplastophyta;Streptophyta;Embryophyta;Tracheophyta;Spermatophyta;Magnoliophyta;Incertae Sedis;Vahlia;";"0.0";"0";"1";"1";"0";"1";"0";"430523";"5766"
"LOK1378_1mm";"SILVA (only NR);Eukaryota;Archaeplastida;Chloroplastida;Charophyta;Phragmoplastophyta;Streptophyta;Embryophyta;Tracheophyta;Spermatophyta;Magnoliophyta;Lamiales;";"0.0";"0";"83";"78";"0";"78";"5";"430446";"5766"
"LOK1378_1mm";"SILVA (only NR);Eukaryota;Archaeplastida;Chloroplastida;Charophyta;Phragmoplastophyta;Streptophyta;Embryophyta;Tracheophyta;Spermatophyta;Magnoliophyta;Lamiales;Aeginetia;";"0.0";"0";"1";"1";"0";"1";"0";"430523";"5766"
"LOK1378_1mm";"SILVA (only NR);Eukaryota;Archaeplastida;Chloroplastida;Charophyta;Phragmoplastophyta;Streptophyta;Embryophyta;Tracheophyta;Spermatophyta;Magnoliophyta;Lamiales;Andrographis;";"0.0";"0";"1";"1";"0";"1";"0";"430523";"5766"
"LOK1378_1mm";"SILVA (only NR);Eukaryota;Archaeplastida;Chloroplastida;Charophyta;Phragmoplastophyta;Streptophyta;Embryophyta;Tracheophyta;Spermatophyta;Magnoliophyta;Lamiales;Aphyllon;";"0.0";"0";"2";"2";"0";"2";"0";"430522";"5766"
"LOK1378_1mm";"SILVA (only NR);Eukaryota;Archaeplastida;Chloroplastida;Charophyta;Phragmoplastophyta;Streptophyta;Embryophyta;Tracheophyta;Spermatophyta;Magnoliophyta;Lamiales;Avicennia;";"0.0";"0";"1";"1";"0";"1";"0";"430523";"5766"
"LOK1378_1mm";"SILVA (only NR);Eukaryota;Archaeplastida;Chloroplastida;Charophyta;Phragmoplastophyta;Streptophyta;Embryophyta;Tracheophyta;Spermatophyta;Magnoliophyta;Lamiales;Bacopa;";"0.0";"0";"1";"1";"0";"1";"0";"430523";"5766"
"LOK1378_1mm";"SILVA (only NR);Eukaryota;Archaeplastida;Chloroplastida;Charophyta;Phragmoplastophyta;Streptophyta;Embryophyta;Tracheophyta;Spermatophyta;Magnoliophyta;Lamiales;Byblis;";"0.0";"0";"1";"1";"0";"1";"0";"430523";"5766"
"LOK1378_1mm";"SILVA (only NR);Eukaryota;Archaeplastida;Chloroplastida;Charophyta;Phragmoplastophyta;Streptophyta;Embryophyta;Tracheophyta;Spermatophyta;Magnoliophyta;Lamiales;Callitriche;";"0.0";"0";"1";"1";"0";"1";"0";"430523";"5766"
"LOK1378_1mm";"SILVA (only NR);Eukaryota;Archaeplastida;Chloroplastida;Charophyta;Phragmoplastophyta;Streptophyta;Embryophyta;Tracheophyta;Spermatophyta;Magnoliophyta;Lamiales;Castilleja;";"0.0";"0";"1";"1";"0";"1";"0";"430523";"5766"
"LOK1378_1mm";"SILVA (only NR);Eukaryota;Archaeplastida;Chloroplastida;Charophyta;Phragmoplastophyta;Streptophyta;Embryophyta;Tracheophyta;Spermatophyta;Magnoliophyta;Lamiales;Clerodendrum;";"0.0";"0";"1";"1";"0";"1";"0";"430523";"5766"
"LOK1378_1mm";"SILVA (only NR);Eukaryota;Archaeplastida;Chloroplastida;Charophyta;Phragmoplastophyta;Streptophyta;Embryophyta;Tracheophyta;Spermatophyta;Magnoliophyta;Lamiales;Conopholis;";"0.0";"0";"1";"1";"0";"1";"0";"430523";"5766"
"LOK1378_1mm";"SILVA (only NR);Eukaryota;Archaeplastida;Chloroplastida;Charophyta;Phragmoplastophyta;Streptophyta;Embryophyta;Tracheophyta;Spermatophyta;Magnoliophyta;Lamiales;Cyrtandra;";"0.0";"0";"1";"1";"0";"1";"0";"430523";"5766"
"LOK1378_1mm";"SILVA (only NR);Eukaryota;Archaeplastida;Chloroplastida;Charophyta;Phragmoplastophyta;Streptophyta;Embryophyta;Tracheophyta;Spermatophyta;Magnoliophyta;Lamiales;Digitalis;";"0.0";"0";"1";"1";"0";"1";"0";"430523";"5766"
"LOK1378_1mm";"SILVA (only NR);Eukaryota;Archaeplastida;Chloroplastida;Charophyta;Phragmoplastophyta;Streptophyta;Embryophyta;Tracheophyta;Spermatophyta;Magnoliophyta;Lamiales;Dorcoceras;";"0.0";"0";"11";"10";"0";"10";"1";"430514";"5766"
"LOK1378_1mm";"SILVA (only NR);Eukaryota;Archaeplastida;Chloroplastida;Charophyta;Phragmoplastophyta;Streptophyta;Embryophyta;Tracheophyta;Spermatophyta;Magnoliophyta;Lamiales;Drymonia;";"0.0";"0";"1";"1";"0";"1";"0";"430523";"5766"
"LOK1378_1mm";"SILVA (only NR);Eukaryota;Archaeplastida;Chloroplastida;Charophyta;Phragmoplastophyta;Streptophyta;Embryophyta;Tracheophyta;Spermatophyta;Magnoliophyta;Lamiales;Erythranthe;";"0.0";"0";"15";"12";"0";"12";"3";"430512";"5766"
"LOK1378_1mm";"SILVA (only NR);Eukaryota;Archaeplastida;Chloroplastida;Charophyta;Phragmoplastophyta;Streptophyta;Embryophyta;Tracheophyta;Spermatophyta;Magnoliophyta;Lamiales;Fraxinus;";"0.0";"0";"1";"1";"0";"1";"0";"430523";"5766"
"LOK1378_1mm";"SILVA (only NR);Eukaryota;Archaeplastida;Chloroplastida;Charophyta;Phragmoplastophyta;Streptophyta;Embryophyta;Tracheophyta;Spermatophyta;Magnoliophyta;Lamiales;Genlisea;";"0.0";"0";"1";"1";"0";"1";"0";"430523";"5766"
"LOK1378_1mm";"SILVA (only NR);Eukaryota;Archaeplastida;Chloroplastida;Charophyta;Phragmoplastophyta;Streptophyta;Embryophyta;Tracheophyta;Spermatophyta;Magnoliophyta;Lamiales;Gratiola;";"0.0";"0";"1";"1";"0";"1";"0";"430523";"5766"
"LOK1378_1mm";"SILVA (only NR);Eukaryota;Archaeplastida;Chloroplastida;Charophyta;Phragmoplastophyta;Streptophyta;Embryophyta;Tracheophyta;Spermatophyta;Magnoliophyta;Lamiales;Harveya;";"0.0";"0";"1";"1";"0";"1";"0";"430523";"5766"
"LOK1378_1mm";"SILVA (only NR);Eukaryota;Archaeplastida;Chloroplastida;Charophyta;Phragmoplastophyta;Streptophyta;Embryophyta;Tracheophyta;Spermatophyta;Magnoliophyta;Lamiales;Hyobanche;";"0.0";"0";"1";"1";"0";"1";"0";"430523";"5766"
"LOK1378_1mm";"SILVA (only NR);Eukaryota;Archaeplastida;Chloroplastida;Charophyta;Phragmoplastophyta;Streptophyta;Embryophyta;Tracheophyta;Spermatophyta;Magnoliophyta;Lamiales;Jasminum;";"0.0";"0";"1";"1";"0";"1";"0";"430523";"5766"
"LOK1378_1mm";"SILVA (only NR);Eukaryota;Archaeplastida;Chloroplastida;Charophyta;Phragmoplastophyta;Streptophyta;Embryophyta;Tracheophyta;Spermatophyta;Magnoliophyta;Lamiales;Justicia;";"0.0";"0";"1";"1";"0";"1";"0";"430523";"5766"
"LOK1378_1mm";"SILVA (only NR);Eukaryota;Archaeplastida;Chloroplastida;Charophyta;Phragmoplastophyta;Streptophyta;Embryophyta;Tracheophyta;Spermatophyta;Magnoliophyta;Lamiales;Lathraea;";"0.0";"0";"1";"1";"0";"1";"0";"430523";"5766"
"LOK1378_1mm";"SILVA (only NR);Eukaryota;Archaeplastida;Chloroplastida;Charophyta;Phragmoplastophyta;Streptophyta;Embryophyta;Tracheophyta;Spermatophyta;Magnoliophyta;Lamiales;Lindernia;";"0.0";"0";"1";"1";"0";"1";"0";"430523";"5766"
"LOK1378_1mm";"SILVA (only NR);Eukaryota;Archaeplastida;Chloroplastida;Charophyta;Phragmoplastophyta;Streptophyta;Embryophyta;Tracheophyta;Spermatophyta;Magnoliophyta;Lamiales;Mazus;";"0.0";"0";"1";"1";"0";"1";"0";"430523";"5766"
"LOK1378_1mm";"SILVA (only NR);Eukaryota;Archaeplastida;Chloroplastida;Charophyta;Phragmoplastophyta;Streptophyta;Embryophyta;Tracheophyta;Spermatophyta;Magnoliophyta;Lamiales;Melampyrum;";"0.0";"0";"1";"1";"0";"1";"0";"430523";"5766"
"LOK1378_1mm";"SILVA (only NR);Eukaryota;Archaeplastida;Chloroplastida;Charophyta;Phragmoplastophyta;Streptophyta;Embryophyta;Tracheophyta;Spermatophyta;Magnoliophyta;Lamiales;Monarda;";"0.0";"0";"1";"1";"0";"1";"0";"430523";"5766"
"LOK1378_1mm";"SILVA (only NR);Eukaryota;Archaeplastida;Chloroplastida;Charophyta;Phragmoplastophyta;Streptophyta;Embryophyta;Tracheophyta;Spermatophyta;Magnoliophyta;Lamiales;Orobanche;";"0.0";"0";"1";"1";"0";"1";"0";"430523";"5766"
"LOK1378_1mm";"SILVA (only NR);Eukaryota;Archaeplastida;Chloroplastida;Charophyta;Phragmoplastophyta;Streptophyta;Embryophyta;Tracheophyta;Spermatophyta;Magnoliophyta;Lamiales;Perilla;";"0.0";"0";"2";"2";"0";"2";"0";"430522";"5766"
"LOK1378_1mm";"SILVA (only NR);Eukaryota;Archaeplastida;Chloroplastida;Charophyta;Phragmoplastophyta;Streptophyta;Embryophyta;Tracheophyta;Spermatophyta;Magnoliophyta;Lamiales;Pinguicula;";"0.0";"0";"2";"2";"0";"2";"0";"430522";"5766"
"LOK1378_1mm";"SILVA (only NR);Eukaryota;Archaeplastida;Chloroplastida;Charophyta;Phragmoplastophyta;Streptophyta;Embryophyta;Tracheophyta;Spermatophyta;Magnoliophyta;Lamiales;Plantago;";"0.0";"0";"1";"1";"0";"1";"0";"430523";"5766"
"LOK1378_1mm";"SILVA (only NR);Eukaryota;Archaeplastida;Chloroplastida;Charophyta;Phragmoplastophyta;Streptophyta;Embryophyta;Tracheophyta;Spermatophyta;Magnoliophyta;Lamiales;Proboscidea;";"0.0";"0";"1";"1";"0";"1";"0";"430523";"5766"
"LOK1378_1mm";"SILVA (only NR);Eukaryota;Archaeplastida;Chloroplastida;Charophyta;Phragmoplastophyta;Streptophyta;Embryophyta;Tracheophyta;Spermatophyta;Magnoliophyta;Lamiales;Rehmannia;";"0.0";"0";"2";"2";"0";"2";"0";"430522";"5766"
"LOK1378_1mm";"SILVA (only NR);Eukaryota;Archaeplastida;Chloroplastida;Charophyta;Phragmoplastophyta;Streptophyta;Embryophyta;Tracheophyta;Spermatophyta;Magnoliophyta;Lamiales;Rhynchoglossum;";"0.0";"0";"1";"1";"0";"1";"0";"430523";"5766"
"LOK1378_1mm";"SILVA (only NR);Eukaryota;Archaeplastida;Chloroplastida;Charophyta;Phragmoplastophyta;Streptophyta;Embryophyta;Tracheophyta;Spermatophyta;Magnoliophyta;Lamiales;Salvia;";"0.0";"0";"1";"0";"0";"0";"1";"430524";"5766"
"LOK1378_1mm";"SILVA (only NR);Eukaryota;Archaeplastida;Chloroplastida;Charophyta;Phragmoplastophyta;Streptophyta;Embryophyta;Tracheophyta;Spermatophyta;Magnoliophyta;Lamiales;Schlegelia;";"0.0";"0";"1";"1";"0";"1";"0";"430523";"5766"
"LOK1378_1mm";"SILVA (only NR);Eukaryota;Archaeplastida;Chloroplastida;Charophyta;Phragmoplastophyta;Streptophyta;Embryophyta;Tracheophyta;Spermatophyta;Magnoliophyta;Lamiales;Scrophularia;";"0.0";"0";"1";"1";"0";"1";"0";"430523";"5766"
"LOK1378_1mm";"SILVA (only NR);Eukaryota;Archaeplastida;Chloroplastida;Charophyta;Phragmoplastophyta;Streptophyta;Embryophyta;Tracheophyta;Spermatophyta;Magnoliophyta;Lamiales;Sesamum;";"0.0";"0";"13";"13";"0";"13";"0";"430511";"5766"
"LOK1378_1mm";"SILVA (only NR);Eukaryota;Archaeplastida;Chloroplastida;Charophyta;Phragmoplastophyta;Streptophyta;Embryophyta;Tracheophyta;Spermatophyta;Magnoliophyta;Lamiales;Streptocarpus;";"0.0";"0";"1";"1";"0";"1";"0";"430523";"5766"
"LOK1378_1mm";"SILVA (only NR);Eukaryota;Archaeplastida;Chloroplastida;Charophyta;Phragmoplastophyta;Streptophyta;Embryophyta;Tracheophyta;Spermatophyta;Magnoliophyta;Lamiales;Tectona;";"0.0";"0";"1";"1";"0";"1";"0";"430523";"5766"
"LOK1378_1mm";"SILVA (only NR);Eukaryota;Archaeplastida;Chloroplastida;Charophyta;Phragmoplastophyta;Streptophyta;Embryophyta;Tracheophyta;Spermatophyta;Magnoliophyta;Lamiales;Utricularia;";"0.0";"0";"2";"2";"0";"2";"0";"430522";"5766"
"LOK1378_1mm";"SILVA (only NR);Eukaryota;Archaeplastida;Chloroplastida;Charophyta;Phragmoplastophyta;Streptophyta;Embryophyta;Tracheophyta;Spermatophyta;Magnoliophyta;Lamiales;Veronica;";"0.0";"0";"1";"1";"0";"1";"0";"430523";"5766"
"LOK1378_1mm";"SILVA (only NR);Eukaryota;Archaeplastida;Chloroplastida;Charophyta;Phragmoplastophyta;Streptophyta;Embryophyta;Tracheophyta;Spermatophyta;Magnoliophyta;Laurales;";"0.0";"0";"12";"12";"0";"12";"0";"430512";"5766"
"LOK1378_1mm";"SILVA (only NR);Eukaryota;Archaeplastida;Chloroplastida;Charophyta;Phragmoplastophyta;Streptophyta;Embryophyta;Tracheophyta;Spermatophyta;Magnoliophyta;Laurales;Calycanthus;";"0.0";"0";"1";"1";"0";"1";"0";"430523";"5766"
"LOK1378_1mm";"SILVA (only NR);Eukaryota;Archaeplastida;Chloroplastida;Charophyta;Phragmoplastophyta;Streptophyta;Embryophyta;Tracheophyta;Spermatophyta;Magnoliophyta;Laurales;Cassytha;";"0.0";"0";"1";"1";"0";"1";"0";"430523";"5766"
"LOK1378_1mm";"SILVA (only NR);Eukaryota;Archaeplastida;Chloroplastida;Charophyta;Phragmoplastophyta;Streptophyta;Embryophyta;Tracheophyta;Spermatophyta;Magnoliophyta;Laurales;Cryptocarya;";"0.0";"0";"1";"1";"0";"1";"0";"430523";"5766"
"LOK1378_1mm";"SILVA (only NR);Eukaryota;Archaeplastida;Chloroplastida;Charophyta;Phragmoplastophyta;Streptophyta;Embryophyta;Tracheophyta;Spermatophyta;Magnoliophyta;Laurales;Doryphora;";"0.0";"0";"1";"1";"0";"1";"0";"430523";"5766"
"LOK1378_1mm";"SILVA (only NR);Eukaryota;Archaeplastida;Chloroplastida;Charophyta;Phragmoplastophyta;Streptophyta;Embryophyta;Tracheophyta;Spermatophyta;Magnoliophyta;Laurales;Gomortega;";"0.0";"0";"1";"1";"0";"1";"0";"430523";"5766"
"LOK1378_1mm";"SILVA (only NR);Eukaryota;Archaeplastida;Chloroplastida;Charophyta;Phragmoplastophyta;Streptophyta;Embryophyta;Tracheophyta;Spermatophyta;Magnoliophyta;Laurales;Gyrocarpus;";"0.0";"0";"1";"1";"0";"1";"0";"430523";"5766"
"LOK1378_1mm";"SILVA (only NR);Eukaryota;Archaeplastida;Chloroplastida;Charophyta;Phragmoplastophyta;Streptophyta;Embryophyta;Tracheophyta;Spermatophyta;Magnoliophyta;Laurales;Hedycarya;";"0.0";"0";"1";"1";"0";"1";"0";"430523";"5766"
"LOK1378_1mm";"SILVA (only NR);Eukaryota;Archaeplastida;Chloroplastida;Charophyta;Phragmoplastophyta;Streptophyta;Embryophyta;Tracheophyta;Spermatophyta;Magnoliophyta;Laurales;Hernandia;";"0.0";"0";"1";"1";"0";"1";"0";"430523";"5766"
"LOK1378_1mm";"SILVA (only NR);Eukaryota;Archaeplastida;Chloroplastida;Charophyta;Phragmoplastophyta;Streptophyta;Embryophyta;Tracheophyta;Spermatophyta;Magnoliophyta;Laurales;Idiospermum;";"0.0";"0";"1";"1";"0";"1";"0";"430523";"5766"
"LOK1378_1mm";"SILVA (only NR);Eukaryota;Archaeplastida;Chloroplastida;Charophyta;Phragmoplastophyta;Streptophyta;Embryophyta;Tracheophyta;Spermatophyta;Magnoliophyta;Laurales;Laurus;";"0.0";"0";"1";"1";"0";"1";"0";"430523";"5766"
"LOK1378_1mm";"SILVA (only NR);Eukaryota;Archaeplastida;Chloroplastida;Charophyta;Phragmoplastophyta;Streptophyta;Embryophyta;Tracheophyta;Spermatophyta;Magnoliophyta;Laurales;Palmeria;";"0.0";"0";"1";"1";"0";"1";"0";"430523";"5766"
"LOK1378_1mm";"SILVA (only NR);Eukaryota;Archaeplastida;Chloroplastida;Charophyta;Phragmoplastophyta;Streptophyta;Embryophyta;Tracheophyta;Spermatophyta;Magnoliophyta;Laurales;Siparuna;";"0.0";"0";"1";"1";"0";"1";"0";"430523";"5766"
"LOK1378_1mm";"SILVA (only NR);Eukaryota;Archaeplastida;Chloroplastida;Charophyta;Phragmoplastophyta;Streptophyta;Embryophyta;Tracheophyta;Spermatophyta;Magnoliophyta;Liliopsida;";"0.0";"0";"671";"620";"0";"620";"51";"429904";"5766"
"LOK1378_1mm";"SILVA (only NR);Eukaryota;Archaeplastida;Chloroplastida;Charophyta;Phragmoplastophyta;Streptophyta;Embryophyta;Tracheophyta;Spermatophyta;Magnoliophyta;Liliopsida;Acorales;";"0.0";"0";"2";"2";"0";"2";"0";"430522";"5766"
"LOK1378_1mm";"SILVA (only NR);Eukaryota;Archaeplastida;Chloroplastida;Charophyta;Phragmoplastophyta;Streptophyta;Embryophyta;Tracheophyta;Spermatophyta;Magnoliophyta;Liliopsida;Acorales;Acorus;";"0.0";"0";"2";"2";"0";"2";"0";"430522";"5766"
"LOK1378_1mm";"SILVA (only NR);Eukaryota;Archaeplastida;Chloroplastida;Charophyta;Phragmoplastophyta;Streptophyta;Embryophyta;Tracheophyta;Spermatophyta;Magnoliophyta;Liliopsida;Alismatales;";"0.0";"0";"46";"46";"0";"46";"0";"430478";"5766"
"LOK1378_1mm";"SILVA (only NR);Eukaryota;Archaeplastida;Chloroplastida;Charophyta;Phragmoplastophyta;Streptophyta;Embryophyta;Tracheophyta;Spermatophyta;Magnoliophyta;Liliopsida;Alismatales;Alisma;";"0.0";"0";"1";"1";"0";"1";"0";"430523";"5766"
"LOK1378_1mm";"SILVA (only NR);Eukaryota;Archaeplastida;Chloroplastida;Charophyta;Phragmoplastophyta;Streptophyta;Embryophyta;Tracheophyta;Spermatophyta;Magnoliophyta;Liliopsida;Alismatales;Aponogeton;";"0.0";"0";"1";"1";"0";"1";"0";"430523";"5766"
"LOK1378_1mm";"SILVA (only NR);Eukaryota;Archaeplastida;Chloroplastida;Charophyta;Phragmoplastophyta;Streptophyta;Embryophyta;Tracheophyta;Spermatophyta;Magnoliophyta;Liliopsida;Alismatales;Arisaema;";"0.0";"0";"1";"1";"0";"1";"0";"430523";"5766"
"LOK1378_1mm";"SILVA (only NR);Eukaryota;Archaeplastida;Chloroplastida;Charophyta;Phragmoplastophyta;Streptophyta;Embryophyta;Tracheophyta;Spermatophyta;Magnoliophyta;Liliopsida;Alismatales;Blyxa;";"0.0";"0";"2";"2";"0";"2";"0";"430522";"5766"
"LOK1378_1mm";"SILVA (only NR);Eukaryota;Archaeplastida;Chloroplastida;Charophyta;Phragmoplastophyta;Streptophyta;Embryophyta;Tracheophyta;Spermatophyta;Magnoliophyta;Liliopsida;Alismatales;Butomus;";"0.0";"0";"1";"1";"0";"1";"0";"430523";"5766"
"LOK1378_1mm";"SILVA (only NR);Eukaryota;Archaeplastida;Chloroplastida;Charophyta;Phragmoplastophyta;Streptophyta;Embryophyta;Tracheophyta;Spermatophyta;Magnoliophyta;Liliopsida;Alismatales;Caldesia;";"0.0";"0";"1";"1";"0";"1";"0";"430523";"5766"
"LOK1378_1mm";"SILVA (only NR);Eukaryota;Archaeplastida;Chloroplastida;Charophyta;Phragmoplastophyta;Streptophyta;Embryophyta;Tracheophyta;Spermatophyta;Magnoliophyta;Liliopsida;Alismatales;Calla;";"0.0";"0";"1";"1";"0";"1";"0";"430523";"5766"
"LOK1378_1mm";"SILVA (only NR);Eukaryota;Archaeplastida;Chloroplastida;Charophyta;Phragmoplastophyta;Streptophyta;Embryophyta;Tracheophyta;Spermatophyta;Magnoliophyta;Liliopsida;Alismatales;Cymodocea;";"0.0";"0";"2";"2";"0";"2";"0";"430522";"5766"
"LOK1378_1mm";"SILVA (only NR);Eukaryota;Archaeplastida;Chloroplastida;Charophyta;Phragmoplastophyta;Streptophyta;Embryophyta;Tracheophyta;Spermatophyta;Magnoliophyta;Liliopsida;Alismatales;Echinodorus;";"0.0";"0";"1";"1";"0";"1";"0";"430523";"5766"
"LOK1378_1mm";"SILVA (only NR);Eukaryota;Archaeplastida;Chloroplastida;Charophyta;Phragmoplastophyta;Streptophyta;Embryophyta;Tracheophyta;Spermatophyta;Magnoliophyta;Liliopsida;Alismatales;Egeria;";"0.0";"0";"1";"1";"0";"1";"0";"430523";"5766"
"LOK1378_1mm";"SILVA (only NR);Eukaryota;Archaeplastida;Chloroplastida;Charophyta;Phragmoplastophyta;Streptophyta;Embryophyta;Tracheophyta;Spermatophyta;Magnoliophyta;Liliopsida;Alismatales;Enhalus;";"0.0";"0";"1";"1";"0";"1";"0";"430523";"5766"
"LOK1378_1mm";"SILVA (only NR);Eukaryota;Archaeplastida;Chloroplastida;Charophyta;Phragmoplastophyta;Streptophyta;Embryophyta;Tracheophyta;Spermatophyta;Magnoliophyta;Liliopsida;Alismatales;Gymnostachys;";"0.0";"0";"1";"1";"0";"1";"0";"430523";"5766"
"LOK1378_1mm";"SILVA (only NR);Eukaryota;Archaeplastida;Chloroplastida;Charophyta;Phragmoplastophyta;Streptophyta;Embryophyta;Tracheophyta;Spermatophyta;Magnoliophyta;Liliopsida;Alismatales;Hydrilla;";"0.0";"0";"1";"1";"0";"1";"0";"430523";"5766"
"LOK1378_1mm";"SILVA (only NR);Eukaryota;Archaeplastida;Chloroplastida;Charophyta;Phragmoplastophyta;Streptophyta;Embryophyta;Tracheophyta;Spermatophyta;Magnoliophyta;Liliopsida;Alismatales;Hydrocharis;";"0.0";"0";"1";"1";"0";"1";"0";"430523";"5766"
"LOK1378_1mm";"SILVA (only NR);Eukaryota;Archaeplastida;Chloroplastida;Charophyta;Phragmoplastophyta;Streptophyta;Embryophyta;Tracheophyta;Spermatophyta;Magnoliophyta;Liliopsida;Alismatales;Hydrocleys;";"0.0";"0";"1";"1";"0";"1";"0";"430523";"5766"
"LOK1378_1mm";"SILVA (only NR);Eukaryota;Archaeplastida;Chloroplastida;Charophyta;Phragmoplastophyta;Streptophyta;Embryophyta;Tracheophyta;Spermatophyta;Magnoliophyta;Liliopsida;Alismatales;Lemna;";"0.0";"0";"2";"2";"0";"2";"0";"430522";"5766"
"LOK1378_1mm";"SILVA (only NR);Eukaryota;Archaeplastida;Chloroplastida;Charophyta;Phragmoplastophyta;Streptophyta;Embryophyta;Tracheophyta;Spermatophyta;Magnoliophyta;Liliopsida;Alismatales;Lilaea;";"0.0";"0";"1";"1";"0";"1";"0";"430523";"5766"
"LOK1378_1mm";"SILVA (only NR);Eukaryota;Archaeplastida;Chloroplastida;Charophyta;Phragmoplastophyta;Streptophyta;Embryophyta;Tracheophyta;Spermatophyta;Magnoliophyta;Liliopsida;Alismatales;Limnocharis;";"0.0";"0";"1";"1";"0";"1";"0";"430523";"5766"
"LOK1378_1mm";"SILVA (only NR);Eukaryota;Archaeplastida;Chloroplastida;Charophyta;Phragmoplastophyta;Streptophyta;Embryophyta;Tracheophyta;Spermatophyta;Magnoliophyta;Liliopsida;Alismatales;Limnophyton;";"0.0";"0";"1";"1";"0";"1";"0";"430523";"5766"
"LOK1378_1mm";"SILVA (only NR);Eukaryota;Archaeplastida;Chloroplastida;Charophyta;Phragmoplastophyta;Streptophyta;Embryophyta;Tracheophyta;Spermatophyta;Magnoliophyta;Liliopsida;Alismatales;Najas;";"0.0";"0";"2";"2";"0";"2";"0";"430522";"5766"
"LOK1378_1mm";"SILVA (only NR);Eukaryota;Archaeplastida;Chloroplastida;Charophyta;Phragmoplastophyta;Streptophyta;Embryophyta;Tracheophyta;Spermatophyta;Magnoliophyta;Liliopsida;Alismatales;Orontium;";"0.0";"0";"1";"1";"0";"1";"0";"430523";"5766"
"LOK1378_1mm";"SILVA (only NR);Eukaryota;Archaeplastida;Chloroplastida;Charophyta;Phragmoplastophyta;Streptophyta;Embryophyta;Tracheophyta;Spermatophyta;Magnoliophyta;Liliopsida;Alismatales;Ottelia;";"0.0";"0";"1";"1";"0";"1";"0";"430523";"5766"
"LOK1378_1mm";"SILVA (only NR);Eukaryota;Archaeplastida;Chloroplastida;Charophyta;Phragmoplastophyta;Streptophyta;Embryophyta;Tracheophyta;Spermatophyta;Magnoliophyta;Liliopsida;Alismatales;Phyllospadix;";"0.0";"0";"1";"1";"0";"1";"0";"430523";"5766"
"LOK1378_1mm";"SILVA (only NR);Eukaryota;Archaeplastida;Chloroplastida;Charophyta;Phragmoplastophyta;Streptophyta;Embryophyta;Tracheophyta;Spermatophyta;Magnoliophyta;Liliopsida;Alismatales;Pistia;";"0.0";"0";"1";"1";"0";"1";"0";"430523";"5766"
"LOK1378_1mm";"SILVA (only NR);Eukaryota;Archaeplastida;Chloroplastida;Charophyta;Phragmoplastophyta;Streptophyta;Embryophyta;Tracheophyta;Spermatophyta;Magnoliophyta;Liliopsida;Alismatales;Pleea;";"0.0";"0";"1";"1";"0";"1";"0";"430523";"5766"
"LOK1378_1mm";"SILVA (only NR);Eukaryota;Archaeplastida;Chloroplastida;Charophyta;Phragmoplastophyta;Streptophyta;Embryophyta;Tracheophyta;Spermatophyta;Magnoliophyta;Liliopsida;Alismatales;Ruppia;";"0.0";"0";"1";"1";"0";"1";"0";"430523";"5766"
"LOK1378_1mm";"SILVA (only NR);Eukaryota;Archaeplastida;Chloroplastida;Charophyta;Phragmoplastophyta;Streptophyta;Embryophyta;Tracheophyta;Spermatophyta;Magnoliophyta;Liliopsida;Alismatales;Sagittaria;";"0.0";"0";"1";"1";"0";"1";"0";"430523";"5766"
"LOK1378_1mm";"SILVA (only NR);Eukaryota;Archaeplastida;Chloroplastida;Charophyta;Phragmoplastophyta;Streptophyta;Embryophyta;Tracheophyta;Spermatophyta;Magnoliophyta;Liliopsida;Alismatales;Scheuchzeria;";"0.0";"0";"1";"1";"0";"1";"0";"430523";"5766"
"LOK1378_1mm";"SILVA (only NR);Eukaryota;Archaeplastida;Chloroplastida;Charophyta;Phragmoplastophyta;Streptophyta;Embryophyta;Tracheophyta;Spermatophyta;Magnoliophyta;Liliopsida;Alismatales;Spathiphyllum;";"0.0";"0";"1";"1";"0";"1";"0";"430523";"5766"
"LOK1378_1mm";"SILVA (only NR);Eukaryota;Archaeplastida;Chloroplastida;Charophyta;Phragmoplastophyta;Streptophyta;Embryophyta;Tracheophyta;Spermatophyta;Magnoliophyta;Liliopsida;Alismatales;Spirodela;";"0.0";"0";"1";"1";"0";"1";"0";"430523";"5766"
"LOK1378_1mm";"SILVA (only NR);Eukaryota;Archaeplastida;Chloroplastida;Charophyta;Phragmoplastophyta;Streptophyta;Embryophyta;Tracheophyta;Spermatophyta;Magnoliophyta;Liliopsida;Alismatales;Stratiotes;";"0.0";"0";"1";"1";"0";"1";"0";"430523";"5766"
"LOK1378_1mm";"SILVA (only NR);Eukaryota;Archaeplastida;Chloroplastida;Charophyta;Phragmoplastophyta;Streptophyta;Embryophyta;Tracheophyta;Spermatophyta;Magnoliophyta;Liliopsida;Alismatales;Stuckenia;";"0.0";"0";"1";"1";"0";"1";"0";"430523";"5766"
"LOK1378_1mm";"SILVA (only NR);Eukaryota;Archaeplastida;Chloroplastida;Charophyta;Phragmoplastophyta;Streptophyta;Embryophyta;Tracheophyta;Spermatophyta;Magnoliophyta;Liliopsida;Alismatales;Syringodium;";"0.0";"0";"1";"1";"0";"1";"0";"430523";"5766"
"LOK1378_1mm";"SILVA (only NR);Eukaryota;Archaeplastida;Chloroplastida;Charophyta;Phragmoplastophyta;Streptophyta;Embryophyta;Tracheophyta;Spermatophyta;Magnoliophyta;Liliopsida;Alismatales;Thalassia;";"0.0";"0";"2";"2";"0";"2";"0";"430522";"5766"
"LOK1378_1mm";"SILVA (only NR);Eukaryota;Archaeplastida;Chloroplastida;Charophyta;Phragmoplastophyta;Streptophyta;Embryophyta;Tracheophyta;Spermatophyta;Magnoliophyta;Liliopsida;Alismatales;Tofieldia;";"0.0";"0";"1";"1";"0";"1";"0";"430523";"5766"
"LOK1378_1mm";"SILVA (only NR);Eukaryota;Archaeplastida;Chloroplastida;Charophyta;Phragmoplastophyta;Streptophyta;Embryophyta;Tracheophyta;Spermatophyta;Magnoliophyta;Liliopsida;Alismatales;Triglochin;";"0.0";"0";"1";"1";"0";"1";"0";"430523";"5766"
"LOK1378_1mm";"SILVA (only NR);Eukaryota;Archaeplastida;Chloroplastida;Charophyta;Phragmoplastophyta;Streptophyta;Embryophyta;Tracheophyta;Spermatophyta;Magnoliophyta;Liliopsida;Alismatales;Wolffia;";"0.0";"0";"3";"3";"0";"3";"0";"430521";"5766"
"LOK1378_1mm";"SILVA (only NR);Eukaryota;Archaeplastida;Chloroplastida;Charophyta;Phragmoplastophyta;Streptophyta;Embryophyta;Tracheophyta;Spermatophyta;Magnoliophyta;Liliopsida;Alismatales;Zannichellia;";"0.0";"0";"1";"1";"0";"1";"0";"430523";"5766"
"LOK1378_1mm";"SILVA (only NR);Eukaryota;Archaeplastida;Chloroplastida;Charophyta;Phragmoplastophyta;Streptophyta;Embryophyta;Tracheophyta;Spermatophyta;Magnoliophyta;Liliopsida;Alismatales;Zantedeschia;";"0.0";"0";"1";"1";"0";"1";"0";"430523";"5766"
"LOK1378_1mm";"SILVA (only NR);Eukaryota;Archaeplastida;Chloroplastida;Charophyta;Phragmoplastophyta;Streptophyta;Embryophyta;Tracheophyta;Spermatophyta;Magnoliophyta;Liliopsida;Arecales;";"0.0";"0";"27";"25";"0";"25";"2";"430499";"5766"
"LOK1378_1mm";"SILVA (only NR);Eukaryota;Archaeplastida;Chloroplastida;Charophyta;Phragmoplastophyta;Streptophyta;Embryophyta;Tracheophyta;Spermatophyta;Magnoliophyta;Liliopsida;Arecales;Aphandra;";"0.0";"0";"1";"1";"0";"1";"0";"430523";"5766"
"LOK1378_1mm";"SILVA (only NR);Eukaryota;Archaeplastida;Chloroplastida;Charophyta;Phragmoplastophyta;Streptophyta;Embryophyta;Tracheophyta;Spermatophyta;Magnoliophyta;Liliopsida;Arecales;Arenga;";"0.0";"0";"1";"1";"0";"1";"0";"430523";"5766"
"LOK1378_1mm";"SILVA (only NR);Eukaryota;Archaeplastida;Chloroplastida;Charophyta;Phragmoplastophyta;Streptophyta;Embryophyta;Tracheophyta;Spermatophyta;Magnoliophyta;Liliopsida;Arecales;Bentinckia;";"0.0";"0";"1";"1";"0";"1";"0";"430523";"5766"
"LOK1378_1mm";"SILVA (only NR);Eukaryota;Archaeplastida;Chloroplastida;Charophyta;Phragmoplastophyta;Streptophyta;Embryophyta;Tracheophyta;Spermatophyta;Magnoliophyta;Liliopsida;Arecales;Borassus;";"0.0";"0";"1";"1";"0";"1";"0";"430523";"5766"
"LOK1378_1mm";"SILVA (only NR);Eukaryota;Archaeplastida;Chloroplastida;Charophyta;Phragmoplastophyta;Streptophyta;Embryophyta;Tracheophyta;Spermatophyta;Magnoliophyta;Liliopsida;Arecales;Calamus;";"0.0";"0";"1";"1";"0";"1";"0";"430523";"5766"
"LOK1378_1mm";"SILVA (only NR);Eukaryota;Archaeplastida;Chloroplastida;Charophyta;Phragmoplastophyta;Streptophyta;Embryophyta;Tracheophyta;Spermatophyta;Magnoliophyta;Liliopsida;Arecales;Calyptrocalyx;";"0.0";"0";"1";"1";"0";"1";"0";"430523";"5766"
"LOK1378_1mm";"SILVA (only NR);Eukaryota;Archaeplastida;Chloroplastida;Charophyta;Phragmoplastophyta;Streptophyta;Embryophyta;Tracheophyta;Spermatophyta;Magnoliophyta;Liliopsida;Arecales;Calyptronoma;";"0.0";"0";"1";"1";"0";"1";"0";"430523";"5766"
"LOK1378_1mm";"SILVA (only NR);Eukaryota;Archaeplastida;Chloroplastida;Charophyta;Phragmoplastophyta;Streptophyta;Embryophyta;Tracheophyta;Spermatophyta;Magnoliophyta;Liliopsida;Arecales;Caryota;";"0.0";"0";"1";"1";"0";"1";"0";"430523";"5766"
"LOK1378_1mm";"SILVA (only NR);Eukaryota;Archaeplastida;Chloroplastida;Charophyta;Phragmoplastophyta;Streptophyta;Embryophyta;Tracheophyta;Spermatophyta;Magnoliophyta;Liliopsida;Arecales;Chamaedorea;";"0.0";"0";"1";"1";"0";"1";"0";"430523";"5766"
"LOK1378_1mm";"SILVA (only NR);Eukaryota;Archaeplastida;Chloroplastida;Charophyta;Phragmoplastophyta;Streptophyta;Embryophyta;Tracheophyta;Spermatophyta;Magnoliophyta;Liliopsida;Arecales;Chamaerops;";"0.0";"0";"1";"1";"0";"1";"0";"430523";"5766"
"LOK1378_1mm";"SILVA (only NR);Eukaryota;Archaeplastida;Chloroplastida;Charophyta;Phragmoplastophyta;Streptophyta;Embryophyta;Tracheophyta;Spermatophyta;Magnoliophyta;Liliopsida;Arecales;Corypha;";"0.0";"0";"1";"1";"0";"1";"0";"430523";"5766"
"LOK1378_1mm";"SILVA (only NR);Eukaryota;Archaeplastida;Chloroplastida;Charophyta;Phragmoplastophyta;Streptophyta;Embryophyta;Tracheophyta;Spermatophyta;Magnoliophyta;Liliopsida;Arecales;Dictyocaryum;";"0.0";"0";"1";"1";"0";"1";"0";"430523";"5766"
"LOK1378_1mm";"SILVA (only NR);Eukaryota;Archaeplastida;Chloroplastida;Charophyta;Phragmoplastophyta;Streptophyta;Embryophyta;Tracheophyta;Spermatophyta;Magnoliophyta;Liliopsida;Arecales;Hydriastele;";"0.0";"0";"2";"2";"0";"2";"0";"430522";"5766"
"LOK1378_1mm";"SILVA (only NR);Eukaryota;Archaeplastida;Chloroplastida;Charophyta;Phragmoplastophyta;Streptophyta;Embryophyta;Tracheophyta;Spermatophyta;Magnoliophyta;Liliopsida;Arecales;Hyophorbe;";"0.0";"0";"1";"1";"0";"1";"0";"430523";"5766"
"LOK1378_1mm";"SILVA (only NR);Eukaryota;Archaeplastida;Chloroplastida;Charophyta;Phragmoplastophyta;Streptophyta;Embryophyta;Tracheophyta;Spermatophyta;Magnoliophyta;Liliopsida;Arecales;Hyphaene;";"0.0";"0";"1";"1";"0";"1";"0";"430523";"5766"
"LOK1378_1mm";"SILVA (only NR);Eukaryota;Archaeplastida;Chloroplastida;Charophyta;Phragmoplastophyta;Streptophyta;Embryophyta;Tracheophyta;Spermatophyta;Magnoliophyta;Liliopsida;Arecales;Iriartea;";"0.0";"0";"1";"1";"0";"1";"0";"430523";"5766"
"LOK1378_1mm";"SILVA (only NR);Eukaryota;Archaeplastida;Chloroplastida;Charophyta;Phragmoplastophyta;Streptophyta;Embryophyta;Tracheophyta;Spermatophyta;Magnoliophyta;Liliopsida;Arecales;Licuala;";"0.0";"0";"1";"1";"0";"1";"0";"430523";"5766"
"LOK1378_1mm";"SILVA (only NR);Eukaryota;Archaeplastida;Chloroplastida;Charophyta;Phragmoplastophyta;Streptophyta;Embryophyta;Tracheophyta;Spermatophyta;Magnoliophyta;Liliopsida;Arecales;Orania;";"0.0";"0";"1";"1";"0";"1";"0";"430523";"5766"
"LOK1378_1mm";"SILVA (only NR);Eukaryota;Archaeplastida;Chloroplastida;Charophyta;Phragmoplastophyta;Streptophyta;Embryophyta;Tracheophyta;Spermatophyta;Magnoliophyta;Liliopsida;Arecales;Phoenix;";"0.0";"0";"3";"1";"0";"1";"2";"430523";"5766"
"LOK1378_1mm";"SILVA (only NR);Eukaryota;Archaeplastida;Chloroplastida;Charophyta;Phragmoplastophyta;Streptophyta;Embryophyta;Tracheophyta;Spermatophyta;Magnoliophyta;Liliopsida;Arecales;Phytelephas;";"0.0";"0";"1";"1";"0";"1";"0";"430523";"5766"
"LOK1378_1mm";"SILVA (only NR);Eukaryota;Archaeplastida;Chloroplastida;Charophyta;Phragmoplastophyta;Streptophyta;Embryophyta;Tracheophyta;Spermatophyta;Magnoliophyta;Liliopsida;Arecales;Ravenea;";"0.0";"0";"1";"1";"0";"1";"0";"430523";"5766"
"LOK1378_1mm";"SILVA (only NR);Eukaryota;Archaeplastida;Chloroplastida;Charophyta;Phragmoplastophyta;Streptophyta;Embryophyta;Tracheophyta;Spermatophyta;Magnoliophyta;Liliopsida;Arecales;Sabal;";"0.0";"0";"1";"1";"0";"1";"0";"430523";"5766"
"LOK1378_1mm";"SILVA (only NR);Eukaryota;Archaeplastida;Chloroplastida;Charophyta;Phragmoplastophyta;Streptophyta;Embryophyta;Tracheophyta;Spermatophyta;Magnoliophyta;Liliopsida;Arecales;Salacca;";"0.0";"0";"1";"1";"0";"1";"0";"430523";"5766"
"LOK1378_1mm";"SILVA (only NR);Eukaryota;Archaeplastida;Chloroplastida;Charophyta;Phragmoplastophyta;Streptophyta;Embryophyta;Tracheophyta;Spermatophyta;Magnoliophyta;Liliopsida;Arecales;Wendlandiella;";"0.0";"0";"1";"1";"0";"1";"0";"430523";"5766"
"LOK1378_1mm";"SILVA (only NR);Eukaryota;Archaeplastida;Chloroplastida;Charophyta;Phragmoplastophyta;Streptophyta;Embryophyta;Tracheophyta;Spermatophyta;Magnoliophyta;Liliopsida;Asparagales;";"0.0";"0";"137";"132";"0";"132";"5";"430392";"5766"
"LOK1378_1mm";"SILVA (only NR);Eukaryota;Archaeplastida;Chloroplastida;Charophyta;Phragmoplastophyta;Streptophyta;Embryophyta;Tracheophyta;Spermatophyta;Magnoliophyta;Liliopsida;Asparagales;Agapanthus;";"0.0";"0";"1";"1";"0";"1";"0";"430523";"5766"
"LOK1378_1mm";"SILVA (only NR);Eukaryota;Archaeplastida;Chloroplastida;Charophyta;Phragmoplastophyta;Streptophyta;Embryophyta;Tracheophyta;Spermatophyta;Magnoliophyta;Liliopsida;Asparagales;Allium;";"0.0";"0";"12";"10";"0";"10";"2";"430514";"5766"
"LOK1378_1mm";"SILVA (only NR);Eukaryota;Archaeplastida;Chloroplastida;Charophyta;Phragmoplastophyta;Streptophyta;Embryophyta;Tracheophyta;Spermatophyta;Magnoliophyta;Liliopsida;Asparagales;Aloe;";"0.0";"0";"1";"1";"0";"1";"0";"430523";"5766"
"LOK1378_1mm";"SILVA (only NR);Eukaryota;Archaeplastida;Chloroplastida;Charophyta;Phragmoplastophyta;Streptophyta;Embryophyta;Tracheophyta;Spermatophyta;Magnoliophyta;Liliopsida;Asparagales;Aphyllanthes;";"0.0";"0";"1";"1";"0";"1";"0";"430523";"5766"
"LOK1378_1mm";"SILVA (only NR);Eukaryota;Archaeplastida;Chloroplastida;Charophyta;Phragmoplastophyta;Streptophyta;Embryophyta;Tracheophyta;Spermatophyta;Magnoliophyta;Liliopsida;Asparagales;Apostasia;";"0.0";"0";"2";"2";"0";"2";"0";"430522";"5766"
"LOK1378_1mm";"SILVA (only NR);Eukaryota;Archaeplastida;Chloroplastida;Charophyta;Phragmoplastophyta;Streptophyta;Embryophyta;Tracheophyta;Spermatophyta;Magnoliophyta;Liliopsida;Asparagales;Asparagus;";"0.0";"0";"14";"13";"0";"13";"1";"430511";"5766"
"LOK1378_1mm";"SILVA (only NR);Eukaryota;Archaeplastida;Chloroplastida;Charophyta;Phragmoplastophyta;Streptophyta;Embryophyta;Tracheophyta;Spermatophyta;Magnoliophyta;Liliopsida;Asparagales;Aspidogyne;";"0.0";"0";"1";"1";"0";"1";"0";"430523";"5766"
"LOK1378_1mm";"SILVA (only NR);Eukaryota;Archaeplastida;Chloroplastida;Charophyta;Phragmoplastophyta;Streptophyta;Embryophyta;Tracheophyta;Spermatophyta;Magnoliophyta;Liliopsida;Asparagales;Astelia;";"0.0";"0";"1";"1";"0";"1";"0";"430523";"5766"
"LOK1378_1mm";"SILVA (only NR);Eukaryota;Archaeplastida;Chloroplastida;Charophyta;Phragmoplastophyta;Streptophyta;Embryophyta;Tracheophyta;Spermatophyta;Magnoliophyta;Liliopsida;Asparagales;Bessera;";"0.0";"0";"1";"1";"0";"1";"0";"430523";"5766"
"LOK1378_1mm";"SILVA (only NR);Eukaryota;Archaeplastida;Chloroplastida;Charophyta;Phragmoplastophyta;Streptophyta;Embryophyta;Tracheophyta;Spermatophyta;Magnoliophyta;Liliopsida;Asparagales;Blandfordia;";"0.0";"0";"1";"1";"0";"1";"0";"430523";"5766"
"LOK1378_1mm";"SILVA (only NR);Eukaryota;Archaeplastida;Chloroplastida;Charophyta;Phragmoplastophyta;Streptophyta;Embryophyta;Tracheophyta;Spermatophyta;Magnoliophyta;Liliopsida;Asparagales;Borya;";"0.0";"0";"1";"1";"0";"1";"0";"430523";"5766"
"LOK1378_1mm";"SILVA (only NR);Eukaryota;Archaeplastida;Chloroplastida;Charophyta;Phragmoplastophyta;Streptophyta;Embryophyta;Tracheophyta;Spermatophyta;Magnoliophyta;Liliopsida;Asparagales;Bulbine;";"0.0";"0";"2";"2";"0";"2";"0";"430522";"5766"
"LOK1378_1mm";"SILVA (only NR);Eukaryota;Archaeplastida;Chloroplastida;Charophyta;Phragmoplastophyta;Streptophyta;Embryophyta;Tracheophyta;Spermatophyta;Magnoliophyta;Liliopsida;Asparagales;Cephalanthera;";"0.0";"0";"2";"2";"0";"2";"0";"430522";"5766"
"LOK1378_1mm";"SILVA (only NR);Eukaryota;Archaeplastida;Chloroplastida;Charophyta;Phragmoplastophyta;Streptophyta;Embryophyta;Tracheophyta;Spermatophyta;Magnoliophyta;Liliopsida;Asparagales;Chlorophytum;";"0.0";"0";"1";"1";"0";"1";"0";"430523";"5766"
"LOK1378_1mm";"SILVA (only NR);Eukaryota;Archaeplastida;Chloroplastida;Charophyta;Phragmoplastophyta;Streptophyta;Embryophyta;Tracheophyta;Spermatophyta;Magnoliophyta;Liliopsida;Asparagales;Cleistes;";"0.0";"0";"3";"3";"0";"3";"0";"430521";"5766"
"LOK1378_1mm";"SILVA (only NR);Eukaryota;Archaeplastida;Chloroplastida;Charophyta;Phragmoplastophyta;Streptophyta;Embryophyta;Tracheophyta;Spermatophyta;Magnoliophyta;Liliopsida;Asparagales;Cleistesiopsis;";"0.0";"0";"1";"1";"0";"1";"0";"430523";"5766"
"LOK1378_1mm";"SILVA (only NR);Eukaryota;Archaeplastida;Chloroplastida;Charophyta;Phragmoplastophyta;Streptophyta;Embryophyta;Tracheophyta;Spermatophyta;Magnoliophyta;Liliopsida;Asparagales;Clematepistephium;";"0.0";"0";"1";"1";"0";"1";"0";"430523";"5766"
"LOK1378_1mm";"SILVA (only NR);Eukaryota;Archaeplastida;Chloroplastida;Charophyta;Phragmoplastophyta;Streptophyta;Embryophyta;Tracheophyta;Spermatophyta;Magnoliophyta;Liliopsida;Asparagales;Corallorhiza;";"0.0";"0";"1";"1";"0";"1";"0";"430523";"5766"
"LOK1378_1mm";"SILVA (only NR);Eukaryota;Archaeplastida;Chloroplastida;Charophyta;Phragmoplastophyta;Streptophyta;Embryophyta;Tracheophyta;Spermatophyta;Magnoliophyta;Liliopsida;Asparagales;Crinum;";"0.0";"0";"1";"1";"0";"1";"0";"430523";"5766"
"LOK1378_1mm";"SILVA (only NR);Eukaryota;Archaeplastida;Chloroplastida;Charophyta;Phragmoplastophyta;Streptophyta;Embryophyta;Tracheophyta;Spermatophyta;Magnoliophyta;Liliopsida;Asparagales;Cyanella;";"0.0";"0";"1";"1";"0";"1";"0";"430523";"5766"
"LOK1378_1mm";"SILVA (only NR);Eukaryota;Archaeplastida;Chloroplastida;Charophyta;Phragmoplastophyta;Streptophyta;Embryophyta;Tracheophyta;Spermatophyta;Magnoliophyta;Liliopsida;Asparagales;Cyclopogon;";"0.0";"0";"1";"1";"0";"1";"0";"430523";"5766"
"LOK1378_1mm";"SILVA (only NR);Eukaryota;Archaeplastida;Chloroplastida;Charophyta;Phragmoplastophyta;Streptophyta;Embryophyta;Tracheophyta;Spermatophyta;Magnoliophyta;Liliopsida;Asparagales;Cymbidium;";"0.0";"0";"1";"1";"0";"1";"0";"430523";"5766"
"LOK1378_1mm";"SILVA (only NR);Eukaryota;Archaeplastida;Chloroplastida;Charophyta;Phragmoplastophyta;Streptophyta;Embryophyta;Tracheophyta;Spermatophyta;Magnoliophyta;Liliopsida;Asparagales;Cypripedium;";"0.0";"0";"1";"1";"0";"1";"0";"430523";"5766"
"LOK1378_1mm";"SILVA (only NR);Eukaryota;Archaeplastida;Chloroplastida;Charophyta;Phragmoplastophyta;Streptophyta;Embryophyta;Tracheophyta;Spermatophyta;Magnoliophyta;Liliopsida;Asparagales;Cyrtosia;";"0.0";"0";"1";"0";"0";"0";"1";"430524";"5766"
"LOK1378_1mm";"SILVA (only NR);Eukaryota;Archaeplastida;Chloroplastida;Charophyta;Phragmoplastophyta;Streptophyta;Embryophyta;Tracheophyta;Spermatophyta;Magnoliophyta;Liliopsida;Asparagales;Dactylorhiza;";"0.0";"0";"1";"1";"0";"1";"0";"430523";"5766"
"LOK1378_1mm";"SILVA (only NR);Eukaryota;Archaeplastida;Chloroplastida;Charophyta;Phragmoplastophyta;Streptophyta;Embryophyta;Tracheophyta;Spermatophyta;Magnoliophyta;Liliopsida;Asparagales;Dasylirion;";"0.0";"0";"1";"1";"0";"1";"0";"430523";"5766"
"LOK1378_1mm";"SILVA (only NR);Eukaryota;Archaeplastida;Chloroplastida;Charophyta;Phragmoplastophyta;Streptophyta;Embryophyta;Tracheophyta;Spermatophyta;Magnoliophyta;Liliopsida;Asparagales;Dendrobium;";"0.0";"0";"1";"1";"0";"1";"0";"430523";"5766"
"LOK1378_1mm";"SILVA (only NR);Eukaryota;Archaeplastida;Chloroplastida;Charophyta;Phragmoplastophyta;Streptophyta;Embryophyta;Tracheophyta;Spermatophyta;Magnoliophyta;Liliopsida;Asparagales;Dianella;";"0.0";"0";"1";"1";"0";"1";"0";"430523";"5766"
"LOK1378_1mm";"SILVA (only NR);Eukaryota;Archaeplastida;Chloroplastida;Charophyta;Phragmoplastophyta;Streptophyta;Embryophyta;Tracheophyta;Spermatophyta;Magnoliophyta;Liliopsida;Asparagales;Dichaea;";"0.0";"0";"1";"1";"0";"1";"0";"430523";"5766"
"LOK1378_1mm";"SILVA (only NR);Eukaryota;Archaeplastida;Chloroplastida;Charophyta;Phragmoplastophyta;Streptophyta;Embryophyta;Tracheophyta;Spermatophyta;Magnoliophyta;Liliopsida;Asparagales;Dichelostemma;";"0.0";"0";"1";"1";"0";"1";"0";"430523";"5766"
"LOK1378_1mm";"SILVA (only NR);Eukaryota;Archaeplastida;Chloroplastida;Charophyta;Phragmoplastophyta;Streptophyta;Embryophyta;Tracheophyta;Spermatophyta;Magnoliophyta;Liliopsida;Asparagales;Diuris;";"0.0";"0";"1";"1";"0";"1";"0";"430523";"5766"
"LOK1378_1mm";"SILVA (only NR);Eukaryota;Archaeplastida;Chloroplastida;Charophyta;Phragmoplastophyta;Streptophyta;Embryophyta;Tracheophyta;Spermatophyta;Magnoliophyta;Liliopsida;Asparagales;Doryanthes;";"0.0";"0";"1";"1";"0";"1";"0";"430523";"5766"
"LOK1378_1mm";"SILVA (only NR);Eukaryota;Archaeplastida;Chloroplastida;Charophyta;Phragmoplastophyta;Streptophyta;Embryophyta;Tracheophyta;Spermatophyta;Magnoliophyta;Liliopsida;Asparagales;Drimia;";"0.0";"0";"1";"1";"0";"1";"0";"430523";"5766"
"LOK1378_1mm";"SILVA (only NR);Eukaryota;Archaeplastida;Chloroplastida;Charophyta;Phragmoplastophyta;Streptophyta;Embryophyta;Tracheophyta;Spermatophyta;Magnoliophyta;Liliopsida;Asparagales;Duckeella;";"0.0";"0";"2";"2";"0";"2";"0";"430522";"5766"
"LOK1378_1mm";"SILVA (only NR);Eukaryota;Archaeplastida;Chloroplastida;Charophyta;Phragmoplastophyta;Streptophyta;Embryophyta;Tracheophyta;Spermatophyta;Magnoliophyta;Liliopsida;Asparagales;Echeandia;";"0.0";"0";"1";"1";"0";"1";"0";"430523";"5766"
"LOK1378_1mm";"SILVA (only NR);Eukaryota;Archaeplastida;Chloroplastida;Charophyta;Phragmoplastophyta;Streptophyta;Embryophyta;Tracheophyta;Spermatophyta;Magnoliophyta;Liliopsida;Asparagales;Epistephium;";"0.0";"0";"2";"2";"0";"2";"0";"430522";"5766"
"LOK1378_1mm";"SILVA (only NR);Eukaryota;Archaeplastida;Chloroplastida;Charophyta;Phragmoplastophyta;Streptophyta;Embryophyta;Tracheophyta;Spermatophyta;Magnoliophyta;Liliopsida;Asparagales;Eremurus;";"0.0";"0";"1";"1";"0";"1";"0";"430523";"5766"
"LOK1378_1mm";"SILVA (only NR);Eukaryota;Archaeplastida;Chloroplastida;Charophyta;Phragmoplastophyta;Streptophyta;Embryophyta;Tracheophyta;Spermatophyta;Magnoliophyta;Liliopsida;Asparagales;Eriaxis;";"0.0";"0";"1";"1";"0";"1";"0";"430523";"5766"
"LOK1378_1mm";"SILVA (only NR);Eukaryota;Archaeplastida;Chloroplastida;Charophyta;Phragmoplastophyta;Streptophyta;Embryophyta;Tracheophyta;Spermatophyta;Magnoliophyta;Liliopsida;Asparagales;Eriospermum;";"0.0";"0";"1";"1";"0";"1";"0";"430523";"5766"
"LOK1378_1mm";"SILVA (only NR);Eukaryota;Archaeplastida;Chloroplastida;Charophyta;Phragmoplastophyta;Streptophyta;Embryophyta;Tracheophyta;Spermatophyta;Magnoliophyta;Liliopsida;Asparagales;Erythrorchis;";"0.0";"0";"1";"1";"0";"1";"0";"430523";"5766"
"LOK1378_1mm";"SILVA (only NR);Eukaryota;Archaeplastida;Chloroplastida;Charophyta;Phragmoplastophyta;Streptophyta;Embryophyta;Tracheophyta;Spermatophyta;Magnoliophyta;Liliopsida;Asparagales;Eucharis;";"0.0";"0";"1";"1";"0";"1";"0";"430523";"5766"
"LOK1378_1mm";"SILVA (only NR);Eukaryota;Archaeplastida;Chloroplastida;Charophyta;Phragmoplastophyta;Streptophyta;Embryophyta;Tracheophyta;Spermatophyta;Magnoliophyta;Liliopsida;Asparagales;Eucomis;";"0.0";"0";"1";"1";"0";"1";"0";"430523";"5766"
"LOK1378_1mm";"SILVA (only NR);Eukaryota;Archaeplastida;Chloroplastida;Charophyta;Phragmoplastophyta;Streptophyta;Embryophyta;Tracheophyta;Spermatophyta;Magnoliophyta;Liliopsida;Asparagales;Eustrephus;";"0.0";"0";"1";"1";"0";"1";"0";"430523";"5766"
"LOK1378_1mm";"SILVA (only NR);Eukaryota;Archaeplastida;Chloroplastida;Charophyta;Phragmoplastophyta;Streptophyta;Embryophyta;Tracheophyta;Spermatophyta;Magnoliophyta;Liliopsida;Asparagales;Galeola;";"0.0";"0";"1";"1";"0";"1";"0";"430523";"5766"
"LOK1378_1mm";"SILVA (only NR);Eukaryota;Archaeplastida;Chloroplastida;Charophyta;Phragmoplastophyta;Streptophyta;Embryophyta;Tracheophyta;Spermatophyta;Magnoliophyta;Liliopsida;Asparagales;Gilliesia;";"0.0";"0";"1";"1";"0";"1";"0";"430523";"5766"
"LOK1378_1mm";"SILVA (only NR);Eukaryota;Archaeplastida;Chloroplastida;Charophyta;Phragmoplastophyta;Streptophyta;Embryophyta;Tracheophyta;Spermatophyta;Magnoliophyta;Liliopsida;Asparagales;Gladiolus;";"0.0";"0";"1";"1";"0";"1";"0";"430523";"5766"
"LOK1378_1mm";"SILVA (only NR);Eukaryota;Archaeplastida;Chloroplastida;Charophyta;Phragmoplastophyta;Streptophyta;Embryophyta;Tracheophyta;Spermatophyta;Magnoliophyta;Liliopsida;Asparagales;Habenaria;";"0.0";"0";"1";"1";"0";"1";"0";"430523";"5766"
"LOK1378_1mm";"SILVA (only NR);Eukaryota;Archaeplastida;Chloroplastida;Charophyta;Phragmoplastophyta;Streptophyta;Embryophyta;Tracheophyta;Spermatophyta;Magnoliophyta;Liliopsida;Asparagales;Herreria;";"0.0";"0";"2";"2";"0";"2";"0";"430522";"5766"
"LOK1378_1mm";"SILVA (only NR);Eukaryota;Archaeplastida;Chloroplastida;Charophyta;Phragmoplastophyta;Streptophyta;Embryophyta;Tracheophyta;Spermatophyta;Magnoliophyta;Liliopsida;Asparagales;Hypoxis;";"0.0";"0";"1";"1";"0";"1";"0";"430523";"5766"
"LOK1378_1mm";"SILVA (only NR);Eukaryota;Archaeplastida;Chloroplastida;Charophyta;Phragmoplastophyta;Streptophyta;Embryophyta;Tracheophyta;Spermatophyta;Magnoliophyta;Liliopsida;Asparagales;Iris;";"0.0";"0";"1";"1";"0";"1";"0";"430523";"5766"
"LOK1378_1mm";"SILVA (only NR);Eukaryota;Archaeplastida;Chloroplastida;Charophyta;Phragmoplastophyta;Streptophyta;Embryophyta;Tracheophyta;Spermatophyta;Magnoliophyta;Liliopsida;Asparagales;Isophysis;";"0.0";"0";"1";"1";"0";"1";"0";"430523";"5766"
"LOK1378_1mm";"SILVA (only NR);Eukaryota;Archaeplastida;Chloroplastida;Charophyta;Phragmoplastophyta;Streptophyta;Embryophyta;Tracheophyta;Spermatophyta;Magnoliophyta;Liliopsida;Asparagales;Isotria;";"0.0";"0";"1";"1";"0";"1";"0";"430523";"5766"
"LOK1378_1mm";"SILVA (only NR);Eukaryota;Archaeplastida;Chloroplastida;Charophyta;Phragmoplastophyta;Streptophyta;Embryophyta;Tracheophyta;Spermatophyta;Magnoliophyta;Liliopsida;Asparagales;Ixiolirion;";"0.0";"0";"1";"1";"0";"1";"0";"430523";"5766"
"LOK1378_1mm";"SILVA (only NR);Eukaryota;Archaeplastida;Chloroplastida;Charophyta;Phragmoplastophyta;Streptophyta;Embryophyta;Tracheophyta;Spermatophyta;Magnoliophyta;Liliopsida;Asparagales;Kniphofia;";"0.0";"0";"1";"1";"0";"1";"0";"430523";"5766"
"LOK1378_1mm";"SILVA (only NR);Eukaryota;Archaeplastida;Chloroplastida;Charophyta;Phragmoplastophyta;Streptophyta;Embryophyta;Tracheophyta;Spermatophyta;Magnoliophyta;Liliopsida;Asparagales;Lanaria;";"0.0";"0";"1";"1";"0";"1";"0";"430523";"5766"
"LOK1378_1mm";"SILVA (only NR);Eukaryota;Archaeplastida;Chloroplastida;Charophyta;Phragmoplastophyta;Streptophyta;Embryophyta;Tracheophyta;Spermatophyta;Magnoliophyta;Liliopsida;Asparagales;Laxmannia;";"0.0";"0";"1";"1";"0";"1";"0";"430523";"5766"
"LOK1378_1mm";"SILVA (only NR);Eukaryota;Archaeplastida;Chloroplastida;Charophyta;Phragmoplastophyta;Streptophyta;Embryophyta;Tracheophyta;Spermatophyta;Magnoliophyta;Liliopsida;Asparagales;Lecanorchis;";"0.0";"0";"1";"1";"0";"1";"0";"430523";"5766"
"LOK1378_1mm";"SILVA (only NR);Eukaryota;Archaeplastida;Chloroplastida;Charophyta;Phragmoplastophyta;Streptophyta;Embryophyta;Tracheophyta;Spermatophyta;Magnoliophyta;Liliopsida;Asparagales;Ledebouria;";"0.0";"0";"2";"2";"0";"2";"0";"430522";"5766"
"LOK1378_1mm";"SILVA (only NR);Eukaryota;Archaeplastida;Chloroplastida;Charophyta;Phragmoplastophyta;Streptophyta;Embryophyta;Tracheophyta;Spermatophyta;Magnoliophyta;Liliopsida;Asparagales;Liriope;";"0.0";"0";"1";"1";"0";"1";"0";"430523";"5766"
"LOK1378_1mm";"SILVA (only NR);Eukaryota;Archaeplastida;Chloroplastida;Charophyta;Phragmoplastophyta;Streptophyta;Embryophyta;Tracheophyta;Spermatophyta;Magnoliophyta;Liliopsida;Asparagales;Listera;";"0.0";"0";"1";"1";"0";"1";"0";"430523";"5766"
"LOK1378_1mm";"SILVA (only NR);Eukaryota;Archaeplastida;Chloroplastida;Charophyta;Phragmoplastophyta;Streptophyta;Embryophyta;Tracheophyta;Spermatophyta;Magnoliophyta;Liliopsida;Asparagales;Lomandra;";"0.0";"0";"2";"2";"0";"2";"0";"430522";"5766"
"LOK1378_1mm";"SILVA (only NR);Eukaryota;Archaeplastida;Chloroplastida;Charophyta;Phragmoplastophyta;Streptophyta;Embryophyta;Tracheophyta;Spermatophyta;Magnoliophyta;Liliopsida;Asparagales;Lycoris;";"0.0";"0";"5";"5";"0";"5";"0";"430519";"5766"
"LOK1378_1mm";"SILVA (only NR);Eukaryota;Archaeplastida;Chloroplastida;Charophyta;Phragmoplastophyta;Streptophyta;Embryophyta;Tracheophyta;Spermatophyta;Magnoliophyta;Liliopsida;Asparagales;Milligania;";"0.0";"0";"1";"1";"0";"1";"0";"430523";"5766"
"LOK1378_1mm";"SILVA (only NR);Eukaryota;Archaeplastida;Chloroplastida;Charophyta;Phragmoplastophyta;Streptophyta;Embryophyta;Tracheophyta;Spermatophyta;Magnoliophyta;Liliopsida;Asparagales;Narcissus;";"0.0";"0";"1";"1";"0";"1";"0";"430523";"5766"
"LOK1378_1mm";"SILVA (only NR);Eukaryota;Archaeplastida;Chloroplastida;Charophyta;Phragmoplastophyta;Streptophyta;Embryophyta;Tracheophyta;Spermatophyta;Magnoliophyta;Liliopsida;Asparagales;Neottia;";"0.0";"0";"1";"1";"0";"1";"0";"430523";"5766"
"LOK1378_1mm";"SILVA (only NR);Eukaryota;Archaeplastida;Chloroplastida;Charophyta;Phragmoplastophyta;Streptophyta;Embryophyta;Tracheophyta;Spermatophyta;Magnoliophyta;Liliopsida;Asparagales;Neuwiedia;";"0.0";"0";"1";"1";"0";"1";"0";"430523";"5766"
"LOK1378_1mm";"SILVA (only NR);Eukaryota;Archaeplastida;Chloroplastida;Charophyta;Phragmoplastophyta;Streptophyta;Embryophyta;Tracheophyta;Spermatophyta;Magnoliophyta;Liliopsida;Asparagales;Oncidium;";"0.0";"0";"2";"2";"0";"2";"0";"430522";"5766"
"LOK1378_1mm";"SILVA (only NR);Eukaryota;Archaeplastida;Chloroplastida;Charophyta;Phragmoplastophyta;Streptophyta;Embryophyta;Tracheophyta;Spermatophyta;Magnoliophyta;Liliopsida;Asparagales;Orchis;";"0.0";"0";"1";"1";"0";"1";"0";"430523";"5766"
"LOK1378_1mm";"SILVA (only NR);Eukaryota;Archaeplastida;Chloroplastida;Charophyta;Phragmoplastophyta;Streptophyta;Embryophyta;Tracheophyta;Spermatophyta;Magnoliophyta;Liliopsida;Asparagales;Palmorchis;";"0.0";"0";"1";"1";"0";"1";"0";"430523";"5766"
"LOK1378_1mm";"SILVA (only NR);Eukaryota;Archaeplastida;Chloroplastida;Charophyta;Phragmoplastophyta;Streptophyta;Embryophyta;Tracheophyta;Spermatophyta;Magnoliophyta;Liliopsida;Asparagales;Paphiopedilum;";"0.0";"0";"1";"1";"0";"1";"0";"430523";"5766"
"LOK1378_1mm";"SILVA (only NR);Eukaryota;Archaeplastida;Chloroplastida;Charophyta;Phragmoplastophyta;Streptophyta;Embryophyta;Tracheophyta;Spermatophyta;Magnoliophyta;Liliopsida;Asparagales;Peliosanthes;";"0.0";"0";"2";"2";"0";"2";"0";"430522";"5766"
"LOK1378_1mm";"SILVA (only NR);Eukaryota;Archaeplastida;Chloroplastida;Charophyta;Phragmoplastophyta;Streptophyta;Embryophyta;Tracheophyta;Spermatophyta;Magnoliophyta;Liliopsida;Asparagales;Phalaenopsis;";"0.0";"0";"3";"2";"0";"2";"1";"430522";"5766"
"LOK1378_1mm";"SILVA (only NR);Eukaryota;Archaeplastida;Chloroplastida;Charophyta;Phragmoplastophyta;Streptophyta;Embryophyta;Tracheophyta;Spermatophyta;Magnoliophyta;Liliopsida;Asparagales;Phormium;";"0.0";"0";"1";"1";"0";"1";"0";"430523";"5766"
"LOK1378_1mm";"SILVA (only NR);Eukaryota;Archaeplastida;Chloroplastida;Charophyta;Phragmoplastophyta;Streptophyta;Embryophyta;Tracheophyta;Spermatophyta;Magnoliophyta;Liliopsida;Asparagales;Pogonia;";"0.0";"0";"1";"1";"0";"1";"0";"430523";"5766"
"LOK1378_1mm";"SILVA (only NR);Eukaryota;Archaeplastida;Chloroplastida;Charophyta;Phragmoplastophyta;Streptophyta;Embryophyta;Tracheophyta;Spermatophyta;Magnoliophyta;Liliopsida;Asparagales;Pogoniopsis;";"0.0";"0";"1";"1";"0";"1";"0";"430523";"5766"
"LOK1378_1mm";"SILVA (only NR);Eukaryota;Archaeplastida;Chloroplastida;Charophyta;Phragmoplastophyta;Streptophyta;Embryophyta;Tracheophyta;Spermatophyta;Magnoliophyta;Liliopsida;Asparagales;Pseudovanilla;";"0.0";"0";"1";"1";"0";"1";"0";"430523";"5766"
"LOK1378_1mm";"SILVA (only NR);Eukaryota;Archaeplastida;Chloroplastida;Charophyta;Phragmoplastophyta;Streptophyta;Embryophyta;Tracheophyta;Spermatophyta;Magnoliophyta;Liliopsida;Asparagales;Psilochilus;";"0.0";"0";"1";"1";"0";"1";"0";"430523";"5766"
"LOK1378_1mm";"SILVA (only NR);Eukaryota;Archaeplastida;Chloroplastida;Charophyta;Phragmoplastophyta;Streptophyta;Embryophyta;Tracheophyta;Spermatophyta;Magnoliophyta;Liliopsida;Asparagales;Rhizanthella;";"0.0";"0";"1";"1";"0";"1";"0";"430523";"5766"
"LOK1378_1mm";"SILVA (only NR);Eukaryota;Archaeplastida;Chloroplastida;Charophyta;Phragmoplastophyta;Streptophyta;Embryophyta;Tracheophyta;Spermatophyta;Magnoliophyta;Liliopsida;Asparagales;Rhodohypoxis;";"0.0";"0";"1";"1";"0";"1";"0";"430523";"5766"
"LOK1378_1mm";"SILVA (only NR);Eukaryota;Archaeplastida;Chloroplastida;Charophyta;Phragmoplastophyta;Streptophyta;Embryophyta;Tracheophyta;Spermatophyta;Magnoliophyta;Liliopsida;Asparagales;Ruscus;";"0.0";"0";"1";"1";"0";"1";"0";"430523";"5766"
"LOK1378_1mm";"SILVA (only NR);Eukaryota;Archaeplastida;Chloroplastida;Charophyta;Phragmoplastophyta;Streptophyta;Embryophyta;Tracheophyta;Spermatophyta;Magnoliophyta;Liliopsida;Asparagales;Sansevieria;";"0.0";"0";"1";"1";"0";"1";"0";"430523";"5766"
"LOK1378_1mm";"SILVA (only NR);Eukaryota;Archaeplastida;Chloroplastida;Charophyta;Phragmoplastophyta;Streptophyta;Embryophyta;Tracheophyta;Spermatophyta;Magnoliophyta;Liliopsida;Asparagales;Scadoxus;";"0.0";"0";"1";"1";"0";"1";"0";"430523";"5766"
"LOK1378_1mm";"SILVA (only NR);Eukaryota;Archaeplastida;Chloroplastida;Charophyta;Phragmoplastophyta;Streptophyta;Embryophyta;Tracheophyta;Spermatophyta;Magnoliophyta;Liliopsida;Asparagales;Spiranthes;";"0.0";"0";"1";"1";"0";"1";"0";"430523";"5766"
"LOK1378_1mm";"SILVA (only NR);Eukaryota;Archaeplastida;Chloroplastida;Charophyta;Phragmoplastophyta;Streptophyta;Embryophyta;Tracheophyta;Spermatophyta;Magnoliophyta;Liliopsida;Asparagales;Triphora;";"0.0";"0";"2";"2";"0";"2";"0";"430522";"5766"
"LOK1378_1mm";"SILVA (only NR);Eukaryota;Archaeplastida;Chloroplastida;Charophyta;Phragmoplastophyta;Streptophyta;Embryophyta;Tracheophyta;Spermatophyta;Magnoliophyta;Liliopsida;Asparagales;Tristagma;";"0.0";"0";"1";"1";"0";"1";"0";"430523";"5766"
"LOK1378_1mm";"SILVA (only NR);Eukaryota;Archaeplastida;Chloroplastida;Charophyta;Phragmoplastophyta;Streptophyta;Embryophyta;Tracheophyta;Spermatophyta;Magnoliophyta;Liliopsida;Asparagales;Tropidia;";"0.0";"0";"1";"1";"0";"1";"0";"430523";"5766"
"LOK1378_1mm";"SILVA (only NR);Eukaryota;Archaeplastida;Chloroplastida;Charophyta;Phragmoplastophyta;Streptophyta;Embryophyta;Tracheophyta;Spermatophyta;Magnoliophyta;Liliopsida;Asparagales;Vanilla;";"0.0";"0";"3";"3";"0";"3";"0";"430521";"5766"
"LOK1378_1mm";"SILVA (only NR);Eukaryota;Archaeplastida;Chloroplastida;Charophyta;Phragmoplastophyta;Streptophyta;Embryophyta;Tracheophyta;Spermatophyta;Magnoliophyta;Liliopsida;Asparagales;Wullschlaegelia;";"0.0";"0";"1";"1";"0";"1";"0";"430523";"5766"
"LOK1378_1mm";"SILVA (only NR);Eukaryota;Archaeplastida;Chloroplastida;Charophyta;Phragmoplastophyta;Streptophyta;Embryophyta;Tracheophyta;Spermatophyta;Magnoliophyta;Liliopsida;Asparagales;Xanthorrhoea;";"0.0";"0";"1";"1";"0";"1";"0";"430523";"5766"
"LOK1378_1mm";"SILVA (only NR);Eukaryota;Archaeplastida;Chloroplastida;Charophyta;Phragmoplastophyta;Streptophyta;Embryophyta;Tracheophyta;Spermatophyta;Magnoliophyta;Liliopsida;Asparagales;Xeronema;";"0.0";"0";"1";"1";"0";"1";"0";"430523";"5766"
"LOK1378_1mm";"SILVA (only NR);Eukaryota;Archaeplastida;Chloroplastida;Charophyta;Phragmoplastophyta;Streptophyta;Embryophyta;Tracheophyta;Spermatophyta;Magnoliophyta;Liliopsida;Asparagales;Yucca;";"0.0";"0";"1";"1";"0";"1";"0";"430523";"5766"
"LOK1378_1mm";"SILVA (only NR);Eukaryota;Archaeplastida;Chloroplastida;Charophyta;Phragmoplastophyta;Streptophyta;Embryophyta;Tracheophyta;Spermatophyta;Magnoliophyta;Liliopsida;Asparagales;Zephyra;";"0.0";"0";"1";"1";"0";"1";"0";"430523";"5766"
"LOK1378_1mm";"SILVA (only NR);Eukaryota;Archaeplastida;Chloroplastida;Charophyta;Phragmoplastophyta;Streptophyta;Embryophyta;Tracheophyta;Spermatophyta;Magnoliophyta;Liliopsida;Commelinales;";"0.0";"0";"8";"8";"0";"8";"0";"430516";"5766"
"LOK1378_1mm";"SILVA (only NR);Eukaryota;Archaeplastida;Chloroplastida;Charophyta;Phragmoplastophyta;Streptophyta;Embryophyta;Tracheophyta;Spermatophyta;Magnoliophyta;Liliopsida;Commelinales;Amischotolype;";"0.0";"0";"1";"1";"0";"1";"0";"430523";"5766"
"LOK1378_1mm";"SILVA (only NR);Eukaryota;Archaeplastida;Chloroplastida;Charophyta;Phragmoplastophyta;Streptophyta;Embryophyta;Tracheophyta;Spermatophyta;Magnoliophyta;Liliopsida;Commelinales;Anigozanthos;";"0.0";"0";"1";"1";"0";"1";"0";"430523";"5766"
"LOK1378_1mm";"SILVA (only NR);Eukaryota;Archaeplastida;Chloroplastida;Charophyta;Phragmoplastophyta;Streptophyta;Embryophyta;Tracheophyta;Spermatophyta;Magnoliophyta;Liliopsida;Commelinales;Eichhornia;";"0.0";"0";"1";"1";"0";"1";"0";"430523";"5766"
"LOK1378_1mm";"SILVA (only NR);Eukaryota;Archaeplastida;Chloroplastida;Charophyta;Phragmoplastophyta;Streptophyta;Embryophyta;Tracheophyta;Spermatophyta;Magnoliophyta;Liliopsida;Commelinales;Hanguana;";"0.0";"0";"1";"1";"0";"1";"0";"430523";"5766"
"LOK1378_1mm";"SILVA (only NR);Eukaryota;Archaeplastida;Chloroplastida;Charophyta;Phragmoplastophyta;Streptophyta;Embryophyta;Tracheophyta;Spermatophyta;Magnoliophyta;Liliopsida;Commelinales;Philydrella;";"0.0";"0";"1";"1";"0";"1";"0";"430523";"5766"
"LOK1378_1mm";"SILVA (only NR);Eukaryota;Archaeplastida;Chloroplastida;Charophyta;Phragmoplastophyta;Streptophyta;Embryophyta;Tracheophyta;Spermatophyta;Magnoliophyta;Liliopsida;Commelinales;Philydrum;";"0.0";"0";"1";"1";"0";"1";"0";"430523";"5766"
"LOK1378_1mm";"SILVA (only NR);Eukaryota;Archaeplastida;Chloroplastida;Charophyta;Phragmoplastophyta;Streptophyta;Embryophyta;Tracheophyta;Spermatophyta;Magnoliophyta;Liliopsida;Commelinales;Pontederia;";"0.0";"0";"2";"2";"0";"2";"0";"430522";"5766"
"LOK1378_1mm";"SILVA (only NR);Eukaryota;Archaeplastida;Chloroplastida;Charophyta;Phragmoplastophyta;Streptophyta;Embryophyta;Tracheophyta;Spermatophyta;Magnoliophyta;Liliopsida;Dasypogonales;";"0.0";"0";"2";"2";"0";"2";"0";"430522";"5766"
"LOK1378_1mm";"SILVA (only NR);Eukaryota;Archaeplastida;Chloroplastida;Charophyta;Phragmoplastophyta;Streptophyta;Embryophyta;Tracheophyta;Spermatophyta;Magnoliophyta;Liliopsida;Dasypogonales;Calectasia;";"0.0";"0";"1";"1";"0";"1";"0";"430523";"5766"
"LOK1378_1mm";"SILVA (only NR);Eukaryota;Archaeplastida;Chloroplastida;Charophyta;Phragmoplastophyta;Streptophyta;Embryophyta;Tracheophyta;Spermatophyta;Magnoliophyta;Liliopsida;Dasypogonales;Dasypogon;";"0.0";"0";"1";"1";"0";"1";"0";"430523";"5766"
"LOK1378_1mm";"SILVA (only NR);Eukaryota;Archaeplastida;Chloroplastida;Charophyta;Phragmoplastophyta;Streptophyta;Embryophyta;Tracheophyta;Spermatophyta;Magnoliophyta;Liliopsida;Dioscoreales;";"0.0";"0";"92";"77";"0";"77";"15";"430447";"5766"
"LOK1378_1mm";"SILVA (only NR);Eukaryota;Archaeplastida;Chloroplastida;Charophyta;Phragmoplastophyta;Streptophyta;Embryophyta;Tracheophyta;Spermatophyta;Magnoliophyta;Liliopsida;Dioscoreales;Afrothismia;";"0.0";"0";"3";"3";"0";"3";"0";"430521";"5766"
"LOK1378_1mm";"SILVA (only NR);Eukaryota;Archaeplastida;Chloroplastida;Charophyta;Phragmoplastophyta;Streptophyta;Embryophyta;Tracheophyta;Spermatophyta;Magnoliophyta;Liliopsida;Dioscoreales;Aletris;";"0.0";"0";"2";"2";"0";"2";"0";"430522";"5766"
"LOK1378_1mm";"SILVA (only NR);Eukaryota;Archaeplastida;Chloroplastida;Charophyta;Phragmoplastophyta;Streptophyta;Embryophyta;Tracheophyta;Spermatophyta;Magnoliophyta;Liliopsida;Dioscoreales;Apteria;";"0.0";"0";"1";"1";"0";"1";"0";"430523";"5766"
"LOK1378_1mm";"SILVA (only NR);Eukaryota;Archaeplastida;Chloroplastida;Charophyta;Phragmoplastophyta;Streptophyta;Embryophyta;Tracheophyta;Spermatophyta;Magnoliophyta;Liliopsida;Dioscoreales;Burmannia;";"0.0";"0";"18";"18";"0";"18";"0";"430506";"5766"
"LOK1378_1mm";"SILVA (only NR);Eukaryota;Archaeplastida;Chloroplastida;Charophyta;Phragmoplastophyta;Streptophyta;Embryophyta;Tracheophyta;Spermatophyta;Magnoliophyta;Liliopsida;Dioscoreales;Campylosiphon;";"0.0";"0";"1";"1";"0";"1";"0";"430523";"5766"
"LOK1378_1mm";"SILVA (only NR);Eukaryota;Archaeplastida;Chloroplastida;Charophyta;Phragmoplastophyta;Streptophyta;Embryophyta;Tracheophyta;Spermatophyta;Magnoliophyta;Liliopsida;Dioscoreales;Cymbocarpa;";"0.0";"0";"2";"2";"0";"2";"0";"430522";"5766"
"LOK1378_1mm";"SILVA (only NR);Eukaryota;Archaeplastida;Chloroplastida;Charophyta;Phragmoplastophyta;Streptophyta;Embryophyta;Tracheophyta;Spermatophyta;Magnoliophyta;Liliopsida;Dioscoreales;Dictyostega;";"0.0";"0";"1";"1";"0";"1";"0";"430523";"5766"
"LOK1378_1mm";"SILVA (only NR);Eukaryota;Archaeplastida;Chloroplastida;Charophyta;Phragmoplastophyta;Streptophyta;Embryophyta;Tracheophyta;Spermatophyta;Magnoliophyta;Liliopsida;Dioscoreales;Dioscorea;";"0.0";"0";"37";"27";"0";"27";"10";"430497";"5766"
"LOK1378_1mm";"SILVA (only NR);Eukaryota;Archaeplastida;Chloroplastida;Charophyta;Phragmoplastophyta;Streptophyta;Embryophyta;Tracheophyta;Spermatophyta;Magnoliophyta;Liliopsida;Dioscoreales;Gymnosiphon;";"0.0";"0";"6";"6";"0";"6";"0";"430518";"5766"
"LOK1378_1mm";"SILVA (only NR);Eukaryota;Archaeplastida;Chloroplastida;Charophyta;Phragmoplastophyta;Streptophyta;Embryophyta;Tracheophyta;Spermatophyta;Magnoliophyta;Liliopsida;Dioscoreales;Haplothismia;";"0.0";"0";"1";"1";"0";"1";"0";"430523";"5766"
"LOK1378_1mm";"SILVA (only NR);Eukaryota;Archaeplastida;Chloroplastida;Charophyta;Phragmoplastophyta;Streptophyta;Embryophyta;Tracheophyta;Spermatophyta;Magnoliophyta;Liliopsida;Dioscoreales;Hexapterella;";"0.0";"0";"1";"1";"0";"1";"0";"430523";"5766"
"LOK1378_1mm";"SILVA (only NR);Eukaryota;Archaeplastida;Chloroplastida;Charophyta;Phragmoplastophyta;Streptophyta;Embryophyta;Tracheophyta;Spermatophyta;Magnoliophyta;Liliopsida;Dioscoreales;Metanarthecium;";"0.0";"0";"1";"1";"0";"1";"0";"430523";"5766"
"LOK1378_1mm";"SILVA (only NR);Eukaryota;Archaeplastida;Chloroplastida;Charophyta;Phragmoplastophyta;Streptophyta;Embryophyta;Tracheophyta;Spermatophyta;Magnoliophyta;Liliopsida;Dioscoreales;Narthecium;";"0.0";"0";"1";"1";"0";"1";"0";"430523";"5766"
"LOK1378_1mm";"SILVA (only NR);Eukaryota;Archaeplastida;Chloroplastida;Charophyta;Phragmoplastophyta;Streptophyta;Embryophyta;Tracheophyta;Spermatophyta;Magnoliophyta;Liliopsida;Dioscoreales;Oxygyne;";"0.0";"0";"1";"1";"0";"1";"0";"430523";"5766"
"LOK1378_1mm";"SILVA (only NR);Eukaryota;Archaeplastida;Chloroplastida;Charophyta;Phragmoplastophyta;Streptophyta;Embryophyta;Tracheophyta;Spermatophyta;Magnoliophyta;Liliopsida;Dioscoreales;Tacca;";"0.0";"0";"3";"3";"0";"3";"0";"430521";"5766"
"LOK1378_1mm";"SILVA (only NR);Eukaryota;Archaeplastida;Chloroplastida;Charophyta;Phragmoplastophyta;Streptophyta;Embryophyta;Tracheophyta;Spermatophyta;Magnoliophyta;Liliopsida;Dioscoreales;Thismia;";"0.0";"0";"11";"6";"0";"6";"5";"430518";"5766"
"LOK1378_1mm";"SILVA (only NR);Eukaryota;Archaeplastida;Chloroplastida;Charophyta;Phragmoplastophyta;Streptophyta;Embryophyta;Tracheophyta;Spermatophyta;Magnoliophyta;Liliopsida;Dioscoreales;Tiputinia;";"0.0";"0";"1";"1";"0";"1";"0";"430523";"5766"
"LOK1378_1mm";"SILVA (only NR);Eukaryota;Archaeplastida;Chloroplastida;Charophyta;Phragmoplastophyta;Streptophyta;Embryophyta;Tracheophyta;Spermatophyta;Magnoliophyta;Liliopsida;Dioscoreales;Trichopus;";"0.0";"0";"1";"1";"0";"1";"0";"430523";"5766"
"LOK1378_1mm";"SILVA (only NR);Eukaryota;Archaeplastida;Chloroplastida;Charophyta;Phragmoplastophyta;Streptophyta;Embryophyta;Tracheophyta;Spermatophyta;Magnoliophyta;Liliopsida;Incertae Sedis;";"0.0";"0";"31";"30";"0";"30";"1";"430494";"5766"
"LOK1378_1mm";"SILVA (only NR);Eukaryota;Archaeplastida;Chloroplastida;Charophyta;Phragmoplastophyta;Streptophyta;Embryophyta;Tracheophyta;Spermatophyta;Magnoliophyta;Liliopsida;Incertae Sedis;Anthurium;";"0.0";"0";"1";"0";"0";"0";"1";"430524";"5766"
"LOK1378_1mm";"SILVA (only NR);Eukaryota;Archaeplastida;Chloroplastida;Charophyta;Phragmoplastophyta;Streptophyta;Embryophyta;Tracheophyta;Spermatophyta;Magnoliophyta;Liliopsida;Incertae Sedis;Astrocaryum;";"0.0";"0";"1";"1";"0";"1";"0";"430523";"5766"
"LOK1378_1mm";"SILVA (only NR);Eukaryota;Archaeplastida;Chloroplastida;Charophyta;Phragmoplastophyta;Streptophyta;Embryophyta;Tracheophyta;Spermatophyta;Magnoliophyta;Liliopsida;Incertae Sedis;Drymophloeus;";"0.0";"0";"1";"1";"0";"1";"0";"430523";"5766"
"LOK1378_1mm";"SILVA (only NR);Eukaryota;Archaeplastida;Chloroplastida;Charophyta;Phragmoplastophyta;Streptophyta;Embryophyta;Tracheophyta;Spermatophyta;Magnoliophyta;Liliopsida;Incertae Sedis;Elaeis;";"0.0";"0";"9";"9";"0";"9";"0";"430515";"5766"
"LOK1378_1mm";"SILVA (only NR);Eukaryota;Archaeplastida;Chloroplastida;Charophyta;Phragmoplastophyta;Streptophyta;Embryophyta;Tracheophyta;Spermatophyta;Magnoliophyta;Liliopsida;Incertae Sedis;Elodea;";"0.0";"0";"2";"2";"0";"2";"0";"430522";"5766"
"LOK1378_1mm";"SILVA (only NR);Eukaryota;Archaeplastida;Chloroplastida;Charophyta;Phragmoplastophyta;Streptophyta;Embryophyta;Tracheophyta;Spermatophyta;Magnoliophyta;Liliopsida;Incertae Sedis;Halodule;";"0.0";"0";"1";"1";"0";"1";"0";"430523";"5766"
"LOK1378_1mm";"SILVA (only NR);Eukaryota;Archaeplastida;Chloroplastida;Charophyta;Phragmoplastophyta;Streptophyta;Embryophyta;Tracheophyta;Spermatophyta;Magnoliophyta;Liliopsida;Incertae Sedis;Halophila;";"0.0";"0";"4";"4";"0";"4";"0";"430520";"5766"
"LOK1378_1mm";"SILVA (only NR);Eukaryota;Archaeplastida;Chloroplastida;Charophyta;Phragmoplastophyta;Streptophyta;Embryophyta;Tracheophyta;Spermatophyta;Magnoliophyta;Liliopsida;Incertae Sedis;Mauritia;";"0.0";"0";"1";"1";"0";"1";"0";"430523";"5766"
"LOK1378_1mm";"SILVA (only NR);Eukaryota;Archaeplastida;Chloroplastida;Charophyta;Phragmoplastophyta;Streptophyta;Embryophyta;Tracheophyta;Spermatophyta;Magnoliophyta;Liliopsida;Incertae Sedis;Nypa;";"0.0";"0";"1";"1";"0";"1";"0";"430523";"5766"
"LOK1378_1mm";"SILVA (only NR);Eukaryota;Archaeplastida;Chloroplastida;Charophyta;Phragmoplastophyta;Streptophyta;Embryophyta;Tracheophyta;Spermatophyta;Magnoliophyta;Liliopsida;Incertae Sedis;Podococcus;";"0.0";"0";"1";"1";"0";"1";"0";"430523";"5766"
"LOK1378_1mm";"SILVA (only NR);Eukaryota;Archaeplastida;Chloroplastida;Charophyta;Phragmoplastophyta;Streptophyta;Embryophyta;Tracheophyta;Spermatophyta;Magnoliophyta;Liliopsida;Incertae Sedis;Posidonia;";"0.0";"0";"3";"3";"0";"3";"0";"430521";"5766"
"LOK1378_1mm";"SILVA (only NR);Eukaryota;Archaeplastida;Chloroplastida;Charophyta;Phragmoplastophyta;Streptophyta;Embryophyta;Tracheophyta;Spermatophyta;Magnoliophyta;Liliopsida;Incertae Sedis;Potamogeton;";"0.0";"0";"2";"2";"0";"2";"0";"430522";"5766"
"LOK1378_1mm";"SILVA (only NR);Eukaryota;Archaeplastida;Chloroplastida;Charophyta;Phragmoplastophyta;Streptophyta;Embryophyta;Tracheophyta;Spermatophyta;Magnoliophyta;Liliopsida;Incertae Sedis;Pseudophoenix;";"0.0";"0";"1";"1";"0";"1";"0";"430523";"5766"
"LOK1378_1mm";"SILVA (only NR);Eukaryota;Archaeplastida;Chloroplastida;Charophyta;Phragmoplastophyta;Streptophyta;Embryophyta;Tracheophyta;Spermatophyta;Magnoliophyta;Liliopsida;Incertae Sedis;Vallisneria;";"0.0";"0";"2";"2";"0";"2";"0";"430522";"5766"
"LOK1378_1mm";"SILVA (only NR);Eukaryota;Archaeplastida;Chloroplastida;Charophyta;Phragmoplastophyta;Streptophyta;Embryophyta;Tracheophyta;Spermatophyta;Magnoliophyta;Liliopsida;Incertae Sedis;Zostera;";"0.0";"0";"1";"1";"0";"1";"0";"430523";"5766"
"LOK1378_1mm";"SILVA (only NR);Eukaryota;Archaeplastida;Chloroplastida;Charophyta;Phragmoplastophyta;Streptophyta;Embryophyta;Tracheophyta;Spermatophyta;Magnoliophyta;Liliopsida;Liliales;";"0.0";"0";"34";"34";"0";"34";"0";"430490";"5766"
"LOK1378_1mm";"SILVA (only NR);Eukaryota;Archaeplastida;Chloroplastida;Charophyta;Phragmoplastophyta;Streptophyta;Embryophyta;Tracheophyta;Spermatophyta;Magnoliophyta;Liliopsida;Liliales;Alstroemeria;";"0.0";"0";"1";"1";"0";"1";"0";"430523";"5766"
"LOK1378_1mm";"SILVA (only NR);Eukaryota;Archaeplastida;Chloroplastida;Charophyta;Phragmoplastophyta;Streptophyta;Embryophyta;Tracheophyta;Spermatophyta;Magnoliophyta;Liliopsida;Liliales;Arachnitis;";"0.0";"0";"1";"1";"0";"1";"0";"430523";"5766"
"LOK1378_1mm";"SILVA (only NR);Eukaryota;Archaeplastida;Chloroplastida;Charophyta;Phragmoplastophyta;Streptophyta;Embryophyta;Tracheophyta;Spermatophyta;Magnoliophyta;Liliopsida;Liliales;Bomarea;";"0.0";"0";"1";"1";"0";"1";"0";"430523";"5766"
"LOK1378_1mm";"SILVA (only NR);Eukaryota;Archaeplastida;Chloroplastida;Charophyta;Phragmoplastophyta;Streptophyta;Embryophyta;Tracheophyta;Spermatophyta;Magnoliophyta;Liliopsida;Liliales;Calochortus;";"0.0";"0";"2";"2";"0";"2";"0";"430522";"5766"
"LOK1378_1mm";"SILVA (only NR);Eukaryota;Archaeplastida;Chloroplastida;Charophyta;Phragmoplastophyta;Streptophyta;Embryophyta;Tracheophyta;Spermatophyta;Magnoliophyta;Liliopsida;Liliales;Campynema;";"0.0";"0";"2";"2";"0";"2";"0";"430522";"5766"
"LOK1378_1mm";"SILVA (only NR);Eukaryota;Archaeplastida;Chloroplastida;Charophyta;Phragmoplastophyta;Streptophyta;Embryophyta;Tracheophyta;Spermatophyta;Magnoliophyta;Liliopsida;Liliales;Campynemanthe;";"0.0";"0";"1";"1";"0";"1";"0";"430523";"5766"
"LOK1378_1mm";"SILVA (only NR);Eukaryota;Archaeplastida;Chloroplastida;Charophyta;Phragmoplastophyta;Streptophyta;Embryophyta;Tracheophyta;Spermatophyta;Magnoliophyta;Liliopsida;Liliales;Chamaelirium;";"0.0";"0";"1";"1";"0";"1";"0";"430523";"5766"
"LOK1378_1mm";"SILVA (only NR);Eukaryota;Archaeplastida;Chloroplastida;Charophyta;Phragmoplastophyta;Streptophyta;Embryophyta;Tracheophyta;Spermatophyta;Magnoliophyta;Liliopsida;Liliales;Clintonia;";"0.0";"0";"1";"1";"0";"1";"0";"430523";"5766"
"LOK1378_1mm";"SILVA (only NR);Eukaryota;Archaeplastida;Chloroplastida;Charophyta;Phragmoplastophyta;Streptophyta;Embryophyta;Tracheophyta;Spermatophyta;Magnoliophyta;Liliopsida;Liliales;Colchicum;";"0.0";"0";"2";"2";"0";"2";"0";"430522";"5766"
"LOK1378_1mm";"SILVA (only NR);Eukaryota;Archaeplastida;Chloroplastida;Charophyta;Phragmoplastophyta;Streptophyta;Embryophyta;Tracheophyta;Spermatophyta;Magnoliophyta;Liliopsida;Liliales;Corsia;";"0.0";"0";"1";"1";"0";"1";"0";"430523";"5766"
"LOK1378_1mm";"SILVA (only NR);Eukaryota;Archaeplastida;Chloroplastida;Charophyta;Phragmoplastophyta;Streptophyta;Embryophyta;Tracheophyta;Spermatophyta;Magnoliophyta;Liliopsida;Liliales;Gloriosa;";"0.0";"0";"3";"3";"0";"3";"0";"430521";"5766"
"LOK1378_1mm";"SILVA (only NR);Eukaryota;Archaeplastida;Chloroplastida;Charophyta;Phragmoplastophyta;Streptophyta;Embryophyta;Tracheophyta;Spermatophyta;Magnoliophyta;Liliopsida;Liliales;Lilium;";"0.0";"0";"2";"2";"0";"2";"0";"430522";"5766"
"LOK1378_1mm";"SILVA (only NR);Eukaryota;Archaeplastida;Chloroplastida;Charophyta;Phragmoplastophyta;Streptophyta;Embryophyta;Tracheophyta;Spermatophyta;Magnoliophyta;Liliopsida;Liliales;Luzuriaga;";"0.0";"0";"1";"1";"0";"1";"0";"430523";"5766"
"LOK1378_1mm";"SILVA (only NR);Eukaryota;Archaeplastida;Chloroplastida;Charophyta;Phragmoplastophyta;Streptophyta;Embryophyta;Tracheophyta;Spermatophyta;Magnoliophyta;Liliopsida;Liliales;Petermannia;";"0.0";"0";"1";"1";"0";"1";"0";"430523";"5766"
"LOK1378_1mm";"SILVA (only NR);Eukaryota;Archaeplastida;Chloroplastida;Charophyta;Phragmoplastophyta;Streptophyta;Embryophyta;Tracheophyta;Spermatophyta;Magnoliophyta;Liliopsida;Liliales;Philesia;";"0.0";"0";"2";"2";"0";"2";"0";"430522";"5766"
"LOK1378_1mm";"SILVA (only NR);Eukaryota;Archaeplastida;Chloroplastida;Charophyta;Phragmoplastophyta;Streptophyta;Embryophyta;Tracheophyta;Spermatophyta;Magnoliophyta;Liliopsida;Liliales;Ripogonum;";"0.0";"0";"3";"3";"0";"3";"0";"430521";"5766"
"LOK1378_1mm";"SILVA (only NR);Eukaryota;Archaeplastida;Chloroplastida;Charophyta;Phragmoplastophyta;Streptophyta;Embryophyta;Tracheophyta;Spermatophyta;Magnoliophyta;Liliopsida;Liliales;Scoliopus;";"0.0";"0";"1";"1";"0";"1";"0";"430523";"5766"
"LOK1378_1mm";"SILVA (only NR);Eukaryota;Archaeplastida;Chloroplastida;Charophyta;Phragmoplastophyta;Streptophyta;Embryophyta;Tracheophyta;Spermatophyta;Magnoliophyta;Liliopsida;Liliales;Smilax;";"0.0";"0";"2";"2";"0";"2";"0";"430522";"5766"
"LOK1378_1mm";"SILVA (only NR);Eukaryota;Archaeplastida;Chloroplastida;Charophyta;Phragmoplastophyta;Streptophyta;Embryophyta;Tracheophyta;Spermatophyta;Magnoliophyta;Liliopsida;Liliales;Tricyrtis;";"0.0";"0";"2";"2";"0";"2";"0";"430522";"5766"
"LOK1378_1mm";"SILVA (only NR);Eukaryota;Archaeplastida;Chloroplastida;Charophyta;Phragmoplastophyta;Streptophyta;Embryophyta;Tracheophyta;Spermatophyta;Magnoliophyta;Liliopsida;Liliales;Trillium;";"0.0";"0";"2";"2";"0";"2";"0";"430522";"5766"
"LOK1378_1mm";"SILVA (only NR);Eukaryota;Archaeplastida;Chloroplastida;Charophyta;Phragmoplastophyta;Streptophyta;Embryophyta;Tracheophyta;Spermatophyta;Magnoliophyta;Liliopsida;Liliales;Veratrum;";"0.0";"0";"2";"2";"0";"2";"0";"430522";"5766"
"LOK1378_1mm";"SILVA (only NR);Eukaryota;Archaeplastida;Chloroplastida;Charophyta;Phragmoplastophyta;Streptophyta;Embryophyta;Tracheophyta;Spermatophyta;Magnoliophyta;Liliopsida;Pandanales;";"0.0";"0";"18";"18";"0";"18";"0";"430506";"5766"
"LOK1378_1mm";"SILVA (only NR);Eukaryota;Archaeplastida;Chloroplastida;Charophyta;Phragmoplastophyta;Streptophyta;Embryophyta;Tracheophyta;Spermatophyta;Magnoliophyta;Liliopsida;Pandanales;Acanthochlamys;";"0.0";"0";"1";"1";"0";"1";"0";"430523";"5766"
"LOK1378_1mm";"SILVA (only NR);Eukaryota;Archaeplastida;Chloroplastida;Charophyta;Phragmoplastophyta;Streptophyta;Embryophyta;Tracheophyta;Spermatophyta;Magnoliophyta;Liliopsida;Pandanales;Andruris;";"0.0";"0";"1";"1";"0";"1";"0";"430523";"5766"
"LOK1378_1mm";"SILVA (only NR);Eukaryota;Archaeplastida;Chloroplastida;Charophyta;Phragmoplastophyta;Streptophyta;Embryophyta;Tracheophyta;Spermatophyta;Magnoliophyta;Liliopsida;Pandanales;Carludovica;";"0.0";"0";"1";"1";"0";"1";"0";"430523";"5766"
"LOK1378_1mm";"SILVA (only NR);Eukaryota;Archaeplastida;Chloroplastida;Charophyta;Phragmoplastophyta;Streptophyta;Embryophyta;Tracheophyta;Spermatophyta;Magnoliophyta;Liliopsida;Pandanales;Kupea;";"0.0";"0";"1";"1";"0";"1";"0";"430523";"5766"
"LOK1378_1mm";"SILVA (only NR);Eukaryota;Archaeplastida;Chloroplastida;Charophyta;Phragmoplastophyta;Streptophyta;Embryophyta;Tracheophyta;Spermatophyta;Magnoliophyta;Liliopsida;Pandanales;Pandanus;";"0.0";"0";"1";"1";"0";"1";"0";"430523";"5766"
"LOK1378_1mm";"SILVA (only NR);Eukaryota;Archaeplastida;Chloroplastida;Charophyta;Phragmoplastophyta;Streptophyta;Embryophyta;Tracheophyta;Spermatophyta;Magnoliophyta;Liliopsida;Pandanales;Pentastemona;";"0.0";"0";"1";"1";"0";"1";"0";"430523";"5766"
"LOK1378_1mm";"SILVA (only NR);Eukaryota;Archaeplastida;Chloroplastida;Charophyta;Phragmoplastophyta;Streptophyta;Embryophyta;Tracheophyta;Spermatophyta;Magnoliophyta;Liliopsida;Pandanales;Sciaphila;";"0.0";"0";"7";"7";"0";"7";"0";"430517";"5766"
"LOK1378_1mm";"SILVA (only NR);Eukaryota;Archaeplastida;Chloroplastida;Charophyta;Phragmoplastophyta;Streptophyta;Embryophyta;Tracheophyta;Spermatophyta;Magnoliophyta;Liliopsida;Pandanales;Seychellaria;";"0.0";"0";"2";"2";"0";"2";"0";"430522";"5766"
"LOK1378_1mm";"SILVA (only NR);Eukaryota;Archaeplastida;Chloroplastida;Charophyta;Phragmoplastophyta;Streptophyta;Embryophyta;Tracheophyta;Spermatophyta;Magnoliophyta;Liliopsida;Pandanales;Stemona;";"0.0";"0";"1";"1";"0";"1";"0";"430523";"5766"
"LOK1378_1mm";"SILVA (only NR);Eukaryota;Archaeplastida;Chloroplastida;Charophyta;Phragmoplastophyta;Streptophyta;Embryophyta;Tracheophyta;Spermatophyta;Magnoliophyta;Liliopsida;Pandanales;Triuris;";"0.0";"0";"1";"1";"0";"1";"0";"430523";"5766"
"LOK1378_1mm";"SILVA (only NR);Eukaryota;Archaeplastida;Chloroplastida;Charophyta;Phragmoplastophyta;Streptophyta;Embryophyta;Tracheophyta;Spermatophyta;Magnoliophyta;Liliopsida;Pandanales;Xerophyta;";"0.0";"0";"1";"1";"0";"1";"0";"430523";"5766"
"LOK1378_1mm";"SILVA (only NR);Eukaryota;Archaeplastida;Chloroplastida;Charophyta;Phragmoplastophyta;Streptophyta;Embryophyta;Tracheophyta;Spermatophyta;Magnoliophyta;Liliopsida;Petrosaviales;";"0.0";"0";"2";"2";"0";"2";"0";"430522";"5766"
"LOK1378_1mm";"SILVA (only NR);Eukaryota;Archaeplastida;Chloroplastida;Charophyta;Phragmoplastophyta;Streptophyta;Embryophyta;Tracheophyta;Spermatophyta;Magnoliophyta;Liliopsida;Petrosaviales;Japonolirion;";"0.0";"0";"1";"1";"0";"1";"0";"430523";"5766"
"LOK1378_1mm";"SILVA (only NR);Eukaryota;Archaeplastida;Chloroplastida;Charophyta;Phragmoplastophyta;Streptophyta;Embryophyta;Tracheophyta;Spermatophyta;Magnoliophyta;Liliopsida;Petrosaviales;Petrosavia;";"0.0";"0";"1";"1";"0";"1";"0";"430523";"5766"
"LOK1378_1mm";"SILVA (only NR);Eukaryota;Archaeplastida;Chloroplastida;Charophyta;Phragmoplastophyta;Streptophyta;Embryophyta;Tracheophyta;Spermatophyta;Magnoliophyta;Liliopsida;Poales;";"0.0";"0";"244";"220";"0";"220";"24";"430304";"5766"
"LOK1378_1mm";"SILVA (only NR);Eukaryota;Archaeplastida;Chloroplastida;Charophyta;Phragmoplastophyta;Streptophyta;Embryophyta;Tracheophyta;Spermatophyta;Magnoliophyta;Liliopsida;Poales;Abolboda;";"0.0";"0";"1";"1";"0";"1";"0";"430523";"5766"
"LOK1378_1mm";"SILVA (only NR);Eukaryota;Archaeplastida;Chloroplastida;Charophyta;Phragmoplastophyta;Streptophyta;Embryophyta;Tracheophyta;Spermatophyta;Magnoliophyta;Liliopsida;Poales;Agrostis;";"0.0";"0";"1";"1";"0";"1";"0";"430523";"5766"
"LOK1378_1mm";"SILVA (only NR);Eukaryota;Archaeplastida;Chloroplastida;Charophyta;Phragmoplastophyta;Streptophyta;Embryophyta;Tracheophyta;Spermatophyta;Magnoliophyta;Liliopsida;Poales;Ananas;";"0.0";"0";"5";"5";"0";"5";"0";"430519";"5766"
"LOK1378_1mm";"SILVA (only NR);Eukaryota;Archaeplastida;Chloroplastida;Charophyta;Phragmoplastophyta;Streptophyta;Embryophyta;Tracheophyta;Spermatophyta;Magnoliophyta;Liliopsida;Poales;Baloskion;";"0.0";"0";"1";"1";"0";"1";"0";"430523";"5766"
"LOK1378_1mm";"SILVA (only NR);Eukaryota;Archaeplastida;Chloroplastida;Charophyta;Phragmoplastophyta;Streptophyta;Embryophyta;Tracheophyta;Spermatophyta;Magnoliophyta;Liliopsida;Poales;Billbergia;";"0.0";"0";"1";"1";"0";"1";"0";"430523";"5766"
"LOK1378_1mm";"SILVA (only NR);Eukaryota;Archaeplastida;Chloroplastida;Charophyta;Phragmoplastophyta;Streptophyta;Embryophyta;Tracheophyta;Spermatophyta;Magnoliophyta;Liliopsida;Poales;Bromus;";"0.0";"0";"1";"0";"0";"0";"1";"430524";"5766"
"LOK1378_1mm";"SILVA (only NR);Eukaryota;Archaeplastida;Chloroplastida;Charophyta;Phragmoplastophyta;Streptophyta;Embryophyta;Tracheophyta;Spermatophyta;Magnoliophyta;Liliopsida;Poales;Carex;";"0.0";"0";"1";"1";"0";"1";"0";"430523";"5766"
"LOK1378_1mm";"SILVA (only NR);Eukaryota;Archaeplastida;Chloroplastida;Charophyta;Phragmoplastophyta;Streptophyta;Embryophyta;Tracheophyta;Spermatophyta;Magnoliophyta;Liliopsida;Poales;Cenchrus;";"0.0";"0";"7";"3";"0";"3";"4";"430521";"5766"
"LOK1378_1mm";"SILVA (only NR);Eukaryota;Archaeplastida;Chloroplastida;Charophyta;Phragmoplastophyta;Streptophyta;Embryophyta;Tracheophyta;Spermatophyta;Magnoliophyta;Liliopsida;Poales;Dendrocalamus;";"0.0";"0";"1";"0";"0";"0";"1";"430524";"5766"
"LOK1378_1mm";"SILVA (only NR);Eukaryota;Archaeplastida;Chloroplastida;Charophyta;Phragmoplastophyta;Streptophyta;Embryophyta;Tracheophyta;Spermatophyta;Magnoliophyta;Liliopsida;Poales;Dichanthelium;";"0.0";"0";"1";"0";"0";"0";"1";"430524";"5766"
"LOK1378_1mm";"SILVA (only NR);Eukaryota;Archaeplastida;Chloroplastida;Charophyta;Phragmoplastophyta;Streptophyta;Embryophyta;Tracheophyta;Spermatophyta;Magnoliophyta;Liliopsida;Poales;Ecdeiocolea;";"0.0";"0";"2";"2";"0";"2";"0";"430522";"5766"
"LOK1378_1mm";"SILVA (only NR);Eukaryota;Archaeplastida;Chloroplastida;Charophyta;Phragmoplastophyta;Streptophyta;Embryophyta;Tracheophyta;Spermatophyta;Magnoliophyta;Liliopsida;Poales;Echinochloa;";"0.0";"0";"1";"1";"0";"1";"0";"430523";"5766"
"LOK1378_1mm";"SILVA (only NR);Eukaryota;Archaeplastida;Chloroplastida;Charophyta;Phragmoplastophyta;Streptophyta;Embryophyta;Tracheophyta;Spermatophyta;Magnoliophyta;Liliopsida;Poales;Elegia;";"0.0";"0";"1";"1";"0";"1";"0";"430523";"5766"
"LOK1378_1mm";"SILVA (only NR);Eukaryota;Archaeplastida;Chloroplastida;Charophyta;Phragmoplastophyta;Streptophyta;Embryophyta;Tracheophyta;Spermatophyta;Magnoliophyta;Liliopsida;Poales;Eleocharis;";"0.0";"0";"1";"0";"0";"0";"1";"430524";"5766"
"LOK1378_1mm";"SILVA (only NR);Eukaryota;Archaeplastida;Chloroplastida;Charophyta;Phragmoplastophyta;Streptophyta;Embryophyta;Tracheophyta;Spermatophyta;Magnoliophyta;Liliopsida;Poales;Eleusine;";"0.0";"0";"1";"0";"0";"0";"1";"430524";"5766"
"LOK1378_1mm";"SILVA (only NR);Eukaryota;Archaeplastida;Chloroplastida;Charophyta;Phragmoplastophyta;Streptophyta;Embryophyta;Tracheophyta;Spermatophyta;Magnoliophyta;Liliopsida;Poales;Eragrostis;";"0.0";"0";"3";"0";"0";"0";"3";"430524";"5766"
"LOK1378_1mm";"SILVA (only NR);Eukaryota;Archaeplastida;Chloroplastida;Charophyta;Phragmoplastophyta;Streptophyta;Embryophyta;Tracheophyta;Spermatophyta;Magnoliophyta;Liliopsida;Poales;Eriocaulon;";"0.0";"0";"1";"1";"0";"1";"0";"430523";"5766"
"LOK1378_1mm";"SILVA (only NR);Eukaryota;Archaeplastida;Chloroplastida;Charophyta;Phragmoplastophyta;Streptophyta;Embryophyta;Tracheophyta;Spermatophyta;Magnoliophyta;Liliopsida;Poales;Festuca;";"0.0";"0";"1";"1";"0";"1";"0";"430523";"5766"
"LOK1378_1mm";"SILVA (only NR);Eukaryota;Archaeplastida;Chloroplastida;Charophyta;Phragmoplastophyta;Streptophyta;Embryophyta;Tracheophyta;Spermatophyta;Magnoliophyta;Liliopsida;Poales;Flagellaria;";"0.0";"0";"1";"1";"0";"1";"0";"430523";"5766"
"LOK1378_1mm";"SILVA (only NR);Eukaryota;Archaeplastida;Chloroplastida;Charophyta;Phragmoplastophyta;Streptophyta;Embryophyta;Tracheophyta;Spermatophyta;Magnoliophyta;Liliopsida;Poales;Hordeum;";"0.0";"0";"24";"23";"0";"23";"1";"430501";"5766"
"LOK1378_1mm";"SILVA (only NR);Eukaryota;Archaeplastida;Chloroplastida;Charophyta;Phragmoplastophyta;Streptophyta;Embryophyta;Tracheophyta;Spermatophyta;Magnoliophyta;Liliopsida;Poales;Joinvillea;";"0.0";"0";"1";"1";"0";"1";"0";"430523";"5766"
"LOK1378_1mm";"SILVA (only NR);Eukaryota;Archaeplastida;Chloroplastida;Charophyta;Phragmoplastophyta;Streptophyta;Embryophyta;Tracheophyta;Spermatophyta;Magnoliophyta;Liliopsida;Poales;Juncus;";"0.0";"0";"4";"2";"0";"2";"2";"430522";"5766"
"LOK1378_1mm";"SILVA (only NR);Eukaryota;Archaeplastida;Chloroplastida;Charophyta;Phragmoplastophyta;Streptophyta;Embryophyta;Tracheophyta;Spermatophyta;Magnoliophyta;Liliopsida;Poales;Loliinae;";"0.0";"0";"2";"1";"0";"1";"1";"430523";"5766"
"LOK1378_1mm";"SILVA (only NR);Eukaryota;Archaeplastida;Chloroplastida;Charophyta;Phragmoplastophyta;Streptophyta;Embryophyta;Tracheophyta;Spermatophyta;Magnoliophyta;Liliopsida;Poales;Mayaca;";"0.0";"0";"1";"1";"0";"1";"0";"430523";"5766"
"LOK1378_1mm";"SILVA (only NR);Eukaryota;Archaeplastida;Chloroplastida;Charophyta;Phragmoplastophyta;Streptophyta;Embryophyta;Tracheophyta;Spermatophyta;Magnoliophyta;Liliopsida;Poales;Oropetium;";"0.0";"0";"2";"2";"0";"2";"0";"430522";"5766"
"LOK1378_1mm";"SILVA (only NR);Eukaryota;Archaeplastida;Chloroplastida;Charophyta;Phragmoplastophyta;Streptophyta;Embryophyta;Tracheophyta;Spermatophyta;Magnoliophyta;Liliopsida;Poales;Oryza;";"0.0";"0";"31";"29";"0";"29";"2";"430495";"5766"
"LOK1378_1mm";"SILVA (only NR);Eukaryota;Archaeplastida;Chloroplastida;Charophyta;Phragmoplastophyta;Streptophyta;Embryophyta;Tracheophyta;Spermatophyta;Magnoliophyta;Liliopsida;Poales;Panicum;";"0.0";"0";"1";"1";"0";"1";"0";"430523";"5766"
"LOK1378_1mm";"SILVA (only NR);Eukaryota;Archaeplastida;Chloroplastida;Charophyta;Phragmoplastophyta;Streptophyta;Embryophyta;Tracheophyta;Spermatophyta;Magnoliophyta;Liliopsida;Poales;Rhynchospora;";"0.0";"0";"1";"1";"0";"1";"0";"430523";"5766"
"LOK1378_1mm";"SILVA (only NR);Eukaryota;Archaeplastida;Chloroplastida;Charophyta;Phragmoplastophyta;Streptophyta;Embryophyta;Tracheophyta;Spermatophyta;Magnoliophyta;Liliopsida;Poales;Setaria;";"0.0";"0";"1";"1";"0";"1";"0";"430523";"5766"
"LOK1378_1mm";"SILVA (only NR);Eukaryota;Archaeplastida;Chloroplastida;Charophyta;Phragmoplastophyta;Streptophyta;Embryophyta;Tracheophyta;Spermatophyta;Magnoliophyta;Liliopsida;Poales;Sorghum;";"0.0";"0";"6";"6";"0";"6";"0";"430518";"5766"
"LOK1378_1mm";"SILVA (only NR);Eukaryota;Archaeplastida;Chloroplastida;Charophyta;Phragmoplastophyta;Streptophyta;Embryophyta;Tracheophyta;Spermatophyta;Magnoliophyta;Liliopsida;Poales;Sparganium;";"0.0";"0";"1";"1";"0";"1";"0";"430523";"5766"
"LOK1378_1mm";"SILVA (only NR);Eukaryota;Archaeplastida;Chloroplastida;Charophyta;Phragmoplastophyta;Streptophyta;Embryophyta;Tracheophyta;Spermatophyta;Magnoliophyta;Liliopsida;Poales;Sporobolus;";"0.0";"0";"2";"2";"0";"2";"0";"430522";"5766"
"LOK1378_1mm";"SILVA (only NR);Eukaryota;Archaeplastida;Chloroplastida;Charophyta;Phragmoplastophyta;Streptophyta;Embryophyta;Tracheophyta;Spermatophyta;Magnoliophyta;Liliopsida;Poales;Triticum;";"0.0";"0";"74";"71";"0";"71";"3";"430453";"5766"
"LOK1378_1mm";"SILVA (only NR);Eukaryota;Archaeplastida;Chloroplastida;Charophyta;Phragmoplastophyta;Streptophyta;Embryophyta;Tracheophyta;Spermatophyta;Magnoliophyta;Liliopsida;Poales;Typha;";"0.0";"0";"2";"2";"0";"2";"0";"430522";"5766"
"LOK1378_1mm";"SILVA (only NR);Eukaryota;Archaeplastida;Chloroplastida;Charophyta;Phragmoplastophyta;Streptophyta;Embryophyta;Tracheophyta;Spermatophyta;Magnoliophyta;Liliopsida;Poales;Xyris;";"0.0";"0";"1";"1";"0";"1";"0";"430523";"5766"
"LOK1378_1mm";"SILVA (only NR);Eukaryota;Archaeplastida;Chloroplastida;Charophyta;Phragmoplastophyta;Streptophyta;Embryophyta;Tracheophyta;Spermatophyta;Magnoliophyta;Liliopsida;Poales;Zea;";"0.0";"0";"56";"53";"0";"53";"3";"430471";"5766"
"LOK1378_1mm";"SILVA (only NR);Eukaryota;Archaeplastida;Chloroplastida;Charophyta;Phragmoplastophyta;Streptophyta;Embryophyta;Tracheophyta;Spermatophyta;Magnoliophyta;Liliopsida;Poales;Zizania;";"0.0";"0";"2";"2";"0";"2";"0";"430522";"5766"
"LOK1378_1mm";"SILVA (only NR);Eukaryota;Archaeplastida;Chloroplastida;Charophyta;Phragmoplastophyta;Streptophyta;Embryophyta;Tracheophyta;Spermatophyta;Magnoliophyta;Liliopsida;Zingiberales;";"0.0";"0";"28";"24";"0";"24";"4";"430500";"5766"
"LOK1378_1mm";"SILVA (only NR);Eukaryota;Archaeplastida;Chloroplastida;Charophyta;Phragmoplastophyta;Streptophyta;Embryophyta;Tracheophyta;Spermatophyta;Magnoliophyta;Liliopsida;Zingiberales;Canna;";"0.0";"0";"2";"2";"0";"2";"0";"430522";"5766"
"LOK1378_1mm";"SILVA (only NR);Eukaryota;Archaeplastida;Chloroplastida;Charophyta;Phragmoplastophyta;Streptophyta;Embryophyta;Tracheophyta;Spermatophyta;Magnoliophyta;Liliopsida;Zingiberales;Dimerocostus;";"0.0";"0";"1";"1";"0";"1";"0";"430523";"5766"
"LOK1378_1mm";"SILVA (only NR);Eukaryota;Archaeplastida;Chloroplastida;Charophyta;Phragmoplastophyta;Streptophyta;Embryophyta;Tracheophyta;Spermatophyta;Magnoliophyta;Liliopsida;Zingiberales;Ensete;";"0.0";"0";"3";"1";"0";"1";"2";"430523";"5766"
"LOK1378_1mm";"SILVA (only NR);Eukaryota;Archaeplastida;Chloroplastida;Charophyta;Phragmoplastophyta;Streptophyta;Embryophyta;Tracheophyta;Spermatophyta;Magnoliophyta;Liliopsida;Zingiberales;Globba;";"0.0";"0";"1";"1";"0";"1";"0";"430523";"5766"
"LOK1378_1mm";"SILVA (only NR);Eukaryota;Archaeplastida;Chloroplastida;Charophyta;Phragmoplastophyta;Streptophyta;Embryophyta;Tracheophyta;Spermatophyta;Magnoliophyta;Liliopsida;Zingiberales;Goeppertia;";"0.0";"0";"1";"1";"0";"1";"0";"430523";"5766"
"LOK1378_1mm";"SILVA (only NR);Eukaryota;Archaeplastida;Chloroplastida;Charophyta;Phragmoplastophyta;Streptophyta;Embryophyta;Tracheophyta;Spermatophyta;Magnoliophyta;Liliopsida;Zingiberales;Hedychium;";"0.0";"0";"1";"1";"0";"1";"0";"430523";"5766"
"LOK1378_1mm";"SILVA (only NR);Eukaryota;Archaeplastida;Chloroplastida;Charophyta;Phragmoplastophyta;Streptophyta;Embryophyta;Tracheophyta;Spermatophyta;Magnoliophyta;Liliopsida;Zingiberales;Maranta;";"0.0";"0";"1";"1";"0";"1";"0";"430523";"5766"
"LOK1378_1mm";"SILVA (only NR);Eukaryota;Archaeplastida;Chloroplastida;Charophyta;Phragmoplastophyta;Streptophyta;Embryophyta;Tracheophyta;Spermatophyta;Magnoliophyta;Liliopsida;Zingiberales;Monocostus;";"0.0";"0";"1";"1";"0";"1";"0";"430523";"5766"
"LOK1378_1mm";"SILVA (only NR);Eukaryota;Archaeplastida;Chloroplastida;Charophyta;Phragmoplastophyta;Streptophyta;Embryophyta;Tracheophyta;Spermatophyta;Magnoliophyta;Liliopsida;Zingiberales;Musa;";"0.0";"0";"12";"10";"0";"10";"2";"430514";"5766"
"LOK1378_1mm";"SILVA (only NR);Eukaryota;Archaeplastida;Chloroplastida;Charophyta;Phragmoplastophyta;Streptophyta;Embryophyta;Tracheophyta;Spermatophyta;Magnoliophyta;Liliopsida;Zingiberales;Musella;";"0.0";"0";"1";"1";"0";"1";"0";"430523";"5766"
"LOK1378_1mm";"SILVA (only NR);Eukaryota;Archaeplastida;Chloroplastida;Charophyta;Phragmoplastophyta;Streptophyta;Embryophyta;Tracheophyta;Spermatophyta;Magnoliophyta;Liliopsida;Zingiberales;Orchidantha;";"0.0";"0";"1";"1";"0";"1";"0";"430523";"5766"
"LOK1378_1mm";"SILVA (only NR);Eukaryota;Archaeplastida;Chloroplastida;Charophyta;Phragmoplastophyta;Streptophyta;Embryophyta;Tracheophyta;Spermatophyta;Magnoliophyta;Liliopsida;Zingiberales;Phenakospermum;";"0.0";"0";"1";"1";"0";"1";"0";"430523";"5766"
"LOK1378_1mm";"SILVA (only NR);Eukaryota;Archaeplastida;Chloroplastida;Charophyta;Phragmoplastophyta;Streptophyta;Embryophyta;Tracheophyta;Spermatophyta;Magnoliophyta;Liliopsida;Zingiberales;Ravenala;";"0.0";"0";"1";"1";"0";"1";"0";"430523";"5766"
"LOK1378_1mm";"SILVA (only NR);Eukaryota;Archaeplastida;Chloroplastida;Charophyta;Phragmoplastophyta;Streptophyta;Embryophyta;Tracheophyta;Spermatophyta;Magnoliophyta;Liliopsida;Zingiberales;Tapeinochilos;";"0.0";"0";"1";"1";"0";"1";"0";"430523";"5766"
"LOK1378_1mm";"SILVA (only NR);Eukaryota;Archaeplastida;Chloroplastida;Charophyta;Phragmoplastophyta;Streptophyta;Embryophyta;Tracheophyta;Spermatophyta;Magnoliophyta;Magnoliales;";"0.0";"0";"20";"20";"0";"20";"0";"430504";"5766"
"LOK1378_1mm";"SILVA (only NR);Eukaryota;Archaeplastida;Chloroplastida;Charophyta;Phragmoplastophyta;Streptophyta;Embryophyta;Tracheophyta;Spermatophyta;Magnoliophyta;Magnoliales;Annona;";"0.0";"0";"1";"1";"0";"1";"0";"430523";"5766"
"LOK1378_1mm";"SILVA (only NR);Eukaryota;Archaeplastida;Chloroplastida;Charophyta;Phragmoplastophyta;Streptophyta;Embryophyta;Tracheophyta;Spermatophyta;Magnoliophyta;Magnoliales;Asimina;";"0.0";"0";"1";"1";"0";"1";"0";"430523";"5766"
"LOK1378_1mm";"SILVA (only NR);Eukaryota;Archaeplastida;Chloroplastida;Charophyta;Phragmoplastophyta;Streptophyta;Embryophyta;Tracheophyta;Spermatophyta;Magnoliophyta;Magnoliales;Cananga;";"0.0";"0";"1";"1";"0";"1";"0";"430523";"5766"
"LOK1378_1mm";"SILVA (only NR);Eukaryota;Archaeplastida;Chloroplastida;Charophyta;Phragmoplastophyta;Streptophyta;Embryophyta;Tracheophyta;Spermatophyta;Magnoliophyta;Magnoliales;Degeneria;";"0.0";"0";"1";"1";"0";"1";"0";"430523";"5766"
"LOK1378_1mm";"SILVA (only NR);Eukaryota;Archaeplastida;Chloroplastida;Charophyta;Phragmoplastophyta;Streptophyta;Embryophyta;Tracheophyta;Spermatophyta;Magnoliophyta;Magnoliales;Galbulimima;";"0.0";"0";"1";"1";"0";"1";"0";"430523";"5766"
"LOK1378_1mm";"SILVA (only NR);Eukaryota;Archaeplastida;Chloroplastida;Charophyta;Phragmoplastophyta;Streptophyta;Embryophyta;Tracheophyta;Spermatophyta;Magnoliophyta;Magnoliales;Gymnacranthera;";"0.0";"0";"2";"2";"0";"2";"0";"430522";"5766"
"LOK1378_1mm";"SILVA (only NR);Eukaryota;Archaeplastida;Chloroplastida;Charophyta;Phragmoplastophyta;Streptophyta;Embryophyta;Tracheophyta;Spermatophyta;Magnoliophyta;Magnoliales;Horsfieldia;";"0.0";"0";"3";"3";"0";"3";"0";"430521";"5766"
"LOK1378_1mm";"SILVA (only NR);Eukaryota;Archaeplastida;Chloroplastida;Charophyta;Phragmoplastophyta;Streptophyta;Embryophyta;Tracheophyta;Spermatophyta;Magnoliophyta;Magnoliales;Knema;";"0.0";"0";"2";"2";"0";"2";"0";"430522";"5766"
"LOK1378_1mm";"SILVA (only NR);Eukaryota;Archaeplastida;Chloroplastida;Charophyta;Phragmoplastophyta;Streptophyta;Embryophyta;Tracheophyta;Spermatophyta;Magnoliophyta;Magnoliales;Liriodendron;";"0.0";"0";"1";"1";"0";"1";"0";"430523";"5766"
"LOK1378_1mm";"SILVA (only NR);Eukaryota;Archaeplastida;Chloroplastida;Charophyta;Phragmoplastophyta;Streptophyta;Embryophyta;Tracheophyta;Spermatophyta;Magnoliophyta;Magnoliales;Magnolia;";"0.0";"0";"1";"1";"0";"1";"0";"430523";"5766"
"LOK1378_1mm";"SILVA (only NR);Eukaryota;Archaeplastida;Chloroplastida;Charophyta;Phragmoplastophyta;Streptophyta;Embryophyta;Tracheophyta;Spermatophyta;Magnoliophyta;Magnoliales;Mauloutchia;";"0.0";"0";"1";"1";"0";"1";"0";"430523";"5766"
"LOK1378_1mm";"SILVA (only NR);Eukaryota;Archaeplastida;Chloroplastida;Charophyta;Phragmoplastophyta;Streptophyta;Embryophyta;Tracheophyta;Spermatophyta;Magnoliophyta;Magnoliales;Myristica;";"0.0";"0";"4";"4";"0";"4";"0";"430520";"5766"
"LOK1378_1mm";"SILVA (only NR);Eukaryota;Archaeplastida;Chloroplastida;Charophyta;Phragmoplastophyta;Streptophyta;Embryophyta;Tracheophyta;Spermatophyta;Magnoliophyta;Magnoliales;Polyalthia;";"0.0";"0";"1";"1";"0";"1";"0";"430523";"5766"
"LOK1378_1mm";"SILVA (only NR);Eukaryota;Archaeplastida;Chloroplastida;Charophyta;Phragmoplastophyta;Streptophyta;Embryophyta;Tracheophyta;Spermatophyta;Magnoliophyta;Malpighiales;";"0.0";"0";"157";"137";"0";"137";"20";"430387";"5766"
"LOK1378_1mm";"SILVA (only NR);Eukaryota;Archaeplastida;Chloroplastida;Charophyta;Phragmoplastophyta;Streptophyta;Embryophyta;Tracheophyta;Spermatophyta;Magnoliophyta;Malpighiales;Acharia;";"0.0";"0";"1";"1";"0";"1";"0";"430523";"5766"
"LOK1378_1mm";"SILVA (only NR);Eukaryota;Archaeplastida;Chloroplastida;Charophyta;Phragmoplastophyta;Streptophyta;Embryophyta;Tracheophyta;Spermatophyta;Magnoliophyta;Malpighiales;Acidoton;";"0.0";"0";"1";"1";"0";"1";"0";"430523";"5766"
"LOK1378_1mm";"SILVA (only NR);Eukaryota;Archaeplastida;Chloroplastida;Charophyta;Phragmoplastophyta;Streptophyta;Embryophyta;Tracheophyta;Spermatophyta;Magnoliophyta;Malpighiales;Acridocarpus;";"0.0";"0";"1";"1";"0";"1";"0";"430523";"5766"
"LOK1378_1mm";"SILVA (only NR);Eukaryota;Archaeplastida;Chloroplastida;Charophyta;Phragmoplastophyta;Streptophyta;Embryophyta;Tracheophyta;Spermatophyta;Magnoliophyta;Malpighiales;Adriana;";"0.0";"0";"1";"1";"0";"1";"0";"430523";"5766"
"LOK1378_1mm";"SILVA (only NR);Eukaryota;Archaeplastida;Chloroplastida;Charophyta;Phragmoplastophyta;Streptophyta;Embryophyta;Tracheophyta;Spermatophyta;Magnoliophyta;Malpighiales;Agrostistachys;";"0.0";"0";"1";"1";"0";"1";"0";"430523";"5766"
"LOK1378_1mm";"SILVA (only NR);Eukaryota;Archaeplastida;Chloroplastida;Charophyta;Phragmoplastophyta;Streptophyta;Embryophyta;Tracheophyta;Spermatophyta;Magnoliophyta;Malpighiales;Allexis;";"0.0";"0";"1";"1";"0";"1";"0";"430523";"5766"
"LOK1378_1mm";"SILVA (only NR);Eukaryota;Archaeplastida;Chloroplastida;Charophyta;Phragmoplastophyta;Streptophyta;Embryophyta;Tracheophyta;Spermatophyta;Magnoliophyta;Malpighiales;Aneulophus;";"0.0";"0";"1";"1";"0";"1";"0";"430523";"5766"
"LOK1378_1mm";"SILVA (only NR);Eukaryota;Archaeplastida;Chloroplastida;Charophyta;Phragmoplastophyta;Streptophyta;Embryophyta;Tracheophyta;Spermatophyta;Magnoliophyta;Malpighiales;Aporosa;";"0.0";"0";"1";"1";"0";"1";"0";"430523";"5766"
"LOK1378_1mm";"SILVA (only NR);Eukaryota;Archaeplastida;Chloroplastida;Charophyta;Phragmoplastophyta;Streptophyta;Embryophyta;Tracheophyta;Spermatophyta;Magnoliophyta;Malpighiales;Aristogeitonia;";"0.0";"0";"1";"1";"0";"1";"0";"430523";"5766"
"LOK1378_1mm";"SILVA (only NR);Eukaryota;Archaeplastida;Chloroplastida;Charophyta;Phragmoplastophyta;Streptophyta;Embryophyta;Tracheophyta;Spermatophyta;Magnoliophyta;Malpighiales;Astrocasia;";"0.0";"0";"1";"1";"0";"1";"0";"430523";"5766"
"LOK1378_1mm";"SILVA (only NR);Eukaryota;Archaeplastida;Chloroplastida;Charophyta;Phragmoplastophyta;Streptophyta;Embryophyta;Tracheophyta;Spermatophyta;Magnoliophyta;Malpighiales;Balanops;";"0.0";"0";"1";"1";"0";"1";"0";"430523";"5766"
"LOK1378_1mm";"SILVA (only NR);Eukaryota;Archaeplastida;Chloroplastida;Charophyta;Phragmoplastophyta;Streptophyta;Embryophyta;Tracheophyta;Spermatophyta;Magnoliophyta;Malpighiales;Bhesa;";"0.0";"0";"1";"1";"0";"1";"0";"430523";"5766"
"LOK1378_1mm";"SILVA (only NR);Eukaryota;Archaeplastida;Chloroplastida;Charophyta;Phragmoplastophyta;Streptophyta;Embryophyta;Tracheophyta;Spermatophyta;Magnoliophyta;Malpighiales;Bonnetia;";"0.0";"0";"1";"1";"0";"1";"0";"430523";"5766"
"LOK1378_1mm";"SILVA (only NR);Eukaryota;Archaeplastida;Chloroplastida;Charophyta;Phragmoplastophyta;Streptophyta;Embryophyta;Tracheophyta;Spermatophyta;Magnoliophyta;Malpighiales;Bunchosia;";"0.0";"0";"1";"1";"0";"1";"0";"430523";"5766"
"LOK1378_1mm";"SILVA (only NR);Eukaryota;Archaeplastida;Chloroplastida;Charophyta;Phragmoplastophyta;Streptophyta;Embryophyta;Tracheophyta;Spermatophyta;Magnoliophyta;Malpighiales;Byrsonima;";"0.0";"0";"1";"1";"0";"1";"0";"430523";"5766"
"LOK1378_1mm";"SILVA (only NR);Eukaryota;Archaeplastida;Chloroplastida;Charophyta;Phragmoplastophyta;Streptophyta;Embryophyta;Tracheophyta;Spermatophyta;Magnoliophyta;Malpighiales;Camptostylus;";"0.0";"0";"1";"1";"0";"1";"0";"430523";"5766"
"LOK1378_1mm";"SILVA (only NR);Eukaryota;Archaeplastida;Chloroplastida;Charophyta;Phragmoplastophyta;Streptophyta;Embryophyta;Tracheophyta;Spermatophyta;Magnoliophyta;Malpighiales;Carallia;";"0.0";"0";"1";"1";"0";"1";"0";"430523";"5766"
"LOK1378_1mm";"SILVA (only NR);Eukaryota;Archaeplastida;Chloroplastida;Charophyta;Phragmoplastophyta;Streptophyta;Embryophyta;Tracheophyta;Spermatophyta;Magnoliophyta;Malpighiales;Caryocar;";"0.0";"0";"1";"1";"0";"1";"0";"430523";"5766"
"LOK1378_1mm";"SILVA (only NR);Eukaryota;Archaeplastida;Chloroplastida;Charophyta;Phragmoplastophyta;Streptophyta;Embryophyta;Tracheophyta;Spermatophyta;Magnoliophyta;Malpighiales;Chaetocarpus;";"0.0";"0";"1";"1";"0";"1";"0";"430523";"5766"
"LOK1378_1mm";"SILVA (only NR);Eukaryota;Archaeplastida;Chloroplastida;Charophyta;Phragmoplastophyta;Streptophyta;Embryophyta;Tracheophyta;Spermatophyta;Magnoliophyta;Malpighiales;Cladogynos;";"0.0";"0";"1";"1";"0";"1";"0";"430523";"5766"
"LOK1378_1mm";"SILVA (only NR);Eukaryota;Archaeplastida;Chloroplastida;Charophyta;Phragmoplastophyta;Streptophyta;Embryophyta;Tracheophyta;Spermatophyta;Magnoliophyta;Malpighiales;Clusia;";"0.0";"0";"1";"1";"0";"1";"0";"430523";"5766"
"LOK1378_1mm";"SILVA (only NR);Eukaryota;Archaeplastida;Chloroplastida;Charophyta;Phragmoplastophyta;Streptophyta;Embryophyta;Tracheophyta;Spermatophyta;Magnoliophyta;Malpighiales;Clutia;";"0.0";"0";"1";"1";"0";"1";"0";"430523";"5766"
"LOK1378_1mm";"SILVA (only NR);Eukaryota;Archaeplastida;Chloroplastida;Charophyta;Phragmoplastophyta;Streptophyta;Embryophyta;Tracheophyta;Spermatophyta;Magnoliophyta;Malpighiales;Cratoxylum;";"0.0";"0";"1";"1";"0";"1";"0";"430523";"5766"
"LOK1378_1mm";"SILVA (only NR);Eukaryota;Archaeplastida;Chloroplastida;Charophyta;Phragmoplastophyta;Streptophyta;Embryophyta;Tracheophyta;Spermatophyta;Magnoliophyta;Malpighiales;Croizatia;";"0.0";"0";"1";"1";"0";"1";"0";"430523";"5766"
"LOK1378_1mm";"SILVA (only NR);Eukaryota;Archaeplastida;Chloroplastida;Charophyta;Phragmoplastophyta;Streptophyta;Embryophyta;Tracheophyta;Spermatophyta;Magnoliophyta;Malpighiales;Croton;";"0.0";"0";"1";"1";"0";"1";"0";"430523";"5766"
"LOK1378_1mm";"SILVA (only NR);Eukaryota;Archaeplastida;Chloroplastida;Charophyta;Phragmoplastophyta;Streptophyta;Embryophyta;Tracheophyta;Spermatophyta;Magnoliophyta;Malpighiales;Dasylepis;";"0.0";"0";"1";"1";"0";"1";"0";"430523";"5766"
"LOK1378_1mm";"SILVA (only NR);Eukaryota;Archaeplastida;Chloroplastida;Charophyta;Phragmoplastophyta;Streptophyta;Embryophyta;Tracheophyta;Spermatophyta;Magnoliophyta;Malpighiales;Decorsella;";"0.0";"0";"1";"1";"0";"1";"0";"430523";"5766"
"LOK1378_1mm";"SILVA (only NR);Eukaryota;Archaeplastida;Chloroplastida;Charophyta;Phragmoplastophyta;Streptophyta;Embryophyta;Tracheophyta;Spermatophyta;Magnoliophyta;Malpighiales;Dicoelia;";"0.0";"0";"1";"1";"0";"1";"0";"430523";"5766"
"LOK1378_1mm";"SILVA (only NR);Eukaryota;Archaeplastida;Chloroplastida;Charophyta;Phragmoplastophyta;Streptophyta;Embryophyta;Tracheophyta;Spermatophyta;Magnoliophyta;Malpighiales;Diporidium;";"0.0";"0";"1";"1";"0";"1";"0";"430523";"5766"
"LOK1378_1mm";"SILVA (only NR);Eukaryota;Archaeplastida;Chloroplastida;Charophyta;Phragmoplastophyta;Streptophyta;Embryophyta;Tracheophyta;Spermatophyta;Magnoliophyta;Malpighiales;Durandea;";"0.0";"0";"1";"1";"0";"1";"0";"430523";"5766"
"LOK1378_1mm";"SILVA (only NR);Eukaryota;Archaeplastida;Chloroplastida;Charophyta;Phragmoplastophyta;Streptophyta;Embryophyta;Tracheophyta;Spermatophyta;Magnoliophyta;Malpighiales;Elatine;";"0.0";"0";"1";"1";"0";"1";"0";"430523";"5766"
"LOK1378_1mm";"SILVA (only NR);Eukaryota;Archaeplastida;Chloroplastida;Charophyta;Phragmoplastophyta;Streptophyta;Embryophyta;Tracheophyta;Spermatophyta;Magnoliophyta;Malpighiales;Endodesmia;";"0.0";"0";"1";"1";"0";"1";"0";"430523";"5766"
"LOK1378_1mm";"SILVA (only NR);Eukaryota;Archaeplastida;Chloroplastida;Charophyta;Phragmoplastophyta;Streptophyta;Embryophyta;Tracheophyta;Spermatophyta;Magnoliophyta;Malpighiales;Endospermum;";"0.0";"0";"1";"1";"0";"1";"0";"430523";"5766"
"LOK1378_1mm";"SILVA (only NR);Eukaryota;Archaeplastida;Chloroplastida;Charophyta;Phragmoplastophyta;Streptophyta;Embryophyta;Tracheophyta;Spermatophyta;Magnoliophyta;Malpighiales;Erythrococca;";"0.0";"0";"1";"1";"0";"1";"0";"430523";"5766"
"LOK1378_1mm";"SILVA (only NR);Eukaryota;Archaeplastida;Chloroplastida;Charophyta;Phragmoplastophyta;Streptophyta;Embryophyta;Tracheophyta;Spermatophyta;Magnoliophyta;Malpighiales;Erythroxylum;";"0.0";"0";"1";"1";"0";"1";"0";"430523";"5766"
"LOK1378_1mm";"SILVA (only NR);Eukaryota;Archaeplastida;Chloroplastida;Charophyta;Phragmoplastophyta;Streptophyta;Embryophyta;Tracheophyta;Spermatophyta;Magnoliophyta;Malpighiales;Euphorbia;";"0.0";"0";"18";"6";"0";"6";"12";"430518";"5766"
"LOK1378_1mm";"SILVA (only NR);Eukaryota;Archaeplastida;Chloroplastida;Charophyta;Phragmoplastophyta;Streptophyta;Embryophyta;Tracheophyta;Spermatophyta;Magnoliophyta;Malpighiales;Euphronia;";"0.0";"0";"1";"1";"0";"1";"0";"430523";"5766"
"LOK1378_1mm";"SILVA (only NR);Eukaryota;Archaeplastida;Chloroplastida;Charophyta;Phragmoplastophyta;Streptophyta;Embryophyta;Tracheophyta;Spermatophyta;Magnoliophyta;Malpighiales;Flacourtia;";"0.0";"0";"1";"1";"0";"1";"0";"430523";"5766"
"LOK1378_1mm";"SILVA (only NR);Eukaryota;Archaeplastida;Chloroplastida;Charophyta;Phragmoplastophyta;Streptophyta;Embryophyta;Tracheophyta;Spermatophyta;Magnoliophyta;Malpighiales;Flueggea;";"0.0";"0";"1";"1";"0";"1";"0";"430523";"5766"
"LOK1378_1mm";"SILVA (only NR);Eukaryota;Archaeplastida;Chloroplastida;Charophyta;Phragmoplastophyta;Streptophyta;Embryophyta;Tracheophyta;Spermatophyta;Magnoliophyta;Malpighiales;Fusispermum;";"0.0";"0";"1";"1";"0";"1";"0";"430523";"5766"
"LOK1378_1mm";"SILVA (only NR);Eukaryota;Archaeplastida;Chloroplastida;Charophyta;Phragmoplastophyta;Streptophyta;Embryophyta;Tracheophyta;Spermatophyta;Magnoliophyta;Malpighiales;Galearia;";"0.0";"0";"1";"1";"0";"1";"0";"430523";"5766"
"LOK1378_1mm";"SILVA (only NR);Eukaryota;Archaeplastida;Chloroplastida;Charophyta;Phragmoplastophyta;Streptophyta;Embryophyta;Tracheophyta;Spermatophyta;Magnoliophyta;Malpighiales;Galphimia;";"0.0";"0";"1";"1";"0";"1";"0";"430523";"5766"
"LOK1378_1mm";"SILVA (only NR);Eukaryota;Archaeplastida;Chloroplastida;Charophyta;Phragmoplastophyta;Streptophyta;Embryophyta;Tracheophyta;Spermatophyta;Magnoliophyta;Malpighiales;Garcinia;";"0.0";"0";"1";"1";"0";"1";"0";"430523";"5766"
"LOK1378_1mm";"SILVA (only NR);Eukaryota;Archaeplastida;Chloroplastida;Charophyta;Phragmoplastophyta;Streptophyta;Embryophyta;Tracheophyta;Spermatophyta;Magnoliophyta;Malpighiales;Hevea;";"0.0";"0";"10";"10";"0";"10";"0";"430514";"5766"
"LOK1378_1mm";"SILVA (only NR);Eukaryota;Archaeplastida;Chloroplastida;Charophyta;Phragmoplastophyta;Streptophyta;Embryophyta;Tracheophyta;Spermatophyta;Magnoliophyta;Malpighiales;Heywoodia;";"0.0";"0";"1";"1";"0";"1";"0";"430523";"5766"
"LOK1378_1mm";"SILVA (only NR);Eukaryota;Archaeplastida;Chloroplastida;Charophyta;Phragmoplastophyta;Streptophyta;Embryophyta;Tracheophyta;Spermatophyta;Magnoliophyta;Malpighiales;Hirtella;";"0.0";"0";"1";"1";"0";"1";"0";"430523";"5766"
"LOK1378_1mm";"SILVA (only NR);Eukaryota;Archaeplastida;Chloroplastida;Charophyta;Phragmoplastophyta;Streptophyta;Embryophyta;Tracheophyta;Spermatophyta;Magnoliophyta;Malpighiales;Homalium;";"0.0";"0";"1";"1";"0";"1";"0";"430523";"5766"
"LOK1378_1mm";"SILVA (only NR);Eukaryota;Archaeplastida;Chloroplastida;Charophyta;Phragmoplastophyta;Streptophyta;Embryophyta;Tracheophyta;Spermatophyta;Magnoliophyta;Malpighiales;Hugonia;";"0.0";"0";"1";"1";"0";"1";"0";"430523";"5766"
"LOK1378_1mm";"SILVA (only NR);Eukaryota;Archaeplastida;Chloroplastida;Charophyta;Phragmoplastophyta;Streptophyta;Embryophyta;Tracheophyta;Spermatophyta;Magnoliophyta;Malpighiales;Hybanthus;";"0.0";"0";"1";"1";"0";"1";"0";"430523";"5766"
"LOK1378_1mm";"SILVA (only NR);Eukaryota;Archaeplastida;Chloroplastida;Charophyta;Phragmoplastophyta;Streptophyta;Embryophyta;Tracheophyta;Spermatophyta;Magnoliophyta;Malpighiales;Hymenanthera;";"0.0";"0";"1";"1";"0";"1";"0";"430523";"5766"
"LOK1378_1mm";"SILVA (only NR);Eukaryota;Archaeplastida;Chloroplastida;Charophyta;Phragmoplastophyta;Streptophyta;Embryophyta;Tracheophyta;Spermatophyta;Magnoliophyta;Malpighiales;Hypericum;";"0.0";"0";"1";"1";"0";"1";"0";"430523";"5766"
"LOK1378_1mm";"SILVA (only NR);Eukaryota;Archaeplastida;Chloroplastida;Charophyta;Phragmoplastophyta;Streptophyta;Embryophyta;Tracheophyta;Spermatophyta;Magnoliophyta;Malpighiales;Irvingia;";"0.0";"0";"1";"1";"0";"1";"0";"430523";"5766"
"LOK1378_1mm";"SILVA (only NR);Eukaryota;Archaeplastida;Chloroplastida;Charophyta;Phragmoplastophyta;Streptophyta;Embryophyta;Tracheophyta;Spermatophyta;Magnoliophyta;Malpighiales;Isodendrion;";"0.0";"0";"1";"1";"0";"1";"0";"430523";"5766"
"LOK1378_1mm";"SILVA (only NR);Eukaryota;Archaeplastida;Chloroplastida;Charophyta;Phragmoplastophyta;Streptophyta;Embryophyta;Tracheophyta;Spermatophyta;Magnoliophyta;Malpighiales;Ixonanthes;";"0.0";"0";"3";"3";"0";"3";"0";"430521";"5766"
"LOK1378_1mm";"SILVA (only NR);Eukaryota;Archaeplastida;Chloroplastida;Charophyta;Phragmoplastophyta;Streptophyta;Embryophyta;Tracheophyta;Spermatophyta;Magnoliophyta;Malpighiales;Jatropha;";"0.0";"0";"2";"2";"0";"2";"0";"430522";"5766"
"LOK1378_1mm";"SILVA (only NR);Eukaryota;Archaeplastida;Chloroplastida;Charophyta;Phragmoplastophyta;Streptophyta;Embryophyta;Tracheophyta;Spermatophyta;Magnoliophyta;Malpighiales;Lachnostylis;";"0.0";"0";"1";"1";"0";"1";"0";"430523";"5766"
"LOK1378_1mm";"SILVA (only NR);Eukaryota;Archaeplastida;Chloroplastida;Charophyta;Phragmoplastophyta;Streptophyta;Embryophyta;Tracheophyta;Spermatophyta;Magnoliophyta;Malpighiales;Lacistema;";"0.0";"0";"2";"2";"0";"2";"0";"430522";"5766"
"LOK1378_1mm";"SILVA (only NR);Eukaryota;Archaeplastida;Chloroplastida;Charophyta;Phragmoplastophyta;Streptophyta;Embryophyta;Tracheophyta;Spermatophyta;Magnoliophyta;Malpighiales;Lasiocroton;";"0.0";"0";"1";"1";"0";"1";"0";"430523";"5766"
"LOK1378_1mm";"SILVA (only NR);Eukaryota;Archaeplastida;Chloroplastida;Charophyta;Phragmoplastophyta;Streptophyta;Embryophyta;Tracheophyta;Spermatophyta;Magnoliophyta;Malpighiales;Linum;";"0.0";"0";"6";"5";"0";"5";"1";"430519";"5766"
"LOK1378_1mm";"SILVA (only NR);Eukaryota;Archaeplastida;Chloroplastida;Charophyta;Phragmoplastophyta;Streptophyta;Embryophyta;Tracheophyta;Spermatophyta;Magnoliophyta;Malpighiales;Lophopyxis;";"0.0";"0";"1";"1";"0";"1";"0";"430523";"5766"
"LOK1378_1mm";"SILVA (only NR);Eukaryota;Archaeplastida;Chloroplastida;Charophyta;Phragmoplastophyta;Streptophyta;Embryophyta;Tracheophyta;Spermatophyta;Magnoliophyta;Malpighiales;Luxemburgia;";"0.0";"0";"1";"1";"0";"1";"0";"430523";"5766"
"LOK1378_1mm";"SILVA (only NR);Eukaryota;Archaeplastida;Chloroplastida;Charophyta;Phragmoplastophyta;Streptophyta;Embryophyta;Tracheophyta;Spermatophyta;Magnoliophyta;Malpighiales;Malesherbia;";"0.0";"0";"1";"1";"0";"1";"0";"430523";"5766"
"LOK1378_1mm";"SILVA (only NR);Eukaryota;Archaeplastida;Chloroplastida;Charophyta;Phragmoplastophyta;Streptophyta;Embryophyta;Tracheophyta;Spermatophyta;Magnoliophyta;Malpighiales;Malpighia;";"0.0";"0";"1";"1";"0";"1";"0";"430523";"5766"
"LOK1378_1mm";"SILVA (only NR);Eukaryota;Archaeplastida;Chloroplastida;Charophyta;Phragmoplastophyta;Streptophyta;Embryophyta;Tracheophyta;Spermatophyta;Magnoliophyta;Malpighiales;Mammea;";"0.0";"0";"1";"1";"0";"1";"0";"430523";"5766"
"LOK1378_1mm";"SILVA (only NR);Eukaryota;Archaeplastida;Chloroplastida;Charophyta;Phragmoplastophyta;Streptophyta;Embryophyta;Tracheophyta;Spermatophyta;Magnoliophyta;Malpighiales;Manihot;";"0.0";"0";"4";"3";"0";"3";"1";"430521";"5766"
"LOK1378_1mm";"SILVA (only NR);Eukaryota;Archaeplastida;Chloroplastida;Charophyta;Phragmoplastophyta;Streptophyta;Embryophyta;Tracheophyta;Spermatophyta;Magnoliophyta;Malpighiales;Marathrum;";"0.0";"0";"1";"1";"0";"1";"0";"430523";"5766"
"LOK1378_1mm";"SILVA (only NR);Eukaryota;Archaeplastida;Chloroplastida;Charophyta;Phragmoplastophyta;Streptophyta;Embryophyta;Tracheophyta;Spermatophyta;Magnoliophyta;Malpighiales;Mareya;";"0.0";"0";"1";"1";"0";"1";"0";"430523";"5766"
"LOK1378_1mm";"SILVA (only NR);Eukaryota;Archaeplastida;Chloroplastida;Charophyta;Phragmoplastophyta;Streptophyta;Embryophyta;Tracheophyta;Spermatophyta;Magnoliophyta;Malpighiales;Mathurina;";"0.0";"0";"1";"1";"0";"1";"0";"430523";"5766"
"LOK1378_1mm";"SILVA (only NR);Eukaryota;Archaeplastida;Chloroplastida;Charophyta;Phragmoplastophyta;Streptophyta;Embryophyta;Tracheophyta;Spermatophyta;Magnoliophyta;Malpighiales;Mayanaea;";"0.0";"0";"1";"1";"0";"1";"0";"430523";"5766"
"LOK1378_1mm";"SILVA (only NR);Eukaryota;Archaeplastida;Chloroplastida;Charophyta;Phragmoplastophyta;Streptophyta;Embryophyta;Tracheophyta;Spermatophyta;Magnoliophyta;Malpighiales;Medusagyne;";"0.0";"0";"1";"1";"0";"1";"0";"430523";"5766"
"LOK1378_1mm";"SILVA (only NR);Eukaryota;Archaeplastida;Chloroplastida;Charophyta;Phragmoplastophyta;Streptophyta;Embryophyta;Tracheophyta;Spermatophyta;Magnoliophyta;Malpighiales;Meineckia;";"0.0";"0";"1";"1";"0";"1";"0";"430523";"5766"
"LOK1378_1mm";"SILVA (only NR);Eukaryota;Archaeplastida;Chloroplastida;Charophyta;Phragmoplastophyta;Streptophyta;Embryophyta;Tracheophyta;Spermatophyta;Magnoliophyta;Malpighiales;Mesua;";"0.0";"0";"1";"1";"0";"1";"0";"430523";"5766"
"LOK1378_1mm";"SILVA (only NR);Eukaryota;Archaeplastida;Chloroplastida;Charophyta;Phragmoplastophyta;Streptophyta;Embryophyta;Tracheophyta;Spermatophyta;Magnoliophyta;Malpighiales;Montrouziera;";"0.0";"0";"1";"1";"0";"1";"0";"430523";"5766"
"LOK1378_1mm";"SILVA (only NR);Eukaryota;Archaeplastida;Chloroplastida;Charophyta;Phragmoplastophyta;Streptophyta;Embryophyta;Tracheophyta;Spermatophyta;Magnoliophyta;Malpighiales;Ochthocosmus;";"0.0";"0";"1";"1";"0";"1";"0";"430523";"5766"
"LOK1378_1mm";"SILVA (only NR);Eukaryota;Archaeplastida;Chloroplastida;Charophyta;Phragmoplastophyta;Streptophyta;Embryophyta;Tracheophyta;Spermatophyta;Magnoliophyta;Malpighiales;Omphalea;";"0.0";"0";"1";"1";"0";"1";"0";"430523";"5766"
"LOK1378_1mm";"SILVA (only NR);Eukaryota;Archaeplastida;Chloroplastida;Charophyta;Phragmoplastophyta;Streptophyta;Embryophyta;Tracheophyta;Spermatophyta;Magnoliophyta;Malpighiales;Pangium;";"0.0";"0";"1";"1";"0";"1";"0";"430523";"5766"
"LOK1378_1mm";"SILVA (only NR);Eukaryota;Archaeplastida;Chloroplastida;Charophyta;Phragmoplastophyta;Streptophyta;Embryophyta;Tracheophyta;Spermatophyta;Magnoliophyta;Malpighiales;Paradrypetes;";"0.0";"0";"1";"1";"0";"1";"0";"430523";"5766"
"LOK1378_1mm";"SILVA (only NR);Eukaryota;Archaeplastida;Chloroplastida;Charophyta;Phragmoplastophyta;Streptophyta;Embryophyta;Tracheophyta;Spermatophyta;Magnoliophyta;Malpighiales;Passiflora;";"0.0";"0";"1";"1";"0";"1";"0";"430523";"5766"
"LOK1378_1mm";"SILVA (only NR);Eukaryota;Archaeplastida;Chloroplastida;Charophyta;Phragmoplastophyta;Streptophyta;Embryophyta;Tracheophyta;Spermatophyta;Magnoliophyta;Malpighiales;Pera;";"0.0";"0";"1";"1";"0";"1";"0";"430523";"5766"
"LOK1378_1mm";"SILVA (only NR);Eukaryota;Archaeplastida;Chloroplastida;Charophyta;Phragmoplastophyta;Streptophyta;Embryophyta;Tracheophyta;Spermatophyta;Magnoliophyta;Malpighiales;Philyra;";"0.0";"0";"1";"1";"0";"1";"0";"430523";"5766"
"LOK1378_1mm";"SILVA (only NR);Eukaryota;Archaeplastida;Chloroplastida;Charophyta;Phragmoplastophyta;Streptophyta;Embryophyta;Tracheophyta;Spermatophyta;Magnoliophyta;Malpighiales;Phyllanthus;";"0.0";"0";"2";"2";"0";"2";"0";"430522";"5766"
"LOK1378_1mm";"SILVA (only NR);Eukaryota;Archaeplastida;Chloroplastida;Charophyta;Phragmoplastophyta;Streptophyta;Embryophyta;Tracheophyta;Spermatophyta;Magnoliophyta;Malpighiales;Picrodendron;";"0.0";"0";"1";"1";"0";"1";"0";"430523";"5766"
"LOK1378_1mm";"SILVA (only NR);Eukaryota;Archaeplastida;Chloroplastida;Charophyta;Phragmoplastophyta;Streptophyta;Embryophyta;Tracheophyta;Spermatophyta;Magnoliophyta;Malpighiales;Piriqueta;";"0.0";"0";"1";"1";"0";"1";"0";"430523";"5766"
"LOK1378_1mm";"SILVA (only NR);Eukaryota;Archaeplastida;Chloroplastida;Charophyta;Phragmoplastophyta;Streptophyta;Embryophyta;Tracheophyta;Spermatophyta;Magnoliophyta;Malpighiales;Ploiarium;";"0.0";"0";"1";"1";"0";"1";"0";"430523";"5766"
"LOK1378_1mm";"SILVA (only NR);Eukaryota;Archaeplastida;Chloroplastida;Charophyta;Phragmoplastophyta;Streptophyta;Embryophyta;Tracheophyta;Spermatophyta;Magnoliophyta;Malpighiales;Plukenetia;";"0.0";"0";"1";"1";"0";"1";"0";"430523";"5766"
"LOK1378_1mm";"SILVA (only NR);Eukaryota;Archaeplastida;Chloroplastida;Charophyta;Phragmoplastophyta;Streptophyta;Embryophyta;Tracheophyta;Spermatophyta;Magnoliophyta;Malpighiales;Podostemum;";"0.0";"0";"1";"1";"0";"1";"0";"430523";"5766"
"LOK1378_1mm";"SILVA (only NR);Eukaryota;Archaeplastida;Chloroplastida;Charophyta;Phragmoplastophyta;Streptophyta;Embryophyta;Tracheophyta;Spermatophyta;Magnoliophyta;Malpighiales;Populus;";"0.0";"0";"12";"6";"0";"6";"6";"430518";"5766"
"LOK1378_1mm";"SILVA (only NR);Eukaryota;Archaeplastida;Chloroplastida;Charophyta;Phragmoplastophyta;Streptophyta;Embryophyta;Tracheophyta;Spermatophyta;Magnoliophyta;Malpighiales;Putranjiva;";"0.0";"0";"1";"1";"0";"1";"0";"430523";"5766"
"LOK1378_1mm";"SILVA (only NR);Eukaryota;Archaeplastida;Chloroplastida;Charophyta;Phragmoplastophyta;Streptophyta;Embryophyta;Tracheophyta;Spermatophyta;Magnoliophyta;Malpighiales;Quiina;";"0.0";"0";"1";"1";"0";"1";"0";"430523";"5766"
"LOK1378_1mm";"SILVA (only NR);Eukaryota;Archaeplastida;Chloroplastida;Charophyta;Phragmoplastophyta;Streptophyta;Embryophyta;Tracheophyta;Spermatophyta;Magnoliophyta;Malpighiales;Rafflesia;";"0.0";"0";"1";"1";"0";"1";"0";"430523";"5766"
"LOK1378_1mm";"SILVA (only NR);Eukaryota;Archaeplastida;Chloroplastida;Charophyta;Phragmoplastophyta;Streptophyta;Embryophyta;Tracheophyta;Spermatophyta;Magnoliophyta;Malpighiales;Reinwardtia;";"0.0";"0";"1";"1";"0";"1";"0";"430523";"5766"
"LOK1378_1mm";"SILVA (only NR);Eukaryota;Archaeplastida;Chloroplastida;Charophyta;Phragmoplastophyta;Streptophyta;Embryophyta;Tracheophyta;Spermatophyta;Magnoliophyta;Malpighiales;Rhizanthes;";"0.0";"0";"1";"1";"0";"1";"0";"430523";"5766"
"LOK1378_1mm";"SILVA (only NR);Eukaryota;Archaeplastida;Chloroplastida;Charophyta;Phragmoplastophyta;Streptophyta;Embryophyta;Tracheophyta;Spermatophyta;Magnoliophyta;Malpighiales;Ricinus;";"0.0";"0";"3";"3";"0";"3";"0";"430521";"5766"
"LOK1378_1mm";"SILVA (only NR);Eukaryota;Archaeplastida;Chloroplastida;Charophyta;Phragmoplastophyta;Streptophyta;Embryophyta;Tracheophyta;Spermatophyta;Magnoliophyta;Malpighiales;Rinorea;";"0.0";"0";"1";"1";"0";"1";"0";"430523";"5766"
"LOK1378_1mm";"SILVA (only NR);Eukaryota;Archaeplastida;Chloroplastida;Charophyta;Phragmoplastophyta;Streptophyta;Embryophyta;Tracheophyta;Spermatophyta;Magnoliophyta;Malpighiales;Rinoreocarpus;";"0.0";"0";"1";"1";"0";"1";"0";"430523";"5766"
"LOK1378_1mm";"SILVA (only NR);Eukaryota;Archaeplastida;Chloroplastida;Charophyta;Phragmoplastophyta;Streptophyta;Embryophyta;Tracheophyta;Spermatophyta;Magnoliophyta;Malpighiales;Sapria;";"0.0";"0";"2";"2";"0";"2";"0";"430522";"5766"
"LOK1378_1mm";"SILVA (only NR);Eukaryota;Archaeplastida;Chloroplastida;Charophyta;Phragmoplastophyta;Streptophyta;Embryophyta;Tracheophyta;Spermatophyta;Magnoliophyta;Malpighiales;Sauvagesia;";"0.0";"0";"1";"1";"0";"1";"0";"430523";"5766"
"LOK1378_1mm";"SILVA (only NR);Eukaryota;Archaeplastida;Chloroplastida;Charophyta;Phragmoplastophyta;Streptophyta;Embryophyta;Tracheophyta;Spermatophyta;Magnoliophyta;Malpighiales;Stapfiella;";"0.0";"0";"1";"1";"0";"1";"0";"430523";"5766"
"LOK1378_1mm";"SILVA (only NR);Eukaryota;Archaeplastida;Chloroplastida;Charophyta;Phragmoplastophyta;Streptophyta;Embryophyta;Tracheophyta;Spermatophyta;Magnoliophyta;Malpighiales;Tapura;";"0.0";"0";"1";"1";"0";"1";"0";"430523";"5766"
"LOK1378_1mm";"SILVA (only NR);Eukaryota;Archaeplastida;Chloroplastida;Charophyta;Phragmoplastophyta;Streptophyta;Embryophyta;Tracheophyta;Spermatophyta;Magnoliophyta;Malpighiales;Tetrapterys;";"0.0";"0";"1";"1";"0";"1";"0";"430523";"5766"
"LOK1378_1mm";"SILVA (only NR);Eukaryota;Archaeplastida;Chloroplastida;Charophyta;Phragmoplastophyta;Streptophyta;Embryophyta;Tracheophyta;Spermatophyta;Magnoliophyta;Malpighiales;Tetrorchidium;";"0.0";"0";"1";"1";"0";"1";"0";"430523";"5766"
"LOK1378_1mm";"SILVA (only NR);Eukaryota;Archaeplastida;Chloroplastida;Charophyta;Phragmoplastophyta;Streptophyta;Embryophyta;Tracheophyta;Spermatophyta;Magnoliophyta;Malpighiales;Trigonia;";"0.0";"0";"1";"1";"0";"1";"0";"430523";"5766"
"LOK1378_1mm";"SILVA (only NR);Eukaryota;Archaeplastida;Chloroplastida;Charophyta;Phragmoplastophyta;Streptophyta;Embryophyta;Tracheophyta;Spermatophyta;Magnoliophyta;Malpighiales;Vantanea;";"0.0";"0";"1";"1";"0";"1";"0";"430523";"5766"
"LOK1378_1mm";"SILVA (only NR);Eukaryota;Archaeplastida;Chloroplastida;Charophyta;Phragmoplastophyta;Streptophyta;Embryophyta;Tracheophyta;Spermatophyta;Magnoliophyta;Malpighiales;Viola;";"0.0";"0";"1";"1";"0";"1";"0";"430523";"5766"
"LOK1378_1mm";"SILVA (only NR);Eukaryota;Archaeplastida;Chloroplastida;Charophyta;Phragmoplastophyta;Streptophyta;Embryophyta;Tracheophyta;Spermatophyta;Magnoliophyta;Malvales;";"0.0";"0";"328";"316";"0";"316";"12";"430208";"5766"
"LOK1378_1mm";"SILVA (only NR);Eukaryota;Archaeplastida;Chloroplastida;Charophyta;Phragmoplastophyta;Streptophyta;Embryophyta;Tracheophyta;Spermatophyta;Magnoliophyta;Malvales;Anisoptera;";"0.0";"0";"1";"1";"0";"1";"0";"430523";"5766"
"LOK1378_1mm";"SILVA (only NR);Eukaryota;Archaeplastida;Chloroplastida;Charophyta;Phragmoplastophyta;Streptophyta;Embryophyta;Tracheophyta;Spermatophyta;Magnoliophyta;Malvales;Aquilaria;";"0.0";"0";"15";"13";"0";"13";"2";"430511";"5766"
"LOK1378_1mm";"SILVA (only NR);Eukaryota;Archaeplastida;Chloroplastida;Charophyta;Phragmoplastophyta;Streptophyta;Embryophyta;Tracheophyta;Spermatophyta;Magnoliophyta;Malvales;Bdallophytum;";"0.0";"0";"1";"1";"0";"1";"0";"430523";"5766"
"LOK1378_1mm";"SILVA (only NR);Eukaryota;Archaeplastida;Chloroplastida;Charophyta;Phragmoplastophyta;Streptophyta;Embryophyta;Tracheophyta;Spermatophyta;Magnoliophyta;Malvales;Bixa;";"0.0";"0";"1";"1";"0";"1";"0";"430523";"5766"
"LOK1378_1mm";"SILVA (only NR);Eukaryota;Archaeplastida;Chloroplastida;Charophyta;Phragmoplastophyta;Streptophyta;Embryophyta;Tracheophyta;Spermatophyta;Magnoliophyta;Malvales;Bombax;";"0.0";"0";"1";"1";"0";"1";"0";"430523";"5766"
"LOK1378_1mm";"SILVA (only NR);Eukaryota;Archaeplastida;Chloroplastida;Charophyta;Phragmoplastophyta;Streptophyta;Embryophyta;Tracheophyta;Spermatophyta;Magnoliophyta;Malvales;Callirhoe;";"0.0";"0";"1";"1";"0";"1";"0";"430523";"5766"
"LOK1378_1mm";"SILVA (only NR);Eukaryota;Archaeplastida;Chloroplastida;Charophyta;Phragmoplastophyta;Streptophyta;Embryophyta;Tracheophyta;Spermatophyta;Magnoliophyta;Malvales;Corchorus;";"0.0";"0";"2";"2";"0";"2";"0";"430522";"5766"
"LOK1378_1mm";"SILVA (only NR);Eukaryota;Archaeplastida;Chloroplastida;Charophyta;Phragmoplastophyta;Streptophyta;Embryophyta;Tracheophyta;Spermatophyta;Magnoliophyta;Malvales;Cytinus;";"0.0";"0";"3";"3";"0";"3";"0";"430521";"5766"
"LOK1378_1mm";"SILVA (only NR);Eukaryota;Archaeplastida;Chloroplastida;Charophyta;Phragmoplastophyta;Streptophyta;Embryophyta;Tracheophyta;Spermatophyta;Magnoliophyta;Malvales;Durio;";"0.0";"0";"1";"1";"0";"1";"0";"430523";"5766"
"LOK1378_1mm";"SILVA (only NR);Eukaryota;Archaeplastida;Chloroplastida;Charophyta;Phragmoplastophyta;Streptophyta;Embryophyta;Tracheophyta;Spermatophyta;Magnoliophyta;Malvales;Gossypium;";"0.0";"0";"284";"277";"0";"277";"7";"430247";"5766"
"LOK1378_1mm";"SILVA (only NR);Eukaryota;Archaeplastida;Chloroplastida;Charophyta;Phragmoplastophyta;Streptophyta;Embryophyta;Tracheophyta;Spermatophyta;Magnoliophyta;Malvales;Grewia;";"0.0";"0";"1";"1";"0";"1";"0";"430523";"5766"
"LOK1378_1mm";"SILVA (only NR);Eukaryota;Archaeplastida;Chloroplastida;Charophyta;Phragmoplastophyta;Streptophyta;Embryophyta;Tracheophyta;Spermatophyta;Magnoliophyta;Malvales;Helianthemum;";"0.0";"0";"1";"0";"0";"0";"1";"430524";"5766"
"LOK1378_1mm";"SILVA (only NR);Eukaryota;Archaeplastida;Chloroplastida;Charophyta;Phragmoplastophyta;Streptophyta;Embryophyta;Tracheophyta;Spermatophyta;Magnoliophyta;Malvales;Hibiscus;";"0.0";"0";"8";"6";"0";"6";"2";"430518";"5766"
"LOK1378_1mm";"SILVA (only NR);Eukaryota;Archaeplastida;Chloroplastida;Charophyta;Phragmoplastophyta;Streptophyta;Embryophyta;Tracheophyta;Spermatophyta;Magnoliophyta;Malvales;Malva;";"0.0";"0";"1";"1";"0";"1";"0";"430523";"5766"
"LOK1378_1mm";"SILVA (only NR);Eukaryota;Archaeplastida;Chloroplastida;Charophyta;Phragmoplastophyta;Streptophyta;Embryophyta;Tracheophyta;Spermatophyta;Magnoliophyta;Malvales;Muntingia;";"0.0";"0";"1";"1";"0";"1";"0";"430523";"5766"
"LOK1378_1mm";"SILVA (only NR);Eukaryota;Archaeplastida;Chloroplastida;Charophyta;Phragmoplastophyta;Streptophyta;Embryophyta;Tracheophyta;Spermatophyta;Magnoliophyta;Malvales;Neurada;";"0.0";"0";"1";"1";"0";"1";"0";"430523";"5766"
"LOK1378_1mm";"SILVA (only NR);Eukaryota;Archaeplastida;Chloroplastida;Charophyta;Phragmoplastophyta;Streptophyta;Embryophyta;Tracheophyta;Spermatophyta;Magnoliophyta;Malvales;Ochroma;";"0.0";"0";"1";"1";"0";"1";"0";"430523";"5766"
"LOK1378_1mm";"SILVA (only NR);Eukaryota;Archaeplastida;Chloroplastida;Charophyta;Phragmoplastophyta;Streptophyta;Embryophyta;Tracheophyta;Spermatophyta;Magnoliophyta;Malvales;Sphaeralcea;";"0.0";"0";"1";"1";"0";"1";"0";"430523";"5766"
"LOK1378_1mm";"SILVA (only NR);Eukaryota;Archaeplastida;Chloroplastida;Charophyta;Phragmoplastophyta;Streptophyta;Embryophyta;Tracheophyta;Spermatophyta;Magnoliophyta;Malvales;Sterculia;";"0.0";"0";"1";"1";"0";"1";"0";"430523";"5766"
"LOK1378_1mm";"SILVA (only NR);Eukaryota;Archaeplastida;Chloroplastida;Charophyta;Phragmoplastophyta;Streptophyta;Embryophyta;Tracheophyta;Spermatophyta;Magnoliophyta;Malvales;Theobroma;";"0.0";"0";"1";"1";"0";"1";"0";"430523";"5766"
"LOK1378_1mm";"SILVA (only NR);Eukaryota;Archaeplastida;Chloroplastida;Charophyta;Phragmoplastophyta;Streptophyta;Embryophyta;Tracheophyta;Spermatophyta;Magnoliophyta;Malvales;Thymelaea;";"0.0";"0";"1";"1";"0";"1";"0";"430523";"5766"
"LOK1378_1mm";"SILVA (only NR);Eukaryota;Archaeplastida;Chloroplastida;Charophyta;Phragmoplastophyta;Streptophyta;Embryophyta;Tracheophyta;Spermatophyta;Magnoliophyta;Myrtales;";"0.0";"0";"53";"35";"0";"35";"18";"430489";"5766"
"LOK1378_1mm";"SILVA (only NR);Eukaryota;Archaeplastida;Chloroplastida;Charophyta;Phragmoplastophyta;Streptophyta;Embryophyta;Tracheophyta;Spermatophyta;Magnoliophyta;Myrtales;Brachysiphon;";"0.0";"0";"1";"1";"0";"1";"0";"430523";"5766"
"LOK1378_1mm";"SILVA (only NR);Eukaryota;Archaeplastida;Chloroplastida;Charophyta;Phragmoplastophyta;Streptophyta;Embryophyta;Tracheophyta;Spermatophyta;Magnoliophyta;Myrtales;Combretum;";"0.0";"0";"1";"1";"0";"1";"0";"430523";"5766"
"LOK1378_1mm";"SILVA (only NR);Eukaryota;Archaeplastida;Chloroplastida;Charophyta;Phragmoplastophyta;Streptophyta;Embryophyta;Tracheophyta;Spermatophyta;Magnoliophyta;Myrtales;Crypteronia;";"0.0";"0";"1";"1";"0";"1";"0";"430523";"5766"
"LOK1378_1mm";"SILVA (only NR);Eukaryota;Archaeplastida;Chloroplastida;Charophyta;Phragmoplastophyta;Streptophyta;Embryophyta;Tracheophyta;Spermatophyta;Magnoliophyta;Myrtales;Cuphea;";"0.0";"0";"1";"1";"0";"1";"0";"430523";"5766"
"LOK1378_1mm";"SILVA (only NR);Eukaryota;Archaeplastida;Chloroplastida;Charophyta;Phragmoplastophyta;Streptophyta;Embryophyta;Tracheophyta;Spermatophyta;Magnoliophyta;Myrtales;Endonema;";"0.0";"0";"1";"1";"0";"1";"0";"430523";"5766"
"LOK1378_1mm";"SILVA (only NR);Eukaryota;Archaeplastida;Chloroplastida;Charophyta;Phragmoplastophyta;Streptophyta;Embryophyta;Tracheophyta;Spermatophyta;Magnoliophyta;Myrtales;Eucalyptus;";"0.0";"0";"8";"6";"0";"6";"2";"430518";"5766"
"LOK1378_1mm";"SILVA (only NR);Eukaryota;Archaeplastida;Chloroplastida;Charophyta;Phragmoplastophyta;Streptophyta;Embryophyta;Tracheophyta;Spermatophyta;Magnoliophyta;Myrtales;Laguncularia;";"0.0";"0";"1";"1";"0";"1";"0";"430523";"5766"
"LOK1378_1mm";"SILVA (only NR);Eukaryota;Archaeplastida;Chloroplastida;Charophyta;Phragmoplastophyta;Streptophyta;Embryophyta;Tracheophyta;Spermatophyta;Magnoliophyta;Myrtales;Lythrum;";"0.0";"0";"1";"1";"0";"1";"0";"430523";"5766"
"LOK1378_1mm";"SILVA (only NR);Eukaryota;Archaeplastida;Chloroplastida;Charophyta;Phragmoplastophyta;Streptophyta;Embryophyta;Tracheophyta;Spermatophyta;Magnoliophyta;Myrtales;Mouriri;";"0.0";"0";"1";"1";"0";"1";"0";"430523";"5766"
"LOK1378_1mm";"SILVA (only NR);Eukaryota;Archaeplastida;Chloroplastida;Charophyta;Phragmoplastophyta;Streptophyta;Embryophyta;Tracheophyta;Spermatophyta;Magnoliophyta;Myrtales;Oenothera;";"0.0";"0";"3";"3";"0";"3";"0";"430521";"5766"
"LOK1378_1mm";"SILVA (only NR);Eukaryota;Archaeplastida;Chloroplastida;Charophyta;Phragmoplastophyta;Streptophyta;Embryophyta;Tracheophyta;Spermatophyta;Magnoliophyta;Myrtales;Osbeckia;";"0.0";"0";"1";"1";"0";"1";"0";"430523";"5766"
"LOK1378_1mm";"SILVA (only NR);Eukaryota;Archaeplastida;Chloroplastida;Charophyta;Phragmoplastophyta;Streptophyta;Embryophyta;Tracheophyta;Spermatophyta;Magnoliophyta;Myrtales;Pemphis;";"0.0";"0";"1";"1";"0";"1";"0";"430523";"5766"
"LOK1378_1mm";"SILVA (only NR);Eukaryota;Archaeplastida;Chloroplastida;Charophyta;Phragmoplastophyta;Streptophyta;Embryophyta;Tracheophyta;Spermatophyta;Magnoliophyta;Myrtales;Punica;";"0.0";"0";"29";"13";"0";"13";"16";"430511";"5766"
"LOK1378_1mm";"SILVA (only NR);Eukaryota;Archaeplastida;Chloroplastida;Charophyta;Phragmoplastophyta;Streptophyta;Embryophyta;Tracheophyta;Spermatophyta;Magnoliophyta;Myrtales;Qualea;";"0.0";"0";"1";"1";"0";"1";"0";"430523";"5766"
"LOK1378_1mm";"SILVA (only NR);Eukaryota;Archaeplastida;Chloroplastida;Charophyta;Phragmoplastophyta;Streptophyta;Embryophyta;Tracheophyta;Spermatophyta;Magnoliophyta;Myrtales;Sonneratia;";"0.0";"0";"1";"1";"0";"1";"0";"430523";"5766"
"LOK1378_1mm";"SILVA (only NR);Eukaryota;Archaeplastida;Chloroplastida;Charophyta;Phragmoplastophyta;Streptophyta;Embryophyta;Tracheophyta;Spermatophyta;Magnoliophyta;Myrtales;Trapa;";"0.0";"0";"1";"1";"0";"1";"0";"430523";"5766"
"LOK1378_1mm";"SILVA (only NR);Eukaryota;Archaeplastida;Chloroplastida;Charophyta;Phragmoplastophyta;Streptophyta;Embryophyta;Tracheophyta;Spermatophyta;Magnoliophyta;Nymphaeales;";"0.0";"0";"4";"4";"0";"4";"0";"430520";"5766"
"LOK1378_1mm";"SILVA (only NR);Eukaryota;Archaeplastida;Chloroplastida;Charophyta;Phragmoplastophyta;Streptophyta;Embryophyta;Tracheophyta;Spermatophyta;Magnoliophyta;Nymphaeales;Brasenia;";"0.0";"0";"1";"1";"0";"1";"0";"430523";"5766"
"LOK1378_1mm";"SILVA (only NR);Eukaryota;Archaeplastida;Chloroplastida;Charophyta;Phragmoplastophyta;Streptophyta;Embryophyta;Tracheophyta;Spermatophyta;Magnoliophyta;Nymphaeales;Cabomba;";"0.0";"0";"1";"1";"0";"1";"0";"430523";"5766"
"LOK1378_1mm";"SILVA (only NR);Eukaryota;Archaeplastida;Chloroplastida;Charophyta;Phragmoplastophyta;Streptophyta;Embryophyta;Tracheophyta;Spermatophyta;Magnoliophyta;Nymphaeales;Nuphar;";"0.0";"0";"1";"1";"0";"1";"0";"430523";"5766"
"LOK1378_1mm";"SILVA (only NR);Eukaryota;Archaeplastida;Chloroplastida;Charophyta;Phragmoplastophyta;Streptophyta;Embryophyta;Tracheophyta;Spermatophyta;Magnoliophyta;Nymphaeales;Nymphaea;";"0.0";"0";"1";"1";"0";"1";"0";"430523";"5766"
"LOK1378_1mm";"SILVA (only NR);Eukaryota;Archaeplastida;Chloroplastida;Charophyta;Phragmoplastophyta;Streptophyta;Embryophyta;Tracheophyta;Spermatophyta;Magnoliophyta;Oxalidales;";"0.0";"0";"11";"11";"0";"11";"0";"430513";"5766"
"LOK1378_1mm";"SILVA (only NR);Eukaryota;Archaeplastida;Chloroplastida;Charophyta;Phragmoplastophyta;Streptophyta;Embryophyta;Tracheophyta;Spermatophyta;Magnoliophyta;Oxalidales;Averrhoa;";"0.0";"0";"1";"1";"0";"1";"0";"430523";"5766"
"LOK1378_1mm";"SILVA (only NR);Eukaryota;Archaeplastida;Chloroplastida;Charophyta;Phragmoplastophyta;Streptophyta;Embryophyta;Tracheophyta;Spermatophyta;Magnoliophyta;Oxalidales;Cephalotus;";"0.0";"0";"2";"2";"0";"2";"0";"430522";"5766"
"LOK1378_1mm";"SILVA (only NR);Eukaryota;Archaeplastida;Chloroplastida;Charophyta;Phragmoplastophyta;Streptophyta;Embryophyta;Tracheophyta;Spermatophyta;Magnoliophyta;Oxalidales;Connarus;";"0.0";"0";"1";"1";"0";"1";"0";"430523";"5766"
"LOK1378_1mm";"SILVA (only NR);Eukaryota;Archaeplastida;Chloroplastida;Charophyta;Phragmoplastophyta;Streptophyta;Embryophyta;Tracheophyta;Spermatophyta;Magnoliophyta;Oxalidales;Davidsonia;";"0.0";"0";"1";"1";"0";"1";"0";"430523";"5766"
"LOK1378_1mm";"SILVA (only NR);Eukaryota;Archaeplastida;Chloroplastida;Charophyta;Phragmoplastophyta;Streptophyta;Embryophyta;Tracheophyta;Spermatophyta;Magnoliophyta;Oxalidales;Hua;";"0.0";"0";"1";"1";"0";"1";"0";"430523";"5766"
"LOK1378_1mm";"SILVA (only NR);Eukaryota;Archaeplastida;Chloroplastida;Charophyta;Phragmoplastophyta;Streptophyta;Embryophyta;Tracheophyta;Spermatophyta;Magnoliophyta;Oxalidales;Oxalis;";"0.0";"0";"3";"3";"0";"3";"0";"430521";"5766"
"LOK1378_1mm";"SILVA (only NR);Eukaryota;Archaeplastida;Chloroplastida;Charophyta;Phragmoplastophyta;Streptophyta;Embryophyta;Tracheophyta;Spermatophyta;Magnoliophyta;Oxalidales;Platytheca;";"0.0";"0";"1";"1";"0";"1";"0";"430523";"5766"
"LOK1378_1mm";"SILVA (only NR);Eukaryota;Archaeplastida;Chloroplastida;Charophyta;Phragmoplastophyta;Streptophyta;Embryophyta;Tracheophyta;Spermatophyta;Magnoliophyta;Oxalidales;Rourea;";"0.0";"0";"1";"1";"0";"1";"0";"430523";"5766"
"LOK1378_1mm";"SILVA (only NR);Eukaryota;Archaeplastida;Chloroplastida;Charophyta;Phragmoplastophyta;Streptophyta;Embryophyta;Tracheophyta;Spermatophyta;Magnoliophyta;Paracryphiales;";"0.0";"0";"1";"1";"0";"1";"0";"430523";"5766"
"LOK1378_1mm";"SILVA (only NR);Eukaryota;Archaeplastida;Chloroplastida;Charophyta;Phragmoplastophyta;Streptophyta;Embryophyta;Tracheophyta;Spermatophyta;Magnoliophyta;Paracryphiales;Paracryphia;";"0.0";"0";"1";"1";"0";"1";"0";"430523";"5766"
"LOK1378_1mm";"SILVA (only NR);Eukaryota;Archaeplastida;Chloroplastida;Charophyta;Phragmoplastophyta;Streptophyta;Embryophyta;Tracheophyta;Spermatophyta;Magnoliophyta;Piperales;";"0.0";"0";"17";"17";"0";"17";"0";"430507";"5766"
"LOK1378_1mm";"SILVA (only NR);Eukaryota;Archaeplastida;Chloroplastida;Charophyta;Phragmoplastophyta;Streptophyta;Embryophyta;Tracheophyta;Spermatophyta;Magnoliophyta;Piperales;Anemopsis;";"0.0";"0";"1";"1";"0";"1";"0";"430523";"5766"
"LOK1378_1mm";"SILVA (only NR);Eukaryota;Archaeplastida;Chloroplastida;Charophyta;Phragmoplastophyta;Streptophyta;Embryophyta;Tracheophyta;Spermatophyta;Magnoliophyta;Piperales;Aristolochia;";"0.0";"0";"2";"2";"0";"2";"0";"430522";"5766"
"LOK1378_1mm";"SILVA (only NR);Eukaryota;Archaeplastida;Chloroplastida;Charophyta;Phragmoplastophyta;Streptophyta;Embryophyta;Tracheophyta;Spermatophyta;Magnoliophyta;Piperales;Houttuynia;";"0.0";"0";"1";"1";"0";"1";"0";"430523";"5766"
"LOK1378_1mm";"SILVA (only NR);Eukaryota;Archaeplastida;Chloroplastida;Charophyta;Phragmoplastophyta;Streptophyta;Embryophyta;Tracheophyta;Spermatophyta;Magnoliophyta;Piperales;Hydnora;";"0.0";"0";"1";"1";"0";"1";"0";"430523";"5766"
"LOK1378_1mm";"SILVA (only NR);Eukaryota;Archaeplastida;Chloroplastida;Charophyta;Phragmoplastophyta;Streptophyta;Embryophyta;Tracheophyta;Spermatophyta;Magnoliophyta;Piperales;Lactoris;";"0.0";"0";"1";"1";"0";"1";"0";"430523";"5766"
"LOK1378_1mm";"SILVA (only NR);Eukaryota;Archaeplastida;Chloroplastida;Charophyta;Phragmoplastophyta;Streptophyta;Embryophyta;Tracheophyta;Spermatophyta;Magnoliophyta;Piperales;Manekia;";"0.0";"0";"1";"1";"0";"1";"0";"430523";"5766"
"LOK1378_1mm";"SILVA (only NR);Eukaryota;Archaeplastida;Chloroplastida;Charophyta;Phragmoplastophyta;Streptophyta;Embryophyta;Tracheophyta;Spermatophyta;Magnoliophyta;Piperales;Peperomia;";"0.0";"0";"4";"4";"0";"4";"0";"430520";"5766"
"LOK1378_1mm";"SILVA (only NR);Eukaryota;Archaeplastida;Chloroplastida;Charophyta;Phragmoplastophyta;Streptophyta;Embryophyta;Tracheophyta;Spermatophyta;Magnoliophyta;Piperales;Piper;";"0.0";"0";"2";"2";"0";"2";"0";"430522";"5766"
"LOK1378_1mm";"SILVA (only NR);Eukaryota;Archaeplastida;Chloroplastida;Charophyta;Phragmoplastophyta;Streptophyta;Embryophyta;Tracheophyta;Spermatophyta;Magnoliophyta;Piperales;Prosopanche;";"0.0";"0";"1";"1";"0";"1";"0";"430523";"5766"
"LOK1378_1mm";"SILVA (only NR);Eukaryota;Archaeplastida;Chloroplastida;Charophyta;Phragmoplastophyta;Streptophyta;Embryophyta;Tracheophyta;Spermatophyta;Magnoliophyta;Piperales;Saruma;";"0.0";"0";"1";"1";"0";"1";"0";"430523";"5766"
"LOK1378_1mm";"SILVA (only NR);Eukaryota;Archaeplastida;Chloroplastida;Charophyta;Phragmoplastophyta;Streptophyta;Embryophyta;Tracheophyta;Spermatophyta;Magnoliophyta;Piperales;Saururus;";"0.0";"0";"1";"1";"0";"1";"0";"430523";"5766"
"LOK1378_1mm";"SILVA (only NR);Eukaryota;Archaeplastida;Chloroplastida;Charophyta;Phragmoplastophyta;Streptophyta;Embryophyta;Tracheophyta;Spermatophyta;Magnoliophyta;Piperales;Verhuellia;";"0.0";"0";"1";"1";"0";"1";"0";"430523";"5766"
"LOK1378_1mm";"SILVA (only NR);Eukaryota;Archaeplastida;Chloroplastida;Charophyta;Phragmoplastophyta;Streptophyta;Embryophyta;Tracheophyta;Spermatophyta;Magnoliophyta;Proteales;";"0.0";"0";"18";"18";"0";"18";"0";"430506";"5766"
"LOK1378_1mm";"SILVA (only NR);Eukaryota;Archaeplastida;Chloroplastida;Charophyta;Phragmoplastophyta;Streptophyta;Embryophyta;Tracheophyta;Spermatophyta;Magnoliophyta;Proteales;Grevillea;";"0.0";"0";"1";"1";"0";"1";"0";"430523";"5766"
"LOK1378_1mm";"SILVA (only NR);Eukaryota;Archaeplastida;Chloroplastida;Charophyta;Phragmoplastophyta;Streptophyta;Embryophyta;Tracheophyta;Spermatophyta;Magnoliophyta;Proteales;Knightia;";"0.0";"0";"1";"1";"0";"1";"0";"430523";"5766"
"LOK1378_1mm";"SILVA (only NR);Eukaryota;Archaeplastida;Chloroplastida;Charophyta;Phragmoplastophyta;Streptophyta;Embryophyta;Tracheophyta;Spermatophyta;Magnoliophyta;Proteales;Macadamia;";"0.0";"0";"1";"1";"0";"1";"0";"430523";"5766"
"LOK1378_1mm";"SILVA (only NR);Eukaryota;Archaeplastida;Chloroplastida;Charophyta;Phragmoplastophyta;Streptophyta;Embryophyta;Tracheophyta;Spermatophyta;Magnoliophyta;Proteales;Meliosma;";"0.0";"0";"1";"1";"0";"1";"0";"430523";"5766"
"LOK1378_1mm";"SILVA (only NR);Eukaryota;Archaeplastida;Chloroplastida;Charophyta;Phragmoplastophyta;Streptophyta;Embryophyta;Tracheophyta;Spermatophyta;Magnoliophyta;Proteales;Nelumbo;";"0.0";"0";"11";"11";"0";"11";"0";"430513";"5766"
"LOK1378_1mm";"SILVA (only NR);Eukaryota;Archaeplastida;Chloroplastida;Charophyta;Phragmoplastophyta;Streptophyta;Embryophyta;Tracheophyta;Spermatophyta;Magnoliophyta;Proteales;Persoonia;";"0.0";"0";"1";"1";"0";"1";"0";"430523";"5766"
"LOK1378_1mm";"SILVA (only NR);Eukaryota;Archaeplastida;Chloroplastida;Charophyta;Phragmoplastophyta;Streptophyta;Embryophyta;Tracheophyta;Spermatophyta;Magnoliophyta;Proteales;Platanus;";"0.0";"0";"1";"1";"0";"1";"0";"430523";"5766"
"LOK1378_1mm";"SILVA (only NR);Eukaryota;Archaeplastida;Chloroplastida;Charophyta;Phragmoplastophyta;Streptophyta;Embryophyta;Tracheophyta;Spermatophyta;Magnoliophyta;Proteales;Roupala;";"0.0";"0";"1";"1";"0";"1";"0";"430523";"5766"
"LOK1378_1mm";"SILVA (only NR);Eukaryota;Archaeplastida;Chloroplastida;Charophyta;Phragmoplastophyta;Streptophyta;Embryophyta;Tracheophyta;Spermatophyta;Magnoliophyta;Ranunculales;";"0.0";"0";"23";"22";"0";"22";"1";"430502";"5766"
"LOK1378_1mm";"SILVA (only NR);Eukaryota;Archaeplastida;Chloroplastida;Charophyta;Phragmoplastophyta;Streptophyta;Embryophyta;Tracheophyta;Spermatophyta;Magnoliophyta;Ranunculales;Aconitum;";"0.0";"0";"1";"1";"0";"1";"0";"430523";"5766"
"LOK1378_1mm";"SILVA (only NR);Eukaryota;Archaeplastida;Chloroplastida;Charophyta;Phragmoplastophyta;Streptophyta;Embryophyta;Tracheophyta;Spermatophyta;Magnoliophyta;Ranunculales;Actaea;";"0.0";"0";"1";"1";"0";"1";"0";"430523";"5766"
"LOK1378_1mm";"SILVA (only NR);Eukaryota;Archaeplastida;Chloroplastida;Charophyta;Phragmoplastophyta;Streptophyta;Embryophyta;Tracheophyta;Spermatophyta;Magnoliophyta;Ranunculales;Akebia;";"0.0";"0";"1";"1";"0";"1";"0";"430523";"5766"
"LOK1378_1mm";"SILVA (only NR);Eukaryota;Archaeplastida;Chloroplastida;Charophyta;Phragmoplastophyta;Streptophyta;Embryophyta;Tracheophyta;Spermatophyta;Magnoliophyta;Ranunculales;Anemone;";"0.0";"0";"1";"1";"0";"1";"0";"430523";"5766"
"LOK1378_1mm";"SILVA (only NR);Eukaryota;Archaeplastida;Chloroplastida;Charophyta;Phragmoplastophyta;Streptophyta;Embryophyta;Tracheophyta;Spermatophyta;Magnoliophyta;Ranunculales;Aquilegia;";"0.0";"0";"1";"1";"0";"1";"0";"430523";"5766"
"LOK1378_1mm";"SILVA (only NR);Eukaryota;Archaeplastida;Chloroplastida;Charophyta;Phragmoplastophyta;Streptophyta;Embryophyta;Tracheophyta;Spermatophyta;Magnoliophyta;Ranunculales;Arcangelisia;";"0.0";"0";"1";"1";"0";"1";"0";"430523";"5766"
"LOK1378_1mm";"SILVA (only NR);Eukaryota;Archaeplastida;Chloroplastida;Charophyta;Phragmoplastophyta;Streptophyta;Embryophyta;Tracheophyta;Spermatophyta;Magnoliophyta;Ranunculales;Argemone;";"0.0";"0";"1";"1";"0";"1";"0";"430523";"5766"
"LOK1378_1mm";"SILVA (only NR);Eukaryota;Archaeplastida;Chloroplastida;Charophyta;Phragmoplastophyta;Streptophyta;Embryophyta;Tracheophyta;Spermatophyta;Magnoliophyta;Ranunculales;Berberis;";"0.0";"0";"1";"1";"0";"1";"0";"430523";"5766"
"LOK1378_1mm";"SILVA (only NR);Eukaryota;Archaeplastida;Chloroplastida;Charophyta;Phragmoplastophyta;Streptophyta;Embryophyta;Tracheophyta;Spermatophyta;Magnoliophyta;Ranunculales;Cissampelos;";"0.0";"0";"1";"1";"0";"1";"0";"430523";"5766"
"LOK1378_1mm";"SILVA (only NR);Eukaryota;Archaeplastida;Chloroplastida;Charophyta;Phragmoplastophyta;Streptophyta;Embryophyta;Tracheophyta;Spermatophyta;Magnoliophyta;Ranunculales;Clematis;";"0.0";"0";"1";"1";"0";"1";"0";"430523";"5766"
"LOK1378_1mm";"SILVA (only NR);Eukaryota;Archaeplastida;Chloroplastida;Charophyta;Phragmoplastophyta;Streptophyta;Embryophyta;Tracheophyta;Spermatophyta;Magnoliophyta;Ranunculales;Coptis;";"0.0";"0";"1";"1";"0";"1";"0";"430523";"5766"
"LOK1378_1mm";"SILVA (only NR);Eukaryota;Archaeplastida;Chloroplastida;Charophyta;Phragmoplastophyta;Streptophyta;Embryophyta;Tracheophyta;Spermatophyta;Magnoliophyta;Ranunculales;Corydalis;";"0.0";"0";"2";"2";"0";"2";"0";"430522";"5766"
"LOK1378_1mm";"SILVA (only NR);Eukaryota;Archaeplastida;Chloroplastida;Charophyta;Phragmoplastophyta;Streptophyta;Embryophyta;Tracheophyta;Spermatophyta;Magnoliophyta;Ranunculales;Fibraurea;";"0.0";"0";"1";"1";"0";"1";"0";"430523";"5766"
"LOK1378_1mm";"SILVA (only NR);Eukaryota;Archaeplastida;Chloroplastida;Charophyta;Phragmoplastophyta;Streptophyta;Embryophyta;Tracheophyta;Spermatophyta;Magnoliophyta;Ranunculales;Papaver;";"0.0";"0";"1";"0";"0";"0";"1";"430524";"5766"
"LOK1378_1mm";"SILVA (only NR);Eukaryota;Archaeplastida;Chloroplastida;Charophyta;Phragmoplastophyta;Streptophyta;Embryophyta;Tracheophyta;Spermatophyta;Magnoliophyta;Ranunculales;Podophyllum;";"0.0";"0";"1";"1";"0";"1";"0";"430523";"5766"
"LOK1378_1mm";"SILVA (only NR);Eukaryota;Archaeplastida;Chloroplastida;Charophyta;Phragmoplastophyta;Streptophyta;Embryophyta;Tracheophyta;Spermatophyta;Magnoliophyta;Ranunculales;Ranunculus;";"0.0";"0";"2";"2";"0";"2";"0";"430522";"5766"
"LOK1378_1mm";"SILVA (only NR);Eukaryota;Archaeplastida;Chloroplastida;Charophyta;Phragmoplastophyta;Streptophyta;Embryophyta;Tracheophyta;Spermatophyta;Magnoliophyta;Ranunculales;Sanguinaria;";"0.0";"0";"1";"1";"0";"1";"0";"430523";"5766"
"LOK1378_1mm";"SILVA (only NR);Eukaryota;Archaeplastida;Chloroplastida;Charophyta;Phragmoplastophyta;Streptophyta;Embryophyta;Tracheophyta;Spermatophyta;Magnoliophyta;Ranunculales;Stephania;";"0.0";"0";"4";"4";"0";"4";"0";"430520";"5766"
"LOK1378_1mm";"SILVA (only NR);Eukaryota;Archaeplastida;Chloroplastida;Charophyta;Phragmoplastophyta;Streptophyta;Embryophyta;Tracheophyta;Spermatophyta;Magnoliophyta;Rosales;";"0.0";"0";"95";"94";"0";"94";"1";"430430";"5766"
"LOK1378_1mm";"SILVA (only NR);Eukaryota;Archaeplastida;Chloroplastida;Charophyta;Phragmoplastophyta;Streptophyta;Embryophyta;Tracheophyta;Spermatophyta;Magnoliophyta;Rosales;Adenostoma;";"0.0";"0";"1";"1";"0";"1";"0";"430523";"5766"
"LOK1378_1mm";"SILVA (only NR);Eukaryota;Archaeplastida;Chloroplastida;Charophyta;Phragmoplastophyta;Streptophyta;Embryophyta;Tracheophyta;Spermatophyta;Magnoliophyta;Rosales;Barbeya;";"0.0";"0";"1";"1";"0";"1";"0";"430523";"5766"
"LOK1378_1mm";"SILVA (only NR);Eukaryota;Archaeplastida;Chloroplastida;Charophyta;Phragmoplastophyta;Streptophyta;Embryophyta;Tracheophyta;Spermatophyta;Magnoliophyta;Rosales;Boehmeria;";"0.0";"0";"2";"2";"0";"2";"0";"430522";"5766"
"LOK1378_1mm";"SILVA (only NR);Eukaryota;Archaeplastida;Chloroplastida;Charophyta;Phragmoplastophyta;Streptophyta;Embryophyta;Tracheophyta;Spermatophyta;Magnoliophyta;Rosales;Broussonetia;";"0.0";"0";"1";"1";"0";"1";"0";"430523";"5766"
"LOK1378_1mm";"SILVA (only NR);Eukaryota;Archaeplastida;Chloroplastida;Charophyta;Phragmoplastophyta;Streptophyta;Embryophyta;Tracheophyta;Spermatophyta;Magnoliophyta;Rosales;Cannabis;";"0.0";"0";"11";"11";"0";"11";"0";"430513";"5766"
"LOK1378_1mm";"SILVA (only NR);Eukaryota;Archaeplastida;Chloroplastida;Charophyta;Phragmoplastophyta;Streptophyta;Embryophyta;Tracheophyta;Spermatophyta;Magnoliophyta;Rosales;Ceanothus;";"0.0";"0";"1";"1";"0";"1";"0";"430523";"5766"
"LOK1378_1mm";"SILVA (only NR);Eukaryota;Archaeplastida;Chloroplastida;Charophyta;Phragmoplastophyta;Streptophyta;Embryophyta;Tracheophyta;Spermatophyta;Magnoliophyta;Rosales;Cecropia;";"0.0";"0";"1";"1";"0";"1";"0";"430523";"5766"
"LOK1378_1mm";"SILVA (only NR);Eukaryota;Archaeplastida;Chloroplastida;Charophyta;Phragmoplastophyta;Streptophyta;Embryophyta;Tracheophyta;Spermatophyta;Magnoliophyta;Rosales;Didymodoxa;";"0.0";"0";"1";"1";"0";"1";"0";"430523";"5766"
"LOK1378_1mm";"SILVA (only NR);Eukaryota;Archaeplastida;Chloroplastida;Charophyta;Phragmoplastophyta;Streptophyta;Embryophyta;Tracheophyta;Spermatophyta;Magnoliophyta;Rosales;Dirachma;";"0.0";"0";"1";"1";"0";"1";"0";"430523";"5766"
"LOK1378_1mm";"SILVA (only NR);Eukaryota;Archaeplastida;Chloroplastida;Charophyta;Phragmoplastophyta;Streptophyta;Embryophyta;Tracheophyta;Spermatophyta;Magnoliophyta;Rosales;Elaeagnus;";"0.0";"0";"1";"1";"0";"1";"0";"430523";"5766"
"LOK1378_1mm";"SILVA (only NR);Eukaryota;Archaeplastida;Chloroplastida;Charophyta;Phragmoplastophyta;Streptophyta;Embryophyta;Tracheophyta;Spermatophyta;Magnoliophyta;Rosales;Exochorda;";"0.0";"0";"1";"1";"0";"1";"0";"430523";"5766"
"LOK1378_1mm";"SILVA (only NR);Eukaryota;Archaeplastida;Chloroplastida;Charophyta;Phragmoplastophyta;Streptophyta;Embryophyta;Tracheophyta;Spermatophyta;Magnoliophyta;Rosales;Ficus;";"0.0";"0";"1";"1";"0";"1";"0";"430523";"5766"
"LOK1378_1mm";"SILVA (only NR);Eukaryota;Archaeplastida;Chloroplastida;Charophyta;Phragmoplastophyta;Streptophyta;Embryophyta;Tracheophyta;Spermatophyta;Magnoliophyta;Rosales;Filipendula;";"0.0";"0";"1";"1";"0";"1";"0";"430523";"5766"
"LOK1378_1mm";"SILVA (only NR);Eukaryota;Archaeplastida;Chloroplastida;Charophyta;Phragmoplastophyta;Streptophyta;Embryophyta;Tracheophyta;Spermatophyta;Magnoliophyta;Rosales;Forsskaolea;";"0.0";"0";"1";"1";"0";"1";"0";"430523";"5766"
"LOK1378_1mm";"SILVA (only NR);Eukaryota;Archaeplastida;Chloroplastida;Charophyta;Phragmoplastophyta;Streptophyta;Embryophyta;Tracheophyta;Spermatophyta;Magnoliophyta;Rosales;Fragaria;";"0.0";"0";"5";"5";"0";"5";"0";"430519";"5766"
"LOK1378_1mm";"SILVA (only NR);Eukaryota;Archaeplastida;Chloroplastida;Charophyta;Phragmoplastophyta;Streptophyta;Embryophyta;Tracheophyta;Spermatophyta;Magnoliophyta;Rosales;Gonostegia;";"0.0";"0";"1";"1";"0";"1";"0";"430523";"5766"
"LOK1378_1mm";"SILVA (only NR);Eukaryota;Archaeplastida;Chloroplastida;Charophyta;Phragmoplastophyta;Streptophyta;Embryophyta;Tracheophyta;Spermatophyta;Magnoliophyta;Rosales;Gouania;";"0.0";"0";"1";"1";"0";"1";"0";"430523";"5766"
"LOK1378_1mm";"SILVA (only NR);Eukaryota;Archaeplastida;Chloroplastida;Charophyta;Phragmoplastophyta;Streptophyta;Embryophyta;Tracheophyta;Spermatophyta;Magnoliophyta;Rosales;Holoptelea;";"0.0";"0";"1";"1";"0";"1";"0";"430523";"5766"
"LOK1378_1mm";"SILVA (only NR);Eukaryota;Archaeplastida;Chloroplastida;Charophyta;Phragmoplastophyta;Streptophyta;Embryophyta;Tracheophyta;Spermatophyta;Magnoliophyta;Rosales;Humulus;";"0.0";"0";"7";"7";"0";"7";"0";"430517";"5766"
"LOK1378_1mm";"SILVA (only NR);Eukaryota;Archaeplastida;Chloroplastida;Charophyta;Phragmoplastophyta;Streptophyta;Embryophyta;Tracheophyta;Spermatophyta;Magnoliophyta;Rosales;Kerria;";"0.0";"0";"1";"1";"0";"1";"0";"430523";"5766"
"LOK1378_1mm";"SILVA (only NR);Eukaryota;Archaeplastida;Chloroplastida;Charophyta;Phragmoplastophyta;Streptophyta;Embryophyta;Tracheophyta;Spermatophyta;Magnoliophyta;Rosales;Malus;";"0.0";"0";"3";"2";"0";"2";"1";"430522";"5766"
"LOK1378_1mm";"SILVA (only NR);Eukaryota;Archaeplastida;Chloroplastida;Charophyta;Phragmoplastophyta;Streptophyta;Embryophyta;Tracheophyta;Spermatophyta;Magnoliophyta;Rosales;Morus;";"0.0";"0";"2";"2";"0";"2";"0";"430522";"5766"
"LOK1378_1mm";"SILVA (only NR);Eukaryota;Archaeplastida;Chloroplastida;Charophyta;Phragmoplastophyta;Streptophyta;Embryophyta;Tracheophyta;Spermatophyta;Magnoliophyta;Rosales;Myriocarpa;";"0.0";"0";"1";"1";"0";"1";"0";"430523";"5766"
"LOK1378_1mm";"SILVA (only NR);Eukaryota;Archaeplastida;Chloroplastida;Charophyta;Phragmoplastophyta;Streptophyta;Embryophyta;Tracheophyta;Spermatophyta;Magnoliophyta;Rosales;Nanocnide;";"0.0";"0";"1";"1";"0";"1";"0";"430523";"5766"
"LOK1378_1mm";"SILVA (only NR);Eukaryota;Archaeplastida;Chloroplastida;Charophyta;Phragmoplastophyta;Streptophyta;Embryophyta;Tracheophyta;Spermatophyta;Magnoliophyta;Rosales;Neodistemon;";"0.0";"0";"1";"1";"0";"1";"0";"430523";"5766"
"LOK1378_1mm";"SILVA (only NR);Eukaryota;Archaeplastida;Chloroplastida;Charophyta;Phragmoplastophyta;Streptophyta;Embryophyta;Tracheophyta;Spermatophyta;Magnoliophyta;Rosales;Neraudia;";"0.0";"0";"1";"1";"0";"1";"0";"430523";"5766"
"LOK1378_1mm";"SILVA (only NR);Eukaryota;Archaeplastida;Chloroplastida;Charophyta;Phragmoplastophyta;Streptophyta;Embryophyta;Tracheophyta;Spermatophyta;Magnoliophyta;Rosales;Obetia;";"0.0";"0";"1";"1";"0";"1";"0";"430523";"5766"
"LOK1378_1mm";"SILVA (only NR);Eukaryota;Archaeplastida;Chloroplastida;Charophyta;Phragmoplastophyta;Streptophyta;Embryophyta;Tracheophyta;Spermatophyta;Magnoliophyta;Rosales;Oreocnide;";"0.0";"0";"1";"1";"0";"1";"0";"430523";"5766"
"LOK1378_1mm";"SILVA (only NR);Eukaryota;Archaeplastida;Chloroplastida;Charophyta;Phragmoplastophyta;Streptophyta;Embryophyta;Tracheophyta;Spermatophyta;Magnoliophyta;Rosales;Parietaria;";"0.0";"0";"2";"2";"0";"2";"0";"430522";"5766"
"LOK1378_1mm";"SILVA (only NR);Eukaryota;Archaeplastida;Chloroplastida;Charophyta;Phragmoplastophyta;Streptophyta;Embryophyta;Tracheophyta;Spermatophyta;Magnoliophyta;Rosales;Pellionia;";"0.0";"0";"2";"2";"0";"2";"0";"430522";"5766"
"LOK1378_1mm";"SILVA (only NR);Eukaryota;Archaeplastida;Chloroplastida;Charophyta;Phragmoplastophyta;Streptophyta;Embryophyta;Tracheophyta;Spermatophyta;Magnoliophyta;Rosales;Phyllostylon;";"0.0";"0";"1";"1";"0";"1";"0";"430523";"5766"
"LOK1378_1mm";"SILVA (only NR);Eukaryota;Archaeplastida;Chloroplastida;Charophyta;Phragmoplastophyta;Streptophyta;Embryophyta;Tracheophyta;Spermatophyta;Magnoliophyta;Rosales;Pilea;";"0.0";"0";"1";"1";"0";"1";"0";"430523";"5766"
"LOK1378_1mm";"SILVA (only NR);Eukaryota;Archaeplastida;Chloroplastida;Charophyta;Phragmoplastophyta;Streptophyta;Embryophyta;Tracheophyta;Spermatophyta;Magnoliophyta;Rosales;Pipturus;";"0.0";"0";"1";"1";"0";"1";"0";"430523";"5766"
"LOK1378_1mm";"SILVA (only NR);Eukaryota;Archaeplastida;Chloroplastida;Charophyta;Phragmoplastophyta;Streptophyta;Embryophyta;Tracheophyta;Spermatophyta;Magnoliophyta;Rosales;Prinsepia;";"0.0";"0";"1";"1";"0";"1";"0";"430523";"5766"
"LOK1378_1mm";"SILVA (only NR);Eukaryota;Archaeplastida;Chloroplastida;Charophyta;Phragmoplastophyta;Streptophyta;Embryophyta;Tracheophyta;Spermatophyta;Magnoliophyta;Rosales;Procris;";"0.0";"0";"1";"1";"0";"1";"0";"430523";"5766"
"LOK1378_1mm";"SILVA (only NR);Eukaryota;Archaeplastida;Chloroplastida;Charophyta;Phragmoplastophyta;Streptophyta;Embryophyta;Tracheophyta;Spermatophyta;Magnoliophyta;Rosales;Prunus;";"0.0";"0";"4";"4";"0";"4";"0";"430520";"5766"
"LOK1378_1mm";"SILVA (only NR);Eukaryota;Archaeplastida;Chloroplastida;Charophyta;Phragmoplastophyta;Streptophyta;Embryophyta;Tracheophyta;Spermatophyta;Magnoliophyta;Rosales;Purshia;";"0.0";"0";"1";"1";"0";"1";"0";"430523";"5766"
"LOK1378_1mm";"SILVA (only NR);Eukaryota;Archaeplastida;Chloroplastida;Charophyta;Phragmoplastophyta;Streptophyta;Embryophyta;Tracheophyta;Spermatophyta;Magnoliophyta;Rosales;Pyrus;";"0.0";"0";"5";"5";"0";"5";"0";"430519";"5766"
"LOK1378_1mm";"SILVA (only NR);Eukaryota;Archaeplastida;Chloroplastida;Charophyta;Phragmoplastophyta;Streptophyta;Embryophyta;Tracheophyta;Spermatophyta;Magnoliophyta;Rosales;Retanilla;";"0.0";"0";"1";"1";"0";"1";"0";"430523";"5766"
"LOK1378_1mm";"SILVA (only NR);Eukaryota;Archaeplastida;Chloroplastida;Charophyta;Phragmoplastophyta;Streptophyta;Embryophyta;Tracheophyta;Spermatophyta;Magnoliophyta;Rosales;Rhamnus;";"0.0";"0";"1";"1";"0";"1";"0";"430523";"5766"
"LOK1378_1mm";"SILVA (only NR);Eukaryota;Archaeplastida;Chloroplastida;Charophyta;Phragmoplastophyta;Streptophyta;Embryophyta;Tracheophyta;Spermatophyta;Magnoliophyta;Rosales;Rousselia;";"0.0";"0";"1";"1";"0";"1";"0";"430523";"5766"
"LOK1378_1mm";"SILVA (only NR);Eukaryota;Archaeplastida;Chloroplastida;Charophyta;Phragmoplastophyta;Streptophyta;Embryophyta;Tracheophyta;Spermatophyta;Magnoliophyta;Rosales;Sarcomphalus;";"0.0";"0";"1";"1";"0";"1";"0";"430523";"5766"
"LOK1378_1mm";"SILVA (only NR);Eukaryota;Archaeplastida;Chloroplastida;Charophyta;Phragmoplastophyta;Streptophyta;Embryophyta;Tracheophyta;Spermatophyta;Magnoliophyta;Rosales;Sarcopilea;";"0.0";"0";"1";"1";"0";"1";"0";"430523";"5766"
"LOK1378_1mm";"SILVA (only NR);Eukaryota;Archaeplastida;Chloroplastida;Charophyta;Phragmoplastophyta;Streptophyta;Embryophyta;Tracheophyta;Spermatophyta;Magnoliophyta;Rosales;Shepherdia;";"0.0";"0";"1";"1";"0";"1";"0";"430523";"5766"
"LOK1378_1mm";"SILVA (only NR);Eukaryota;Archaeplastida;Chloroplastida;Charophyta;Phragmoplastophyta;Streptophyta;Embryophyta;Tracheophyta;Spermatophyta;Magnoliophyta;Rosales;Spiraea;";"0.0";"0";"1";"1";"0";"1";"0";"430523";"5766"
"LOK1378_1mm";"SILVA (only NR);Eukaryota;Archaeplastida;Chloroplastida;Charophyta;Phragmoplastophyta;Streptophyta;Embryophyta;Tracheophyta;Spermatophyta;Magnoliophyta;Rosales;Ulmus;";"0.0";"0";"1";"1";"0";"1";"0";"430523";"5766"
"LOK1378_1mm";"SILVA (only NR);Eukaryota;Archaeplastida;Chloroplastida;Charophyta;Phragmoplastophyta;Streptophyta;Embryophyta;Tracheophyta;Spermatophyta;Magnoliophyta;Rosales;Urera;";"0.0";"0";"1";"1";"0";"1";"0";"430523";"5766"
"LOK1378_1mm";"SILVA (only NR);Eukaryota;Archaeplastida;Chloroplastida;Charophyta;Phragmoplastophyta;Streptophyta;Embryophyta;Tracheophyta;Spermatophyta;Magnoliophyta;Rosales;Urtica;";"0.0";"0";"1";"1";"0";"1";"0";"430523";"5766"
"LOK1378_1mm";"SILVA (only NR);Eukaryota;Archaeplastida;Chloroplastida;Charophyta;Phragmoplastophyta;Streptophyta;Embryophyta;Tracheophyta;Spermatophyta;Magnoliophyta;Rosales;Ziziphus;";"0.0";"0";"14";"14";"0";"14";"0";"430510";"5766"
"LOK1378_1mm";"SILVA (only NR);Eukaryota;Archaeplastida;Chloroplastida;Charophyta;Phragmoplastophyta;Streptophyta;Embryophyta;Tracheophyta;Spermatophyta;Magnoliophyta;Santalales;";"0.0";"0";"124";"123";"0";"123";"1";"430401";"5766"
"LOK1378_1mm";"SILVA (only NR);Eukaryota;Archaeplastida;Chloroplastida;Charophyta;Phragmoplastophyta;Streptophyta;Embryophyta;Tracheophyta;Spermatophyta;Magnoliophyta;Santalales;Actinanthella;";"0.0";"0";"1";"1";"0";"1";"0";"430523";"5766"
"LOK1378_1mm";"SILVA (only NR);Eukaryota;Archaeplastida;Chloroplastida;Charophyta;Phragmoplastophyta;Streptophyta;Embryophyta;Tracheophyta;Spermatophyta;Magnoliophyta;Santalales;Agelanthus;";"0.0";"0";"2";"2";"0";"2";"0";"430522";"5766"
"LOK1378_1mm";"SILVA (only NR);Eukaryota;Archaeplastida;Chloroplastida;Charophyta;Phragmoplastophyta;Streptophyta;Embryophyta;Tracheophyta;Spermatophyta;Magnoliophyta;Santalales;Agonandra;";"0.0";"0";"1";"1";"0";"1";"0";"430523";"5766"
"LOK1378_1mm";"SILVA (only NR);Eukaryota;Archaeplastida;Chloroplastida;Charophyta;Phragmoplastophyta;Streptophyta;Embryophyta;Tracheophyta;Spermatophyta;Magnoliophyta;Santalales;Amyema;";"0.0";"0";"1";"1";"0";"1";"0";"430523";"5766"
"LOK1378_1mm";"SILVA (only NR);Eukaryota;Archaeplastida;Chloroplastida;Charophyta;Phragmoplastophyta;Streptophyta;Embryophyta;Tracheophyta;Spermatophyta;Magnoliophyta;Santalales;Anthobolus;";"0.0";"0";"1";"1";"0";"1";"0";"430523";"5766"
"LOK1378_1mm";"SILVA (only NR);Eukaryota;Archaeplastida;Chloroplastida;Charophyta;Phragmoplastophyta;Streptophyta;Embryophyta;Tracheophyta;Spermatophyta;Magnoliophyta;Santalales;Antidaphne;";"0.0";"0";"1";"1";"0";"1";"0";"430523";"5766"
"LOK1378_1mm";"SILVA (only NR);Eukaryota;Archaeplastida;Chloroplastida;Charophyta;Phragmoplastophyta;Streptophyta;Embryophyta;Tracheophyta;Spermatophyta;Magnoliophyta;Santalales;Arceuthobium;";"0.0";"0";"3";"3";"0";"3";"0";"430521";"5766"
"LOK1378_1mm";"SILVA (only NR);Eukaryota;Archaeplastida;Chloroplastida;Charophyta;Phragmoplastophyta;Streptophyta;Embryophyta;Tracheophyta;Spermatophyta;Magnoliophyta;Santalales;Arjona;";"0.0";"0";"1";"1";"0";"1";"0";"430523";"5766"
"LOK1378_1mm";"SILVA (only NR);Eukaryota;Archaeplastida;Chloroplastida;Charophyta;Phragmoplastophyta;Streptophyta;Embryophyta;Tracheophyta;Spermatophyta;Magnoliophyta;Santalales;Balanophora;";"0.0";"0";"7";"7";"0";"7";"0";"430517";"5766"
"LOK1378_1mm";"SILVA (only NR);Eukaryota;Archaeplastida;Chloroplastida;Charophyta;Phragmoplastophyta;Streptophyta;Embryophyta;Tracheophyta;Spermatophyta;Magnoliophyta;Santalales;Benthamina;";"0.0";"0";"1";"1";"0";"1";"0";"430523";"5766"
"LOK1378_1mm";"SILVA (only NR);Eukaryota;Archaeplastida;Chloroplastida;Charophyta;Phragmoplastophyta;Streptophyta;Embryophyta;Tracheophyta;Spermatophyta;Magnoliophyta;Santalales;Berhautia;";"0.0";"0";"1";"1";"0";"1";"0";"430523";"5766"
"LOK1378_1mm";"SILVA (only NR);Eukaryota;Archaeplastida;Chloroplastida;Charophyta;Phragmoplastophyta;Streptophyta;Embryophyta;Tracheophyta;Spermatophyta;Magnoliophyta;Santalales;Cansjera;";"0.0";"0";"1";"1";"0";"1";"0";"430523";"5766"
"LOK1378_1mm";"SILVA (only NR);Eukaryota;Archaeplastida;Chloroplastida;Charophyta;Phragmoplastophyta;Streptophyta;Embryophyta;Tracheophyta;Spermatophyta;Magnoliophyta;Santalales;Cathedra;";"0.0";"0";"1";"1";"0";"1";"0";"430523";"5766"
"LOK1378_1mm";"SILVA (only NR);Eukaryota;Archaeplastida;Chloroplastida;Charophyta;Phragmoplastophyta;Streptophyta;Embryophyta;Tracheophyta;Spermatophyta;Magnoliophyta;Santalales;Cecarria;";"0.0";"0";"1";"1";"0";"1";"0";"430523";"5766"
"LOK1378_1mm";"SILVA (only NR);Eukaryota;Archaeplastida;Chloroplastida;Charophyta;Phragmoplastophyta;Streptophyta;Embryophyta;Tracheophyta;Spermatophyta;Magnoliophyta;Santalales;Chaunochiton;";"0.0";"0";"1";"1";"0";"1";"0";"430523";"5766"
"LOK1378_1mm";"SILVA (only NR);Eukaryota;Archaeplastida;Chloroplastida;Charophyta;Phragmoplastophyta;Streptophyta;Embryophyta;Tracheophyta;Spermatophyta;Magnoliophyta;Santalales;Choretrum;";"0.0";"0";"1";"1";"0";"1";"0";"430523";"5766"
"LOK1378_1mm";"SILVA (only NR);Eukaryota;Archaeplastida;Chloroplastida;Charophyta;Phragmoplastophyta;Streptophyta;Embryophyta;Tracheophyta;Spermatophyta;Magnoliophyta;Santalales;Colpoon;";"0.0";"0";"1";"1";"0";"1";"0";"430523";"5766"
"LOK1378_1mm";"SILVA (only NR);Eukaryota;Archaeplastida;Chloroplastida;Charophyta;Phragmoplastophyta;Streptophyta;Embryophyta;Tracheophyta;Spermatophyta;Magnoliophyta;Santalales;Comandra;";"0.0";"0";"1";"1";"0";"1";"0";"430523";"5766"
"LOK1378_1mm";"SILVA (only NR);Eukaryota;Archaeplastida;Chloroplastida;Charophyta;Phragmoplastophyta;Streptophyta;Embryophyta;Tracheophyta;Spermatophyta;Magnoliophyta;Santalales;Corynaea;";"0.0";"0";"1";"1";"0";"1";"0";"430523";"5766"
"LOK1378_1mm";"SILVA (only NR);Eukaryota;Archaeplastida;Chloroplastida;Charophyta;Phragmoplastophyta;Streptophyta;Embryophyta;Tracheophyta;Spermatophyta;Magnoliophyta;Santalales;Dactylanthus;";"0.0";"0";"1";"1";"0";"1";"0";"430523";"5766"
"LOK1378_1mm";"SILVA (only NR);Eukaryota;Archaeplastida;Chloroplastida;Charophyta;Phragmoplastophyta;Streptophyta;Embryophyta;Tracheophyta;Spermatophyta;Magnoliophyta;Santalales;Daenikera;";"0.0";"0";"1";"1";"0";"1";"0";"430523";"5766"
"LOK1378_1mm";"SILVA (only NR);Eukaryota;Archaeplastida;Chloroplastida;Charophyta;Phragmoplastophyta;Streptophyta;Embryophyta;Tracheophyta;Spermatophyta;Magnoliophyta;Santalales;Decaisnina;";"0.0";"0";"2";"2";"0";"2";"0";"430522";"5766"
"LOK1378_1mm";"SILVA (only NR);Eukaryota;Archaeplastida;Chloroplastida;Charophyta;Phragmoplastophyta;Streptophyta;Embryophyta;Tracheophyta;Spermatophyta;Magnoliophyta;Santalales;Dendrophthora;";"0.0";"0";"1";"1";"0";"1";"0";"430523";"5766"
"LOK1378_1mm";"SILVA (only NR);Eukaryota;Archaeplastida;Chloroplastida;Charophyta;Phragmoplastophyta;Streptophyta;Embryophyta;Tracheophyta;Spermatophyta;Magnoliophyta;Santalales;Dendrotrophe;";"0.0";"0";"1";"1";"0";"1";"0";"430523";"5766"
"LOK1378_1mm";"SILVA (only NR);Eukaryota;Archaeplastida;Chloroplastida;Charophyta;Phragmoplastophyta;Streptophyta;Embryophyta;Tracheophyta;Spermatophyta;Magnoliophyta;Santalales;Diogoa;";"0.0";"0";"1";"1";"0";"1";"0";"430523";"5766"
"LOK1378_1mm";"SILVA (only NR);Eukaryota;Archaeplastida;Chloroplastida;Charophyta;Phragmoplastophyta;Streptophyta;Embryophyta;Tracheophyta;Spermatophyta;Magnoliophyta;Santalales;Diplatia;";"0.0";"0";"1";"1";"0";"1";"0";"430523";"5766"
"LOK1378_1mm";"SILVA (only NR);Eukaryota;Archaeplastida;Chloroplastida;Charophyta;Phragmoplastophyta;Streptophyta;Embryophyta;Tracheophyta;Spermatophyta;Magnoliophyta;Santalales;Dufrenoya;";"0.0";"0";"1";"1";"0";"1";"0";"430523";"5766"
"LOK1378_1mm";"SILVA (only NR);Eukaryota;Archaeplastida;Chloroplastida;Charophyta;Phragmoplastophyta;Streptophyta;Embryophyta;Tracheophyta;Spermatophyta;Magnoliophyta;Santalales;Dulacia;";"0.0";"0";"1";"1";"0";"1";"0";"430523";"5766"
"LOK1378_1mm";"SILVA (only NR);Eukaryota;Archaeplastida;Chloroplastida;Charophyta;Phragmoplastophyta;Streptophyta;Embryophyta;Tracheophyta;Spermatophyta;Magnoliophyta;Santalales;Englerina;";"0.0";"0";"1";"1";"0";"1";"0";"430523";"5766"
"LOK1378_1mm";"SILVA (only NR);Eukaryota;Archaeplastida;Chloroplastida;Charophyta;Phragmoplastophyta;Streptophyta;Embryophyta;Tracheophyta;Spermatophyta;Magnoliophyta;Santalales;Engomegoma;";"0.0";"0";"1";"1";"0";"1";"0";"430523";"5766"
"LOK1378_1mm";"SILVA (only NR);Eukaryota;Archaeplastida;Chloroplastida;Charophyta;Phragmoplastophyta;Streptophyta;Embryophyta;Tracheophyta;Spermatophyta;Magnoliophyta;Santalales;Erianthemum;";"0.0";"0";"1";"1";"0";"1";"0";"430523";"5766"
"LOK1378_1mm";"SILVA (only NR);Eukaryota;Archaeplastida;Chloroplastida;Charophyta;Phragmoplastophyta;Streptophyta;Embryophyta;Tracheophyta;Spermatophyta;Magnoliophyta;Santalales;Erythropalum;";"0.0";"0";"1";"1";"0";"1";"0";"430523";"5766"
"LOK1378_1mm";"SILVA (only NR);Eukaryota;Archaeplastida;Chloroplastida;Charophyta;Phragmoplastophyta;Streptophyta;Embryophyta;Tracheophyta;Spermatophyta;Magnoliophyta;Santalales;Eubrachion;";"0.0";"0";"1";"1";"0";"1";"0";"430523";"5766"
"LOK1378_1mm";"SILVA (only NR);Eukaryota;Archaeplastida;Chloroplastida;Charophyta;Phragmoplastophyta;Streptophyta;Embryophyta;Tracheophyta;Spermatophyta;Magnoliophyta;Santalales;Exocarpos;";"0.0";"0";"1";"1";"0";"1";"0";"430523";"5766"
"LOK1378_1mm";"SILVA (only NR);Eukaryota;Archaeplastida;Chloroplastida;Charophyta;Phragmoplastophyta;Streptophyta;Embryophyta;Tracheophyta;Spermatophyta;Magnoliophyta;Santalales;Geocaulon;";"0.0";"0";"1";"1";"0";"1";"0";"430523";"5766"
"LOK1378_1mm";"SILVA (only NR);Eukaryota;Archaeplastida;Chloroplastida;Charophyta;Phragmoplastophyta;Streptophyta;Embryophyta;Tracheophyta;Spermatophyta;Magnoliophyta;Santalales;Ginalloa;";"0.0";"0";"1";"1";"0";"1";"0";"430523";"5766"
"LOK1378_1mm";"SILVA (only NR);Eukaryota;Archaeplastida;Chloroplastida;Charophyta;Phragmoplastophyta;Streptophyta;Embryophyta;Tracheophyta;Spermatophyta;Magnoliophyta;Santalales;Hachettea;";"0.0";"0";"1";"1";"0";"1";"0";"430523";"5766"
"LOK1378_1mm";"SILVA (only NR);Eukaryota;Archaeplastida;Chloroplastida;Charophyta;Phragmoplastophyta;Streptophyta;Embryophyta;Tracheophyta;Spermatophyta;Magnoliophyta;Santalales;Harmandia;";"0.0";"0";"1";"1";"0";"1";"0";"430523";"5766"
"LOK1378_1mm";"SILVA (only NR);Eukaryota;Archaeplastida;Chloroplastida;Charophyta;Phragmoplastophyta;Streptophyta;Embryophyta;Tracheophyta;Spermatophyta;Magnoliophyta;Santalales;Heisteria;";"0.0";"0";"1";"1";"0";"1";"0";"430523";"5766"
"LOK1378_1mm";"SILVA (only NR);Eukaryota;Archaeplastida;Chloroplastida;Charophyta;Phragmoplastophyta;Streptophyta;Embryophyta;Tracheophyta;Spermatophyta;Magnoliophyta;Santalales;Helixanthera;";"0.0";"0";"1";"1";"0";"1";"0";"430523";"5766"
"LOK1378_1mm";"SILVA (only NR);Eukaryota;Archaeplastida;Chloroplastida;Charophyta;Phragmoplastophyta;Streptophyta;Embryophyta;Tracheophyta;Spermatophyta;Magnoliophyta;Santalales;Helosis;";"0.0";"0";"1";"1";"0";"1";"0";"430523";"5766"
"LOK1378_1mm";"SILVA (only NR);Eukaryota;Archaeplastida;Chloroplastida;Charophyta;Phragmoplastophyta;Streptophyta;Embryophyta;Tracheophyta;Spermatophyta;Magnoliophyta;Santalales;Hondurodendron;";"0.0";"0";"1";"1";"0";"1";"0";"430523";"5766"
"LOK1378_1mm";"SILVA (only NR);Eukaryota;Archaeplastida;Chloroplastida;Charophyta;Phragmoplastophyta;Streptophyta;Embryophyta;Tracheophyta;Spermatophyta;Magnoliophyta;Santalales;Ileostylus;";"0.0";"0";"1";"1";"0";"1";"0";"430523";"5766"
"LOK1378_1mm";"SILVA (only NR);Eukaryota;Archaeplastida;Chloroplastida;Charophyta;Phragmoplastophyta;Streptophyta;Embryophyta;Tracheophyta;Spermatophyta;Magnoliophyta;Santalales;Jodina;";"0.0";"0";"1";"1";"0";"1";"0";"430523";"5766"
"LOK1378_1mm";"SILVA (only NR);Eukaryota;Archaeplastida;Chloroplastida;Charophyta;Phragmoplastophyta;Streptophyta;Embryophyta;Tracheophyta;Spermatophyta;Magnoliophyta;Santalales;Korthalsella;";"0.0";"0";"2";"2";"0";"2";"0";"430522";"5766"
"LOK1378_1mm";"SILVA (only NR);Eukaryota;Archaeplastida;Chloroplastida;Charophyta;Phragmoplastophyta;Streptophyta;Embryophyta;Tracheophyta;Spermatophyta;Magnoliophyta;Santalales;Kunkeliella;";"0.0";"0";"1";"1";"0";"1";"0";"430523";"5766"
"LOK1378_1mm";"SILVA (only NR);Eukaryota;Archaeplastida;Chloroplastida;Charophyta;Phragmoplastophyta;Streptophyta;Embryophyta;Tracheophyta;Spermatophyta;Magnoliophyta;Santalales;Langsdorffia;";"0.0";"0";"1";"1";"0";"1";"0";"430523";"5766"
"LOK1378_1mm";"SILVA (only NR);Eukaryota;Archaeplastida;Chloroplastida;Charophyta;Phragmoplastophyta;Streptophyta;Embryophyta;Tracheophyta;Spermatophyta;Magnoliophyta;Santalales;Lepidoceras;";"0.0";"0";"1";"1";"0";"1";"0";"430523";"5766"
"LOK1378_1mm";"SILVA (only NR);Eukaryota;Archaeplastida;Chloroplastida;Charophyta;Phragmoplastophyta;Streptophyta;Embryophyta;Tracheophyta;Spermatophyta;Magnoliophyta;Santalales;Leptomeria;";"0.0";"0";"1";"1";"0";"1";"0";"430523";"5766"
"LOK1378_1mm";"SILVA (only NR);Eukaryota;Archaeplastida;Chloroplastida;Charophyta;Phragmoplastophyta;Streptophyta;Embryophyta;Tracheophyta;Spermatophyta;Magnoliophyta;Santalales;Ligaria;";"0.0";"0";"1";"1";"0";"1";"0";"430523";"5766"
"LOK1378_1mm";"SILVA (only NR);Eukaryota;Archaeplastida;Chloroplastida;Charophyta;Phragmoplastophyta;Streptophyta;Embryophyta;Tracheophyta;Spermatophyta;Magnoliophyta;Santalales;Lophophytum;";"0.0";"0";"1";"1";"0";"1";"0";"430523";"5766"
"LOK1378_1mm";"SILVA (only NR);Eukaryota;Archaeplastida;Chloroplastida;Charophyta;Phragmoplastophyta;Streptophyta;Embryophyta;Tracheophyta;Spermatophyta;Magnoliophyta;Santalales;Loranthus;";"0.0";"0";"2";"2";"0";"2";"0";"430522";"5766"
"LOK1378_1mm";"SILVA (only NR);Eukaryota;Archaeplastida;Chloroplastida;Charophyta;Phragmoplastophyta;Streptophyta;Embryophyta;Tracheophyta;Spermatophyta;Magnoliophyta;Santalales;Loxanthera;";"0.0";"0";"1";"1";"0";"1";"0";"430523";"5766"
"LOK1378_1mm";"SILVA (only NR);Eukaryota;Archaeplastida;Chloroplastida;Charophyta;Phragmoplastophyta;Streptophyta;Embryophyta;Tracheophyta;Spermatophyta;Magnoliophyta;Santalales;Lysiana;";"0.0";"0";"1";"1";"0";"1";"0";"430523";"5766"
"LOK1378_1mm";"SILVA (only NR);Eukaryota;Archaeplastida;Chloroplastida;Charophyta;Phragmoplastophyta;Streptophyta;Embryophyta;Tracheophyta;Spermatophyta;Magnoliophyta;Santalales;Macrosolen;";"0.0";"0";"1";"1";"0";"1";"0";"430523";"5766"
"LOK1378_1mm";"SILVA (only NR);Eukaryota;Archaeplastida;Chloroplastida;Charophyta;Phragmoplastophyta;Streptophyta;Embryophyta;Tracheophyta;Spermatophyta;Magnoliophyta;Santalales;Malania;";"0.0";"0";"1";"1";"0";"1";"0";"430523";"5766"
"LOK1378_1mm";"SILVA (only NR);Eukaryota;Archaeplastida;Chloroplastida;Charophyta;Phragmoplastophyta;Streptophyta;Embryophyta;Tracheophyta;Spermatophyta;Magnoliophyta;Santalales;Mida;";"0.0";"0";"1";"1";"0";"1";"0";"430523";"5766"
"LOK1378_1mm";"SILVA (only NR);Eukaryota;Archaeplastida;Chloroplastida;Charophyta;Phragmoplastophyta;Streptophyta;Embryophyta;Tracheophyta;Spermatophyta;Magnoliophyta;Santalales;Misodendrum;";"0.0";"0";"2";"2";"0";"2";"0";"430522";"5766"
"LOK1378_1mm";"SILVA (only NR);Eukaryota;Archaeplastida;Chloroplastida;Charophyta;Phragmoplastophyta;Streptophyta;Embryophyta;Tracheophyta;Spermatophyta;Magnoliophyta;Santalales;Moquiniella;";"0.0";"0";"1";"1";"0";"1";"0";"430523";"5766"
"LOK1378_1mm";"SILVA (only NR);Eukaryota;Archaeplastida;Chloroplastida;Charophyta;Phragmoplastophyta;Streptophyta;Embryophyta;Tracheophyta;Spermatophyta;Magnoliophyta;Santalales;Myoschilos;";"0.0";"0";"1";"1";"0";"1";"0";"430523";"5766"
"LOK1378_1mm";"SILVA (only NR);Eukaryota;Archaeplastida;Chloroplastida;Charophyta;Phragmoplastophyta;Streptophyta;Embryophyta;Tracheophyta;Spermatophyta;Magnoliophyta;Santalales;Mystropetalon;";"0.0";"0";"1";"1";"0";"1";"0";"430523";"5766"
"LOK1378_1mm";"SILVA (only NR);Eukaryota;Archaeplastida;Chloroplastida;Charophyta;Phragmoplastophyta;Streptophyta;Embryophyta;Tracheophyta;Spermatophyta;Magnoliophyta;Santalales;Nestronia;";"0.0";"0";"1";"1";"0";"1";"0";"430523";"5766"
"LOK1378_1mm";"SILVA (only NR);Eukaryota;Archaeplastida;Chloroplastida;Charophyta;Phragmoplastophyta;Streptophyta;Embryophyta;Tracheophyta;Spermatophyta;Magnoliophyta;Santalales;Notanthera;";"0.0";"0";"1";"1";"0";"1";"0";"430523";"5766"
"LOK1378_1mm";"SILVA (only NR);Eukaryota;Archaeplastida;Chloroplastida;Charophyta;Phragmoplastophyta;Streptophyta;Embryophyta;Tracheophyta;Spermatophyta;Magnoliophyta;Santalales;Notothixos;";"0.0";"0";"2";"2";"0";"2";"0";"430522";"5766"
"LOK1378_1mm";"SILVA (only NR);Eukaryota;Archaeplastida;Chloroplastida;Charophyta;Phragmoplastophyta;Streptophyta;Embryophyta;Tracheophyta;Spermatophyta;Magnoliophyta;Santalales;Nuytsia;";"0.0";"0";"1";"1";"0";"1";"0";"430523";"5766"
"LOK1378_1mm";"SILVA (only NR);Eukaryota;Archaeplastida;Chloroplastida;Charophyta;Phragmoplastophyta;Streptophyta;Embryophyta;Tracheophyta;Spermatophyta;Magnoliophyta;Santalales;Olax;";"0.0";"0";"3";"3";"0";"3";"0";"430521";"5766"
"LOK1378_1mm";"SILVA (only NR);Eukaryota;Archaeplastida;Chloroplastida;Charophyta;Phragmoplastophyta;Streptophyta;Embryophyta;Tracheophyta;Spermatophyta;Magnoliophyta;Santalales;Oliverella;";"0.0";"0";"1";"1";"0";"1";"0";"430523";"5766"
"LOK1378_1mm";"SILVA (only NR);Eukaryota;Archaeplastida;Chloroplastida;Charophyta;Phragmoplastophyta;Streptophyta;Embryophyta;Tracheophyta;Spermatophyta;Magnoliophyta;Santalales;Ombrophytum;";"0.0";"0";"1";"1";"0";"1";"0";"430523";"5766"
"LOK1378_1mm";"SILVA (only NR);Eukaryota;Archaeplastida;Chloroplastida;Charophyta;Phragmoplastophyta;Streptophyta;Embryophyta;Tracheophyta;Spermatophyta;Magnoliophyta;Santalales;Omphacomeria;";"0.0";"0";"1";"1";"0";"1";"0";"430523";"5766"
"LOK1378_1mm";"SILVA (only NR);Eukaryota;Archaeplastida;Chloroplastida;Charophyta;Phragmoplastophyta;Streptophyta;Embryophyta;Tracheophyta;Spermatophyta;Magnoliophyta;Santalales;Oncella;";"0.0";"0";"1";"1";"0";"1";"0";"430523";"5766"
"LOK1378_1mm";"SILVA (only NR);Eukaryota;Archaeplastida;Chloroplastida;Charophyta;Phragmoplastophyta;Streptophyta;Embryophyta;Tracheophyta;Spermatophyta;Magnoliophyta;Santalales;Ongokea;";"0.0";"0";"1";"1";"0";"1";"0";"430523";"5766"
"LOK1378_1mm";"SILVA (only NR);Eukaryota;Archaeplastida;Chloroplastida;Charophyta;Phragmoplastophyta;Streptophyta;Embryophyta;Tracheophyta;Spermatophyta;Magnoliophyta;Santalales;Oryctanthus;";"0.0";"0";"1";"1";"0";"1";"0";"430523";"5766"
"LOK1378_1mm";"SILVA (only NR);Eukaryota;Archaeplastida;Chloroplastida;Charophyta;Phragmoplastophyta;Streptophyta;Embryophyta;Tracheophyta;Spermatophyta;Magnoliophyta;Santalales;Osyridicarpos;";"0.0";"0";"1";"1";"0";"1";"0";"430523";"5766"
"LOK1378_1mm";"SILVA (only NR);Eukaryota;Archaeplastida;Chloroplastida;Charophyta;Phragmoplastophyta;Streptophyta;Embryophyta;Tracheophyta;Spermatophyta;Magnoliophyta;Santalales;Osyris;";"0.0";"0";"2";"2";"0";"2";"0";"430522";"5766"
"LOK1378_1mm";"SILVA (only NR);Eukaryota;Archaeplastida;Chloroplastida;Charophyta;Phragmoplastophyta;Streptophyta;Embryophyta;Tracheophyta;Spermatophyta;Magnoliophyta;Santalales;Pentarhopalopilia;";"0.0";"0";"1";"1";"0";"1";"0";"430523";"5766"
"LOK1378_1mm";"SILVA (only NR);Eukaryota;Archaeplastida;Chloroplastida;Charophyta;Phragmoplastophyta;Streptophyta;Embryophyta;Tracheophyta;Spermatophyta;Magnoliophyta;Santalales;Phacellaria;";"0.0";"0";"1";"0";"0";"0";"1";"430524";"5766"
"LOK1378_1mm";"SILVA (only NR);Eukaryota;Archaeplastida;Chloroplastida;Charophyta;Phragmoplastophyta;Streptophyta;Embryophyta;Tracheophyta;Spermatophyta;Magnoliophyta;Santalales;Phoradendron;";"0.0";"0";"1";"1";"0";"1";"0";"430523";"5766"
"LOK1378_1mm";"SILVA (only NR);Eukaryota;Archaeplastida;Chloroplastida;Charophyta;Phragmoplastophyta;Streptophyta;Embryophyta;Tracheophyta;Spermatophyta;Magnoliophyta;Santalales;Phthirusa;";"0.0";"0";"1";"1";"0";"1";"0";"430523";"5766"
"LOK1378_1mm";"SILVA (only NR);Eukaryota;Archaeplastida;Chloroplastida;Charophyta;Phragmoplastophyta;Streptophyta;Embryophyta;Tracheophyta;Spermatophyta;Magnoliophyta;Santalales;Plicosepalus;";"0.0";"0";"1";"1";"0";"1";"0";"430523";"5766"
"LOK1378_1mm";"SILVA (only NR);Eukaryota;Archaeplastida;Chloroplastida;Charophyta;Phragmoplastophyta;Streptophyta;Embryophyta;Tracheophyta;Spermatophyta;Magnoliophyta;Santalales;Psittacanthus;";"0.0";"0";"1";"1";"0";"1";"0";"430523";"5766"
"LOK1378_1mm";"SILVA (only NR);Eukaryota;Archaeplastida;Chloroplastida;Charophyta;Phragmoplastophyta;Streptophyta;Embryophyta;Tracheophyta;Spermatophyta;Magnoliophyta;Santalales;Ptychopetalum;";"0.0";"0";"1";"1";"0";"1";"0";"430523";"5766"
"LOK1378_1mm";"SILVA (only NR);Eukaryota;Archaeplastida;Chloroplastida;Charophyta;Phragmoplastophyta;Streptophyta;Embryophyta;Tracheophyta;Spermatophyta;Magnoliophyta;Santalales;Quinchamalium;";"0.0";"0";"1";"1";"0";"1";"0";"430523";"5766"
"LOK1378_1mm";"SILVA (only NR);Eukaryota;Archaeplastida;Chloroplastida;Charophyta;Phragmoplastophyta;Streptophyta;Embryophyta;Tracheophyta;Spermatophyta;Magnoliophyta;Santalales;Rhoiacarpos;";"0.0";"0";"1";"1";"0";"1";"0";"430523";"5766"
"LOK1378_1mm";"SILVA (only NR);Eukaryota;Archaeplastida;Chloroplastida;Charophyta;Phragmoplastophyta;Streptophyta;Embryophyta;Tracheophyta;Spermatophyta;Magnoliophyta;Santalales;Santalum;";"0.0";"0";"1";"1";"0";"1";"0";"430523";"5766"
"LOK1378_1mm";"SILVA (only NR);Eukaryota;Archaeplastida;Chloroplastida;Charophyta;Phragmoplastophyta;Streptophyta;Embryophyta;Tracheophyta;Spermatophyta;Magnoliophyta;Santalales;Sarcophyte;";"0.0";"0";"1";"1";"0";"1";"0";"430523";"5766"
"LOK1378_1mm";"SILVA (only NR);Eukaryota;Archaeplastida;Chloroplastida;Charophyta;Phragmoplastophyta;Streptophyta;Embryophyta;Tracheophyta;Spermatophyta;Magnoliophyta;Santalales;Schoepfia;";"0.0";"0";"2";"2";"0";"2";"0";"430522";"5766"
"LOK1378_1mm";"SILVA (only NR);Eukaryota;Archaeplastida;Chloroplastida;Charophyta;Phragmoplastophyta;Streptophyta;Embryophyta;Tracheophyta;Spermatophyta;Magnoliophyta;Santalales;Scleropyrum;";"0.0";"0";"1";"1";"0";"1";"0";"430523";"5766"
"LOK1378_1mm";"SILVA (only NR);Eukaryota;Archaeplastida;Chloroplastida;Charophyta;Phragmoplastophyta;Streptophyta;Embryophyta;Tracheophyta;Spermatophyta;Magnoliophyta;Santalales;Scorodocarpus;";"0.0";"0";"1";"1";"0";"1";"0";"430523";"5766"
"LOK1378_1mm";"SILVA (only NR);Eukaryota;Archaeplastida;Chloroplastida;Charophyta;Phragmoplastophyta;Streptophyta;Embryophyta;Tracheophyta;Spermatophyta;Magnoliophyta;Santalales;Scybalium;";"0.0";"0";"1";"1";"0";"1";"0";"430523";"5766"
"LOK1378_1mm";"SILVA (only NR);Eukaryota;Archaeplastida;Chloroplastida;Charophyta;Phragmoplastophyta;Streptophyta;Embryophyta;Tracheophyta;Spermatophyta;Magnoliophyta;Santalales;Sogerianthe;";"0.0";"0";"1";"1";"0";"1";"0";"430523";"5766"
"LOK1378_1mm";"SILVA (only NR);Eukaryota;Archaeplastida;Chloroplastida;Charophyta;Phragmoplastophyta;Streptophyta;Embryophyta;Tracheophyta;Spermatophyta;Magnoliophyta;Santalales;Strombosia;";"0.0";"0";"1";"1";"0";"1";"0";"430523";"5766"
"LOK1378_1mm";"SILVA (only NR);Eukaryota;Archaeplastida;Chloroplastida;Charophyta;Phragmoplastophyta;Streptophyta;Embryophyta;Tracheophyta;Spermatophyta;Magnoliophyta;Santalales;Strombosiopsis;";"0.0";"0";"1";"1";"0";"1";"0";"430523";"5766"
"LOK1378_1mm";"SILVA (only NR);Eukaryota;Archaeplastida;Chloroplastida;Charophyta;Phragmoplastophyta;Streptophyta;Embryophyta;Tracheophyta;Spermatophyta;Magnoliophyta;Santalales;Struthanthus;";"0.0";"0";"2";"2";"0";"2";"0";"430522";"5766"
"LOK1378_1mm";"SILVA (only NR);Eukaryota;Archaeplastida;Chloroplastida;Charophyta;Phragmoplastophyta;Streptophyta;Embryophyta;Tracheophyta;Spermatophyta;Magnoliophyta;Santalales;Taxillus;";"0.0";"0";"2";"2";"0";"2";"0";"430522";"5766"
"LOK1378_1mm";"SILVA (only NR);Eukaryota;Archaeplastida;Chloroplastida;Charophyta;Phragmoplastophyta;Streptophyta;Embryophyta;Tracheophyta;Spermatophyta;Magnoliophyta;Santalales;Thesidium;";"0.0";"0";"1";"1";"0";"1";"0";"430523";"5766"
"LOK1378_1mm";"SILVA (only NR);Eukaryota;Archaeplastida;Chloroplastida;Charophyta;Phragmoplastophyta;Streptophyta;Embryophyta;Tracheophyta;Spermatophyta;Magnoliophyta;Santalales;Thesium;";"0.0";"0";"2";"2";"0";"2";"0";"430522";"5766"
"LOK1378_1mm";"SILVA (only NR);Eukaryota;Archaeplastida;Chloroplastida;Charophyta;Phragmoplastophyta;Streptophyta;Embryophyta;Tracheophyta;Spermatophyta;Magnoliophyta;Santalales;Thonningia;";"0.0";"0";"1";"1";"0";"1";"0";"430523";"5766"
"LOK1378_1mm";"SILVA (only NR);Eukaryota;Archaeplastida;Chloroplastida;Charophyta;Phragmoplastophyta;Streptophyta;Embryophyta;Tracheophyta;Spermatophyta;Magnoliophyta;Santalales;Tristerix;";"0.0";"0";"1";"1";"0";"1";"0";"430523";"5766"
"LOK1378_1mm";"SILVA (only NR);Eukaryota;Archaeplastida;Chloroplastida;Charophyta;Phragmoplastophyta;Streptophyta;Embryophyta;Tracheophyta;Spermatophyta;Magnoliophyta;Santalales;Vanwykia;";"0.0";"0";"1";"1";"0";"1";"0";"430523";"5766"
"LOK1378_1mm";"SILVA (only NR);Eukaryota;Archaeplastida;Chloroplastida;Charophyta;Phragmoplastophyta;Streptophyta;Embryophyta;Tracheophyta;Spermatophyta;Magnoliophyta;Santalales;Viscum;";"0.0";"0";"3";"3";"0";"3";"0";"430521";"5766"
"LOK1378_1mm";"SILVA (only NR);Eukaryota;Archaeplastida;Chloroplastida;Charophyta;Phragmoplastophyta;Streptophyta;Embryophyta;Tracheophyta;Spermatophyta;Magnoliophyta;Santalales;Ximenia;";"0.0";"0";"1";"1";"0";"1";"0";"430523";"5766"
"LOK1378_1mm";"SILVA (only NR);Eukaryota;Archaeplastida;Chloroplastida;Charophyta;Phragmoplastophyta;Streptophyta;Embryophyta;Tracheophyta;Spermatophyta;Magnoliophyta;Santales;";"0.0";"0";"1";"1";"0";"1";"0";"430523";"5766"
"LOK1378_1mm";"SILVA (only NR);Eukaryota;Archaeplastida;Chloroplastida;Charophyta;Phragmoplastophyta;Streptophyta;Embryophyta;Tracheophyta;Spermatophyta;Magnoliophyta;Santales;Minquartia;";"0.0";"0";"1";"1";"0";"1";"0";"430523";"5766"
"LOK1378_1mm";"SILVA (only NR);Eukaryota;Archaeplastida;Chloroplastida;Charophyta;Phragmoplastophyta;Streptophyta;Embryophyta;Tracheophyta;Spermatophyta;Magnoliophyta;Sapindales;";"0.0";"0";"44";"37";"0";"37";"7";"430487";"5766"
"LOK1378_1mm";"SILVA (only NR);Eukaryota;Archaeplastida;Chloroplastida;Charophyta;Phragmoplastophyta;Streptophyta;Embryophyta;Tracheophyta;Spermatophyta;Magnoliophyta;Sapindales;Anacardium;";"0.0";"0";"1";"1";"0";"1";"0";"430523";"5766"
"LOK1378_1mm";"SILVA (only NR);Eukaryota;Archaeplastida;Chloroplastida;Charophyta;Phragmoplastophyta;Streptophyta;Embryophyta;Tracheophyta;Spermatophyta;Magnoliophyta;Sapindales;Atalantia;";"0.0";"0";"1";"1";"0";"1";"0";"430523";"5766"
"LOK1378_1mm";"SILVA (only NR);Eukaryota;Archaeplastida;Chloroplastida;Charophyta;Phragmoplastophyta;Streptophyta;Embryophyta;Tracheophyta;Spermatophyta;Magnoliophyta;Sapindales;Azadirachta;";"0.0";"0";"1";"0";"0";"0";"1";"430524";"5766"
"LOK1378_1mm";"SILVA (only NR);Eukaryota;Archaeplastida;Chloroplastida;Charophyta;Phragmoplastophyta;Streptophyta;Embryophyta;Tracheophyta;Spermatophyta;Magnoliophyta;Sapindales;Biebersteinia;";"0.0";"0";"1";"1";"0";"1";"0";"430523";"5766"
"LOK1378_1mm";"SILVA (only NR);Eukaryota;Archaeplastida;Chloroplastida;Charophyta;Phragmoplastophyta;Streptophyta;Embryophyta;Tracheophyta;Spermatophyta;Magnoliophyta;Sapindales;Bursera;";"0.0";"0";"1";"1";"0";"1";"0";"430523";"5766"
"LOK1378_1mm";"SILVA (only NR);Eukaryota;Archaeplastida;Chloroplastida;Charophyta;Phragmoplastophyta;Streptophyta;Embryophyta;Tracheophyta;Spermatophyta;Magnoliophyta;Sapindales;Citrus;";"0.0";"0";"24";"21";"0";"21";"3";"430503";"5766"
"LOK1378_1mm";"SILVA (only NR);Eukaryota;Archaeplastida;Chloroplastida;Charophyta;Phragmoplastophyta;Streptophyta;Embryophyta;Tracheophyta;Spermatophyta;Magnoliophyta;Sapindales;Dodonaea;";"0.0";"0";"1";"1";"0";"1";"0";"430523";"5766"
"LOK1378_1mm";"SILVA (only NR);Eukaryota;Archaeplastida;Chloroplastida;Charophyta;Phragmoplastophyta;Streptophyta;Embryophyta;Tracheophyta;Spermatophyta;Magnoliophyta;Sapindales;Guarea;";"0.0";"0";"1";"1";"0";"1";"0";"430523";"5766"
"LOK1378_1mm";"SILVA (only NR);Eukaryota;Archaeplastida;Chloroplastida;Charophyta;Phragmoplastophyta;Streptophyta;Embryophyta;Tracheophyta;Spermatophyta;Magnoliophyta;Sapindales;Koelreuteria;";"0.0";"0";"2";"2";"0";"2";"0";"430522";"5766"
"LOK1378_1mm";"SILVA (only NR);Eukaryota;Archaeplastida;Chloroplastida;Charophyta;Phragmoplastophyta;Streptophyta;Embryophyta;Tracheophyta;Spermatophyta;Magnoliophyta;Sapindales;Litchi;";"0.0";"0";"1";"1";"0";"1";"0";"430523";"5766"
"LOK1378_1mm";"SILVA (only NR);Eukaryota;Archaeplastida;Chloroplastida;Charophyta;Phragmoplastophyta;Streptophyta;Embryophyta;Tracheophyta;Spermatophyta;Magnoliophyta;Sapindales;Mangifera;";"0.0";"0";"7";"4";"0";"4";"3";"430520";"5766"
"LOK1378_1mm";"SILVA (only NR);Eukaryota;Archaeplastida;Chloroplastida;Charophyta;Phragmoplastophyta;Streptophyta;Embryophyta;Tracheophyta;Spermatophyta;Magnoliophyta;Sapindales;Nitraria;";"0.0";"0";"2";"2";"0";"2";"0";"430522";"5766"
"LOK1378_1mm";"SILVA (only NR);Eukaryota;Archaeplastida;Chloroplastida;Charophyta;Phragmoplastophyta;Streptophyta;Embryophyta;Tracheophyta;Spermatophyta;Magnoliophyta;Sapindales;Xylocarpus;";"0.0";"0";"1";"1";"0";"1";"0";"430523";"5766"
"LOK1378_1mm";"SILVA (only NR);Eukaryota;Archaeplastida;Chloroplastida;Charophyta;Phragmoplastophyta;Streptophyta;Embryophyta;Tracheophyta;Spermatophyta;Magnoliophyta;Saxifragales;";"0.0";"0";"17";"16";"0";"16";"1";"430508";"5766"
"LOK1378_1mm";"SILVA (only NR);Eukaryota;Archaeplastida;Chloroplastida;Charophyta;Phragmoplastophyta;Streptophyta;Embryophyta;Tracheophyta;Spermatophyta;Magnoliophyta;Saxifragales;Chrysosplenium;";"0.0";"0";"1";"1";"0";"1";"0";"430523";"5766"
"LOK1378_1mm";"SILVA (only NR);Eukaryota;Archaeplastida;Chloroplastida;Charophyta;Phragmoplastophyta;Streptophyta;Embryophyta;Tracheophyta;Spermatophyta;Magnoliophyta;Saxifragales;Crassula;";"0.0";"0";"1";"1";"0";"1";"0";"430523";"5766"
"LOK1378_1mm";"SILVA (only NR);Eukaryota;Archaeplastida;Chloroplastida;Charophyta;Phragmoplastophyta;Streptophyta;Embryophyta;Tracheophyta;Spermatophyta;Magnoliophyta;Saxifragales;Cynomorium;";"0.0";"0";"3";"2";"0";"2";"1";"430522";"5766"
"LOK1378_1mm";"SILVA (only NR);Eukaryota;Archaeplastida;Chloroplastida;Charophyta;Phragmoplastophyta;Streptophyta;Embryophyta;Tracheophyta;Spermatophyta;Magnoliophyta;Saxifragales;Fendlera;";"0.0";"0";"1";"1";"0";"1";"0";"430523";"5766"
"LOK1378_1mm";"SILVA (only NR);Eukaryota;Archaeplastida;Chloroplastida;Charophyta;Phragmoplastophyta;Streptophyta;Embryophyta;Tracheophyta;Spermatophyta;Magnoliophyta;Saxifragales;Kalanchoe;";"0.0";"0";"1";"1";"0";"1";"0";"430523";"5766"
"LOK1378_1mm";"SILVA (only NR);Eukaryota;Archaeplastida;Chloroplastida;Charophyta;Phragmoplastophyta;Streptophyta;Embryophyta;Tracheophyta;Spermatophyta;Magnoliophyta;Saxifragales;Micranthes;";"0.0";"0";"1";"1";"0";"1";"0";"430523";"5766"
"LOK1378_1mm";"SILVA (only NR);Eukaryota;Archaeplastida;Chloroplastida;Charophyta;Phragmoplastophyta;Streptophyta;Embryophyta;Tracheophyta;Spermatophyta;Magnoliophyta;Saxifragales;Myriophyllum;";"0.0";"0";"1";"1";"0";"1";"0";"430523";"5766"
"LOK1378_1mm";"SILVA (only NR);Eukaryota;Archaeplastida;Chloroplastida;Charophyta;Phragmoplastophyta;Streptophyta;Embryophyta;Tracheophyta;Spermatophyta;Magnoliophyta;Saxifragales;Mytilaria;";"0.0";"0";"1";"1";"0";"1";"0";"430523";"5766"
"LOK1378_1mm";"SILVA (only NR);Eukaryota;Archaeplastida;Chloroplastida;Charophyta;Phragmoplastophyta;Streptophyta;Embryophyta;Tracheophyta;Spermatophyta;Magnoliophyta;Saxifragales;Paeonia;";"0.0";"0";"1";"1";"0";"1";"0";"430523";"5766"
"LOK1378_1mm";"SILVA (only NR);Eukaryota;Archaeplastida;Chloroplastida;Charophyta;Phragmoplastophyta;Streptophyta;Embryophyta;Tracheophyta;Spermatophyta;Magnoliophyta;Saxifragales;Peltoboykinia;";"0.0";"0";"1";"1";"0";"1";"0";"430523";"5766"
"LOK1378_1mm";"SILVA (only NR);Eukaryota;Archaeplastida;Chloroplastida;Charophyta;Phragmoplastophyta;Streptophyta;Embryophyta;Tracheophyta;Spermatophyta;Magnoliophyta;Saxifragales;Penthorum;";"0.0";"0";"1";"1";"0";"1";"0";"430523";"5766"
"LOK1378_1mm";"SILVA (only NR);Eukaryota;Archaeplastida;Chloroplastida;Charophyta;Phragmoplastophyta;Streptophyta;Embryophyta;Tracheophyta;Spermatophyta;Magnoliophyta;Saxifragales;Peridiscus;";"0.0";"0";"1";"1";"0";"1";"0";"430523";"5766"
"LOK1378_1mm";"SILVA (only NR);Eukaryota;Archaeplastida;Chloroplastida;Charophyta;Phragmoplastophyta;Streptophyta;Embryophyta;Tracheophyta;Spermatophyta;Magnoliophyta;Saxifragales;Ribes;";"0.0";"0";"1";"1";"0";"1";"0";"430523";"5766"
"LOK1378_1mm";"SILVA (only NR);Eukaryota;Archaeplastida;Chloroplastida;Charophyta;Phragmoplastophyta;Streptophyta;Embryophyta;Tracheophyta;Spermatophyta;Magnoliophyta;Saxifragales;Saxifraga;";"0.0";"0";"1";"1";"0";"1";"0";"430523";"5766"
"LOK1378_1mm";"SILVA (only NR);Eukaryota;Archaeplastida;Chloroplastida;Charophyta;Phragmoplastophyta;Streptophyta;Embryophyta;Tracheophyta;Spermatophyta;Magnoliophyta;Saxifragales;Tetracarpaea;";"0.0";"0";"1";"1";"0";"1";"0";"430523";"5766"
"LOK1378_1mm";"SILVA (only NR);Eukaryota;Archaeplastida;Chloroplastida;Charophyta;Phragmoplastophyta;Streptophyta;Embryophyta;Tracheophyta;Spermatophyta;Magnoliophyta;Solanales;";"0.0";"0";"633";"583";"0";"583";"50";"429941";"5766"
"LOK1378_1mm";"SILVA (only NR);Eukaryota;Archaeplastida;Chloroplastida;Charophyta;Phragmoplastophyta;Streptophyta;Embryophyta;Tracheophyta;Spermatophyta;Magnoliophyta;Solanales;Atropa;";"0.0";"0";"1";"1";"0";"1";"0";"430523";"5766"
"LOK1378_1mm";"SILVA (only NR);Eukaryota;Archaeplastida;Chloroplastida;Charophyta;Phragmoplastophyta;Streptophyta;Embryophyta;Tracheophyta;Spermatophyta;Magnoliophyta;Solanales;Capsicum;";"0.0";"0";"83";"77";"0";"77";"6";"430447";"5766"
"LOK1378_1mm";"SILVA (only NR);Eukaryota;Archaeplastida;Chloroplastida;Charophyta;Phragmoplastophyta;Streptophyta;Embryophyta;Tracheophyta;Spermatophyta;Magnoliophyta;Solanales;Cuscuta;";"0.0";"0";"2";"2";"0";"2";"0";"430522";"5766"
"LOK1378_1mm";"SILVA (only NR);Eukaryota;Archaeplastida;Chloroplastida;Charophyta;Phragmoplastophyta;Streptophyta;Embryophyta;Tracheophyta;Spermatophyta;Magnoliophyta;Solanales;Evolvulus;";"0.0";"0";"1";"1";"0";"1";"0";"430523";"5766"
"LOK1378_1mm";"SILVA (only NR);Eukaryota;Archaeplastida;Chloroplastida;Charophyta;Phragmoplastophyta;Streptophyta;Embryophyta;Tracheophyta;Spermatophyta;Magnoliophyta;Solanales;Hydroleaceae;";"0.0";"0";"1";"1";"0";"1";"0";"430523";"5766"
"LOK1378_1mm";"SILVA (only NR);Eukaryota;Archaeplastida;Chloroplastida;Charophyta;Phragmoplastophyta;Streptophyta;Embryophyta;Tracheophyta;Spermatophyta;Magnoliophyta;Solanales;Hydroleaceae;Hydrolea;";"0.0";"0";"1";"1";"0";"1";"0";"430523";"5766"
"LOK1378_1mm";"SILVA (only NR);Eukaryota;Archaeplastida;Chloroplastida;Charophyta;Phragmoplastophyta;Streptophyta;Embryophyta;Tracheophyta;Spermatophyta;Magnoliophyta;Solanales;Ipomoea;";"0.0";"0";"324";"299";"0";"299";"25";"430225";"5766"
"LOK1378_1mm";"SILVA (only NR);Eukaryota;Archaeplastida;Chloroplastida;Charophyta;Phragmoplastophyta;Streptophyta;Embryophyta;Tracheophyta;Spermatophyta;Magnoliophyta;Solanales;Montinia;";"0.0";"0";"2";"2";"0";"2";"0";"430522";"5766"
"LOK1378_1mm";"SILVA (only NR);Eukaryota;Archaeplastida;Chloroplastida;Charophyta;Phragmoplastophyta;Streptophyta;Embryophyta;Tracheophyta;Spermatophyta;Magnoliophyta;Solanales;Nicotiana;";"0.0";"0";"142";"126";"0";"126";"16";"430398";"5766"
"LOK1378_1mm";"SILVA (only NR);Eukaryota;Archaeplastida;Chloroplastida;Charophyta;Phragmoplastophyta;Streptophyta;Embryophyta;Tracheophyta;Spermatophyta;Magnoliophyta;Solanales;Petunia;";"0.0";"0";"6";"5";"0";"5";"1";"430519";"5766"
"LOK1378_1mm";"SILVA (only NR);Eukaryota;Archaeplastida;Chloroplastida;Charophyta;Phragmoplastophyta;Streptophyta;Embryophyta;Tracheophyta;Spermatophyta;Magnoliophyta;Solanales;Phacelia;";"0.0";"0";"1";"1";"0";"1";"0";"430523";"5766"
"LOK1378_1mm";"SILVA (only NR);Eukaryota;Archaeplastida;Chloroplastida;Charophyta;Phragmoplastophyta;Streptophyta;Embryophyta;Tracheophyta;Spermatophyta;Magnoliophyta;Solanales;Schizanthus;";"0.0";"0";"1";"1";"0";"1";"0";"430523";"5766"
"LOK1378_1mm";"SILVA (only NR);Eukaryota;Archaeplastida;Chloroplastida;Charophyta;Phragmoplastophyta;Streptophyta;Embryophyta;Tracheophyta;Spermatophyta;Magnoliophyta;Solanales;Solanum;";"0.0";"0";"63";"61";"0";"61";"2";"430463";"5766"
"LOK1378_1mm";"SILVA (only NR);Eukaryota;Archaeplastida;Chloroplastida;Charophyta;Phragmoplastophyta;Streptophyta;Embryophyta;Tracheophyta;Spermatophyta;Magnoliophyta;Solanales;Sphenoclea;";"0.0";"0";"1";"1";"0";"1";"0";"430523";"5766"
"LOK1378_1mm";"SILVA (only NR);Eukaryota;Archaeplastida;Chloroplastida;Charophyta;Phragmoplastophyta;Streptophyta;Embryophyta;Tracheophyta;Spermatophyta;Magnoliophyta;Solanales;Withania;";"0.0";"0";"5";"5";"0";"5";"0";"430519";"5766"
"LOK1378_1mm";"SILVA (only NR);Eukaryota;Archaeplastida;Chloroplastida;Charophyta;Phragmoplastophyta;Streptophyta;Embryophyta;Tracheophyta;Spermatophyta;Magnoliophyta;Trochodendrales;";"0.0";"0";"1";"1";"0";"1";"0";"430523";"5766"
"LOK1378_1mm";"SILVA (only NR);Eukaryota;Archaeplastida;Chloroplastida;Charophyta;Phragmoplastophyta;Streptophyta;Embryophyta;Tracheophyta;Spermatophyta;Magnoliophyta;Trochodendrales;Trochodendron;";"0.0";"0";"1";"1";"0";"1";"0";"430523";"5766"
"LOK1378_1mm";"SILVA (only NR);Eukaryota;Archaeplastida;Chloroplastida;Charophyta;Phragmoplastophyta;Streptophyta;Embryophyta;Tracheophyta;Spermatophyta;Magnoliophyta;Vitales;";"0.0";"0";"6";"6";"0";"6";"0";"430518";"5766"
"LOK1378_1mm";"SILVA (only NR);Eukaryota;Archaeplastida;Chloroplastida;Charophyta;Phragmoplastophyta;Streptophyta;Embryophyta;Tracheophyta;Spermatophyta;Magnoliophyta;Vitales;Leea;";"0.0";"0";"1";"1";"0";"1";"0";"430523";"5766"
"LOK1378_1mm";"SILVA (only NR);Eukaryota;Archaeplastida;Chloroplastida;Charophyta;Phragmoplastophyta;Streptophyta;Embryophyta;Tracheophyta;Spermatophyta;Magnoliophyta;Vitales;Tetrastigma;";"0.0";"0";"1";"1";"0";"1";"0";"430523";"5766"
"LOK1378_1mm";"SILVA (only NR);Eukaryota;Archaeplastida;Chloroplastida;Charophyta;Phragmoplastophyta;Streptophyta;Embryophyta;Tracheophyta;Spermatophyta;Magnoliophyta;Vitales;Vitis;";"0.0";"0";"4";"4";"0";"4";"0";"430520";"5766"
"LOK1378_1mm";"SILVA (only NR);Eukaryota;Archaeplastida;Chloroplastida;Charophyta;Phragmoplastophyta;Streptophyta;Embryophyta;Tracheophyta;Spermatophyta;Magnoliophyta;Zygophyllales;";"0.0";"0";"2";"2";"0";"2";"0";"430522";"5766"
"LOK1378_1mm";"SILVA (only NR);Eukaryota;Archaeplastida;Chloroplastida;Charophyta;Phragmoplastophyta;Streptophyta;Embryophyta;Tracheophyta;Spermatophyta;Magnoliophyta;Zygophyllales;Krameria;";"0.0";"0";"1";"1";"0";"1";"0";"430523";"5766"
"LOK1378_1mm";"SILVA (only NR);Eukaryota;Archaeplastida;Chloroplastida;Charophyta;Phragmoplastophyta;Streptophyta;Embryophyta;Tracheophyta;Spermatophyta;Magnoliophyta;Zygophyllales;Larrea;";"0.0";"0";"1";"1";"0";"1";"0";"430523";"5766"
"LOK1378_1mm";"SILVA (only NR);Eukaryota;Archaeplastida;Chloroplastida;Charophyta;Phragmoplastophyta;Streptophyta;Embryophyta;Tracheophyta;Spermatophyta;Pinophyta;";"0.0";"0";"686";"624";"0";"624";"62";"429900";"5766"
"LOK1378_1mm";"SILVA (only NR);Eukaryota;Archaeplastida;Chloroplastida;Charophyta;Phragmoplastophyta;Streptophyta;Embryophyta;Tracheophyta;Spermatophyta;Pinophyta;Araucariales;";"0.0";"0";"19";"19";"0";"19";"0";"430505";"5766"
"LOK1378_1mm";"SILVA (only NR);Eukaryota;Archaeplastida;Chloroplastida;Charophyta;Phragmoplastophyta;Streptophyta;Embryophyta;Tracheophyta;Spermatophyta;Pinophyta;Araucariales;Afrocarpus;";"0.0";"0";"1";"1";"0";"1";"0";"430523";"5766"
"LOK1378_1mm";"SILVA (only NR);Eukaryota;Archaeplastida;Chloroplastida;Charophyta;Phragmoplastophyta;Streptophyta;Embryophyta;Tracheophyta;Spermatophyta;Pinophyta;Araucariales;Agathis;";"0.0";"0";"1";"1";"0";"1";"0";"430523";"5766"
"LOK1378_1mm";"SILVA (only NR);Eukaryota;Archaeplastida;Chloroplastida;Charophyta;Phragmoplastophyta;Streptophyta;Embryophyta;Tracheophyta;Spermatophyta;Pinophyta;Araucariales;Araucaria;";"0.0";"0";"6";"6";"0";"6";"0";"430518";"5766"
"LOK1378_1mm";"SILVA (only NR);Eukaryota;Archaeplastida;Chloroplastida;Charophyta;Phragmoplastophyta;Streptophyta;Embryophyta;Tracheophyta;Spermatophyta;Pinophyta;Araucariales;Dacrydium;";"0.0";"0";"1";"1";"0";"1";"0";"430523";"5766"
"LOK1378_1mm";"SILVA (only NR);Eukaryota;Archaeplastida;Chloroplastida;Charophyta;Phragmoplastophyta;Streptophyta;Embryophyta;Tracheophyta;Spermatophyta;Pinophyta;Araucariales;Halocarpus;";"0.0";"0";"1";"1";"0";"1";"0";"430523";"5766"
"LOK1378_1mm";"SILVA (only NR);Eukaryota;Archaeplastida;Chloroplastida;Charophyta;Phragmoplastophyta;Streptophyta;Embryophyta;Tracheophyta;Spermatophyta;Pinophyta;Araucariales;Lagarostrobos;";"0.0";"0";"1";"1";"0";"1";"0";"430523";"5766"
"LOK1378_1mm";"SILVA (only NR);Eukaryota;Archaeplastida;Chloroplastida;Charophyta;Phragmoplastophyta;Streptophyta;Embryophyta;Tracheophyta;Spermatophyta;Pinophyta;Araucariales;Manoao;";"0.0";"0";"1";"1";"0";"1";"0";"430523";"5766"
"LOK1378_1mm";"SILVA (only NR);Eukaryota;Archaeplastida;Chloroplastida;Charophyta;Phragmoplastophyta;Streptophyta;Embryophyta;Tracheophyta;Spermatophyta;Pinophyta;Araucariales;Microcachrys;";"0.0";"0";"1";"1";"0";"1";"0";"430523";"5766"
"LOK1378_1mm";"SILVA (only NR);Eukaryota;Archaeplastida;Chloroplastida;Charophyta;Phragmoplastophyta;Streptophyta;Embryophyta;Tracheophyta;Spermatophyta;Pinophyta;Araucariales;Parasitaxus;";"0.0";"0";"1";"1";"0";"1";"0";"430523";"5766"
"LOK1378_1mm";"SILVA (only NR);Eukaryota;Archaeplastida;Chloroplastida;Charophyta;Phragmoplastophyta;Streptophyta;Embryophyta;Tracheophyta;Spermatophyta;Pinophyta;Araucariales;Pherosphaera;";"0.0";"0";"1";"1";"0";"1";"0";"430523";"5766"
"LOK1378_1mm";"SILVA (only NR);Eukaryota;Archaeplastida;Chloroplastida;Charophyta;Phragmoplastophyta;Streptophyta;Embryophyta;Tracheophyta;Spermatophyta;Pinophyta;Araucariales;Phyllocladus;";"0.0";"0";"1";"1";"0";"1";"0";"430523";"5766"
"LOK1378_1mm";"SILVA (only NR);Eukaryota;Archaeplastida;Chloroplastida;Charophyta;Phragmoplastophyta;Streptophyta;Embryophyta;Tracheophyta;Spermatophyta;Pinophyta;Araucariales;Podocarpus;";"0.0";"0";"1";"1";"0";"1";"0";"430523";"5766"
"LOK1378_1mm";"SILVA (only NR);Eukaryota;Archaeplastida;Chloroplastida;Charophyta;Phragmoplastophyta;Streptophyta;Embryophyta;Tracheophyta;Spermatophyta;Pinophyta;Araucariales;Prumnopitys;";"0.0";"0";"1";"1";"0";"1";"0";"430523";"5766"
"LOK1378_1mm";"SILVA (only NR);Eukaryota;Archaeplastida;Chloroplastida;Charophyta;Phragmoplastophyta;Streptophyta;Embryophyta;Tracheophyta;Spermatophyta;Pinophyta;Araucariales;Saxegothaea;";"0.0";"0";"1";"1";"0";"1";"0";"430523";"5766"
"LOK1378_1mm";"SILVA (only NR);Eukaryota;Archaeplastida;Chloroplastida;Charophyta;Phragmoplastophyta;Streptophyta;Embryophyta;Tracheophyta;Spermatophyta;Pinophyta;Cupressales;";"0.0";"0";"23";"22";"0";"22";"1";"430502";"5766"
"LOK1378_1mm";"SILVA (only NR);Eukaryota;Archaeplastida;Chloroplastida;Charophyta;Phragmoplastophyta;Streptophyta;Embryophyta;Tracheophyta;Spermatophyta;Pinophyta;Cupressales;Actinostrobus;";"0.0";"0";"1";"1";"0";"1";"0";"430523";"5766"
"LOK1378_1mm";"SILVA (only NR);Eukaryota;Archaeplastida;Chloroplastida;Charophyta;Phragmoplastophyta;Streptophyta;Embryophyta;Tracheophyta;Spermatophyta;Pinophyta;Cupressales;Amentotaxus;";"0.0";"0";"1";"1";"0";"1";"0";"430523";"5766"
"LOK1378_1mm";"SILVA (only NR);Eukaryota;Archaeplastida;Chloroplastida;Charophyta;Phragmoplastophyta;Streptophyta;Embryophyta;Tracheophyta;Spermatophyta;Pinophyta;Cupressales;Austrocedrus;";"0.0";"0";"1";"1";"0";"1";"0";"430523";"5766"
"LOK1378_1mm";"SILVA (only NR);Eukaryota;Archaeplastida;Chloroplastida;Charophyta;Phragmoplastophyta;Streptophyta;Embryophyta;Tracheophyta;Spermatophyta;Pinophyta;Cupressales;Austrotaxus;";"0.0";"0";"1";"1";"0";"1";"0";"430523";"5766"
"LOK1378_1mm";"SILVA (only NR);Eukaryota;Archaeplastida;Chloroplastida;Charophyta;Phragmoplastophyta;Streptophyta;Embryophyta;Tracheophyta;Spermatophyta;Pinophyta;Cupressales;Callitropsis;";"0.0";"0";"1";"1";"0";"1";"0";"430523";"5766"
"LOK1378_1mm";"SILVA (only NR);Eukaryota;Archaeplastida;Chloroplastida;Charophyta;Phragmoplastophyta;Streptophyta;Embryophyta;Tracheophyta;Spermatophyta;Pinophyta;Cupressales;Calocedrus;";"0.0";"0";"1";"1";"0";"1";"0";"430523";"5766"
"LOK1378_1mm";"SILVA (only NR);Eukaryota;Archaeplastida;Chloroplastida;Charophyta;Phragmoplastophyta;Streptophyta;Embryophyta;Tracheophyta;Spermatophyta;Pinophyta;Cupressales;Chamaecyparis;";"0.0";"0";"2";"2";"0";"2";"0";"430522";"5766"
"LOK1378_1mm";"SILVA (only NR);Eukaryota;Archaeplastida;Chloroplastida;Charophyta;Phragmoplastophyta;Streptophyta;Embryophyta;Tracheophyta;Spermatophyta;Pinophyta;Cupressales;Cunninghamia;";"0.0";"0";"1";"1";"0";"1";"0";"430523";"5766"
"LOK1378_1mm";"SILVA (only NR);Eukaryota;Archaeplastida;Chloroplastida;Charophyta;Phragmoplastophyta;Streptophyta;Embryophyta;Tracheophyta;Spermatophyta;Pinophyta;Cupressales;Cupressus;";"0.0";"0";"1";"1";"0";"1";"0";"430523";"5766"
"LOK1378_1mm";"SILVA (only NR);Eukaryota;Archaeplastida;Chloroplastida;Charophyta;Phragmoplastophyta;Streptophyta;Embryophyta;Tracheophyta;Spermatophyta;Pinophyta;Cupressales;Hesperocyparis;";"0.0";"0";"1";"1";"0";"1";"0";"430523";"5766"
"LOK1378_1mm";"SILVA (only NR);Eukaryota;Archaeplastida;Chloroplastida;Charophyta;Phragmoplastophyta;Streptophyta;Embryophyta;Tracheophyta;Spermatophyta;Pinophyta;Cupressales;Juniperus;";"0.0";"0";"2";"1";"0";"1";"1";"430523";"5766"
"LOK1378_1mm";"SILVA (only NR);Eukaryota;Archaeplastida;Chloroplastida;Charophyta;Phragmoplastophyta;Streptophyta;Embryophyta;Tracheophyta;Spermatophyta;Pinophyta;Cupressales;Metasequoia;";"0.0";"0";"1";"1";"0";"1";"0";"430523";"5766"
"LOK1378_1mm";"SILVA (only NR);Eukaryota;Archaeplastida;Chloroplastida;Charophyta;Phragmoplastophyta;Streptophyta;Embryophyta;Tracheophyta;Spermatophyta;Pinophyta;Cupressales;Sciadopitys;";"0.0";"0";"1";"1";"0";"1";"0";"430523";"5766"
"LOK1378_1mm";"SILVA (only NR);Eukaryota;Archaeplastida;Chloroplastida;Charophyta;Phragmoplastophyta;Streptophyta;Embryophyta;Tracheophyta;Spermatophyta;Pinophyta;Cupressales;Sequoia;";"0.0";"0";"1";"1";"0";"1";"0";"430523";"5766"
"LOK1378_1mm";"SILVA (only NR);Eukaryota;Archaeplastida;Chloroplastida;Charophyta;Phragmoplastophyta;Streptophyta;Embryophyta;Tracheophyta;Spermatophyta;Pinophyta;Cupressales;Taiwania;";"0.0";"0";"1";"1";"0";"1";"0";"430523";"5766"
"LOK1378_1mm";"SILVA (only NR);Eukaryota;Archaeplastida;Chloroplastida;Charophyta;Phragmoplastophyta;Streptophyta;Embryophyta;Tracheophyta;Spermatophyta;Pinophyta;Cupressales;Taxus;";"0.0";"0";"6";"6";"0";"6";"0";"430518";"5766"
"LOK1378_1mm";"SILVA (only NR);Eukaryota;Archaeplastida;Chloroplastida;Charophyta;Phragmoplastophyta;Streptophyta;Embryophyta;Tracheophyta;Spermatophyta;Pinophyta;Pinales;";"0.0";"0";"634";"573";"0";"573";"61";"429951";"5766"
"LOK1378_1mm";"SILVA (only NR);Eukaryota;Archaeplastida;Chloroplastida;Charophyta;Phragmoplastophyta;Streptophyta;Embryophyta;Tracheophyta;Spermatophyta;Pinophyta;Pinales;Abies;";"0.0";"0";"1";"1";"0";"1";"0";"430523";"5766"
"LOK1378_1mm";"SILVA (only NR);Eukaryota;Archaeplastida;Chloroplastida;Charophyta;Phragmoplastophyta;Streptophyta;Embryophyta;Tracheophyta;Spermatophyta;Pinophyta;Pinales;Cathaya;";"0.0";"0";"1";"1";"0";"1";"0";"430523";"5766"
"LOK1378_1mm";"SILVA (only NR);Eukaryota;Archaeplastida;Chloroplastida;Charophyta;Phragmoplastophyta;Streptophyta;Embryophyta;Tracheophyta;Spermatophyta;Pinophyta;Pinales;Cedrus;";"0.0";"0";"2";"2";"0";"2";"0";"430522";"5766"
"LOK1378_1mm";"SILVA (only NR);Eukaryota;Archaeplastida;Chloroplastida;Charophyta;Phragmoplastophyta;Streptophyta;Embryophyta;Tracheophyta;Spermatophyta;Pinophyta;Pinales;Nothotsuga;";"0.0";"0";"2";"2";"0";"2";"0";"430522";"5766"
"LOK1378_1mm";"SILVA (only NR);Eukaryota;Archaeplastida;Chloroplastida;Charophyta;Phragmoplastophyta;Streptophyta;Embryophyta;Tracheophyta;Spermatophyta;Pinophyta;Pinales;Picea;";"0.0";"0";"79";"66";"0";"66";"13";"430458";"5766"
"LOK1378_1mm";"SILVA (only NR);Eukaryota;Archaeplastida;Chloroplastida;Charophyta;Phragmoplastophyta;Streptophyta;Embryophyta;Tracheophyta;Spermatophyta;Pinophyta;Pinales;Pinus;";"0.0";"0";"548";"500";"0";"500";"48";"430024";"5766"
"LOK1378_1mm";"SILVA (only NR);Eukaryota;Archaeplastida;Chloroplastida;Charophyta;Phragmoplastophyta;Streptophyta;Embryophyta;Tracheophyta;Spermatophyta;Pinophyta;Pinales;Pseudolarix;";"0.0";"0";"1";"1";"0";"1";"0";"430523";"5766"
"LOK1378_1mm";"SILVA (only NR);Eukaryota;Archaeplastida;Chloroplastida;Charophyta;Phragmoplastophyta;Streptophyta;Embryophyta;uncultured;";"0.0";"0";"5";"5";"0";"5";"0";"430519";"5766"
"LOK1378_1mm";"SILVA (only NR);Eukaryota;Archaeplastida;Chloroplastida;Charophyta;Phragmoplastophyta;Zygnematophyceae;";"0.0";"0";"170";"170";"0";"170";"0";"430354";"5766"
"LOK1378_1mm";"SILVA (only NR);Eukaryota;Archaeplastida;Chloroplastida;Charophyta;Phragmoplastophyta;Zygnematophyceae;Desmidiales;";"0.0";"0";"107";"107";"0";"107";"0";"430417";"5766"
"LOK1378_1mm";"SILVA (only NR);Eukaryota;Archaeplastida;Chloroplastida;Charophyta;Phragmoplastophyta;Zygnematophyceae;Desmidiales;Actinotaenium;";"0.0";"0";"5";"5";"0";"5";"0";"430519";"5766"
"LOK1378_1mm";"SILVA (only NR);Eukaryota;Archaeplastida;Chloroplastida;Charophyta;Phragmoplastophyta;Zygnematophyceae;Desmidiales;Closterium;";"0.0";"0";"15";"15";"0";"15";"0";"430509";"5766"
"LOK1378_1mm";"SILVA (only NR);Eukaryota;Archaeplastida;Chloroplastida;Charophyta;Phragmoplastophyta;Zygnematophyceae;Desmidiales;Cosmarium;";"0.0";"0";"29";"29";"0";"29";"0";"430495";"5766"
"LOK1378_1mm";"SILVA (only NR);Eukaryota;Archaeplastida;Chloroplastida;Charophyta;Phragmoplastophyta;Zygnematophyceae;Desmidiales;Cosmocladium;";"0.0";"0";"1";"1";"0";"1";"0";"430523";"5766"
"LOK1378_1mm";"SILVA (only NR);Eukaryota;Archaeplastida;Chloroplastida;Charophyta;Phragmoplastophyta;Zygnematophyceae;Desmidiales;Desmidium;";"0.0";"0";"1";"1";"0";"1";"0";"430523";"5766"
"LOK1378_1mm";"SILVA (only NR);Eukaryota;Archaeplastida;Chloroplastida;Charophyta;Phragmoplastophyta;Zygnematophyceae;Desmidiales;Euastrum;";"0.0";"0";"6";"6";"0";"6";"0";"430518";"5766"
"LOK1378_1mm";"SILVA (only NR);Eukaryota;Archaeplastida;Chloroplastida;Charophyta;Phragmoplastophyta;Zygnematophyceae;Desmidiales;Genicularia;";"0.0";"0";"1";"1";"0";"1";"0";"430523";"5766"
"LOK1378_1mm";"SILVA (only NR);Eukaryota;Archaeplastida;Chloroplastida;Charophyta;Phragmoplastophyta;Zygnematophyceae;Desmidiales;Gonatozygon;";"0.0";"0";"5";"5";"0";"5";"0";"430519";"5766"
"LOK1378_1mm";"SILVA (only NR);Eukaryota;Archaeplastida;Chloroplastida;Charophyta;Phragmoplastophyta;Zygnematophyceae;Desmidiales;Groenbladia;";"0.0";"0";"1";"1";"0";"1";"0";"430523";"5766"
"LOK1378_1mm";"SILVA (only NR);Eukaryota;Archaeplastida;Chloroplastida;Charophyta;Phragmoplastophyta;Zygnematophyceae;Desmidiales;Haplotaenium;";"0.0";"0";"1";"1";"0";"1";"0";"430523";"5766"
"LOK1378_1mm";"SILVA (only NR);Eukaryota;Archaeplastida;Chloroplastida;Charophyta;Phragmoplastophyta;Zygnematophyceae;Desmidiales;Hyalotheca;";"0.0";"0";"3";"3";"0";"3";"0";"430521";"5766"
"LOK1378_1mm";"SILVA (only NR);Eukaryota;Archaeplastida;Chloroplastida;Charophyta;Phragmoplastophyta;Zygnematophyceae;Desmidiales;Micrasterias;";"0.0";"0";"11";"11";"0";"11";"0";"430513";"5766"
"LOK1378_1mm";"SILVA (only NR);Eukaryota;Archaeplastida;Chloroplastida;Charophyta;Phragmoplastophyta;Zygnematophyceae;Desmidiales;Penium;";"0.0";"0";"6";"6";"0";"6";"0";"430518";"5766"
"LOK1378_1mm";"SILVA (only NR);Eukaryota;Archaeplastida;Chloroplastida;Charophyta;Phragmoplastophyta;Zygnematophyceae;Desmidiales;Phymatodocis;";"0.0";"0";"1";"1";"0";"1";"0";"430523";"5766"
"LOK1378_1mm";"SILVA (only NR);Eukaryota;Archaeplastida;Chloroplastida;Charophyta;Phragmoplastophyta;Zygnematophyceae;Desmidiales;Pleurotaenium;";"0.0";"0";"1";"1";"0";"1";"0";"430523";"5766"
"LOK1378_1mm";"SILVA (only NR);Eukaryota;Archaeplastida;Chloroplastida;Charophyta;Phragmoplastophyta;Zygnematophyceae;Desmidiales;Sphaerozosma;";"0.0";"0";"1";"1";"0";"1";"0";"430523";"5766"
"LOK1378_1mm";"SILVA (only NR);Eukaryota;Archaeplastida;Chloroplastida;Charophyta;Phragmoplastophyta;Zygnematophyceae;Desmidiales;Spinoclosterium;";"0.0";"0";"1";"1";"0";"1";"0";"430523";"5766"
"LOK1378_1mm";"SILVA (only NR);Eukaryota;Archaeplastida;Chloroplastida;Charophyta;Phragmoplastophyta;Zygnematophyceae;Desmidiales;Spondylosium;";"0.0";"0";"3";"3";"0";"3";"0";"430521";"5766"
"LOK1378_1mm";"SILVA (only NR);Eukaryota;Archaeplastida;Chloroplastida;Charophyta;Phragmoplastophyta;Zygnematophyceae;Desmidiales;Staurastrum;";"0.0";"0";"6";"6";"0";"6";"0";"430518";"5766"
"LOK1378_1mm";"SILVA (only NR);Eukaryota;Archaeplastida;Chloroplastida;Charophyta;Phragmoplastophyta;Zygnematophyceae;Desmidiales;Staurodesmus;";"0.0";"0";"7";"7";"0";"7";"0";"430517";"5766"
"LOK1378_1mm";"SILVA (only NR);Eukaryota;Archaeplastida;Chloroplastida;Charophyta;Phragmoplastophyta;Zygnematophyceae;Desmidiales;Tetmemorus;";"0.0";"0";"1";"1";"0";"1";"0";"430523";"5766"
"LOK1378_1mm";"SILVA (only NR);Eukaryota;Archaeplastida;Chloroplastida;Charophyta;Phragmoplastophyta;Zygnematophyceae;Desmidiales;Xanthidium;";"0.0";"0";"1";"1";"0";"1";"0";"430523";"5766"
"LOK1378_1mm";"SILVA (only NR);Eukaryota;Archaeplastida;Chloroplastida;Charophyta;Phragmoplastophyta;Zygnematophyceae;Mesotaeniaceae;";"0.0";"0";"1";"1";"0";"1";"0";"430523";"5766"
"LOK1378_1mm";"SILVA (only NR);Eukaryota;Archaeplastida;Chloroplastida;Charophyta;Phragmoplastophyta;Zygnematophyceae;Zygnematales;";"0.0";"0";"56";"56";"0";"56";"0";"430468";"5766"
"LOK1378_1mm";"SILVA (only NR);Eukaryota;Archaeplastida;Chloroplastida;Charophyta;Phragmoplastophyta;Zygnematophyceae;Zygnematales;Ancylonema;";"0.0";"0";"1";"1";"0";"1";"0";"430523";"5766"
"LOK1378_1mm";"SILVA (only NR);Eukaryota;Archaeplastida;Chloroplastida;Charophyta;Phragmoplastophyta;Zygnematophyceae;Zygnematales;Cylindrocystis;";"0.0";"0";"5";"5";"0";"5";"0";"430519";"5766"
"LOK1378_1mm";"SILVA (only NR);Eukaryota;Archaeplastida;Chloroplastida;Charophyta;Phragmoplastophyta;Zygnematophyceae;Zygnematales;Fottea;";"0.0";"0";"1";"1";"0";"1";"0";"430523";"5766"
"LOK1378_1mm";"SILVA (only NR);Eukaryota;Archaeplastida;Chloroplastida;Charophyta;Phragmoplastophyta;Zygnematophyceae;Zygnematales;Mesotaenium;";"0.0";"0";"5";"5";"0";"5";"0";"430519";"5766"
"LOK1378_1mm";"SILVA (only NR);Eukaryota;Archaeplastida;Chloroplastida;Charophyta;Phragmoplastophyta;Zygnematophyceae;Zygnematales;Mougeotia;";"0.0";"0";"2";"2";"0";"2";"0";"430522";"5766"
"LOK1378_1mm";"SILVA (only NR);Eukaryota;Archaeplastida;Chloroplastida;Charophyta;Phragmoplastophyta;Zygnematophyceae;Zygnematales;Netrium;";"0.0";"0";"3";"3";"0";"3";"0";"430521";"5766"
"LOK1378_1mm";"SILVA (only NR);Eukaryota;Archaeplastida;Chloroplastida;Charophyta;Phragmoplastophyta;Zygnematophyceae;Zygnematales;Nucleotaenium;";"0.0";"0";"2";"2";"0";"2";"0";"430522";"5766"
"LOK1378_1mm";"SILVA (only NR);Eukaryota;Archaeplastida;Chloroplastida;Charophyta;Phragmoplastophyta;Zygnematophyceae;Zygnematales;Planotaenium;";"0.0";"0";"2";"2";"0";"2";"0";"430522";"5766"
"LOK1378_1mm";"SILVA (only NR);Eukaryota;Archaeplastida;Chloroplastida;Charophyta;Phragmoplastophyta;Zygnematophyceae;Zygnematales;Roya;";"0.0";"0";"1";"1";"0";"1";"0";"430523";"5766"
"LOK1378_1mm";"SILVA (only NR);Eukaryota;Archaeplastida;Chloroplastida;Charophyta;Phragmoplastophyta;Zygnematophyceae;Zygnematales;Sirogonium;";"0.0";"0";"1";"1";"0";"1";"0";"430523";"5766"
"LOK1378_1mm";"SILVA (only NR);Eukaryota;Archaeplastida;Chloroplastida;Charophyta;Phragmoplastophyta;Zygnematophyceae;Zygnematales;Spirogyra;";"0.0";"0";"24";"24";"0";"24";"0";"430500";"5766"
"LOK1378_1mm";"SILVA (only NR);Eukaryota;Archaeplastida;Chloroplastida;Charophyta;Phragmoplastophyta;Zygnematophyceae;Zygnematales;Spirotaenia;";"0.0";"0";"1";"1";"0";"1";"0";"430523";"5766"
"LOK1378_1mm";"SILVA (only NR);Eukaryota;Archaeplastida;Chloroplastida;Charophyta;Phragmoplastophyta;Zygnematophyceae;Zygnematales;Tortitaenia;";"0.0";"0";"2";"2";"0";"2";"0";"430522";"5766"
"LOK1378_1mm";"SILVA (only NR);Eukaryota;Archaeplastida;Chloroplastida;Charophyta;Phragmoplastophyta;Zygnematophyceae;Zygnematales;Zygnema;";"0.0";"0";"4";"4";"0";"4";"0";"430520";"5766"
"LOK1378_1mm";"SILVA (only NR);Eukaryota;Archaeplastida;Chloroplastida;Charophyta;Phragmoplastophyta;Zygnematophyceae;Zygnematales;Zygnemopsis;";"0.0";"0";"1";"1";"0";"1";"0";"430523";"5766"
"LOK1378_1mm";"SILVA (only NR);Eukaryota;Archaeplastida;Chloroplastida;Charophyta;Phragmoplastophyta;Zygnematophyceae;Zygnematales;Zygogonium;";"0.0";"0";"1";"1";"0";"1";"0";"430523";"5766"
"LOK1378_1mm";"SILVA (only NR);Eukaryota;Archaeplastida;Chloroplastida;Chlorophyta;";"0.0";"0";"1908";"1813";"0";"1813";"95";"428711";"5766"
"LOK1378_1mm";"SILVA (only NR);Eukaryota;Archaeplastida;Chloroplastida;Chlorophyta;Chlorodendrophyceae;";"0.0";"0";"28";"27";"0";"27";"1";"430497";"5766"
"LOK1378_1mm";"SILVA (only NR);Eukaryota;Archaeplastida;Chloroplastida;Chlorophyta;Chlorodendrophyceae;Chlorodendrales;";"0.0";"0";"26";"25";"0";"25";"1";"430499";"5766"
"LOK1378_1mm";"SILVA (only NR);Eukaryota;Archaeplastida;Chloroplastida;Chlorophyta;Chlorodendrophyceae;Chlorodendrales;Scherffelia;";"0.0";"0";"1";"1";"0";"1";"0";"430523";"5766"
"LOK1378_1mm";"SILVA (only NR);Eukaryota;Archaeplastida;Chloroplastida;Chlorophyta;Chlorodendrophyceae;Chlorodendrales;Tetraselmis;";"0.0";"0";"25";"24";"0";"24";"1";"430500";"5766"
"LOK1378_1mm";"SILVA (only NR);Eukaryota;Archaeplastida;Chloroplastida;Chlorophyta;Chlorophyceae;";"0.0";"0";"783";"746";"0";"746";"37";"429778";"5766"
"LOK1378_1mm";"SILVA (only NR);Eukaryota;Archaeplastida;Chloroplastida;Chlorophyta;Chlorophyceae;Chaetopeltidales;";"0.0";"0";"5";"5";"0";"5";"0";"430519";"5766"
"LOK1378_1mm";"SILVA (only NR);Eukaryota;Archaeplastida;Chloroplastida;Chlorophyta;Chlorophyceae;Chaetopeltidales;Chaetopeltis;";"0.0";"0";"1";"1";"0";"1";"0";"430523";"5766"
"LOK1378_1mm";"SILVA (only NR);Eukaryota;Archaeplastida;Chloroplastida;Chlorophyta;Chlorophyceae;Chaetopeltidales;Dicranochaete;";"0.0";"0";"1";"1";"0";"1";"0";"430523";"5766"
"LOK1378_1mm";"SILVA (only NR);Eukaryota;Archaeplastida;Chloroplastida;Chlorophyta;Chlorophyceae;Chaetopeltidales;Floydiella;";"0.0";"0";"1";"1";"0";"1";"0";"430523";"5766"
"LOK1378_1mm";"SILVA (only NR);Eukaryota;Archaeplastida;Chloroplastida;Chlorophyta;Chlorophyceae;Chaetopeltidales;Hormotilopsis;";"0.0";"0";"1";"1";"0";"1";"0";"430523";"5766"
"LOK1378_1mm";"SILVA (only NR);Eukaryota;Archaeplastida;Chloroplastida;Chlorophyta;Chlorophyceae;Chaetopeltidales;Koshicola;";"0.0";"0";"1";"1";"0";"1";"0";"430523";"5766"
"LOK1378_1mm";"SILVA (only NR);Eukaryota;Archaeplastida;Chloroplastida;Chlorophyta;Chlorophyceae;Chaetophorales;";"0.0";"0";"13";"13";"0";"13";"0";"430511";"5766"
"LOK1378_1mm";"SILVA (only NR);Eukaryota;Archaeplastida;Chloroplastida;Chlorophyta;Chlorophyceae;Chaetophorales;Aphanochaete;";"0.0";"0";"4";"4";"0";"4";"0";"430520";"5766"
"LOK1378_1mm";"SILVA (only NR);Eukaryota;Archaeplastida;Chloroplastida;Chlorophyta;Chlorophyceae;Chaetophorales;Barranca;";"0.0";"0";"1";"1";"0";"1";"0";"430523";"5766"
"LOK1378_1mm";"SILVA (only NR);Eukaryota;Archaeplastida;Chloroplastida;Chlorophyta;Chlorophyceae;Chaetophorales;Chaetophora;";"0.0";"0";"3";"3";"0";"3";"0";"430521";"5766"
"LOK1378_1mm";"SILVA (only NR);Eukaryota;Archaeplastida;Chloroplastida;Chlorophyta;Chlorophyceae;Chaetophorales;Gloeococcus;";"0.0";"0";"1";"1";"0";"1";"0";"430523";"5766"
"LOK1378_1mm";"SILVA (only NR);Eukaryota;Archaeplastida;Chloroplastida;Chlorophyta;Chlorophyceae;Chaetophorales;Schizomeris;";"0.0";"0";"1";"1";"0";"1";"0";"430523";"5766"
"LOK1378_1mm";"SILVA (only NR);Eukaryota;Archaeplastida;Chloroplastida;Chlorophyta;Chlorophyceae;Chaetophorales;Stigeoclonium;";"0.0";"0";"3";"3";"0";"3";"0";"430521";"5766"
"LOK1378_1mm";"SILVA (only NR);Eukaryota;Archaeplastida;Chloroplastida;Chlorophyta;Chlorophyceae;Chlamydomonadales;";"0.0";"0";"275";"268";"0";"268";"7";"430256";"5766"
"LOK1378_1mm";"SILVA (only NR);Eukaryota;Archaeplastida;Chloroplastida;Chlorophyta;Chlorophyceae;Chlamydomonadales;Actinochloris;";"0.0";"0";"2";"2";"0";"2";"0";"430522";"5766"
"LOK1378_1mm";"SILVA (only NR);Eukaryota;Archaeplastida;Chloroplastida;Chlorophyta;Chlorophyceae;Chlamydomonadales;Ascochloris;";"0.0";"0";"1";"1";"0";"1";"0";"430523";"5766"
"LOK1378_1mm";"SILVA (only NR);Eukaryota;Archaeplastida;Chloroplastida;Chlorophyta;Chlorophyceae;Chlamydomonadales;Asteromonas;";"0.0";"0";"1";"1";"0";"1";"0";"430523";"5766"
"LOK1378_1mm";"SILVA (only NR);Eukaryota;Archaeplastida;Chloroplastida;Chlorophyta;Chlorophyceae;Chlamydomonadales;Astrephomene;";"0.0";"0";"2";"2";"0";"2";"0";"430522";"5766"
"LOK1378_1mm";"SILVA (only NR);Eukaryota;Archaeplastida;Chloroplastida;Chlorophyta;Chlorophyceae;Chlamydomonadales;Axilosphaera;";"0.0";"0";"1";"1";"0";"1";"0";"430523";"5766"
"LOK1378_1mm";"SILVA (only NR);Eukaryota;Archaeplastida;Chloroplastida;Chlorophyta;Chlorophyceae;Chlamydomonadales;Basichlamys;";"0.0";"0";"1";"1";"0";"1";"0";"430523";"5766"
"LOK1378_1mm";"SILVA (only NR);Eukaryota;Archaeplastida;Chloroplastida;Chlorophyta;Chlorophyceae;Chlamydomonadales;Brachiomonas;";"0.0";"0";"1";"1";"0";"1";"0";"430523";"5766"
"LOK1378_1mm";"SILVA (only NR);Eukaryota;Archaeplastida;Chloroplastida;Chlorophyta;Chlorophyceae;Chlamydomonadales;Cephalomonas;";"0.0";"0";"1";"1";"0";"1";"0";"430523";"5766"
"LOK1378_1mm";"SILVA (only NR);Eukaryota;Archaeplastida;Chloroplastida;Chlorophyta;Chlorophyceae;Chlamydomonadales;Characiochloris;";"0.0";"0";"2";"2";"0";"2";"0";"430522";"5766"
"LOK1378_1mm";"SILVA (only NR);Eukaryota;Archaeplastida;Chloroplastida;Chlorophyta;Chlorophyceae;Chlamydomonadales;Characium;";"0.0";"0";"3";"3";"0";"3";"0";"430521";"5766"
"LOK1378_1mm";"SILVA (only NR);Eukaryota;Archaeplastida;Chloroplastida;Chlorophyta;Chlorophyceae;Chlamydomonadales;Chlamydomonas;";"0.0";"0";"84";"82";"0";"82";"2";"430442";"5766"
"LOK1378_1mm";"SILVA (only NR);Eukaryota;Archaeplastida;Chloroplastida;Chlorophyta;Chlorophyceae;Chlamydomonadales;Chlorococcum;";"0.0";"0";"20";"20";"0";"20";"0";"430504";"5766"
"LOK1378_1mm";"SILVA (only NR);Eukaryota;Archaeplastida;Chloroplastida;Chlorophyta;Chlorophyceae;Chlamydomonadales;Chlorogonium;";"0.0";"0";"1";"1";"0";"1";"0";"430523";"5766"
"LOK1378_1mm";"SILVA (only NR);Eukaryota;Archaeplastida;Chloroplastida;Chlorophyta;Chlorophyceae;Chlamydomonadales;Chloromonas;";"0.0";"0";"26";"25";"0";"25";"1";"430499";"5766"
"LOK1378_1mm";"SILVA (only NR);Eukaryota;Archaeplastida;Chloroplastida;Chlorophyta;Chlorophyceae;Chlamydomonadales;Colemanosphaera;";"0.0";"0";"1";"1";"0";"1";"0";"430523";"5766"
"LOK1378_1mm";"SILVA (only NR);Eukaryota;Archaeplastida;Chloroplastida;Chlorophyta;Chlorophyceae;Chlamydomonadales;Cylindrocapsa;";"0.0";"0";"2";"2";"0";"2";"0";"430522";"5766"
"LOK1378_1mm";"SILVA (only NR);Eukaryota;Archaeplastida;Chloroplastida;Chlorophyta;Chlorophyceae;Chlamydomonadales;Deasonia;";"0.0";"0";"2";"2";"0";"2";"0";"430522";"5766"
"LOK1378_1mm";"SILVA (only NR);Eukaryota;Archaeplastida;Chloroplastida;Chlorophyta;Chlorophyceae;Chlamydomonadales;Dunaliella;";"0.0";"0";"21";"20";"0";"20";"1";"430504";"5766"
"LOK1378_1mm";"SILVA (only NR);Eukaryota;Archaeplastida;Chloroplastida;Chlorophyta;Chlorophyceae;Chlamydomonadales;Dysmorphococcus;";"0.0";"0";"2";"2";"0";"2";"0";"430522";"5766"
"LOK1378_1mm";"SILVA (only NR);Eukaryota;Archaeplastida;Chloroplastida;Chlorophyta;Chlorophyceae;Chlamydomonadales;Ettlia;";"0.0";"0";"2";"2";"0";"2";"0";"430522";"5766"
"LOK1378_1mm";"SILVA (only NR);Eukaryota;Archaeplastida;Chloroplastida;Chlorophyta;Chlorophyceae;Chlamydomonadales;Eudorina;";"0.0";"0";"3";"3";"0";"3";"0";"430521";"5766"
"LOK1378_1mm";"SILVA (only NR);Eukaryota;Archaeplastida;Chloroplastida;Chlorophyta;Chlorophyceae;Chlamydomonadales;Gloeomonas;";"0.0";"0";"2";"2";"0";"2";"0";"430522";"5766"
"LOK1378_1mm";"SILVA (only NR);Eukaryota;Archaeplastida;Chloroplastida;Chlorophyta;Chlorophyceae;Chlamydomonadales;Golenkinia;";"0.0";"0";"3";"3";"0";"3";"0";"430521";"5766"
"LOK1378_1mm";"SILVA (only NR);Eukaryota;Archaeplastida;Chloroplastida;Chlorophyta;Chlorophyceae;Chlamydomonadales;Gonium;";"0.0";"0";"4";"4";"0";"4";"0";"430520";"5766"
"LOK1378_1mm";"SILVA (only NR);Eukaryota;Archaeplastida;Chloroplastida;Chlorophyta;Chlorophyceae;Chlamydomonadales;Gungnir;";"0.0";"0";"2";"2";"0";"2";"0";"430522";"5766"
"LOK1378_1mm";"SILVA (only NR);Eukaryota;Archaeplastida;Chloroplastida;Chlorophyta;Chlorophyceae;Chlamydomonadales;Haematococcus;";"0.0";"0";"1";"1";"0";"1";"0";"430523";"5766"
"LOK1378_1mm";"SILVA (only NR);Eukaryota;Archaeplastida;Chloroplastida;Chlorophyta;Chlorophyceae;Chlamydomonadales;Hafniomonas;";"0.0";"0";"3";"3";"0";"3";"0";"430521";"5766"
"LOK1378_1mm";"SILVA (only NR);Eukaryota;Archaeplastida;Chloroplastida;Chlorophyta;Chlorophyceae;Chlamydomonadales;Halosarcinochlamys;";"0.0";"0";"1";"1";"0";"1";"0";"430523";"5766"
"LOK1378_1mm";"SILVA (only NR);Eukaryota;Archaeplastida;Chloroplastida;Chlorophyta;Chlorophyceae;Chlamydomonadales;Hapalochloris;";"0.0";"0";"1";"1";"0";"1";"0";"430523";"5766"
"LOK1378_1mm";"SILVA (only NR);Eukaryota;Archaeplastida;Chloroplastida;Chlorophyta;Chlorophyceae;Chlamydomonadales;Hemiflagellochloris;";"0.0";"0";"1";"1";"0";"1";"0";"430523";"5766"
"LOK1378_1mm";"SILVA (only NR);Eukaryota;Archaeplastida;Chloroplastida;Chlorophyta;Chlorophyceae;Chlamydomonadales;Heterochlamydomonas;";"0.0";"0";"1";"1";"0";"1";"0";"430523";"5766"
"LOK1378_1mm";"SILVA (only NR);Eukaryota;Archaeplastida;Chloroplastida;Chlorophyta;Chlorophyceae;Chlamydomonadales;Heterotetracystis;";"0.0";"0";"1";"1";"0";"1";"0";"430523";"5766"
"LOK1378_1mm";"SILVA (only NR);Eukaryota;Archaeplastida;Chloroplastida;Chlorophyta;Chlorophyceae;Chlamydomonadales;Lobochlamys;";"0.0";"0";"6";"6";"0";"6";"0";"430518";"5766"
"LOK1378_1mm";"SILVA (only NR);Eukaryota;Archaeplastida;Chloroplastida;Chlorophyta;Chlorophyceae;Chlamydomonadales;Lobomonas;";"0.0";"0";"2";"2";"0";"2";"0";"430522";"5766"
"LOK1378_1mm";"SILVA (only NR);Eukaryota;Archaeplastida;Chloroplastida;Chlorophyta;Chlorophyceae;Chlamydomonadales;Microglena;";"0.0";"0";"6";"5";"0";"5";"1";"430519";"5766"
"LOK1378_1mm";"SILVA (only NR);Eukaryota;Archaeplastida;Chloroplastida;Chlorophyta;Chlorophyceae;Chlamydomonadales;Neospongiococcum;";"0.0";"0";"2";"2";"0";"2";"0";"430522";"5766"
"LOK1378_1mm";"SILVA (only NR);Eukaryota;Archaeplastida;Chloroplastida;Chlorophyta;Chlorophyceae;Chlamydomonadales;Oogamochlamys;";"0.0";"0";"3";"3";"0";"3";"0";"430521";"5766"
"LOK1378_1mm";"SILVA (only NR);Eukaryota;Archaeplastida;Chloroplastida;Chlorophyta;Chlorophyceae;Chlamydomonadales;Oophila;";"0.0";"0";"5";"4";"0";"4";"1";"430520";"5766"
"LOK1378_1mm";"SILVA (only NR);Eukaryota;Archaeplastida;Chloroplastida;Chlorophyta;Chlorophyceae;Chlamydomonadales;Pachycladella;";"0.0";"0";"1";"1";"0";"1";"0";"430523";"5766"
"LOK1378_1mm";"SILVA (only NR);Eukaryota;Archaeplastida;Chloroplastida;Chlorophyta;Chlorophyceae;Chlamydomonadales;Pandorina;";"0.0";"0";"4";"4";"0";"4";"0";"430520";"5766"
"LOK1378_1mm";"SILVA (only NR);Eukaryota;Archaeplastida;Chloroplastida;Chlorophyta;Chlorophyceae;Chlamydomonadales;Pascherina;";"0.0";"0";"1";"1";"0";"1";"0";"430523";"5766"
"LOK1378_1mm";"SILVA (only NR);Eukaryota;Archaeplastida;Chloroplastida;Chlorophyta;Chlorophyceae;Chlamydomonadales;Phacotus;";"0.0";"0";"2";"2";"0";"2";"0";"430522";"5766"
"LOK1378_1mm";"SILVA (only NR);Eukaryota;Archaeplastida;Chloroplastida;Chlorophyta;Chlorophyceae;Chlamydomonadales;Pleodorina;";"0.0";"0";"1";"1";"0";"1";"0";"430523";"5766"
"LOK1378_1mm";"SILVA (only NR);Eukaryota;Archaeplastida;Chloroplastida;Chlorophyta;Chlorophyceae;Chlamydomonadales;Polytoma;";"0.0";"0";"2";"2";"0";"2";"0";"430522";"5766"
"LOK1378_1mm";"SILVA (only NR);Eukaryota;Archaeplastida;Chloroplastida;Chlorophyta;Chlorophyceae;Chlamydomonadales;Polytomella;";"0.0";"0";"4";"4";"0";"4";"0";"430520";"5766"
"LOK1378_1mm";"SILVA (only NR);Eukaryota;Archaeplastida;Chloroplastida;Chlorophyta;Chlorophyceae;Chlamydomonadales;Protosiphon;";"0.0";"0";"2";"1";"0";"1";"1";"430523";"5766"
"LOK1378_1mm";"SILVA (only NR);Eukaryota;Archaeplastida;Chloroplastida;Chlorophyta;Chlorophyceae;Chlamydomonadales;Pteromonas;";"0.0";"0";"1";"1";"0";"1";"0";"430523";"5766"
"LOK1378_1mm";"SILVA (only NR);Eukaryota;Archaeplastida;Chloroplastida;Chlorophyta;Chlorophyceae;Chlamydomonadales;Pyrobotrys;";"0.0";"0";"2";"2";"0";"2";"0";"430522";"5766"
"LOK1378_1mm";"SILVA (only NR);Eukaryota;Archaeplastida;Chloroplastida;Chlorophyta;Chlorophyceae;Chlamydomonadales;Radiosphaera;";"0.0";"0";"1";"1";"0";"1";"0";"430523";"5766"
"LOK1378_1mm";"SILVA (only NR);Eukaryota;Archaeplastida;Chloroplastida;Chlorophyta;Chlorophyceae;Chlamydomonadales;Rhysamphichloris;";"0.0";"0";"1";"1";"0";"1";"0";"430523";"5766"
"LOK1378_1mm";"SILVA (only NR);Eukaryota;Archaeplastida;Chloroplastida;Chlorophyta;Chlorophyceae;Chlamydomonadales;Rusalka;";"0.0";"0";"1";"1";"0";"1";"0";"430523";"5766"
"LOK1378_1mm";"SILVA (only NR);Eukaryota;Archaeplastida;Chloroplastida;Chlorophyta;Chlorophyceae;Chlamydomonadales;Spongiochloris;";"0.0";"0";"2";"2";"0";"2";"0";"430522";"5766"
"LOK1378_1mm";"SILVA (only NR);Eukaryota;Archaeplastida;Chloroplastida;Chlorophyta;Chlorophyceae;Chlamydomonadales;Stephanosphaera;";"0.0";"0";"1";"1";"0";"1";"0";"430523";"5766"
"LOK1378_1mm";"SILVA (only NR);Eukaryota;Archaeplastida;Chloroplastida;Chlorophyta;Chlorophyceae;Chlamydomonadales;Tetrabaena;";"0.0";"0";"1";"1";"0";"1";"0";"430523";"5766"
"LOK1378_1mm";"SILVA (only NR);Eukaryota;Archaeplastida;Chloroplastida;Chlorophyta;Chlorophyceae;Chlamydomonadales;Tetracystis;";"0.0";"0";"11";"11";"0";"11";"0";"430513";"5766"
"LOK1378_1mm";"SILVA (only NR);Eukaryota;Archaeplastida;Chloroplastida;Chlorophyta;Chlorophyceae;Chlamydomonadales;Vitreochlamys;";"0.0";"0";"6";"6";"0";"6";"0";"430518";"5766"
"LOK1378_1mm";"SILVA (only NR);Eukaryota;Archaeplastida;Chloroplastida;Chlorophyta;Chlorophyceae;Chlamydomonadales;Volvox;";"0.0";"0";"5";"5";"0";"5";"0";"430519";"5766"
"LOK1378_1mm";"SILVA (only NR);Eukaryota;Archaeplastida;Chloroplastida;Chlorophyta;Chlorophyceae;Chlamydomonadales;Volvulina;";"0.0";"0";"3";"3";"0";"3";"0";"430521";"5766"
"LOK1378_1mm";"SILVA (only NR);Eukaryota;Archaeplastida;Chloroplastida;Chlorophyta;Chlorophyceae;Chlorosarcinales;";"0.0";"0";"18";"18";"0";"18";"0";"430506";"5766"
"LOK1378_1mm";"SILVA (only NR);Eukaryota;Archaeplastida;Chloroplastida;Chlorophyta;Chlorophyceae;Chlorosarcinales;Chlorosarcina;";"0.0";"0";"3";"3";"0";"3";"0";"430521";"5766"
"LOK1378_1mm";"SILVA (only NR);Eukaryota;Archaeplastida;Chloroplastida;Chlorophyta;Chlorophyceae;Chlorosarcinales;Chlorosarcinopsis;";"0.0";"0";"9";"9";"0";"9";"0";"430515";"5766"
"LOK1378_1mm";"SILVA (only NR);Eukaryota;Archaeplastida;Chloroplastida;Chlorophyta;Chlorophyceae;Chlorosarcinales;Neochlorosarcina;";"0.0";"0";"6";"6";"0";"6";"0";"430518";"5766"
"LOK1378_1mm";"SILVA (only NR);Eukaryota;Archaeplastida;Chloroplastida;Chlorophyta;Chlorophyceae;Incertae Sedis;";"0.0";"0";"26";"24";"0";"24";"2";"430500";"5766"
"LOK1378_1mm";"SILVA (only NR);Eukaryota;Archaeplastida;Chloroplastida;Chlorophyta;Chlorophyceae;Incertae Sedis;Botryococcus;";"0.0";"0";"1";"0";"0";"0";"1";"430524";"5766"
"LOK1378_1mm";"SILVA (only NR);Eukaryota;Archaeplastida;Chloroplastida;Chlorophyta;Chlorophyceae;Incertae Sedis;Carteria;";"0.0";"0";"8";"8";"0";"8";"0";"430516";"5766"
"LOK1378_1mm";"SILVA (only NR);Eukaryota;Archaeplastida;Chloroplastida;Chlorophyta;Chlorophyceae;Incertae Sedis;Chlamydopodium;";"0.0";"0";"3";"3";"0";"3";"0";"430521";"5766"
"LOK1378_1mm";"SILVA (only NR);Eukaryota;Archaeplastida;Chloroplastida;Chlorophyta;Chlorophyceae;Incertae Sedis;Chlorochytrium;";"0.0";"0";"2";"2";"0";"2";"0";"430522";"5766"
"LOK1378_1mm";"SILVA (only NR);Eukaryota;Archaeplastida;Chloroplastida;Chlorophyta;Chlorophyceae;Incertae Sedis;Jenufa;";"0.0";"0";"3";"3";"0";"3";"0";"430521";"5766"
"LOK1378_1mm";"SILVA (only NR);Eukaryota;Archaeplastida;Chloroplastida;Chlorophyta;Chlorophyceae;Incertae Sedis;Nautococcus;";"0.0";"0";"1";"1";"0";"1";"0";"430523";"5766"
"LOK1378_1mm";"SILVA (only NR);Eukaryota;Archaeplastida;Chloroplastida;Chlorophyta;Chlorophyceae;Incertae Sedis;Pleurastrum;";"0.0";"0";"1";"1";"0";"1";"0";"430523";"5766"
"LOK1378_1mm";"SILVA (only NR);Eukaryota;Archaeplastida;Chloroplastida;Chlorophyta;Chlorophyceae;Incertae Sedis;Spermatozopsis;";"0.0";"0";"1";"1";"0";"1";"0";"430523";"5766"
"LOK1378_1mm";"SILVA (only NR);Eukaryota;Archaeplastida;Chloroplastida;Chlorophyta;Chlorophyceae;Incertae Sedis;Tetraflagellochloris;";"0.0";"0";"1";"1";"0";"1";"0";"430523";"5766"
"LOK1378_1mm";"SILVA (only NR);Eukaryota;Archaeplastida;Chloroplastida;Chlorophyta;Chlorophyceae;Oedogoniales;";"0.0";"0";"16";"15";"0";"15";"1";"430509";"5766"
"LOK1378_1mm";"SILVA (only NR);Eukaryota;Archaeplastida;Chloroplastida;Chlorophyta;Chlorophyceae;Oedogoniales;Bulbochaete;";"0.0";"0";"1";"1";"0";"1";"0";"430523";"5766"
"LOK1378_1mm";"SILVA (only NR);Eukaryota;Archaeplastida;Chloroplastida;Chlorophyta;Chlorophyceae;Oedogoniales;Oedocladium;";"0.0";"0";"2";"2";"0";"2";"0";"430522";"5766"
"LOK1378_1mm";"SILVA (only NR);Eukaryota;Archaeplastida;Chloroplastida;Chlorophyta;Chlorophyceae;Oedogoniales;Oedogonium;";"0.0";"0";"13";"12";"0";"12";"1";"430512";"5766"
"LOK1378_1mm";"SILVA (only NR);Eukaryota;Archaeplastida;Chloroplastida;Chlorophyta;Chlorophyceae;Sphaeropleales;";"0.0";"0";"180";"164";"0";"164";"16";"430360";"5766"
"LOK1378_1mm";"SILVA (only NR);Eukaryota;Archaeplastida;Chloroplastida;Chlorophyta;Chlorophyceae;Sphaeropleales;Acutodesmus;";"0.0";"0";"2";"1";"0";"1";"1";"430523";"5766"
"LOK1378_1mm";"SILVA (only NR);Eukaryota;Archaeplastida;Chloroplastida;Chlorophyta;Chlorophyceae;Sphaeropleales;Ankistrodesmus;";"0.0";"0";"7";"7";"0";"7";"0";"430517";"5766"
"LOK1378_1mm";"SILVA (only NR);Eukaryota;Archaeplastida;Chloroplastida;Chlorophyta;Chlorophyceae;Sphaeropleales;Ankyra;";"0.0";"0";"1";"1";"0";"1";"0";"430523";"5766"
"LOK1378_1mm";"SILVA (only NR);Eukaryota;Archaeplastida;Chloroplastida;Chlorophyta;Chlorophyceae;Sphaeropleales;Asterarcys;";"0.0";"0";"1";"1";"0";"1";"0";"430523";"5766"
"LOK1378_1mm";"SILVA (only NR);Eukaryota;Archaeplastida;Chloroplastida;Chlorophyta;Chlorophyceae;Sphaeropleales;Auctodesmus;";"0.0";"0";"1";"1";"0";"1";"0";"430523";"5766"
"LOK1378_1mm";"SILVA (only NR);Eukaryota;Archaeplastida;Chloroplastida;Chlorophyta;Chlorophyceae;Sphaeropleales;Bracteacoccus;";"0.0";"0";"15";"14";"0";"14";"1";"430510";"5766"
"LOK1378_1mm";"SILVA (only NR);Eukaryota;Archaeplastida;Chloroplastida;Chlorophyta;Chlorophyceae;Sphaeropleales;Characiopodium;";"0.0";"0";"2";"2";"0";"2";"0";"430522";"5766"
"LOK1378_1mm";"SILVA (only NR);Eukaryota;Archaeplastida;Chloroplastida;Chlorophyta;Chlorophyceae;Sphaeropleales;Chlorolobion;";"0.0";"0";"2";"2";"0";"2";"0";"430522";"5766"
"LOK1378_1mm";"SILVA (only NR);Eukaryota;Archaeplastida;Chloroplastida;Chlorophyta;Chlorophyceae;Sphaeropleales;Chlorotetraedron;";"0.0";"0";"1";"1";"0";"1";"0";"430523";"5766"
"LOK1378_1mm";"SILVA (only NR);Eukaryota;Archaeplastida;Chloroplastida;Chlorophyta;Chlorophyceae;Sphaeropleales;Chromochloris;";"0.0";"0";"1";"1";"0";"1";"0";"430523";"5766"
"LOK1378_1mm";"SILVA (only NR);Eukaryota;Archaeplastida;Chloroplastida;Chlorophyta;Chlorophyceae;Sphaeropleales;Coelastrella;";"0.0";"0";"11";"11";"0";"11";"0";"430513";"5766"
"LOK1378_1mm";"SILVA (only NR);Eukaryota;Archaeplastida;Chloroplastida;Chlorophyta;Chlorophyceae;Sphaeropleales;Coelastrum;";"0.0";"0";"2";"2";"0";"2";"0";"430522";"5766"
"LOK1378_1mm";"SILVA (only NR);Eukaryota;Archaeplastida;Chloroplastida;Chlorophyta;Chlorophyceae;Sphaeropleales;Crucigenia;";"0.0";"0";"1";"1";"0";"1";"0";"430523";"5766"
"LOK1378_1mm";"SILVA (only NR);Eukaryota;Archaeplastida;Chloroplastida;Chlorophyta;Chlorophyceae;Sphaeropleales;Desmodesmus;";"0.0";"0";"17";"14";"0";"14";"3";"430510";"5766"
"LOK1378_1mm";"SILVA (only NR);Eukaryota;Archaeplastida;Chloroplastida;Chlorophyta;Chlorophyceae;Sphaeropleales;Dictyochloris;";"0.0";"0";"1";"1";"0";"1";"0";"430523";"5766"
"LOK1378_1mm";"SILVA (only NR);Eukaryota;Archaeplastida;Chloroplastida;Chlorophyta;Chlorophyceae;Sphaeropleales;Dictyococcus;";"0.0";"0";"7";"7";"0";"7";"0";"430517";"5766"
"LOK1378_1mm";"SILVA (only NR);Eukaryota;Archaeplastida;Chloroplastida;Chlorophyta;Chlorophyceae;Sphaeropleales;Dimorphococcus;";"0.0";"0";"1";"1";"0";"1";"0";"430523";"5766"
"LOK1378_1mm";"SILVA (only NR);Eukaryota;Archaeplastida;Chloroplastida;Chlorophyta;Chlorophyceae;Sphaeropleales;Hylodesmus;";"0.0";"0";"1";"1";"0";"1";"0";"430523";"5766"
"LOK1378_1mm";"SILVA (only NR);Eukaryota;Archaeplastida;Chloroplastida;Chlorophyta;Chlorophyceae;Sphaeropleales;Kirchneriella;";"0.0";"0";"1";"1";"0";"1";"0";"430523";"5766"
"LOK1378_1mm";"SILVA (only NR);Eukaryota;Archaeplastida;Chloroplastida;Chlorophyta;Chlorophyceae;Sphaeropleales;Lacunastrum;";"0.0";"0";"1";"1";"0";"1";"0";"430523";"5766"
"LOK1378_1mm";"SILVA (only NR);Eukaryota;Archaeplastida;Chloroplastida;Chlorophyta;Chlorophyceae;Sphaeropleales;Messastrum;";"0.0";"0";"2";"2";"0";"2";"0";"430522";"5766"
"LOK1378_1mm";"SILVA (only NR);Eukaryota;Archaeplastida;Chloroplastida;Chlorophyta;Chlorophyceae;Sphaeropleales;Monactinus;";"0.0";"0";"2";"2";"0";"2";"0";"430522";"5766"
"LOK1378_1mm";"SILVA (only NR);Eukaryota;Archaeplastida;Chloroplastida;Chlorophyta;Chlorophyceae;Sphaeropleales;Monoraphidium;";"0.0";"0";"23";"18";"0";"18";"5";"430506";"5766"
"LOK1378_1mm";"SILVA (only NR);Eukaryota;Archaeplastida;Chloroplastida;Chlorophyta;Chlorophyceae;Sphaeropleales;Mychonastes;";"0.0";"0";"9";"8";"0";"8";"1";"430516";"5766"
"LOK1378_1mm";"SILVA (only NR);Eukaryota;Archaeplastida;Chloroplastida;Chlorophyta;Chlorophyceae;Sphaeropleales;Neochloris;";"0.0";"0";"3";"3";"0";"3";"0";"430521";"5766"
"LOK1378_1mm";"SILVA (only NR);Eukaryota;Archaeplastida;Chloroplastida;Chlorophyta;Chlorophyceae;Sphaeropleales;Neodesmus;";"0.0";"0";"1";"1";"0";"1";"0";"430523";"5766"
"LOK1378_1mm";"SILVA (only NR);Eukaryota;Archaeplastida;Chloroplastida;Chlorophyta;Chlorophyceae;Sphaeropleales;Ourococcus;";"0.0";"0";"1";"1";"0";"1";"0";"430523";"5766"
"LOK1378_1mm";"SILVA (only NR);Eukaryota;Archaeplastida;Chloroplastida;Chlorophyta;Chlorophyceae;Sphaeropleales;Parapediastrum;";"0.0";"0";"1";"1";"0";"1";"0";"430523";"5766"
"LOK1378_1mm";"SILVA (only NR);Eukaryota;Archaeplastida;Chloroplastida;Chlorophyta;Chlorophyceae;Sphaeropleales;Pectinodesmus;";"0.0";"0";"2";"2";"0";"2";"0";"430522";"5766"
"LOK1378_1mm";"SILVA (only NR);Eukaryota;Archaeplastida;Chloroplastida;Chlorophyta;Chlorophyceae;Sphaeropleales;Pectodictyon;";"0.0";"0";"1";"1";"0";"1";"0";"430523";"5766"
"LOK1378_1mm";"SILVA (only NR);Eukaryota;Archaeplastida;Chloroplastida;Chlorophyta;Chlorophyceae;Sphaeropleales;Pediastrum;";"0.0";"0";"2";"2";"0";"2";"0";"430522";"5766"
"LOK1378_1mm";"SILVA (only NR);Eukaryota;Archaeplastida;Chloroplastida;Chlorophyta;Chlorophyceae;Sphaeropleales;Planktosphaeria;";"0.0";"0";"1";"1";"0";"1";"0";"430523";"5766"
"LOK1378_1mm";"SILVA (only NR);Eukaryota;Archaeplastida;Chloroplastida;Chlorophyta;Chlorophyceae;Sphaeropleales;Polyedriopsis;";"0.0";"0";"2";"2";"0";"2";"0";"430522";"5766"
"LOK1378_1mm";"SILVA (only NR);Eukaryota;Archaeplastida;Chloroplastida;Chlorophyta;Chlorophyceae;Sphaeropleales;Protodesmus;";"0.0";"0";"1";"1";"0";"1";"0";"430523";"5766"
"LOK1378_1mm";"SILVA (only NR);Eukaryota;Archaeplastida;Chloroplastida;Chlorophyta;Chlorophyceae;Sphaeropleales;Pseudomuriella;";"0.0";"0";"4";"4";"0";"4";"0";"430520";"5766"
"LOK1378_1mm";"SILVA (only NR);Eukaryota;Archaeplastida;Chloroplastida;Chlorophyta;Chlorophyceae;Sphaeropleales;Pseudopediastrum;";"0.0";"0";"5";"5";"0";"5";"0";"430519";"5766"
"LOK1378_1mm";"SILVA (only NR);Eukaryota;Archaeplastida;Chloroplastida;Chlorophyta;Chlorophyceae;Sphaeropleales;Pseudoschroederia;";"0.0";"0";"1";"1";"0";"1";"0";"430523";"5766"
"LOK1378_1mm";"SILVA (only NR);Eukaryota;Archaeplastida;Chloroplastida;Chlorophyta;Chlorophyceae;Sphaeropleales;Quadrigula;";"0.0";"0";"1";"1";"0";"1";"0";"430523";"5766"
"LOK1378_1mm";"SILVA (only NR);Eukaryota;Archaeplastida;Chloroplastida;Chlorophyta;Chlorophyceae;Sphaeropleales;Radiococcus;";"0.0";"0";"3";"3";"0";"3";"0";"430521";"5766"
"LOK1378_1mm";"SILVA (only NR);Eukaryota;Archaeplastida;Chloroplastida;Chlorophyta;Chlorophyceae;Sphaeropleales;Raphidocelis;";"0.0";"0";"1";"1";"0";"1";"0";"430523";"5766"
"LOK1378_1mm";"SILVA (only NR);Eukaryota;Archaeplastida;Chloroplastida;Chlorophyta;Chlorophyceae;Sphaeropleales;Rhombocystis;";"0.0";"0";"1";"1";"0";"1";"0";"430523";"5766"
"LOK1378_1mm";"SILVA (only NR);Eukaryota;Archaeplastida;Chloroplastida;Chlorophyta;Chlorophyceae;Sphaeropleales;Rotundella;";"0.0";"0";"1";"1";"0";"1";"0";"430523";"5766"
"LOK1378_1mm";"SILVA (only NR);Eukaryota;Archaeplastida;Chloroplastida;Chlorophyta;Chlorophyceae;Sphaeropleales;Scenedesmus;";"0.0";"0";"22";"17";"0";"17";"5";"430507";"5766"
"LOK1378_1mm";"SILVA (only NR);Eukaryota;Archaeplastida;Chloroplastida;Chlorophyta;Chlorophyceae;Sphaeropleales;Selenastrum;";"0.0";"0";"2";"2";"0";"2";"0";"430522";"5766"
"LOK1378_1mm";"SILVA (only NR);Eukaryota;Archaeplastida;Chloroplastida;Chlorophyta;Chlorophyceae;Sphaeropleales;Stauridium;";"0.0";"0";"1";"1";"0";"1";"0";"430523";"5766"
"LOK1378_1mm";"SILVA (only NR);Eukaryota;Archaeplastida;Chloroplastida;Chlorophyta;Chlorophyceae;Sphaeropleales;Tetradesmus;";"0.0";"0";"3";"3";"0";"3";"0";"430521";"5766"
"LOK1378_1mm";"SILVA (only NR);Eukaryota;Archaeplastida;Chloroplastida;Chlorophyta;Chlorophyceae;Sphaeropleales;Tetraedron;";"0.0";"0";"2";"2";"0";"2";"0";"430522";"5766"
"LOK1378_1mm";"SILVA (only NR);Eukaryota;Archaeplastida;Chloroplastida;Chlorophyta;Chlorophyceae;Sphaeropleales;Tetranephris;";"0.0";"0";"3";"3";"0";"3";"0";"430521";"5766"
"LOK1378_1mm";"SILVA (only NR);Eukaryota;Archaeplastida;Chloroplastida;Chlorophyta;Chlorophyceae;Sphaeropleales;Tumidella;";"0.0";"0";"1";"1";"0";"1";"0";"430523";"5766"
"LOK1378_1mm";"SILVA (only NR);Eukaryota;Archaeplastida;Chloroplastida;Chlorophyta;Chlorophyceae;Sphaeropleales;Verrucodesmus;";"0.0";"0";"1";"1";"0";"1";"0";"430523";"5766"
"LOK1378_1mm";"SILVA (only NR);Eukaryota;Archaeplastida;Chloroplastida;Chlorophyta;Chlorophyceae;Sphaeropleales;Westella;";"0.0";"0";"1";"1";"0";"1";"0";"430523";"5766"
"LOK1378_1mm";"SILVA (only NR);Eukaryota;Archaeplastida;Chloroplastida;Chlorophyta;Chlorophyceae;Tetrasporales;";"0.0";"0";"3";"2";"0";"2";"1";"430522";"5766"
"LOK1378_1mm";"SILVA (only NR);Eukaryota;Archaeplastida;Chloroplastida;Chlorophyta;Chlorophyceae;Tetrasporales;Asterococcus;";"0.0";"0";"1";"0";"0";"0";"1";"430524";"5766"
"LOK1378_1mm";"SILVA (only NR);Eukaryota;Archaeplastida;Chloroplastida;Chlorophyta;Chlorophyceae;Tetrasporales;Fritschiella;";"0.0";"0";"1";"1";"0";"1";"0";"430523";"5766"
"LOK1378_1mm";"SILVA (only NR);Eukaryota;Archaeplastida;Chloroplastida;Chlorophyta;Chlorophyceae;Tetrasporales;Paulschulzia;";"0.0";"0";"1";"1";"0";"1";"0";"430523";"5766"
"LOK1378_1mm";"SILVA (only NR);Eukaryota;Archaeplastida;Chloroplastida;Chlorophyta;Clade IX;";"0.0";"0";"31";"31";"0";"31";"0";"430493";"5766"
"LOK1378_1mm";"SILVA (only NR);Eukaryota;Archaeplastida;Chloroplastida;Chlorophyta;Clade VII;";"0.0";"0";"38";"38";"0";"38";"0";"430486";"5766"
"LOK1378_1mm";"SILVA (only NR);Eukaryota;Archaeplastida;Chloroplastida;Chlorophyta;Clade VII;Subclade A;";"0.0";"0";"26";"26";"0";"26";"0";"430498";"5766"
"LOK1378_1mm";"SILVA (only NR);Eukaryota;Archaeplastida;Chloroplastida;Chlorophyta;Clade VII;Subclade B;";"0.0";"0";"12";"12";"0";"12";"0";"430512";"5766"
"LOK1378_1mm";"SILVA (only NR);Eukaryota;Archaeplastida;Chloroplastida;Chlorophyta;Incertae Sedis;";"0.0";"0";"2";"2";"0";"2";"0";"430522";"5766"
"LOK1378_1mm";"SILVA (only NR);Eukaryota;Archaeplastida;Chloroplastida;Chlorophyta;Incertae Sedis;Picocystis;";"0.0";"0";"2";"2";"0";"2";"0";"430522";"5766"
"LOK1378_1mm";"SILVA (only NR);Eukaryota;Archaeplastida;Chloroplastida;Chlorophyta;Mamiellophyceae;";"0.0";"0";"140";"135";"0";"135";"5";"430389";"5766"
"LOK1378_1mm";"SILVA (only NR);Eukaryota;Archaeplastida;Chloroplastida;Chlorophyta;Mamiellophyceae;DSGM-81;";"0.0";"0";"4";"4";"0";"4";"0";"430520";"5766"
"LOK1378_1mm";"SILVA (only NR);Eukaryota;Archaeplastida;Chloroplastida;Chlorophyta;Mamiellophyceae;Dolichomastigales;";"0.0";"0";"7";"7";"0";"7";"0";"430517";"5766"
"LOK1378_1mm";"SILVA (only NR);Eukaryota;Archaeplastida;Chloroplastida;Chlorophyta;Mamiellophyceae;Dolichomastigales;Crustomastix;";"0.0";"0";"7";"7";"0";"7";"0";"430517";"5766"
"LOK1378_1mm";"SILVA (only NR);Eukaryota;Archaeplastida;Chloroplastida;Chlorophyta;Mamiellophyceae;Dolichomastix;";"0.0";"0";"3";"3";"0";"3";"0";"430521";"5766"
"LOK1378_1mm";"SILVA (only NR);Eukaryota;Archaeplastida;Chloroplastida;Chlorophyta;Mamiellophyceae;Mamiellales;";"0.0";"0";"109";"105";"0";"105";"4";"430419";"5766"
"LOK1378_1mm";"SILVA (only NR);Eukaryota;Archaeplastida;Chloroplastida;Chlorophyta;Mamiellophyceae;Mamiellales;Bathycoccus;";"0.0";"0";"24";"22";"0";"22";"2";"430502";"5766"
"LOK1378_1mm";"SILVA (only NR);Eukaryota;Archaeplastida;Chloroplastida;Chlorophyta;Mamiellophyceae;Mamiellales;Mamiella;";"0.0";"0";"4";"4";"0";"4";"0";"430520";"5766"
"LOK1378_1mm";"SILVA (only NR);Eukaryota;Archaeplastida;Chloroplastida;Chlorophyta;Mamiellophyceae;Mamiellales;Mantoniella;";"0.0";"0";"1";"1";"0";"1";"0";"430523";"5766"
"LOK1378_1mm";"SILVA (only NR);Eukaryota;Archaeplastida;Chloroplastida;Chlorophyta;Mamiellophyceae;Mamiellales;Micromonas;";"0.0";"0";"62";"61";"0";"61";"1";"430463";"5766"
"LOK1378_1mm";"SILVA (only NR);Eukaryota;Archaeplastida;Chloroplastida;Chlorophyta;Mamiellophyceae;Mamiellales;Ostreococcus;";"0.0";"0";"18";"17";"0";"17";"1";"430507";"5766"
"LOK1378_1mm";"SILVA (only NR);Eukaryota;Archaeplastida;Chloroplastida;Chlorophyta;Mamiellophyceae;Monomastigales;";"0.0";"0";"3";"2";"0";"2";"1";"430522";"5766"
"LOK1378_1mm";"SILVA (only NR);Eukaryota;Archaeplastida;Chloroplastida;Chlorophyta;Mamiellophyceae;Monomastigales;Monomastix;";"0.0";"0";"3";"2";"0";"2";"1";"430522";"5766"
"LOK1378_1mm";"SILVA (only NR);Eukaryota;Archaeplastida;Chloroplastida;Chlorophyta;Mamiellophyceae;uncultured;";"0.0";"0";"3";"3";"0";"3";"0";"430521";"5766"
"LOK1378_1mm";"SILVA (only NR);Eukaryota;Archaeplastida;Chloroplastida;Chlorophyta;Nephroselmidophyceae;";"0.0";"0";"16";"16";"0";"16";"0";"430508";"5766"
"LOK1378_1mm";"SILVA (only NR);Eukaryota;Archaeplastida;Chloroplastida;Chlorophyta;Nephroselmidophyceae;Nephroselmidales;";"0.0";"0";"16";"16";"0";"16";"0";"430508";"5766"
"LOK1378_1mm";"SILVA (only NR);Eukaryota;Archaeplastida;Chloroplastida;Chlorophyta;Nephroselmidophyceae;Nephroselmidales;Nephroselmis;";"0.0";"0";"16";"16";"0";"16";"0";"430508";"5766"
"LOK1378_1mm";"SILVA (only NR);Eukaryota;Archaeplastida;Chloroplastida;Chlorophyta;Palmophyllophyceae;";"0.0";"0";"2";"2";"0";"2";"0";"430522";"5766"
"LOK1378_1mm";"SILVA (only NR);Eukaryota;Archaeplastida;Chloroplastida;Chlorophyta;Palmophyllophyceae;Palmophyllales;";"0.0";"0";"2";"2";"0";"2";"0";"430522";"5766"
"LOK1378_1mm";"SILVA (only NR);Eukaryota;Archaeplastida;Chloroplastida;Chlorophyta;Palmophyllophyceae;Palmophyllales;Palmophyllum;";"0.0";"0";"1";"1";"0";"1";"0";"430523";"5766"
"LOK1378_1mm";"SILVA (only NR);Eukaryota;Archaeplastida;Chloroplastida;Chlorophyta;Palmophyllophyceae;Palmophyllales;Verdigellas;";"0.0";"0";"1";"1";"0";"1";"0";"430523";"5766"
"LOK1378_1mm";"SILVA (only NR);Eukaryota;Archaeplastida;Chloroplastida;Chlorophyta;Pedinophyceae;";"0.0";"0";"9";"9";"0";"9";"0";"430515";"5766"
"LOK1378_1mm";"SILVA (only NR);Eukaryota;Archaeplastida;Chloroplastida;Chlorophyta;Pedinophyceae;Pedinomonadales;";"0.0";"0";"9";"9";"0";"9";"0";"430515";"5766"
"LOK1378_1mm";"SILVA (only NR);Eukaryota;Archaeplastida;Chloroplastida;Chlorophyta;Pedinophyceae;Pedinomonadales;Pedinomonas;";"0.0";"0";"9";"9";"0";"9";"0";"430515";"5766"
"LOK1378_1mm";"SILVA (only NR);Eukaryota;Archaeplastida;Chloroplastida;Chlorophyta;Prasinophytae;";"0.0";"0";"56";"53";"0";"53";"3";"430471";"5766"
"LOK1378_1mm";"SILVA (only NR);Eukaryota;Archaeplastida;Chloroplastida;Chlorophyta;Prasinophytae;Prasinococcales;";"0.0";"0";"5";"3";"0";"3";"2";"430521";"5766"
"LOK1378_1mm";"SILVA (only NR);Eukaryota;Archaeplastida;Chloroplastida;Chlorophyta;Prasinophytae;Prasinococcales;Prasinococcus;";"0.0";"0";"5";"3";"0";"3";"2";"430521";"5766"
"LOK1378_1mm";"SILVA (only NR);Eukaryota;Archaeplastida;Chloroplastida;Chlorophyta;Prasinophytae;Pseudoscourfieldiales;";"0.0";"0";"11";"11";"0";"11";"0";"430513";"5766"
"LOK1378_1mm";"SILVA (only NR);Eukaryota;Archaeplastida;Chloroplastida;Chlorophyta;Prasinophytae;Pseudoscourfieldiales;Prasinoderma;";"0.0";"0";"9";"9";"0";"9";"0";"430515";"5766"
"LOK1378_1mm";"SILVA (only NR);Eukaryota;Archaeplastida;Chloroplastida;Chlorophyta;Prasinophytae;Pseudoscourfieldiales;Pycnococcus;";"0.0";"0";"2";"2";"0";"2";"0";"430522";"5766"
"LOK1378_1mm";"SILVA (only NR);Eukaryota;Archaeplastida;Chloroplastida;Chlorophyta;Prasinophytae;Pyramimonadales;";"0.0";"0";"26";"26";"0";"26";"0";"430498";"5766"
"LOK1378_1mm";"SILVA (only NR);Eukaryota;Archaeplastida;Chloroplastida;Chlorophyta;Prasinophytae;Pyramimonadales;Cymbomonas;";"0.0";"0";"1";"1";"0";"1";"0";"430523";"5766"
"LOK1378_1mm";"SILVA (only NR);Eukaryota;Archaeplastida;Chloroplastida;Chlorophyta;Prasinophytae;Pyramimonadales;Prasinopapilla;";"0.0";"0";"1";"1";"0";"1";"0";"430523";"5766"
"LOK1378_1mm";"SILVA (only NR);Eukaryota;Archaeplastida;Chloroplastida;Chlorophyta;Prasinophytae;Pyramimonadales;Pterosperma;";"0.0";"0";"5";"5";"0";"5";"0";"430519";"5766"
"LOK1378_1mm";"SILVA (only NR);Eukaryota;Archaeplastida;Chloroplastida;Chlorophyta;Prasinophytae;Pyramimonadales;Pyramimonas;";"0.0";"0";"19";"19";"0";"19";"0";"430505";"5766"
"LOK1378_1mm";"SILVA (only NR);Eukaryota;Archaeplastida;Chloroplastida;Chlorophyta;Prasinophytae;shizugawa;";"0.0";"0";"3";"3";"0";"3";"0";"430521";"5766"
"LOK1378_1mm";"SILVA (only NR);Eukaryota;Archaeplastida;Chloroplastida;Chlorophyta;Trebouxiophyceae;";"0.0";"0";"440";"408";"0";"408";"32";"430116";"5766"
"LOK1378_1mm";"SILVA (only NR);Eukaryota;Archaeplastida;Chloroplastida;Chlorophyta;Trebouxiophyceae;Chlorellales;";"0.0";"0";"131";"118";"0";"118";"13";"430406";"5766"
"LOK1378_1mm";"SILVA (only NR);Eukaryota;Archaeplastida;Chloroplastida;Chlorophyta;Trebouxiophyceae;Chlorellales;Auxenochlorella;";"0.0";"0";"2";"2";"0";"2";"0";"430522";"5766"
"LOK1378_1mm";"SILVA (only NR);Eukaryota;Archaeplastida;Chloroplastida;Chlorophyta;Trebouxiophyceae;Chlorellales;Chlorella;";"0.0";"0";"47";"43";"0";"43";"4";"430481";"5766"
"LOK1378_1mm";"SILVA (only NR);Eukaryota;Archaeplastida;Chloroplastida;Chlorophyta;Trebouxiophyceae;Chlorellales;Chloroidium;";"0.0";"0";"10";"9";"0";"9";"1";"430515";"5766"
"LOK1378_1mm";"SILVA (only NR);Eukaryota;Archaeplastida;Chloroplastida;Chlorophyta;Trebouxiophyceae;Chlorellales;Didymogenes;";"0.0";"0";"2";"2";"0";"2";"0";"430522";"5766"
"LOK1378_1mm";"SILVA (only NR);Eukaryota;Archaeplastida;Chloroplastida;Chlorophyta;Trebouxiophyceae;Chlorellales;Echinocoleum;";"0.0";"0";"1";"1";"0";"1";"0";"430523";"5766"
"LOK1378_1mm";"SILVA (only NR);Eukaryota;Archaeplastida;Chloroplastida;Chlorophyta;Trebouxiophyceae;Chlorellales;Elongatocystis;";"0.0";"0";"1";"1";"0";"1";"0";"430523";"5766"
"LOK1378_1mm";"SILVA (only NR);Eukaryota;Archaeplastida;Chloroplastida;Chlorophyta;Trebouxiophyceae;Chlorellales;Eremosphaera;";"0.0";"0";"2";"2";"0";"2";"0";"430522";"5766"
"LOK1378_1mm";"SILVA (only NR);Eukaryota;Archaeplastida;Chloroplastida;Chlorophyta;Trebouxiophyceae;Chlorellales;Franceia;";"0.0";"0";"2";"2";"0";"2";"0";"430522";"5766"
"LOK1378_1mm";"SILVA (only NR);Eukaryota;Archaeplastida;Chloroplastida;Chlorophyta;Trebouxiophyceae;Chlorellales;Hemichloris;";"0.0";"0";"2";"2";"0";"2";"0";"430522";"5766"
"LOK1378_1mm";"SILVA (only NR);Eukaryota;Archaeplastida;Chloroplastida;Chlorophyta;Trebouxiophyceae;Chlorellales;Heveochlorella;";"0.0";"0";"1";"1";"0";"1";"0";"430523";"5766"
"LOK1378_1mm";"SILVA (only NR);Eukaryota;Archaeplastida;Chloroplastida;Chlorophyta;Trebouxiophyceae;Chlorellales;Lagerheimia;";"0.0";"0";"6";"2";"0";"2";"4";"430522";"5766"
"LOK1378_1mm";"SILVA (only NR);Eukaryota;Archaeplastida;Chloroplastida;Chlorophyta;Trebouxiophyceae;Chlorellales;Makinoella;";"0.0";"0";"2";"1";"0";"1";"1";"430523";"5766"
"LOK1378_1mm";"SILVA (only NR);Eukaryota;Archaeplastida;Chloroplastida;Chlorophyta;Trebouxiophyceae;Chlorellales;Marvania;";"0.0";"0";"1";"1";"0";"1";"0";"430523";"5766"
"LOK1378_1mm";"SILVA (only NR);Eukaryota;Archaeplastida;Chloroplastida;Chlorophyta;Trebouxiophyceae;Chlorellales;Micractinium;";"0.0";"0";"10";"10";"0";"10";"0";"430514";"5766"
"LOK1378_1mm";"SILVA (only NR);Eukaryota;Archaeplastida;Chloroplastida;Chlorophyta;Trebouxiophyceae;Chlorellales;Nannochloris;";"0.0";"0";"6";"6";"0";"6";"0";"430518";"5766"
"LOK1378_1mm";"SILVA (only NR);Eukaryota;Archaeplastida;Chloroplastida;Chlorophyta;Trebouxiophyceae;Chlorellales;Neglectella;";"0.0";"0";"2";"2";"0";"2";"0";"430522";"5766"
"LOK1378_1mm";"SILVA (only NR);Eukaryota;Archaeplastida;Chloroplastida;Chlorophyta;Trebouxiophyceae;Chlorellales;Oocystella;";"0.0";"0";"5";"4";"0";"4";"1";"430520";"5766"
"LOK1378_1mm";"SILVA (only NR);Eukaryota;Archaeplastida;Chloroplastida;Chlorophyta;Trebouxiophyceae;Chlorellales;Oocystis;";"0.0";"0";"8";"8";"0";"8";"0";"430516";"5766"
"LOK1378_1mm";"SILVA (only NR);Eukaryota;Archaeplastida;Chloroplastida;Chlorophyta;Trebouxiophyceae;Chlorellales;Parachlorella;";"0.0";"0";"4";"4";"0";"4";"0";"430520";"5766"
"LOK1378_1mm";"SILVA (only NR);Eukaryota;Archaeplastida;Chloroplastida;Chlorophyta;Trebouxiophyceae;Chlorellales;Prototheca;";"0.0";"0";"10";"8";"0";"8";"2";"430516";"5766"
"LOK1378_1mm";"SILVA (only NR);Eukaryota;Archaeplastida;Chloroplastida;Chlorophyta;Trebouxiophyceae;Chlorellales;Quadricoccus;";"0.0";"0";"1";"1";"0";"1";"0";"430523";"5766"
"LOK1378_1mm";"SILVA (only NR);Eukaryota;Archaeplastida;Chloroplastida;Chlorophyta;Trebouxiophyceae;Chlorellales;Tetrachlorella;";"0.0";"0";"1";"1";"0";"1";"0";"430523";"5766"
"LOK1378_1mm";"SILVA (only NR);Eukaryota;Archaeplastida;Chloroplastida;Chlorophyta;Trebouxiophyceae;Chlorellales;Tetrastrum;";"0.0";"0";"3";"3";"0";"3";"0";"430521";"5766"
"LOK1378_1mm";"SILVA (only NR);Eukaryota;Archaeplastida;Chloroplastida;Chlorophyta;Trebouxiophyceae;Chlorellales;Viridiella;";"0.0";"0";"1";"1";"0";"1";"0";"430523";"5766"
"LOK1378_1mm";"SILVA (only NR);Eukaryota;Archaeplastida;Chloroplastida;Chlorophyta;Trebouxiophyceae;Ctenocladales;";"0.0";"0";"1";"1";"0";"1";"0";"430523";"5766"
"LOK1378_1mm";"SILVA (only NR);Eukaryota;Archaeplastida;Chloroplastida;Chlorophyta;Trebouxiophyceae;Ctenocladales;Leptosira;";"0.0";"0";"1";"1";"0";"1";"0";"430523";"5766"
"LOK1378_1mm";"SILVA (only NR);Eukaryota;Archaeplastida;Chloroplastida;Chlorophyta;Trebouxiophyceae;Incertae Sedis;";"0.0";"0";"94";"90";"0";"90";"4";"430434";"5766"
"LOK1378_1mm";"SILVA (only NR);Eukaryota;Archaeplastida;Chloroplastida;Chlorophyta;Trebouxiophyceae;Incertae Sedis;Actinastrum;";"0.0";"0";"2";"2";"0";"2";"0";"430522";"5766"
"LOK1378_1mm";"SILVA (only NR);Eukaryota;Archaeplastida;Chloroplastida;Chlorophyta;Trebouxiophyceae;Incertae Sedis;Botryococcus;";"0.0";"0";"16";"15";"0";"15";"1";"430509";"5766"
"LOK1378_1mm";"SILVA (only NR);Eukaryota;Archaeplastida;Chloroplastida;Chlorophyta;Trebouxiophyceae;Incertae Sedis;Chloroparva;";"0.0";"0";"2";"2";"0";"2";"0";"430522";"5766"
"LOK1378_1mm";"SILVA (only NR);Eukaryota;Archaeplastida;Chloroplastida;Chlorophyta;Trebouxiophyceae;Incertae Sedis;Chloropyrula;";"0.0";"0";"1";"1";"0";"1";"0";"430523";"5766"
"LOK1378_1mm";"SILVA (only NR);Eukaryota;Archaeplastida;Chloroplastida;Chlorophyta;Trebouxiophyceae;Incertae Sedis;Chlorosphaera;";"0.0";"0";"1";"1";"0";"1";"0";"430523";"5766"
"LOK1378_1mm";"SILVA (only NR);Eukaryota;Archaeplastida;Chloroplastida;Chlorophyta;Trebouxiophyceae;Incertae Sedis;Choricystis;";"0.0";"0";"2";"2";"0";"2";"0";"430522";"5766"
"LOK1378_1mm";"SILVA (only NR);Eukaryota;Archaeplastida;Chloroplastida;Chlorophyta;Trebouxiophyceae;Incertae Sedis;Coccomyxa;";"0.0";"0";"20";"19";"0";"19";"1";"430505";"5766"
"LOK1378_1mm";"SILVA (only NR);Eukaryota;Archaeplastida;Chloroplastida;Chlorophyta;Trebouxiophyceae;Incertae Sedis;Coenocystis;";"0.0";"0";"1";"1";"0";"1";"0";"430523";"5766"
"LOK1378_1mm";"SILVA (only NR);Eukaryota;Archaeplastida;Chloroplastida;Chlorophyta;Trebouxiophyceae;Incertae Sedis;Dictyosphaerium;";"0.0";"0";"8";"8";"0";"8";"0";"430516";"5766"
"LOK1378_1mm";"SILVA (only NR);Eukaryota;Archaeplastida;Chloroplastida;Chlorophyta;Trebouxiophyceae;Incertae Sedis;Gloeotila;";"0.0";"0";"2";"2";"0";"2";"0";"430522";"5766"
"LOK1378_1mm";"SILVA (only NR);Eukaryota;Archaeplastida;Chloroplastida;Chlorophyta;Trebouxiophyceae;Incertae Sedis;Heterochlorella;";"0.0";"0";"6";"6";"0";"6";"0";"430518";"5766"
"LOK1378_1mm";"SILVA (only NR);Eukaryota;Archaeplastida;Chloroplastida;Chlorophyta;Trebouxiophyceae;Incertae Sedis;Hindakia;";"0.0";"0";"1";"1";"0";"1";"0";"430523";"5766"
"LOK1378_1mm";"SILVA (only NR);Eukaryota;Archaeplastida;Chloroplastida;Chlorophyta;Trebouxiophyceae;Incertae Sedis;Kalinella;";"0.0";"0";"2";"2";"0";"2";"0";"430522";"5766"
"LOK1378_1mm";"SILVA (only NR);Eukaryota;Archaeplastida;Chloroplastida;Chlorophyta;Trebouxiophyceae;Incertae Sedis;Lemmermannia;";"0.0";"0";"4";"4";"0";"4";"0";"430520";"5766"
"LOK1378_1mm";"SILVA (only NR);Eukaryota;Archaeplastida;Chloroplastida;Chlorophyta;Trebouxiophyceae;Incertae Sedis;Leptochlorella;";"0.0";"0";"2";"2";"0";"2";"0";"430522";"5766"
"LOK1378_1mm";"SILVA (only NR);Eukaryota;Archaeplastida;Chloroplastida;Chlorophyta;Trebouxiophyceae;Incertae Sedis;Mucidosphaerium;";"0.0";"0";"2";"2";"0";"2";"0";"430522";"5766"
"LOK1378_1mm";"SILVA (only NR);Eukaryota;Archaeplastida;Chloroplastida;Chlorophyta;Trebouxiophyceae;Incertae Sedis;Muriella;";"0.0";"0";"1";"1";"0";"1";"0";"430523";"5766"
"LOK1378_1mm";"SILVA (only NR);Eukaryota;Archaeplastida;Chloroplastida;Chlorophyta;Trebouxiophyceae;Incertae Sedis;Mysteriochloris;";"0.0";"0";"1";"1";"0";"1";"0";"430523";"5766"
"LOK1378_1mm";"SILVA (only NR);Eukaryota;Archaeplastida;Chloroplastida;Chlorophyta;Trebouxiophyceae;Incertae Sedis;Neocystis;";"0.0";"0";"1";"1";"0";"1";"0";"430523";"5766"
"LOK1378_1mm";"SILVA (only NR);Eukaryota;Archaeplastida;Chloroplastida;Chlorophyta;Trebouxiophyceae;Incertae Sedis;Parachloroidium;";"0.0";"0";"1";"1";"0";"1";"0";"430523";"5766"
"LOK1378_1mm";"SILVA (only NR);Eukaryota;Archaeplastida;Chloroplastida;Chlorophyta;Trebouxiophyceae;Incertae Sedis;Parietochloris;";"0.0";"0";"1";"1";"0";"1";"0";"430523";"5766"
"LOK1378_1mm";"SILVA (only NR);Eukaryota;Archaeplastida;Chloroplastida;Chlorophyta;Trebouxiophyceae;Incertae Sedis;Picochlorum;";"0.0";"0";"13";"11";"0";"11";"2";"430513";"5766"
"LOK1378_1mm";"SILVA (only NR);Eukaryota;Archaeplastida;Chloroplastida;Chlorophyta;Trebouxiophyceae;Incertae Sedis;Pseudostichococcus;";"0.0";"0";"1";"1";"0";"1";"0";"430523";"5766"
"LOK1378_1mm";"SILVA (only NR);Eukaryota;Archaeplastida;Chloroplastida;Chlorophyta;Trebouxiophyceae;Incertae Sedis;Watanabea;";"0.0";"0";"1";"1";"0";"1";"0";"430523";"5766"
"LOK1378_1mm";"SILVA (only NR);Eukaryota;Archaeplastida;Chloroplastida;Chlorophyta;Trebouxiophyceae;Incertae Sedis;Xylochloris;";"0.0";"0";"2";"2";"0";"2";"0";"430522";"5766"
"LOK1378_1mm";"SILVA (only NR);Eukaryota;Archaeplastida;Chloroplastida;Chlorophyta;Trebouxiophyceae;Microthamniales;";"0.0";"0";"12";"12";"0";"12";"0";"430512";"5766"
"LOK1378_1mm";"SILVA (only NR);Eukaryota;Archaeplastida;Chloroplastida;Chlorophyta;Trebouxiophyceae;Microthamniales;Asterochloris;";"0.0";"0";"1";"1";"0";"1";"0";"430523";"5766"
"LOK1378_1mm";"SILVA (only NR);Eukaryota;Archaeplastida;Chloroplastida;Chlorophyta;Trebouxiophyceae;Microthamniales;Dictyochloropsis;";"0.0";"0";"3";"3";"0";"3";"0";"430521";"5766"
"LOK1378_1mm";"SILVA (only NR);Eukaryota;Archaeplastida;Chloroplastida;Chlorophyta;Trebouxiophyceae;Microthamniales;Elliptochloris;";"0.0";"0";"4";"4";"0";"4";"0";"430520";"5766"
"LOK1378_1mm";"SILVA (only NR);Eukaryota;Archaeplastida;Chloroplastida;Chlorophyta;Trebouxiophyceae;Microthamniales;Microthamnion;";"0.0";"0";"2";"2";"0";"2";"0";"430522";"5766"
"LOK1378_1mm";"SILVA (only NR);Eukaryota;Archaeplastida;Chloroplastida;Chlorophyta;Trebouxiophyceae;Microthamniales;Pseudomarvania;";"0.0";"0";"2";"2";"0";"2";"0";"430522";"5766"
"LOK1378_1mm";"SILVA (only NR);Eukaryota;Archaeplastida;Chloroplastida;Chlorophyta;Trebouxiophyceae;Prasiolales;";"0.0";"0";"26";"25";"0";"25";"1";"430499";"5766"
"LOK1378_1mm";"SILVA (only NR);Eukaryota;Archaeplastida;Chloroplastida;Chlorophyta;Trebouxiophyceae;Prasiolales;Desmococcus;";"0.0";"0";"1";"1";"0";"1";"0";"430523";"5766"
"LOK1378_1mm";"SILVA (only NR);Eukaryota;Archaeplastida;Chloroplastida;Chlorophyta;Trebouxiophyceae;Prasiolales;Koliella;";"0.0";"0";"4";"4";"0";"4";"0";"430520";"5766"
"LOK1378_1mm";"SILVA (only NR);Eukaryota;Archaeplastida;Chloroplastida;Chlorophyta;Trebouxiophyceae;Prasiolales;Pabia;";"0.0";"0";"1";"1";"0";"1";"0";"430523";"5766"
"LOK1378_1mm";"SILVA (only NR);Eukaryota;Archaeplastida;Chloroplastida;Chlorophyta;Trebouxiophyceae;Prasiolales;Prasiola;";"0.0";"0";"7";"6";"0";"6";"1";"430518";"5766"
"LOK1378_1mm";"SILVA (only NR);Eukaryota;Archaeplastida;Chloroplastida;Chlorophyta;Trebouxiophyceae;Prasiolales;Prasiolopsis;";"0.0";"0";"1";"1";"0";"1";"0";"430523";"5766"
"LOK1378_1mm";"SILVA (only NR);Eukaryota;Archaeplastida;Chloroplastida;Chlorophyta;Trebouxiophyceae;Prasiolales;Stichococcus;";"0.0";"0";"12";"12";"0";"12";"0";"430512";"5766"
"LOK1378_1mm";"SILVA (only NR);Eukaryota;Archaeplastida;Chloroplastida;Chlorophyta;Trebouxiophyceae;Trebouxiales;";"0.0";"0";"7";"7";"0";"7";"0";"430517";"5766"
"LOK1378_1mm";"SILVA (only NR);Eukaryota;Archaeplastida;Chloroplastida;Chlorophyta;Trebouxiophyceae;Trebouxiales;Myrmecia;";"0.0";"0";"3";"3";"0";"3";"0";"430521";"5766"
"LOK1378_1mm";"SILVA (only NR);Eukaryota;Archaeplastida;Chloroplastida;Chlorophyta;Trebouxiophyceae;Trebouxiales;Trebouxia;";"0.0";"0";"4";"4";"0";"4";"0";"430520";"5766"
"LOK1378_1mm";"SILVA (only NR);Eukaryota;Archaeplastida;Chloroplastida;Chlorophyta;Ulvophyceae;";"0.0";"0";"356";"339";"0";"339";"17";"430185";"5766"
"LOK1378_1mm";"SILVA (only NR);Eukaryota;Archaeplastida;Chloroplastida;Chlorophyta;Ulvophyceae;Bryopsidales;";"0.0";"0";"30";"30";"0";"30";"0";"430494";"5766"
"LOK1378_1mm";"SILVA (only NR);Eukaryota;Archaeplastida;Chloroplastida;Chlorophyta;Ulvophyceae;Bryopsidales;Bryopsis;";"0.0";"0";"1";"1";"0";"1";"0";"430523";"5766"
"LOK1378_1mm";"SILVA (only NR);Eukaryota;Archaeplastida;Chloroplastida;Chlorophyta;Ulvophyceae;Bryopsidales;Caulerpa;";"0.0";"0";"6";"6";"0";"6";"0";"430518";"5766"
"LOK1378_1mm";"SILVA (only NR);Eukaryota;Archaeplastida;Chloroplastida;Chlorophyta;Ulvophyceae;Bryopsidales;Chlorodesmis;";"0.0";"0";"2";"2";"0";"2";"0";"430522";"5766"
"LOK1378_1mm";"SILVA (only NR);Eukaryota;Archaeplastida;Chloroplastida;Chlorophyta;Ulvophyceae;Bryopsidales;Flabellia;";"0.0";"0";"1";"1";"0";"1";"0";"430523";"5766"
"LOK1378_1mm";"SILVA (only NR);Eukaryota;Archaeplastida;Chloroplastida;Chlorophyta;Ulvophyceae;Bryopsidales;Halimeda;";"0.0";"0";"12";"12";"0";"12";"0";"430512";"5766"
"LOK1378_1mm";"SILVA (only NR);Eukaryota;Archaeplastida;Chloroplastida;Chlorophyta;Ulvophyceae;Bryopsidales;Penicillus;";"0.0";"0";"2";"2";"0";"2";"0";"430522";"5766"
"LOK1378_1mm";"SILVA (only NR);Eukaryota;Archaeplastida;Chloroplastida;Chlorophyta;Ulvophyceae;Bryopsidales;Udotea;";"0.0";"0";"6";"6";"0";"6";"0";"430518";"5766"
"LOK1378_1mm";"SILVA (only NR);Eukaryota;Archaeplastida;Chloroplastida;Chlorophyta;Ulvophyceae;Chlorocystidales;";"0.0";"0";"2";"2";"0";"2";"0";"430522";"5766"
"LOK1378_1mm";"SILVA (only NR);Eukaryota;Archaeplastida;Chloroplastida;Chlorophyta;Ulvophyceae;Chlorocystidales;Desmochloris;";"0.0";"0";"2";"2";"0";"2";"0";"430522";"5766"
"LOK1378_1mm";"SILVA (only NR);Eukaryota;Archaeplastida;Chloroplastida;Chlorophyta;Ulvophyceae;Cladophorales;";"0.0";"0";"73";"71";"0";"71";"2";"430453";"5766"
"LOK1378_1mm";"SILVA (only NR);Eukaryota;Archaeplastida;Chloroplastida;Chlorophyta;Ulvophyceae;Cladophorales;Aegagropila;";"0.0";"0";"1";"1";"0";"1";"0";"430523";"5766"
"LOK1378_1mm";"SILVA (only NR);Eukaryota;Archaeplastida;Chloroplastida;Chlorophyta;Ulvophyceae;Cladophorales;Aegagropilopsis;";"0.0";"0";"4";"4";"0";"4";"0";"430520";"5766"
"LOK1378_1mm";"SILVA (only NR);Eukaryota;Archaeplastida;Chloroplastida;Chlorophyta;Ulvophyceae;Cladophorales;Arnoldiella;";"0.0";"0";"2";"2";"0";"2";"0";"430522";"5766"
"LOK1378_1mm";"SILVA (only NR);Eukaryota;Archaeplastida;Chloroplastida;Chlorophyta;Ulvophyceae;Cladophorales;Boergesenia;";"0.0";"0";"3";"3";"0";"3";"0";"430521";"5766"
"LOK1378_1mm";"SILVA (only NR);Eukaryota;Archaeplastida;Chloroplastida;Chlorophyta;Ulvophyceae;Cladophorales;Chaetomorpha;";"0.0";"0";"14";"12";"0";"12";"2";"430512";"5766"
"LOK1378_1mm";"SILVA (only NR);Eukaryota;Archaeplastida;Chloroplastida;Chlorophyta;Ulvophyceae;Cladophorales;Chamaedoris;";"0.0";"0";"1";"1";"0";"1";"0";"430523";"5766"
"LOK1378_1mm";"SILVA (only NR);Eukaryota;Archaeplastida;Chloroplastida;Chlorophyta;Ulvophyceae;Cladophorales;Cladophora;";"0.0";"0";"17";"17";"0";"17";"0";"430507";"5766"
"LOK1378_1mm";"SILVA (only NR);Eukaryota;Archaeplastida;Chloroplastida;Chlorophyta;Ulvophyceae;Cladophorales;Cladophoropsis;";"0.0";"0";"2";"2";"0";"2";"0";"430522";"5766"
"LOK1378_1mm";"SILVA (only NR);Eukaryota;Archaeplastida;Chloroplastida;Chlorophyta;Ulvophyceae;Cladophorales;Dictyosphaeria;";"0.0";"0";"1";"1";"0";"1";"0";"430523";"5766"
"LOK1378_1mm";"SILVA (only NR);Eukaryota;Archaeplastida;Chloroplastida;Chlorophyta;Ulvophyceae;Cladophorales;Ernodesmis;";"0.0";"0";"2";"2";"0";"2";"0";"430522";"5766"
"LOK1378_1mm";"SILVA (only NR);Eukaryota;Archaeplastida;Chloroplastida;Chlorophyta;Ulvophyceae;Cladophorales;Phyllodictyon;";"0.0";"0";"1";"1";"0";"1";"0";"430523";"5766"
"LOK1378_1mm";"SILVA (only NR);Eukaryota;Archaeplastida;Chloroplastida;Chlorophyta;Ulvophyceae;Cladophorales;Pseudocladophora;";"0.0";"0";"1";"1";"0";"1";"0";"430523";"5766"
"LOK1378_1mm";"SILVA (only NR);Eukaryota;Archaeplastida;Chloroplastida;Chlorophyta;Ulvophyceae;Cladophorales;Rhizoclonium;";"0.0";"0";"10";"10";"0";"10";"0";"430514";"5766"
"LOK1378_1mm";"SILVA (only NR);Eukaryota;Archaeplastida;Chloroplastida;Chlorophyta;Ulvophyceae;Cladophorales;Siphonocladus;";"0.0";"0";"1";"1";"0";"1";"0";"430523";"5766"
"LOK1378_1mm";"SILVA (only NR);Eukaryota;Archaeplastida;Chloroplastida;Chlorophyta;Ulvophyceae;Cladophorales;Spongiochrysis;";"0.0";"0";"1";"1";"0";"1";"0";"430523";"5766"
"LOK1378_1mm";"SILVA (only NR);Eukaryota;Archaeplastida;Chloroplastida;Chlorophyta;Ulvophyceae;Cladophorales;Valonia;";"0.0";"0";"8";"8";"0";"8";"0";"430516";"5766"
"LOK1378_1mm";"SILVA (only NR);Eukaryota;Archaeplastida;Chloroplastida;Chlorophyta;Ulvophyceae;Cladophorales;Valoniopsis;";"0.0";"0";"1";"1";"0";"1";"0";"430523";"5766"
"LOK1378_1mm";"SILVA (only NR);Eukaryota;Archaeplastida;Chloroplastida;Chlorophyta;Ulvophyceae;Cladophorales;Ventricaria;";"0.0";"0";"1";"1";"0";"1";"0";"430523";"5766"
"LOK1378_1mm";"SILVA (only NR);Eukaryota;Archaeplastida;Chloroplastida;Chlorophyta;Ulvophyceae;Cladophorales;Wittrockiella;";"0.0";"0";"2";"2";"0";"2";"0";"430522";"5766"
"LOK1378_1mm";"SILVA (only NR);Eukaryota;Archaeplastida;Chloroplastida;Chlorophyta;Ulvophyceae;Dasycladales;";"0.0";"0";"20";"20";"0";"20";"0";"430504";"5766"
"LOK1378_1mm";"SILVA (only NR);Eukaryota;Archaeplastida;Chloroplastida;Chlorophyta;Ulvophyceae;Dasycladales;Acetabularia;";"0.0";"0";"10";"10";"0";"10";"0";"430514";"5766"
"LOK1378_1mm";"SILVA (only NR);Eukaryota;Archaeplastida;Chloroplastida;Chlorophyta;Ulvophyceae;Dasycladales;Batophora;";"0.0";"0";"1";"1";"0";"1";"0";"430523";"5766"
"LOK1378_1mm";"SILVA (only NR);Eukaryota;Archaeplastida;Chloroplastida;Chlorophyta;Ulvophyceae;Dasycladales;Bornetella;";"0.0";"0";"1";"1";"0";"1";"0";"430523";"5766"
"LOK1378_1mm";"SILVA (only NR);Eukaryota;Archaeplastida;Chloroplastida;Chlorophyta;Ulvophyceae;Dasycladales;Chalmasia;";"0.0";"0";"1";"1";"0";"1";"0";"430523";"5766"
"LOK1378_1mm";"SILVA (only NR);Eukaryota;Archaeplastida;Chloroplastida;Chlorophyta;Ulvophyceae;Dasycladales;Cymopolia;";"0.0";"0";"1";"1";"0";"1";"0";"430523";"5766"
"LOK1378_1mm";"SILVA (only NR);Eukaryota;Archaeplastida;Chloroplastida;Chlorophyta;Ulvophyceae;Dasycladales;Neomeris;";"0.0";"0";"1";"1";"0";"1";"0";"430523";"5766"
"LOK1378_1mm";"SILVA (only NR);Eukaryota;Archaeplastida;Chloroplastida;Chlorophyta;Ulvophyceae;Dasycladales;Parvocaulis;";"0.0";"0";"5";"5";"0";"5";"0";"430519";"5766"
"LOK1378_1mm";"SILVA (only NR);Eukaryota;Archaeplastida;Chloroplastida;Chlorophyta;Ulvophyceae;Incertae Sedis;";"0.0";"0";"2";"1";"0";"1";"1";"430523";"5766"
"LOK1378_1mm";"SILVA (only NR);Eukaryota;Archaeplastida;Chloroplastida;Chlorophyta;Ulvophyceae;Incertae Sedis;Dilabifilum;";"0.0";"0";"2";"1";"0";"1";"1";"430523";"5766"
"LOK1378_1mm";"SILVA (only NR);Eukaryota;Archaeplastida;Chloroplastida;Chlorophyta;Ulvophyceae;Oltmansiellopsidales;";"0.0";"0";"3";"3";"0";"3";"0";"430521";"5766"
"LOK1378_1mm";"SILVA (only NR);Eukaryota;Archaeplastida;Chloroplastida;Chlorophyta;Ulvophyceae;Oltmansiellopsidales;Oltmannsiellopsis;";"0.0";"0";"3";"3";"0";"3";"0";"430521";"5766"
"LOK1378_1mm";"SILVA (only NR);Eukaryota;Archaeplastida;Chloroplastida;Chlorophyta;Ulvophyceae;Scotinosphaerales;";"0.0";"0";"4";"4";"0";"4";"0";"430520";"5766"
"LOK1378_1mm";"SILVA (only NR);Eukaryota;Archaeplastida;Chloroplastida;Chlorophyta;Ulvophyceae;Scotinosphaerales;Scotinosphaera;";"0.0";"0";"4";"4";"0";"4";"0";"430520";"5766"
"LOK1378_1mm";"SILVA (only NR);Eukaryota;Archaeplastida;Chloroplastida;Chlorophyta;Ulvophyceae;Trentepohliales;";"0.0";"0";"88";"78";"0";"78";"10";"430446";"5766"
"LOK1378_1mm";"SILVA (only NR);Eukaryota;Archaeplastida;Chloroplastida;Chlorophyta;Ulvophyceae;Trentepohliales;Cephaleuros;";"0.0";"0";"16";"16";"0";"16";"0";"430508";"5766"
"LOK1378_1mm";"SILVA (only NR);Eukaryota;Archaeplastida;Chloroplastida;Chlorophyta;Ulvophyceae;Trentepohliales;Phycopeltis;";"0.0";"0";"6";"6";"0";"6";"0";"430518";"5766"
"LOK1378_1mm";"SILVA (only NR);Eukaryota;Archaeplastida;Chloroplastida;Chlorophyta;Ulvophyceae;Trentepohliales;Printzina;";"0.0";"0";"7";"5";"0";"5";"2";"430519";"5766"
"LOK1378_1mm";"SILVA (only NR);Eukaryota;Archaeplastida;Chloroplastida;Chlorophyta;Ulvophyceae;Trentepohliales;Stomatochroon;";"0.0";"0";"1";"1";"0";"1";"0";"430523";"5766"
"LOK1378_1mm";"SILVA (only NR);Eukaryota;Archaeplastida;Chloroplastida;Chlorophyta;Ulvophyceae;Trentepohliales;Trentepohlia;";"0.0";"0";"58";"50";"0";"50";"8";"430474";"5766"
"LOK1378_1mm";"SILVA (only NR);Eukaryota;Archaeplastida;Chloroplastida;Chlorophyta;Ulvophyceae;Ulotrichales;";"0.0";"0";"10";"10";"0";"10";"0";"430514";"5766"
"LOK1378_1mm";"SILVA (only NR);Eukaryota;Archaeplastida;Chloroplastida;Chlorophyta;Ulvophyceae;Ulotrichales;Acrosiphonia;";"0.0";"0";"2";"2";"0";"2";"0";"430522";"5766"
"LOK1378_1mm";"SILVA (only NR);Eukaryota;Archaeplastida;Chloroplastida;Chlorophyta;Ulvophyceae;Ulotrichales;Gloeotilopsis;";"0.0";"0";"1";"1";"0";"1";"0";"430523";"5766"
"LOK1378_1mm";"SILVA (only NR);Eukaryota;Archaeplastida;Chloroplastida;Chlorophyta;Ulvophyceae;Ulotrichales;Halochlorococcum;";"0.0";"0";"1";"1";"0";"1";"0";"430523";"5766"
"LOK1378_1mm";"SILVA (only NR);Eukaryota;Archaeplastida;Chloroplastida;Chlorophyta;Ulvophyceae;Ulotrichales;Hazenia;";"0.0";"0";"2";"2";"0";"2";"0";"430522";"5766"
"LOK1378_1mm";"SILVA (only NR);Eukaryota;Archaeplastida;Chloroplastida;Chlorophyta;Ulvophyceae;Ulotrichales;Kraftionema;";"0.0";"0";"1";"1";"0";"1";"0";"430523";"5766"
"LOK1378_1mm";"SILVA (only NR);Eukaryota;Archaeplastida;Chloroplastida;Chlorophyta;Ulvophyceae;Ulotrichales;Pseudoneochloris;";"0.0";"0";"1";"1";"0";"1";"0";"430523";"5766"
"LOK1378_1mm";"SILVA (only NR);Eukaryota;Archaeplastida;Chloroplastida;Chlorophyta;Ulvophyceae;Ulotrichales;Ulothrix;";"0.0";"0";"1";"1";"0";"1";"0";"430523";"5766"
"LOK1378_1mm";"SILVA (only NR);Eukaryota;Archaeplastida;Chloroplastida;Chlorophyta;Ulvophyceae;Ulotrichales;Urospora;";"0.0";"0";"1";"1";"0";"1";"0";"430523";"5766"
"LOK1378_1mm";"SILVA (only NR);Eukaryota;Archaeplastida;Chloroplastida;Chlorophyta;Ulvophyceae;Ulvales;";"0.0";"0";"36";"36";"0";"36";"0";"430488";"5766"
"LOK1378_1mm";"SILVA (only NR);Eukaryota;Archaeplastida;Chloroplastida;Chlorophyta;Ulvophyceae;Ulvales;Blidingia;";"0.0";"0";"2";"2";"0";"2";"0";"430522";"5766"
"LOK1378_1mm";"SILVA (only NR);Eukaryota;Archaeplastida;Chloroplastida;Chlorophyta;Ulvophyceae;Ulvales;Bolbocoleon;";"0.0";"0";"1";"1";"0";"1";"0";"430523";"5766"
"LOK1378_1mm";"SILVA (only NR);Eukaryota;Archaeplastida;Chloroplastida;Chlorophyta;Ulvophyceae;Ulvales;Cloniophora;";"0.0";"0";"1";"1";"0";"1";"0";"430523";"5766"
"LOK1378_1mm";"SILVA (only NR);Eukaryota;Archaeplastida;Chloroplastida;Chlorophyta;Ulvophyceae;Ulvales;Jaoa;";"0.0";"0";"1";"1";"0";"1";"0";"430523";"5766"
"LOK1378_1mm";"SILVA (only NR);Eukaryota;Archaeplastida;Chloroplastida;Chlorophyta;Ulvophyceae;Ulvales;Monostroma;";"0.0";"0";"2";"2";"0";"2";"0";"430522";"5766"
"LOK1378_1mm";"SILVA (only NR);Eukaryota;Archaeplastida;Chloroplastida;Chlorophyta;Ulvophyceae;Ulvales;Ochlochaete;";"0.0";"0";"3";"3";"0";"3";"0";"430521";"5766"
"LOK1378_1mm";"SILVA (only NR);Eukaryota;Archaeplastida;Chloroplastida;Chlorophyta;Ulvophyceae;Ulvales;Phaeophila;";"0.0";"0";"3";"3";"0";"3";"0";"430521";"5766"
"LOK1378_1mm";"SILVA (only NR);Eukaryota;Archaeplastida;Chloroplastida;Chlorophyta;Ulvophyceae;Ulvales;Pseudendoclonium;";"0.0";"0";"4";"4";"0";"4";"0";"430520";"5766"
"LOK1378_1mm";"SILVA (only NR);Eukaryota;Archaeplastida;Chloroplastida;Chlorophyta;Ulvophyceae;Ulvales;Ruthnielsenia;";"0.0";"0";"1";"1";"0";"1";"0";"430523";"5766"
"LOK1378_1mm";"SILVA (only NR);Eukaryota;Archaeplastida;Chloroplastida;Chlorophyta;Ulvophyceae;Ulvales;Ulva;";"0.0";"0";"10";"10";"0";"10";"0";"430514";"5766"
"LOK1378_1mm";"SILVA (only NR);Eukaryota;Archaeplastida;Chloroplastida;Chlorophyta;Ulvophyceae;Ulvales;Ulvaria;";"0.0";"0";"1";"1";"0";"1";"0";"430523";"5766"
"LOK1378_1mm";"SILVA (only NR);Eukaryota;Archaeplastida;Chloroplastida;Chlorophyta;Ulvophyceae;Ulvales;Ulvella;";"0.0";"0";"6";"6";"0";"6";"0";"430518";"5766"
"LOK1378_1mm";"SILVA (only NR);Eukaryota;Archaeplastida;Chloroplastida;Chlorophyta;Ulvophyceae;Ulvales;Umbraulva;";"0.0";"0";"1";"1";"0";"1";"0";"430523";"5766"
"LOK1378_1mm";"SILVA (only NR);Eukaryota;Archaeplastida;Glaucophyta;";"0.0";"0";"8";"8";"0";"8";"0";"430516";"5766"
"LOK1378_1mm";"SILVA (only NR);Eukaryota;Archaeplastida;Glaucophyta;Cyanophora;";"0.0";"0";"2";"2";"0";"2";"0";"430522";"5766"
"LOK1378_1mm";"SILVA (only NR);Eukaryota;Archaeplastida;Glaucophyta;Cyanoptyche;";"0.0";"0";"1";"1";"0";"1";"0";"430523";"5766"
"LOK1378_1mm";"SILVA (only NR);Eukaryota;Archaeplastida;Glaucophyta;Glaucocystis;";"0.0";"0";"3";"3";"0";"3";"0";"430521";"5766"
"LOK1378_1mm";"SILVA (only NR);Eukaryota;Archaeplastida;Glaucophyta;Gloeochaete;";"0.0";"0";"1";"1";"0";"1";"0";"430523";"5766"
"LOK1378_1mm";"SILVA (only NR);Eukaryota;Archaeplastida;Rhodophyceae;";"0.0";"0";"881";"872";"0";"872";"9";"429652";"5766"
"LOK1378_1mm";"SILVA (only NR);Eukaryota;Archaeplastida;Rhodophyceae;Bangiales;";"0.0";"0";"147";"145";"0";"145";"2";"430379";"5766"
"LOK1378_1mm";"SILVA (only NR);Eukaryota;Archaeplastida;Rhodophyceae;Bangiales;Bangia;";"0.0";"0";"13";"13";"0";"13";"0";"430511";"5766"
"LOK1378_1mm";"SILVA (only NR);Eukaryota;Archaeplastida;Rhodophyceae;Bangiales;Dione;";"0.0";"0";"1";"1";"0";"1";"0";"430523";"5766"
"LOK1378_1mm";"SILVA (only NR);Eukaryota;Archaeplastida;Rhodophyceae;Bangiales;Fuscifolium;";"0.0";"0";"1";"1";"0";"1";"0";"430523";"5766"
"LOK1378_1mm";"SILVA (only NR);Eukaryota;Archaeplastida;Rhodophyceae;Bangiales;Lysithea;";"0.0";"0";"1";"1";"0";"1";"0";"430523";"5766"
"LOK1378_1mm";"SILVA (only NR);Eukaryota;Archaeplastida;Rhodophyceae;Bangiales;Minerva;";"0.0";"0";"1";"1";"0";"1";"0";"430523";"5766"
"LOK1378_1mm";"SILVA (only NR);Eukaryota;Archaeplastida;Rhodophyceae;Bangiales;Porphyra-Clymene;";"0.0";"0";"20";"20";"0";"20";"0";"430504";"5766"
"LOK1378_1mm";"SILVA (only NR);Eukaryota;Archaeplastida;Rhodophyceae;Bangiales;Porphyra-Clymene;Clymene;";"0.0";"0";"1";"1";"0";"1";"0";"430523";"5766"
"LOK1378_1mm";"SILVA (only NR);Eukaryota;Archaeplastida;Rhodophyceae;Bangiales;Porphyra-Pyropia;";"0.0";"0";"104";"103";"0";"103";"1";"430421";"5766"
"LOK1378_1mm";"SILVA (only NR);Eukaryota;Archaeplastida;Rhodophyceae;Bangiales;Porphyra-Pyropia;Boreophyllum;";"0.0";"0";"2";"2";"0";"2";"0";"430522";"5766"
"LOK1378_1mm";"SILVA (only NR);Eukaryota;Archaeplastida;Rhodophyceae;Bangiales;Porphyra-Pyropia;Pyropia;";"0.0";"0";"5";"5";"0";"5";"0";"430519";"5766"
"LOK1378_1mm";"SILVA (only NR);Eukaryota;Archaeplastida;Rhodophyceae;Bangiales;Porphyra-Pyropia;Wildemania;";"0.0";"0";"8";"8";"0";"8";"0";"430516";"5766"
"LOK1378_1mm";"SILVA (only NR);Eukaryota;Archaeplastida;Rhodophyceae;Bangiales;Porphyra;";"0.0";"0";"1";"0";"0";"0";"1";"430524";"5766"
"LOK1378_1mm";"SILVA (only NR);Eukaryota;Archaeplastida;Rhodophyceae;Bangiales;Pseudobangia;";"0.0";"0";"1";"1";"0";"1";"0";"430523";"5766"
"LOK1378_1mm";"SILVA (only NR);Eukaryota;Archaeplastida;Rhodophyceae;Compsopogonales;";"0.0";"0";"14";"14";"0";"14";"0";"430510";"5766"
"LOK1378_1mm";"SILVA (only NR);Eukaryota;Archaeplastida;Rhodophyceae;Compsopogonales;Chlidophyllon;";"0.0";"0";"1";"1";"0";"1";"0";"430523";"5766"
"LOK1378_1mm";"SILVA (only NR);Eukaryota;Archaeplastida;Rhodophyceae;Compsopogonales;Compsopogon;";"0.0";"0";"2";"2";"0";"2";"0";"430522";"5766"
"LOK1378_1mm";"SILVA (only NR);Eukaryota;Archaeplastida;Rhodophyceae;Compsopogonales;Compsopogonopsis;";"0.0";"0";"1";"1";"0";"1";"0";"430523";"5766"
"LOK1378_1mm";"SILVA (only NR);Eukaryota;Archaeplastida;Rhodophyceae;Compsopogonales;Erythrotrichia;";"0.0";"0";"1";"1";"0";"1";"0";"430523";"5766"
"LOK1378_1mm";"SILVA (only NR);Eukaryota;Archaeplastida;Rhodophyceae;Compsopogonales;Madagascaria;";"0.0";"0";"1";"1";"0";"1";"0";"430523";"5766"
"LOK1378_1mm";"SILVA (only NR);Eukaryota;Archaeplastida;Rhodophyceae;Compsopogonales;Pyrophyllon;";"0.0";"0";"2";"2";"0";"2";"0";"430522";"5766"
"LOK1378_1mm";"SILVA (only NR);Eukaryota;Archaeplastida;Rhodophyceae;Compsopogonales;Rhodochaete;";"0.0";"0";"1";"1";"0";"1";"0";"430523";"5766"
"LOK1378_1mm";"SILVA (only NR);Eukaryota;Archaeplastida;Rhodophyceae;Compsopogonales;Sahlingia;";"0.0";"0";"1";"1";"0";"1";"0";"430523";"5766"
"LOK1378_1mm";"SILVA (only NR);Eukaryota;Archaeplastida;Rhodophyceae;Compsopogonales;Smithora;";"0.0";"0";"1";"1";"0";"1";"0";"430523";"5766"
"LOK1378_1mm";"SILVA (only NR);Eukaryota;Archaeplastida;Rhodophyceae;Cyanidiales;";"0.0";"0";"15";"12";"0";"12";"3";"430512";"5766"
"LOK1378_1mm";"SILVA (only NR);Eukaryota;Archaeplastida;Rhodophyceae;Cyanidiales;Cyanidioschyzon;";"0.0";"0";"2";"2";"0";"2";"0";"430522";"5766"
"LOK1378_1mm";"SILVA (only NR);Eukaryota;Archaeplastida;Rhodophyceae;Cyanidiales;Cyanidium;";"0.0";"0";"2";"1";"0";"1";"1";"430523";"5766"
"LOK1378_1mm";"SILVA (only NR);Eukaryota;Archaeplastida;Rhodophyceae;Cyanidiales;Galdieria;";"0.0";"0";"8";"6";"0";"6";"2";"430518";"5766"
"LOK1378_1mm";"SILVA (only NR);Eukaryota;Archaeplastida;Rhodophyceae;Cyanidiales;uncultured;";"0.0";"0";"2";"2";"0";"2";"0";"430522";"5766"
"LOK1378_1mm";"SILVA (only NR);Eukaryota;Archaeplastida;Rhodophyceae;Florideophycidae;";"0.0";"0";"671";"667";"0";"667";"4";"429857";"5766"
"LOK1378_1mm";"SILVA (only NR);Eukaryota;Archaeplastida;Rhodophyceae;Florideophycidae;Ahnfeltiophycidae;";"0.0";"0";"2";"2";"0";"2";"0";"430522";"5766"
"LOK1378_1mm";"SILVA (only NR);Eukaryota;Archaeplastida;Rhodophyceae;Florideophycidae;Ahnfeltiophycidae;Ahnfeltia;";"0.0";"0";"1";"1";"0";"1";"0";"430523";"5766"
"LOK1378_1mm";"SILVA (only NR);Eukaryota;Archaeplastida;Rhodophyceae;Florideophycidae;Ahnfeltiophycidae;Pihiella;";"0.0";"0";"1";"1";"0";"1";"0";"430523";"5766"
"LOK1378_1mm";"SILVA (only NR);Eukaryota;Archaeplastida;Rhodophyceae;Florideophycidae;Corallinophycidae;";"0.0";"0";"162";"160";"0";"160";"2";"430364";"5766"
"LOK1378_1mm";"SILVA (only NR);Eukaryota;Archaeplastida;Rhodophyceae;Florideophycidae;Corallinophycidae;Amphiroa;";"0.0";"0";"7";"7";"0";"7";"0";"430517";"5766"
"LOK1378_1mm";"SILVA (only NR);Eukaryota;Archaeplastida;Rhodophyceae;Florideophycidae;Corallinophycidae;Arthrocardia;";"0.0";"0";"3";"3";"0";"3";"0";"430521";"5766"
"LOK1378_1mm";"SILVA (only NR);Eukaryota;Archaeplastida;Rhodophyceae;Florideophycidae;Corallinophycidae;Bossiella;";"0.0";"0";"1";"1";"0";"1";"0";"430523";"5766"
"LOK1378_1mm";"SILVA (only NR);Eukaryota;Archaeplastida;Rhodophyceae;Florideophycidae;Corallinophycidae;Callilithophytum;";"0.0";"0";"1";"1";"0";"1";"0";"430523";"5766"
"LOK1378_1mm";"SILVA (only NR);Eukaryota;Archaeplastida;Rhodophyceae;Florideophycidae;Corallinophycidae;Cheilosporum;";"0.0";"0";"1";"1";"0";"1";"0";"430523";"5766"
"LOK1378_1mm";"SILVA (only NR);Eukaryota;Archaeplastida;Rhodophyceae;Florideophycidae;Corallinophycidae;Clathromorphum;";"0.0";"0";"1";"1";"0";"1";"0";"430523";"5766"
"LOK1378_1mm";"SILVA (only NR);Eukaryota;Archaeplastida;Rhodophyceae;Florideophycidae;Corallinophycidae;Corallina;";"0.0";"0";"3";"3";"0";"3";"0";"430521";"5766"
"LOK1378_1mm";"SILVA (only NR);Eukaryota;Archaeplastida;Rhodophyceae;Florideophycidae;Corallinophycidae;Ellisolandia;";"0.0";"0";"1";"1";"0";"1";"0";"430523";"5766"
"LOK1378_1mm";"SILVA (only NR);Eukaryota;Archaeplastida;Rhodophyceae;Florideophycidae;Corallinophycidae;Haliptilon;";"0.0";"0";"1";"1";"0";"1";"0";"430523";"5766"
"LOK1378_1mm";"SILVA (only NR);Eukaryota;Archaeplastida;Rhodophyceae;Florideophycidae;Corallinophycidae;Heydrichia;";"0.0";"0";"3";"3";"0";"3";"0";"430521";"5766"
"LOK1378_1mm";"SILVA (only NR);Eukaryota;Archaeplastida;Rhodophyceae;Florideophycidae;Corallinophycidae;Hydrolithon;";"0.0";"0";"20";"20";"0";"20";"0";"430504";"5766"
"LOK1378_1mm";"SILVA (only NR);Eukaryota;Archaeplastida;Rhodophyceae;Florideophycidae;Corallinophycidae;Jania;";"0.0";"0";"6";"6";"0";"6";"0";"430518";"5766"
"LOK1378_1mm";"SILVA (only NR);Eukaryota;Archaeplastida;Rhodophyceae;Florideophycidae;Corallinophycidae;Leptophytum;";"0.0";"0";"3";"3";"0";"3";"0";"430521";"5766"
"LOK1378_1mm";"SILVA (only NR);Eukaryota;Archaeplastida;Rhodophyceae;Florideophycidae;Corallinophycidae;Lithophyllum;";"0.0";"0";"11";"11";"0";"11";"0";"430513";"5766"
"LOK1378_1mm";"SILVA (only NR);Eukaryota;Archaeplastida;Rhodophyceae;Florideophycidae;Corallinophycidae;Lithothamnion;";"0.0";"0";"4";"4";"0";"4";"0";"430520";"5766"
"LOK1378_1mm";"SILVA (only NR);Eukaryota;Archaeplastida;Rhodophyceae;Florideophycidae;Corallinophycidae;Lithothrix;";"0.0";"0";"1";"1";"0";"1";"0";"430523";"5766"
"LOK1378_1mm";"SILVA (only NR);Eukaryota;Archaeplastida;Rhodophyceae;Florideophycidae;Corallinophycidae;Mastophora;";"0.0";"0";"3";"3";"0";"3";"0";"430521";"5766"
"LOK1378_1mm";"SILVA (only NR);Eukaryota;Archaeplastida;Rhodophyceae;Florideophycidae;Corallinophycidae;Mastophoropsis;";"0.0";"0";"1";"1";"0";"1";"0";"430523";"5766"
"LOK1378_1mm";"SILVA (only NR);Eukaryota;Archaeplastida;Rhodophyceae;Florideophycidae;Corallinophycidae;Mesophyllum;";"0.0";"0";"8";"8";"0";"8";"0";"430516";"5766"
"LOK1378_1mm";"SILVA (only NR);Eukaryota;Archaeplastida;Rhodophyceae;Florideophycidae;Corallinophycidae;Metagoniolithon;";"0.0";"0";"1";"1";"0";"1";"0";"430523";"5766"
"LOK1378_1mm";"SILVA (only NR);Eukaryota;Archaeplastida;Rhodophyceae;Florideophycidae;Corallinophycidae;Metamastophora;";"0.0";"0";"1";"1";"0";"1";"0";"430523";"5766"
"LOK1378_1mm";"SILVA (only NR);Eukaryota;Archaeplastida;Rhodophyceae;Florideophycidae;Corallinophycidae;Neogoniolithon;";"0.0";"0";"13";"13";"0";"13";"0";"430511";"5766"
"LOK1378_1mm";"SILVA (only NR);Eukaryota;Archaeplastida;Rhodophyceae;Florideophycidae;Corallinophycidae;Neopolyporolithon;";"0.0";"0";"1";"1";"0";"1";"0";"430523";"5766"
"LOK1378_1mm";"SILVA (only NR);Eukaryota;Archaeplastida;Rhodophyceae;Florideophycidae;Corallinophycidae;Phymatolithon;";"0.0";"0";"2";"2";"0";"2";"0";"430522";"5766"
"LOK1378_1mm";"SILVA (only NR);Eukaryota;Archaeplastida;Rhodophyceae;Florideophycidae;Corallinophycidae;Rhodogorgon;";"0.0";"0";"2";"2";"0";"2";"0";"430522";"5766"
"LOK1378_1mm";"SILVA (only NR);Eukaryota;Archaeplastida;Rhodophyceae;Florideophycidae;Corallinophycidae;Spongites;";"0.0";"0";"9";"9";"0";"9";"0";"430515";"5766"
"LOK1378_1mm";"SILVA (only NR);Eukaryota;Archaeplastida;Rhodophyceae;Florideophycidae;Corallinophycidae;Sporolithon;";"0.0";"0";"11";"11";"0";"11";"0";"430513";"5766"
"LOK1378_1mm";"SILVA (only NR);Eukaryota;Archaeplastida;Rhodophyceae;Florideophycidae;Corallinophycidae;Synarthrophyton;";"0.0";"0";"3";"3";"0";"3";"0";"430521";"5766"
"LOK1378_1mm";"SILVA (only NR);Eukaryota;Archaeplastida;Rhodophyceae;Florideophycidae;Corallinophycidae;Titanoderma;";"0.0";"0";"1";"1";"0";"1";"0";"430523";"5766"
"LOK1378_1mm";"SILVA (only NR);Eukaryota;Archaeplastida;Rhodophyceae;Florideophycidae;Hildenbrandiophycidae;";"0.0";"0";"29";"29";"0";"29";"0";"430495";"5766"
"LOK1378_1mm";"SILVA (only NR);Eukaryota;Archaeplastida;Rhodophyceae;Florideophycidae;Hildenbrandiophycidae;Apophlaea;";"0.0";"0";"2";"2";"0";"2";"0";"430522";"5766"
"LOK1378_1mm";"SILVA (only NR);Eukaryota;Archaeplastida;Rhodophyceae;Florideophycidae;Hildenbrandiophycidae;Hildenbrandia;";"0.0";"0";"25";"25";"0";"25";"0";"430499";"5766"
"LOK1378_1mm";"SILVA (only NR);Eukaryota;Archaeplastida;Rhodophyceae;Florideophycidae;Nemaliophycidae;";"0.0";"0";"43";"43";"0";"43";"0";"430481";"5766"
"LOK1378_1mm";"SILVA (only NR);Eukaryota;Archaeplastida;Rhodophyceae;Florideophycidae;Nemaliophycidae;Audouinella;";"0.0";"0";"2";"2";"0";"2";"0";"430522";"5766"
"LOK1378_1mm";"SILVA (only NR);Eukaryota;Archaeplastida;Rhodophyceae;Florideophycidae;Nemaliophycidae;Ballia;";"0.0";"0";"2";"2";"0";"2";"0";"430522";"5766"
"LOK1378_1mm";"SILVA (only NR);Eukaryota;Archaeplastida;Rhodophyceae;Florideophycidae;Nemaliophycidae;Balliopsis;";"0.0";"0";"1";"1";"0";"1";"0";"430523";"5766"
"LOK1378_1mm";"SILVA (only NR);Eukaryota;Archaeplastida;Rhodophyceae;Florideophycidae;Nemaliophycidae;Batrachospermum;";"0.0";"0";"6";"6";"0";"6";"0";"430518";"5766"
"LOK1378_1mm";"SILVA (only NR);Eukaryota;Archaeplastida;Rhodophyceae;Florideophycidae;Nemaliophycidae;Camontagnea;";"0.0";"0";"1";"1";"0";"1";"0";"430523";"5766"
"LOK1378_1mm";"SILVA (only NR);Eukaryota;Archaeplastida;Rhodophyceae;Florideophycidae;Nemaliophycidae;Chantransia;";"0.0";"0";"2";"2";"0";"2";"0";"430522";"5766"
"LOK1378_1mm";"SILVA (only NR);Eukaryota;Archaeplastida;Rhodophyceae;Florideophycidae;Nemaliophycidae;Colaconema;";"0.0";"0";"1";"1";"0";"1";"0";"430523";"5766"
"LOK1378_1mm";"SILVA (only NR);Eukaryota;Archaeplastida;Rhodophyceae;Florideophycidae;Nemaliophycidae;Cumagloia;";"0.0";"0";"1";"1";"0";"1";"0";"430523";"5766"
"LOK1378_1mm";"SILVA (only NR);Eukaryota;Archaeplastida;Rhodophyceae;Florideophycidae;Nemaliophycidae;Dichotomaria;";"0.0";"0";"1";"1";"0";"1";"0";"430523";"5766"
"LOK1378_1mm";"SILVA (only NR);Eukaryota;Archaeplastida;Rhodophyceae;Florideophycidae;Nemaliophycidae;Kumanoa;";"0.0";"0";"3";"3";"0";"3";"0";"430521";"5766"
"LOK1378_1mm";"SILVA (only NR);Eukaryota;Archaeplastida;Rhodophyceae;Florideophycidae;Nemaliophycidae;Nemalion;";"0.0";"0";"1";"1";"0";"1";"0";"430523";"5766"
"LOK1378_1mm";"SILVA (only NR);Eukaryota;Archaeplastida;Rhodophyceae;Florideophycidae;Nemaliophycidae;Nemalionopsis;";"0.0";"0";"1";"1";"0";"1";"0";"430523";"5766"
"LOK1378_1mm";"SILVA (only NR);Eukaryota;Archaeplastida;Rhodophyceae;Florideophycidae;Nemaliophycidae;Nothocladus;";"0.0";"0";"1";"1";"0";"1";"0";"430523";"5766"
"LOK1378_1mm";"SILVA (only NR);Eukaryota;Archaeplastida;Rhodophyceae;Florideophycidae;Nemaliophycidae;Nothogenia;";"0.0";"0";"1";"1";"0";"1";"0";"430523";"5766"
"LOK1378_1mm";"SILVA (only NR);Eukaryota;Archaeplastida;Rhodophyceae;Florideophycidae;Nemaliophycidae;Rhodachlya;";"0.0";"0";"1";"1";"0";"1";"0";"430523";"5766"
"LOK1378_1mm";"SILVA (only NR);Eukaryota;Archaeplastida;Rhodophyceae;Florideophycidae;Nemaliophycidae;Rhododraparnaldia;";"0.0";"0";"1";"1";"0";"1";"0";"430523";"5766"
"LOK1378_1mm";"SILVA (only NR);Eukaryota;Archaeplastida;Rhodophyceae;Florideophycidae;Nemaliophycidae;Rhodophysema;";"0.0";"0";"1";"1";"0";"1";"0";"430523";"5766"
"LOK1378_1mm";"SILVA (only NR);Eukaryota;Archaeplastida;Rhodophyceae;Florideophycidae;Nemaliophycidae;Sheathia;";"0.0";"0";"1";"1";"0";"1";"0";"430523";"5766"
"LOK1378_1mm";"SILVA (only NR);Eukaryota;Archaeplastida;Rhodophyceae;Florideophycidae;Nemaliophycidae;Stenopeltis;";"0.0";"0";"1";"1";"0";"1";"0";"430523";"5766"
"LOK1378_1mm";"SILVA (only NR);Eukaryota;Archaeplastida;Rhodophyceae;Florideophycidae;Nemaliophycidae;Thorea;";"0.0";"0";"8";"8";"0";"8";"0";"430516";"5766"
"LOK1378_1mm";"SILVA (only NR);Eukaryota;Archaeplastida;Rhodophyceae;Florideophycidae;Rhodymeniophycidae;";"0.0";"0";"435";"433";"0";"433";"2";"430091";"5766"
"LOK1378_1mm";"SILVA (only NR);Eukaryota;Archaeplastida;Rhodophyceae;Florideophycidae;Rhodymeniophycidae;Acrosymphyton;";"0.0";"0";"1";"1";"0";"1";"0";"430523";"5766"
"LOK1378_1mm";"SILVA (only NR);Eukaryota;Archaeplastida;Rhodophyceae;Florideophycidae;Rhodymeniophycidae;Acrotylus;";"0.0";"0";"1";"1";"0";"1";"0";"430523";"5766"
"LOK1378_1mm";"SILVA (only NR);Eukaryota;Archaeplastida;Rhodophyceae;Florideophycidae;Rhodymeniophycidae;Aglaothamnion;";"0.0";"0";"3";"3";"0";"3";"0";"430521";"5766"
"LOK1378_1mm";"SILVA (only NR);Eukaryota;Archaeplastida;Rhodophyceae;Florideophycidae;Rhodymeniophycidae;Amansia;";"0.0";"0";"2";"2";"0";"2";"0";"430522";"5766"
"LOK1378_1mm";"SILVA (only NR);Eukaryota;Archaeplastida;Rhodophyceae;Florideophycidae;Rhodymeniophycidae;Amphiplexia;";"0.0";"0";"1";"1";"0";"1";"0";"430523";"5766"
"LOK1378_1mm";"SILVA (only NR);Eukaryota;Archaeplastida;Rhodophyceae;Florideophycidae;Rhodymeniophycidae;Aneurianna;";"0.0";"0";"1";"1";"0";"1";"0";"430523";"5766"
"LOK1378_1mm";"SILVA (only NR);Eukaryota;Archaeplastida;Rhodophyceae;Florideophycidae;Rhodymeniophycidae;Anglaothamnion;";"0.0";"0";"1";"1";"0";"1";"0";"430523";"5766"
"LOK1378_1mm";"SILVA (only NR);Eukaryota;Archaeplastida;Rhodophyceae;Florideophycidae;Rhodymeniophycidae;Anotrichium;";"0.0";"0";"2";"2";"0";"2";"0";"430522";"5766"
"LOK1378_1mm";"SILVA (only NR);Eukaryota;Archaeplastida;Rhodophyceae;Florideophycidae;Rhodymeniophycidae;Antithamnion;";"0.0";"0";"1";"1";"0";"1";"0";"430523";"5766"
"LOK1378_1mm";"SILVA (only NR);Eukaryota;Archaeplastida;Rhodophyceae;Florideophycidae;Rhodymeniophycidae;Antithamnionella;";"0.0";"0";"1";"1";"0";"1";"0";"430523";"5766"
"LOK1378_1mm";"SILVA (only NR);Eukaryota;Archaeplastida;Rhodophyceae;Florideophycidae;Rhodymeniophycidae;Antrocentrum;";"0.0";"0";"1";"1";"0";"1";"0";"430523";"5766"
"LOK1378_1mm";"SILVA (only NR);Eukaryota;Archaeplastida;Rhodophyceae;Florideophycidae;Rhodymeniophycidae;Aphanta;";"0.0";"0";"1";"1";"0";"1";"0";"430523";"5766"
"LOK1378_1mm";"SILVA (only NR);Eukaryota;Archaeplastida;Rhodophyceae;Florideophycidae;Rhodymeniophycidae;Asparagopsis;";"0.0";"0";"2";"2";"0";"2";"0";"430522";"5766"
"LOK1378_1mm";"SILVA (only NR);Eukaryota;Archaeplastida;Rhodophyceae;Florideophycidae;Rhodymeniophycidae;Asteromenia;";"0.0";"0";"1";"1";"0";"1";"0";"430523";"5766"
"LOK1378_1mm";"SILVA (only NR);Eukaryota;Archaeplastida;Rhodophyceae;Florideophycidae;Rhodymeniophycidae;Atractophora;";"0.0";"0";"1";"1";"0";"1";"0";"430523";"5766"
"LOK1378_1mm";"SILVA (only NR);Eukaryota;Archaeplastida;Rhodophyceae;Florideophycidae;Rhodymeniophycidae;Austroclonium;";"0.0";"0";"1";"1";"0";"1";"0";"430523";"5766"
"LOK1378_1mm";"SILVA (only NR);Eukaryota;Archaeplastida;Rhodophyceae;Florideophycidae;Rhodymeniophycidae;Betaphycus;";"0.0";"0";"1";"1";"0";"1";"0";"430523";"5766"
"LOK1378_1mm";"SILVA (only NR);Eukaryota;Archaeplastida;Rhodophyceae;Florideophycidae;Rhodymeniophycidae;Boergeseniella;";"0.0";"0";"1";"1";"0";"1";"0";"430523";"5766"
"LOK1378_1mm";"SILVA (only NR);Eukaryota;Archaeplastida;Rhodophyceae;Florideophycidae;Rhodymeniophycidae;Bonnemaisonia;";"0.0";"0";"3";"3";"0";"3";"0";"430521";"5766"
"LOK1378_1mm";"SILVA (only NR);Eukaryota;Archaeplastida;Rhodophyceae;Florideophycidae;Rhodymeniophycidae;Bostrychia;";"0.0";"0";"4";"4";"0";"4";"0";"430520";"5766"
"LOK1378_1mm";"SILVA (only NR);Eukaryota;Archaeplastida;Rhodophyceae;Florideophycidae;Rhodymeniophycidae;Bostrychiocolax;";"0.0";"0";"1";"1";"0";"1";"0";"430523";"5766"
"LOK1378_1mm";"SILVA (only NR);Eukaryota;Archaeplastida;Rhodophyceae;Florideophycidae;Rhodymeniophycidae;Botryocladia;";"0.0";"0";"2";"2";"0";"2";"0";"430522";"5766"
"LOK1378_1mm";"SILVA (only NR);Eukaryota;Archaeplastida;Rhodophyceae;Florideophycidae;Rhodymeniophycidae;Calliblepharis;";"0.0";"0";"6";"6";"0";"6";"0";"430518";"5766"
"LOK1378_1mm";"SILVA (only NR);Eukaryota;Archaeplastida;Rhodophyceae;Florideophycidae;Rhodymeniophycidae;Callithamnion;";"0.0";"0";"2";"2";"0";"2";"0";"430522";"5766"
"LOK1378_1mm";"SILVA (only NR);Eukaryota;Archaeplastida;Rhodophyceae;Florideophycidae;Rhodymeniophycidae;Callophycus;";"0.0";"0";"1";"1";"0";"1";"0";"430523";"5766"
"LOK1378_1mm";"SILVA (only NR);Eukaryota;Archaeplastida;Rhodophyceae;Florideophycidae;Rhodymeniophycidae;Callophyllis;";"0.0";"0";"1";"1";"0";"1";"0";"430523";"5766"
"LOK1378_1mm";"SILVA (only NR);Eukaryota;Archaeplastida;Rhodophyceae;Florideophycidae;Rhodymeniophycidae;Caloglossa;";"0.0";"0";"5";"5";"0";"5";"0";"430519";"5766"
"LOK1378_1mm";"SILVA (only NR);Eukaryota;Archaeplastida;Rhodophyceae;Florideophycidae;Rhodymeniophycidae;Carpothamnion;";"0.0";"0";"1";"1";"0";"1";"0";"430523";"5766"
"LOK1378_1mm";"SILVA (only NR);Eukaryota;Archaeplastida;Rhodophyceae;Florideophycidae;Rhodymeniophycidae;Catenella;";"0.0";"0";"1";"1";"0";"1";"0";"430523";"5766"
"LOK1378_1mm";"SILVA (only NR);Eukaryota;Archaeplastida;Rhodophyceae;Florideophycidae;Rhodymeniophycidae;Caulacanthus;";"0.0";"0";"1";"1";"0";"1";"0";"430523";"5766"
"LOK1378_1mm";"SILVA (only NR);Eukaryota;Archaeplastida;Rhodophyceae;Florideophycidae;Rhodymeniophycidae;Centroceras;";"0.0";"0";"4";"4";"0";"4";"0";"430520";"5766"
"LOK1378_1mm";"SILVA (only NR);Eukaryota;Archaeplastida;Rhodophyceae;Florideophycidae;Rhodymeniophycidae;Cephalocystis;";"0.0";"0";"1";"1";"0";"1";"0";"430523";"5766"
"LOK1378_1mm";"SILVA (only NR);Eukaryota;Archaeplastida;Rhodophyceae;Florideophycidae;Rhodymeniophycidae;Ceramium;";"0.0";"0";"9";"9";"0";"9";"0";"430515";"5766"
"LOK1378_1mm";"SILVA (only NR);Eukaryota;Archaeplastida;Rhodophyceae;Florideophycidae;Rhodymeniophycidae;Ceratodictyon;";"0.0";"0";"1";"1";"0";"1";"0";"430523";"5766"
"LOK1378_1mm";"SILVA (only NR);Eukaryota;Archaeplastida;Rhodophyceae;Florideophycidae;Rhodymeniophycidae;Champia;";"0.0";"0";"9";"9";"0";"9";"0";"430515";"5766"
"LOK1378_1mm";"SILVA (only NR);Eukaryota;Archaeplastida;Rhodophyceae;Florideophycidae;Rhodymeniophycidae;Chondrus;";"0.0";"0";"2";"2";"0";"2";"0";"430522";"5766"
"LOK1378_1mm";"SILVA (only NR);Eukaryota;Archaeplastida;Rhodophyceae;Florideophycidae;Rhodymeniophycidae;Choreocolax;";"0.0";"0";"1";"1";"0";"1";"0";"430523";"5766"
"LOK1378_1mm";"SILVA (only NR);Eukaryota;Archaeplastida;Rhodophyceae;Florideophycidae;Rhodymeniophycidae;Chrysymenia;";"0.0";"0";"2";"2";"0";"2";"0";"430522";"5766"
"LOK1378_1mm";"SILVA (only NR);Eukaryota;Archaeplastida;Rhodophyceae;Florideophycidae;Rhodymeniophycidae;Chylocladia;";"0.0";"0";"2";"2";"0";"2";"0";"430522";"5766"
"LOK1378_1mm";"SILVA (only NR);Eukaryota;Archaeplastida;Rhodophyceae;Florideophycidae;Rhodymeniophycidae;Coelarthrum;";"0.0";"0";"1";"1";"0";"1";"0";"430523";"5766"
"LOK1378_1mm";"SILVA (only NR);Eukaryota;Archaeplastida;Rhodophyceae;Florideophycidae;Rhodymeniophycidae;Coelothrix;";"0.0";"0";"2";"2";"0";"2";"0";"430522";"5766"
"LOK1378_1mm";"SILVA (only NR);Eukaryota;Archaeplastida;Rhodophyceae;Florideophycidae;Rhodymeniophycidae;Compsothamnion;";"0.0";"0";"1";"1";"0";"1";"0";"430523";"5766"
"LOK1378_1mm";"SILVA (only NR);Eukaryota;Archaeplastida;Rhodophyceae;Florideophycidae;Rhodymeniophycidae;Constantinea;";"0.0";"0";"1";"1";"0";"1";"0";"430523";"5766"
"LOK1378_1mm";"SILVA (only NR);Eukaryota;Archaeplastida;Rhodophyceae;Florideophycidae;Rhodymeniophycidae;Cordylecladia;";"0.0";"0";"1";"1";"0";"1";"0";"430523";"5766"
"LOK1378_1mm";"SILVA (only NR);Eukaryota;Archaeplastida;Rhodophyceae;Florideophycidae;Rhodymeniophycidae;Corynocystis;";"0.0";"0";"1";"1";"0";"1";"0";"430523";"5766"
"LOK1378_1mm";"SILVA (only NR);Eukaryota;Archaeplastida;Rhodophyceae;Florideophycidae;Rhodymeniophycidae;Crassitegula;";"0.0";"0";"1";"1";"0";"1";"0";"430523";"5766"
"LOK1378_1mm";"SILVA (only NR);Eukaryota;Archaeplastida;Rhodophyceae;Florideophycidae;Rhodymeniophycidae;Cresia;";"0.0";"0";"1";"1";"0";"1";"0";"430523";"5766"
"LOK1378_1mm";"SILVA (only NR);Eukaryota;Archaeplastida;Rhodophyceae;Florideophycidae;Rhodymeniophycidae;Crouania;";"0.0";"0";"2";"2";"0";"2";"0";"430522";"5766"
"LOK1378_1mm";"SILVA (only NR);Eukaryota;Archaeplastida;Rhodophyceae;Florideophycidae;Rhodymeniophycidae;Cryptopleura;";"0.0";"0";"2";"2";"0";"2";"0";"430522";"5766"
"LOK1378_1mm";"SILVA (only NR);Eukaryota;Archaeplastida;Rhodophyceae;Florideophycidae;Rhodymeniophycidae;Cubiculosporum;";"0.0";"0";"1";"1";"0";"1";"0";"430523";"5766"
"LOK1378_1mm";"SILVA (only NR);Eukaryota;Archaeplastida;Rhodophyceae;Florideophycidae;Rhodymeniophycidae;Curdiea;";"0.0";"0";"2";"2";"0";"2";"0";"430522";"5766"
"LOK1378_1mm";"SILVA (only NR);Eukaryota;Archaeplastida;Rhodophyceae;Florideophycidae;Rhodymeniophycidae;Cystoclonium;";"0.0";"0";"1";"1";"0";"1";"0";"430523";"5766"
"LOK1378_1mm";"SILVA (only NR);Eukaryota;Archaeplastida;Rhodophyceae;Florideophycidae;Rhodymeniophycidae;Dasya;";"0.0";"0";"1";"1";"0";"1";"0";"430523";"5766"
"LOK1378_1mm";"SILVA (only NR);Eukaryota;Archaeplastida;Rhodophyceae;Florideophycidae;Rhodymeniophycidae;Dasyphloea;";"0.0";"0";"1";"1";"0";"1";"0";"430523";"5766"
"LOK1378_1mm";"SILVA (only NR);Eukaryota;Archaeplastida;Rhodophyceae;Florideophycidae;Rhodymeniophycidae;Dasysiphonia;";"0.0";"0";"1";"1";"0";"1";"0";"430523";"5766"
"LOK1378_1mm";"SILVA (only NR);Eukaryota;Archaeplastida;Rhodophyceae;Florideophycidae;Rhodymeniophycidae;Dasythamniella;";"0.0";"0";"1";"1";"0";"1";"0";"430523";"5766"
"LOK1378_1mm";"SILVA (only NR);Eukaryota;Archaeplastida;Rhodophyceae;Florideophycidae;Rhodymeniophycidae;Dawsoniocolax;";"0.0";"0";"1";"1";"0";"1";"0";"430523";"5766"
"LOK1378_1mm";"SILVA (only NR);Eukaryota;Archaeplastida;Rhodophyceae;Florideophycidae;Rhodymeniophycidae;Delisea;";"0.0";"0";"1";"1";"0";"1";"0";"430523";"5766"
"LOK1378_1mm";"SILVA (only NR);Eukaryota;Archaeplastida;Rhodophyceae;Florideophycidae;Rhodymeniophycidae;Diapse;";"0.0";"0";"1";"1";"0";"1";"0";"430523";"5766"
"LOK1378_1mm";"SILVA (only NR);Eukaryota;Archaeplastida;Rhodophyceae;Florideophycidae;Rhodymeniophycidae;Dicranema;";"0.0";"0";"1";"1";"0";"1";"0";"430523";"5766"
"LOK1378_1mm";"SILVA (only NR);Eukaryota;Archaeplastida;Rhodophyceae;Florideophycidae;Rhodymeniophycidae;Dictyothamnion;";"0.0";"0";"1";"1";"0";"1";"0";"430523";"5766"
"LOK1378_1mm";"SILVA (only NR);Eukaryota;Archaeplastida;Rhodophyceae;Florideophycidae;Rhodymeniophycidae;Dictyurus;";"0.0";"0";"1";"1";"0";"1";"0";"430523";"5766"
"LOK1378_1mm";"SILVA (only NR);Eukaryota;Archaeplastida;Rhodophyceae;Florideophycidae;Rhodymeniophycidae;Drouetia;";"0.0";"0";"1";"1";"0";"1";"0";"430523";"5766"
"LOK1378_1mm";"SILVA (only NR);Eukaryota;Archaeplastida;Rhodophyceae;Florideophycidae;Rhodymeniophycidae;Dudresnaya;";"0.0";"0";"1";"1";"0";"1";"0";"430523";"5766"
"LOK1378_1mm";"SILVA (only NR);Eukaryota;Archaeplastida;Rhodophyceae;Florideophycidae;Rhodymeniophycidae;Dumontia;";"0.0";"0";"1";"1";"0";"1";"0";"430523";"5766"
"LOK1378_1mm";"SILVA (only NR);Eukaryota;Archaeplastida;Rhodophyceae;Florideophycidae;Rhodymeniophycidae;Epiphloea;";"0.0";"0";"1";"1";"0";"1";"0";"430523";"5766"
"LOK1378_1mm";"SILVA (only NR);Eukaryota;Archaeplastida;Rhodophyceae;Florideophycidae;Rhodymeniophycidae;Erythrocolon;";"0.0";"0";"1";"1";"0";"1";"0";"430523";"5766"
"LOK1378_1mm";"SILVA (only NR);Eukaryota;Archaeplastida;Rhodophyceae;Florideophycidae;Rhodymeniophycidae;Erythronaema;";"0.0";"0";"1";"1";"0";"1";"0";"430523";"5766"
"LOK1378_1mm";"SILVA (only NR);Eukaryota;Archaeplastida;Rhodophyceae;Florideophycidae;Rhodymeniophycidae;Erythrophyllum;";"0.0";"0";"1";"1";"0";"1";"0";"430523";"5766"
"LOK1378_1mm";"SILVA (only NR);Eukaryota;Archaeplastida;Rhodophyceae;Florideophycidae;Rhodymeniophycidae;Erythrymenia;";"0.0";"0";"1";"1";"0";"1";"0";"430523";"5766"
"LOK1378_1mm";"SILVA (only NR);Eukaryota;Archaeplastida;Rhodophyceae;Florideophycidae;Rhodymeniophycidae;Eucheuma;";"0.0";"0";"1";"1";"0";"1";"0";"430523";"5766"
"LOK1378_1mm";"SILVA (only NR);Eukaryota;Archaeplastida;Rhodophyceae;Florideophycidae;Rhodymeniophycidae;Euptilocladia;";"0.0";"0";"1";"1";"0";"1";"0";"430523";"5766"
"LOK1378_1mm";"SILVA (only NR);Eukaryota;Archaeplastida;Rhodophyceae;Florideophycidae;Rhodymeniophycidae;Euptilota;";"0.0";"0";"3";"3";"0";"3";"0";"430521";"5766"
"LOK1378_1mm";"SILVA (only NR);Eukaryota;Archaeplastida;Rhodophyceae;Florideophycidae;Rhodymeniophycidae;Euthora;";"0.0";"0";"1";"1";"0";"1";"0";"430523";"5766"
"LOK1378_1mm";"SILVA (only NR);Eukaryota;Archaeplastida;Rhodophyceae;Florideophycidae;Rhodymeniophycidae;Fimbrifolium;";"0.0";"0";"1";"1";"0";"1";"0";"430523";"5766"
"LOK1378_1mm";"SILVA (only NR);Eukaryota;Archaeplastida;Rhodophyceae;Florideophycidae;Rhodymeniophycidae;Fryeella;";"0.0";"0";"1";"1";"0";"1";"0";"430523";"5766"
"LOK1378_1mm";"SILVA (only NR);Eukaryota;Archaeplastida;Rhodophyceae;Florideophycidae;Rhodymeniophycidae;Furcellaria;";"0.0";"0";"1";"1";"0";"1";"0";"430523";"5766"
"LOK1378_1mm";"SILVA (only NR);Eukaryota;Archaeplastida;Rhodophyceae;Florideophycidae;Rhodymeniophycidae;Gardneriella;";"0.0";"0";"1";"1";"0";"1";"0";"430523";"5766"
"LOK1378_1mm";"SILVA (only NR);Eukaryota;Archaeplastida;Rhodophyceae;Florideophycidae;Rhodymeniophycidae;Gastroclonium;";"0.0";"0";"1";"1";"0";"1";"0";"430523";"5766"
"LOK1378_1mm";"SILVA (only NR);Eukaryota;Archaeplastida;Rhodophyceae;Florideophycidae;Rhodymeniophycidae;Gelidiella;";"0.0";"0";"2";"2";"0";"2";"0";"430522";"5766"
"LOK1378_1mm";"SILVA (only NR);Eukaryota;Archaeplastida;Rhodophyceae;Florideophycidae;Rhodymeniophycidae;Gelidiopsis;";"0.0";"0";"1";"1";"0";"1";"0";"430523";"5766"
"LOK1378_1mm";"SILVA (only NR);Eukaryota;Archaeplastida;Rhodophyceae;Florideophycidae;Rhodymeniophycidae;Gelidium;";"0.0";"0";"3";"3";"0";"3";"0";"430521";"5766"
"LOK1378_1mm";"SILVA (only NR);Eukaryota;Archaeplastida;Rhodophyceae;Florideophycidae;Rhodymeniophycidae;Georgiella;";"0.0";"0";"1";"1";"0";"1";"0";"430523";"5766"
"LOK1378_1mm";"SILVA (only NR);Eukaryota;Archaeplastida;Rhodophyceae;Florideophycidae;Rhodymeniophycidae;Gibsmithia;";"0.0";"0";"1";"1";"0";"1";"0";"430523";"5766"
"LOK1378_1mm";"SILVA (only NR);Eukaryota;Archaeplastida;Rhodophyceae;Florideophycidae;Rhodymeniophycidae;Gloiocladia;";"0.0";"0";"6";"6";"0";"6";"0";"430518";"5766"
"LOK1378_1mm";"SILVA (only NR);Eukaryota;Archaeplastida;Rhodophyceae;Florideophycidae;Rhodymeniophycidae;Gloiopeltis;";"0.0";"0";"1";"1";"0";"1";"0";"430523";"5766"
"LOK1378_1mm";"SILVA (only NR);Eukaryota;Archaeplastida;Rhodophyceae;Florideophycidae;Rhodymeniophycidae;Gracilaria;";"0.0";"0";"11";"11";"0";"11";"0";"430513";"5766"
"LOK1378_1mm";"SILVA (only NR);Eukaryota;Archaeplastida;Rhodophyceae;Florideophycidae;Rhodymeniophycidae;Gracilariopsis;";"0.0";"0";"7";"7";"0";"7";"0";"430517";"5766"
"LOK1378_1mm";"SILVA (only NR);Eukaryota;Archaeplastida;Rhodophyceae;Florideophycidae;Rhodymeniophycidae;Grateloupia;";"0.0";"0";"2";"1";"0";"1";"1";"430523";"5766"
"LOK1378_1mm";"SILVA (only NR);Eukaryota;Archaeplastida;Rhodophyceae;Florideophycidae;Rhodymeniophycidae;Griffithsia;";"0.0";"0";"2";"2";"0";"2";"0";"430522";"5766"
"LOK1378_1mm";"SILVA (only NR);Eukaryota;Archaeplastida;Rhodophyceae;Florideophycidae;Rhodymeniophycidae;Grinnellia;";"0.0";"0";"1";"1";"0";"1";"0";"430523";"5766"
"LOK1378_1mm";"SILVA (only NR);Eukaryota;Archaeplastida;Rhodophyceae;Florideophycidae;Rhodymeniophycidae;Gulsonia;";"0.0";"0";"1";"1";"0";"1";"0";"430523";"5766"
"LOK1378_1mm";"SILVA (only NR);Eukaryota;Archaeplastida;Rhodophyceae;Florideophycidae;Rhodymeniophycidae;Halichrysis;";"0.0";"0";"1";"1";"0";"1";"0";"430523";"5766"
"LOK1378_1mm";"SILVA (only NR);Eukaryota;Archaeplastida;Rhodophyceae;Florideophycidae;Rhodymeniophycidae;Halopithys;";"0.0";"0";"1";"1";"0";"1";"0";"430523";"5766"
"LOK1378_1mm";"SILVA (only NR);Eukaryota;Archaeplastida;Rhodophyceae;Florideophycidae;Rhodymeniophycidae;Halurus;";"0.0";"0";"1";"1";"0";"1";"0";"430523";"5766"
"LOK1378_1mm";"SILVA (only NR);Eukaryota;Archaeplastida;Rhodophyceae;Florideophycidae;Rhodymeniophycidae;Halydictyon;";"0.0";"0";"1";"1";"0";"1";"0";"430523";"5766"
"LOK1378_1mm";"SILVA (only NR);Eukaryota;Archaeplastida;Rhodophyceae;Florideophycidae;Rhodymeniophycidae;Harveyella;";"0.0";"0";"2";"2";"0";"2";"0";"430522";"5766"
"LOK1378_1mm";"SILVA (only NR);Eukaryota;Archaeplastida;Rhodophyceae;Florideophycidae;Rhodymeniophycidae;Hemineura;";"0.0";"0";"1";"1";"0";"1";"0";"430523";"5766"
"LOK1378_1mm";"SILVA (only NR);Eukaryota;Archaeplastida;Rhodophyceae;Florideophycidae;Rhodymeniophycidae;Herposiphonia;";"0.0";"0";"3";"3";"0";"3";"0";"430521";"5766"
"LOK1378_1mm";"SILVA (only NR);Eukaryota;Archaeplastida;Rhodophyceae;Florideophycidae;Rhodymeniophycidae;Heterocladia;";"0.0";"0";"1";"1";"0";"1";"0";"430523";"5766"
"LOK1378_1mm";"SILVA (only NR);Eukaryota;Archaeplastida;Rhodophyceae;Florideophycidae;Rhodymeniophycidae;Heteroptilon;";"0.0";"0";"1";"1";"0";"1";"0";"430523";"5766"
"LOK1378_1mm";"SILVA (only NR);Eukaryota;Archaeplastida;Rhodophyceae;Florideophycidae;Rhodymeniophycidae;Heterosiphonia;";"0.0";"0";"3";"3";"0";"3";"0";"430521";"5766"
"LOK1378_1mm";"SILVA (only NR);Eukaryota;Archaeplastida;Rhodophyceae;Florideophycidae;Rhodymeniophycidae;Hummbrella;";"0.0";"0";"1";"1";"0";"1";"0";"430523";"5766"
"LOK1378_1mm";"SILVA (only NR);Eukaryota;Archaeplastida;Rhodophyceae;Florideophycidae;Rhodymeniophycidae;Hymenocladia;";"0.0";"0";"1";"1";"0";"1";"0";"430523";"5766"
"LOK1378_1mm";"SILVA (only NR);Eukaryota;Archaeplastida;Rhodophyceae;Florideophycidae;Rhodymeniophycidae;Hymenocladiopsis;";"0.0";"0";"1";"1";"0";"1";"0";"430523";"5766"
"LOK1378_1mm";"SILVA (only NR);Eukaryota;Archaeplastida;Rhodophyceae;Florideophycidae;Rhodymeniophycidae;Hypnea;";"0.0";"0";"2";"2";"0";"2";"0";"430522";"5766"
"LOK1378_1mm";"SILVA (only NR);Eukaryota;Archaeplastida;Rhodophyceae;Florideophycidae;Rhodymeniophycidae;Hypoglossum;";"0.0";"0";"1";"1";"0";"1";"0";"430523";"5766"
"LOK1378_1mm";"SILVA (only NR);Eukaryota;Archaeplastida;Rhodophyceae;Florideophycidae;Rhodymeniophycidae;Inkyuleea;";"0.0";"0";"1";"1";"0";"1";"0";"430523";"5766"
"LOK1378_1mm";"SILVA (only NR);Eukaryota;Archaeplastida;Rhodophyceae;Florideophycidae;Rhodymeniophycidae;Involucrana;";"0.0";"0";"1";"1";"0";"1";"0";"430523";"5766"
"LOK1378_1mm";"SILVA (only NR);Eukaryota;Archaeplastida;Rhodophyceae;Florideophycidae;Rhodymeniophycidae;Irvinea;";"0.0";"0";"1";"1";"0";"1";"0";"430523";"5766"
"LOK1378_1mm";"SILVA (only NR);Eukaryota;Archaeplastida;Rhodophyceae;Florideophycidae;Rhodymeniophycidae;Isabbottia;";"0.0";"0";"1";"1";"0";"1";"0";"430523";"5766"
"LOK1378_1mm";"SILVA (only NR);Eukaryota;Archaeplastida;Rhodophyceae;Florideophycidae;Rhodymeniophycidae;Kappaphycus;";"0.0";"0";"2";"2";"0";"2";"0";"430522";"5766"
"LOK1378_1mm";"SILVA (only NR);Eukaryota;Archaeplastida;Rhodophyceae;Florideophycidae;Rhodymeniophycidae;Kraftia;";"0.0";"0";"1";"1";"0";"1";"0";"430523";"5766"
"LOK1378_1mm";"SILVA (only NR);Eukaryota;Archaeplastida;Rhodophyceae;Florideophycidae;Rhodymeniophycidae;Kuetzingia;";"0.0";"0";"1";"1";"0";"1";"0";"430523";"5766"
"LOK1378_1mm";"SILVA (only NR);Eukaryota;Archaeplastida;Rhodophyceae;Florideophycidae;Rhodymeniophycidae;Laurencia;";"0.0";"0";"1";"1";"0";"1";"0";"430523";"5766"
"LOK1378_1mm";"SILVA (only NR);Eukaryota;Archaeplastida;Rhodophyceae;Florideophycidae;Rhodymeniophycidae;Leachiella;";"0.0";"0";"1";"1";"0";"1";"0";"430523";"5766"
"LOK1378_1mm";"SILVA (only NR);Eukaryota;Archaeplastida;Rhodophyceae;Florideophycidae;Rhodymeniophycidae;Lejolisia;";"0.0";"0";"1";"1";"0";"1";"0";"430523";"5766"
"LOK1378_1mm";"SILVA (only NR);Eukaryota;Archaeplastida;Rhodophyceae;Florideophycidae;Rhodymeniophycidae;Lembergia;";"0.0";"0";"1";"1";"0";"1";"0";"430523";"5766"
"LOK1378_1mm";"SILVA (only NR);Eukaryota;Archaeplastida;Rhodophyceae;Florideophycidae;Rhodymeniophycidae;Lenormandia;";"0.0";"0";"4";"4";"0";"4";"0";"430520";"5766"
"LOK1378_1mm";"SILVA (only NR);Eukaryota;Archaeplastida;Rhodophyceae;Florideophycidae;Rhodymeniophycidae;Leptosomia;";"0.0";"0";"1";"1";"0";"1";"0";"430523";"5766"
"LOK1378_1mm";"SILVA (only NR);Eukaryota;Archaeplastida;Rhodophyceae;Florideophycidae;Rhodymeniophycidae;Lesleigha;";"0.0";"0";"2";"2";"0";"2";"0";"430522";"5766"
"LOK1378_1mm";"SILVA (only NR);Eukaryota;Archaeplastida;Rhodophyceae;Florideophycidae;Rhodymeniophycidae;Lomentaria;";"0.0";"0";"2";"2";"0";"2";"0";"430522";"5766"
"LOK1378_1mm";"SILVA (only NR);Eukaryota;Archaeplastida;Rhodophyceae;Florideophycidae;Rhodymeniophycidae;Lophocladia;";"0.0";"0";"2";"2";"0";"2";"0";"430522";"5766"
"LOK1378_1mm";"SILVA (only NR);Eukaryota;Archaeplastida;Rhodophyceae;Florideophycidae;Rhodymeniophycidae;Lophothalia;";"0.0";"0";"1";"1";"0";"1";"0";"430523";"5766"
"LOK1378_1mm";"SILVA (only NR);Eukaryota;Archaeplastida;Rhodophyceae;Florideophycidae;Rhodymeniophycidae;Maripelta;";"0.0";"0";"1";"1";"0";"1";"0";"430523";"5766"
"LOK1378_1mm";"SILVA (only NR);Eukaryota;Archaeplastida;Rhodophyceae;Florideophycidae;Rhodymeniophycidae;Mastocarpus;";"0.0";"0";"1";"1";"0";"1";"0";"430523";"5766"
"LOK1378_1mm";"SILVA (only NR);Eukaryota;Archaeplastida;Rhodophyceae;Florideophycidae;Rhodymeniophycidae;Melanthalia;";"0.0";"0";"1";"1";"0";"1";"0";"430523";"5766"
"LOK1378_1mm";"SILVA (only NR);Eukaryota;Archaeplastida;Rhodophyceae;Florideophycidae;Rhodymeniophycidae;Micropeuce;";"0.0";"0";"1";"1";"0";"1";"0";"430523";"5766"
"LOK1378_1mm";"SILVA (only NR);Eukaryota;Archaeplastida;Rhodophyceae;Florideophycidae;Rhodymeniophycidae;Monosporus;";"0.0";"0";"1";"1";"0";"1";"0";"430523";"5766"
"LOK1378_1mm";"SILVA (only NR);Eukaryota;Archaeplastida;Rhodophyceae;Florideophycidae;Rhodymeniophycidae;Muellerena;";"0.0";"0";"1";"1";"0";"1";"0";"430523";"5766"
"LOK1378_1mm";"SILVA (only NR);Eukaryota;Archaeplastida;Rhodophyceae;Florideophycidae;Rhodymeniophycidae;Murrayella;";"0.0";"0";"1";"1";"0";"1";"0";"430523";"5766"
"LOK1378_1mm";"SILVA (only NR);Eukaryota;Archaeplastida;Rhodophyceae;Florideophycidae;Rhodymeniophycidae;Naccaria;";"0.0";"0";"1";"1";"0";"1";"0";"430523";"5766"
"LOK1378_1mm";"SILVA (only NR);Eukaryota;Archaeplastida;Rhodophyceae;Florideophycidae;Rhodymeniophycidae;Nemastoma;";"0.0";"0";"1";"1";"0";"1";"0";"430523";"5766"
"LOK1378_1mm";"SILVA (only NR);Eukaryota;Archaeplastida;Rhodophyceae;Florideophycidae;Rhodymeniophycidae;Neodilsea;";"0.0";"0";"1";"1";"0";"1";"0";"430523";"5766"
"LOK1378_1mm";"SILVA (only NR);Eukaryota;Archaeplastida;Rhodophyceae;Florideophycidae;Rhodymeniophycidae;Neorhodomela;";"0.0";"0";"1";"1";"0";"1";"0";"430523";"5766"
"LOK1378_1mm";"SILVA (only NR);Eukaryota;Archaeplastida;Rhodophyceae;Florideophycidae;Rhodymeniophycidae;Neosiphonia;";"0.0";"0";"6";"6";"0";"6";"0";"430518";"5766"
"LOK1378_1mm";"SILVA (only NR);Eukaryota;Archaeplastida;Rhodophyceae;Florideophycidae;Rhodymeniophycidae;Neurymenia;";"0.0";"0";"1";"1";"0";"1";"0";"430523";"5766"
"LOK1378_1mm";"SILVA (only NR);Eukaryota;Archaeplastida;Rhodophyceae;Florideophycidae;Rhodymeniophycidae;Nizymenia;";"0.0";"0";"1";"1";"0";"1";"0";"430523";"5766"
"LOK1378_1mm";"SILVA (only NR);Eukaryota;Archaeplastida;Rhodophyceae;Florideophycidae;Rhodymeniophycidae;Norrissia;";"0.0";"0";"1";"1";"0";"1";"0";"430523";"5766"
"LOK1378_1mm";"SILVA (only NR);Eukaryota;Archaeplastida;Rhodophyceae;Florideophycidae;Rhodymeniophycidae;Odonthalia;";"0.0";"0";"1";"1";"0";"1";"0";"430523";"5766"
"LOK1378_1mm";"SILVA (only NR);Eukaryota;Archaeplastida;Rhodophyceae;Florideophycidae;Rhodymeniophycidae;Ophidocladus;";"0.0";"0";"1";"1";"0";"1";"0";"430523";"5766"
"LOK1378_1mm";"SILVA (only NR);Eukaryota;Archaeplastida;Rhodophyceae;Florideophycidae;Rhodymeniophycidae;Osmundaria;";"0.0";"0";"1";"1";"0";"1";"0";"430523";"5766"
"LOK1378_1mm";"SILVA (only NR);Eukaryota;Archaeplastida;Rhodophyceae;Florideophycidae;Rhodymeniophycidae;Osmundea;";"0.0";"0";"1";"1";"0";"1";"0";"430523";"5766"
"LOK1378_1mm";"SILVA (only NR);Eukaryota;Archaeplastida;Rhodophyceae;Florideophycidae;Rhodymeniophycidae;Pachymenia;";"0.0";"0";"2";"2";"0";"2";"0";"430522";"5766"
"LOK1378_1mm";"SILVA (only NR);Eukaryota;Archaeplastida;Rhodophyceae;Florideophycidae;Rhodymeniophycidae;Parviphycus;";"0.0";"0";"1";"1";"0";"1";"0";"430523";"5766"
"LOK1378_1mm";"SILVA (only NR);Eukaryota;Archaeplastida;Rhodophyceae;Florideophycidae;Rhodymeniophycidae;Peyssonnelia;";"0.0";"0";"16";"16";"0";"16";"0";"430508";"5766"
"LOK1378_1mm";"SILVA (only NR);Eukaryota;Archaeplastida;Rhodophyceae;Florideophycidae;Rhodymeniophycidae;Phycodrys;";"0.0";"0";"1";"1";"0";"1";"0";"430523";"5766"
"LOK1378_1mm";"SILVA (only NR);Eukaryota;Archaeplastida;Rhodophyceae;Florideophycidae;Rhodymeniophycidae;Platoma;";"0.0";"0";"1";"1";"0";"1";"0";"430523";"5766"
"LOK1378_1mm";"SILVA (only NR);Eukaryota;Archaeplastida;Rhodophyceae;Florideophycidae;Rhodymeniophycidae;Platysiphonia;";"0.0";"0";"2";"2";"0";"2";"0";"430522";"5766"
"LOK1378_1mm";"SILVA (only NR);Eukaryota;Archaeplastida;Rhodophyceae;Florideophycidae;Rhodymeniophycidae;Pleonosporium;";"0.0";"0";"1";"1";"0";"1";"0";"430523";"5766"
"LOK1378_1mm";"SILVA (only NR);Eukaryota;Archaeplastida;Rhodophyceae;Florideophycidae;Rhodymeniophycidae;Plocamium;";"0.0";"0";"2";"2";"0";"2";"0";"430522";"5766"
"LOK1378_1mm";"SILVA (only NR);Eukaryota;Archaeplastida;Rhodophyceae;Florideophycidae;Rhodymeniophycidae;Polsiphonia;";"0.0";"0";"1";"1";"0";"1";"0";"430523";"5766"
"LOK1378_1mm";"SILVA (only NR);Eukaryota;Archaeplastida;Rhodophyceae;Florideophycidae;Rhodymeniophycidae;Polyides;";"0.0";"0";"1";"1";"0";"1";"0";"430523";"5766"
"LOK1378_1mm";"SILVA (only NR);Eukaryota;Archaeplastida;Rhodophyceae;Florideophycidae;Rhodymeniophycidae;Polyopes;";"0.0";"0";"1";"1";"0";"1";"0";"430523";"5766"
"LOK1378_1mm";"SILVA (only NR);Eukaryota;Archaeplastida;Rhodophyceae;Florideophycidae;Rhodymeniophycidae;Polysiphonia;";"0.0";"0";"28";"28";"0";"28";"0";"430496";"5766"
"LOK1378_1mm";"SILVA (only NR);Eukaryota;Archaeplastida;Rhodophyceae;Florideophycidae;Rhodymeniophycidae;Polystrata;";"0.0";"0";"1";"1";"0";"1";"0";"430523";"5766"
"LOK1378_1mm";"SILVA (only NR);Eukaryota;Archaeplastida;Rhodophyceae;Florideophycidae;Rhodymeniophycidae;Portieria;";"0.0";"0";"2";"2";"0";"2";"0";"430522";"5766"
"LOK1378_1mm";"SILVA (only NR);Eukaryota;Archaeplastida;Rhodophyceae;Florideophycidae;Rhodymeniophycidae;Predaea;";"0.0";"0";"2";"2";"0";"2";"0";"430522";"5766"
"LOK1378_1mm";"SILVA (only NR);Eukaryota;Archaeplastida;Rhodophyceae;Florideophycidae;Rhodymeniophycidae;Prionitis;";"0.0";"0";"1";"1";"0";"1";"0";"430523";"5766"
"LOK1378_1mm";"SILVA (only NR);Eukaryota;Archaeplastida;Rhodophyceae;Florideophycidae;Rhodymeniophycidae;Pterothamnion;";"0.0";"0";"1";"1";"0";"1";"0";"430523";"5766"
"LOK1378_1mm";"SILVA (only NR);Eukaryota;Archaeplastida;Rhodophyceae;Florideophycidae;Rhodymeniophycidae;Ptilocladiopsis;";"0.0";"0";"1";"1";"0";"1";"0";"430523";"5766"
"LOK1378_1mm";"SILVA (only NR);Eukaryota;Archaeplastida;Rhodophyceae;Florideophycidae;Rhodymeniophycidae;Ptilonia;";"0.0";"0";"1";"1";"0";"1";"0";"430523";"5766"
"LOK1378_1mm";"SILVA (only NR);Eukaryota;Archaeplastida;Rhodophyceae;Florideophycidae;Rhodymeniophycidae;Ptilophora;";"0.0";"0";"1";"1";"0";"1";"0";"430523";"5766"
"LOK1378_1mm";"SILVA (only NR);Eukaryota;Archaeplastida;Rhodophyceae;Florideophycidae;Rhodymeniophycidae;Ptilota;";"0.0";"0";"2";"2";"0";"2";"0";"430522";"5766"
"LOK1378_1mm";"SILVA (only NR);Eukaryota;Archaeplastida;Rhodophyceae;Florideophycidae;Rhodymeniophycidae;Pugetia;";"0.0";"0";"1";"1";"0";"1";"0";"430523";"5766"
"LOK1378_1mm";"SILVA (only NR);Eukaryota;Archaeplastida;Rhodophyceae;Florideophycidae;Rhodymeniophycidae;Rhodocallis;";"0.0";"0";"1";"1";"0";"1";"0";"430523";"5766"
"LOK1378_1mm";"SILVA (only NR);Eukaryota;Archaeplastida;Rhodophyceae;Florideophycidae;Rhodymeniophycidae;Rhodoglossum;";"0.0";"0";"1";"1";"0";"1";"0";"430523";"5766"
"LOK1378_1mm";"SILVA (only NR);Eukaryota;Archaeplastida;Rhodophyceae;Florideophycidae;Rhodymeniophycidae;Rhodomela;";"0.0";"0";"1";"1";"0";"1";"0";"430523";"5766"
"LOK1378_1mm";"SILVA (only NR);Eukaryota;Archaeplastida;Rhodophyceae;Florideophycidae;Rhodymeniophycidae;Rhodopeltis;";"0.0";"0";"1";"1";"0";"1";"0";"430523";"5766"
"LOK1378_1mm";"SILVA (only NR);Eukaryota;Archaeplastida;Rhodophyceae;Florideophycidae;Rhodymeniophycidae;Rhodophyllis;";"0.0";"0";"1";"1";"0";"1";"0";"430523";"5766"
"LOK1378_1mm";"SILVA (only NR);Eukaryota;Archaeplastida;Rhodophyceae;Florideophycidae;Rhodymeniophycidae;Rhodoptilum;";"0.0";"0";"1";"1";"0";"1";"0";"430523";"5766"
"LOK1378_1mm";"SILVA (only NR);Eukaryota;Archaeplastida;Rhodophyceae;Florideophycidae;Rhodymeniophycidae;Rissoella;";"0.0";"0";"1";"1";"0";"1";"0";"430523";"5766"
"LOK1378_1mm";"SILVA (only NR);Eukaryota;Archaeplastida;Rhodophyceae;Florideophycidae;Rhodymeniophycidae;Sarcodia;";"0.0";"0";"1";"1";"0";"1";"0";"430523";"5766"
"LOK1378_1mm";"SILVA (only NR);Eukaryota;Archaeplastida;Rhodophyceae;Florideophycidae;Rhodymeniophycidae;Sarcodiotheca;";"0.0";"0";"2";"2";"0";"2";"0";"430522";"5766"
"LOK1378_1mm";"SILVA (only NR);Eukaryota;Archaeplastida;Rhodophyceae;Florideophycidae;Rhodymeniophycidae;Schimmelmannia;";"0.0";"0";"1";"1";"0";"1";"0";"430523";"5766"
"LOK1378_1mm";"SILVA (only NR);Eukaryota;Archaeplastida;Rhodophyceae;Florideophycidae;Rhodymeniophycidae;Schmitziella;";"0.0";"0";"1";"1";"0";"1";"0";"430523";"5766"
"LOK1378_1mm";"SILVA (only NR);Eukaryota;Archaeplastida;Rhodophyceae;Florideophycidae;Rhodymeniophycidae;Sciurothamnion;";"0.0";"0";"2";"2";"0";"2";"0";"430522";"5766"
"LOK1378_1mm";"SILVA (only NR);Eukaryota;Archaeplastida;Rhodophyceae;Florideophycidae;Rhodymeniophycidae;Sebdenia;";"0.0";"0";"2";"2";"0";"2";"0";"430522";"5766"
"LOK1378_1mm";"SILVA (only NR);Eukaryota;Archaeplastida;Rhodophyceae;Florideophycidae;Rhodymeniophycidae;Seirospora;";"0.0";"0";"3";"3";"0";"3";"0";"430521";"5766"
"LOK1378_1mm";"SILVA (only NR);Eukaryota;Archaeplastida;Rhodophyceae;Florideophycidae;Rhodymeniophycidae;Semnocarpa;";"0.0";"0";"1";"1";"0";"1";"0";"430523";"5766"
"LOK1378_1mm";"SILVA (only NR);Eukaryota;Archaeplastida;Rhodophyceae;Florideophycidae;Rhodymeniophycidae;Shepleya;";"0.0";"0";"1";"1";"0";"1";"0";"430523";"5766"
"LOK1378_1mm";"SILVA (only NR);Eukaryota;Archaeplastida;Rhodophyceae;Florideophycidae;Rhodymeniophycidae;Sonderella;";"0.0";"0";"1";"1";"0";"1";"0";"430523";"5766"
"LOK1378_1mm";"SILVA (only NR);Eukaryota;Archaeplastida;Rhodophyceae;Florideophycidae;Rhodymeniophycidae;Sorella;";"0.0";"0";"1";"1";"0";"1";"0";"430523";"5766"
"LOK1378_1mm";"SILVA (only NR);Eukaryota;Archaeplastida;Rhodophyceae;Florideophycidae;Rhodymeniophycidae;Sparlingia;";"0.0";"0";"1";"1";"0";"1";"0";"430523";"5766"
"LOK1378_1mm";"SILVA (only NR);Eukaryota;Archaeplastida;Rhodophyceae;Florideophycidae;Rhodymeniophycidae;Spermothamnion;";"0.0";"0";"1";"1";"0";"1";"0";"430523";"5766"
"LOK1378_1mm";"SILVA (only NR);Eukaryota;Archaeplastida;Rhodophyceae;Florideophycidae;Rhodymeniophycidae;Sphaerococcus;";"0.0";"0";"1";"1";"0";"1";"0";"430523";"5766"
"LOK1378_1mm";"SILVA (only NR);Eukaryota;Archaeplastida;Rhodophyceae;Florideophycidae;Rhodymeniophycidae;Spongoclonium;";"0.0";"0";"1";"1";"0";"1";"0";"430523";"5766"
"LOK1378_1mm";"SILVA (only NR);Eukaryota;Archaeplastida;Rhodophyceae;Florideophycidae;Rhodymeniophycidae;Spyridia;";"0.0";"0";"3";"3";"0";"3";"0";"430521";"5766"
"LOK1378_1mm";"SILVA (only NR);Eukaryota;Archaeplastida;Rhodophyceae;Florideophycidae;Rhodymeniophycidae;Sterrocladia;";"0.0";"0";"1";"1";"0";"1";"0";"430523";"5766"
"LOK1378_1mm";"SILVA (only NR);Eukaryota;Archaeplastida;Rhodophyceae;Florideophycidae;Rhodymeniophycidae;Stictosporum;";"0.0";"0";"1";"1";"0";"1";"0";"430523";"5766"
"LOK1378_1mm";"SILVA (only NR);Eukaryota;Archaeplastida;Rhodophyceae;Florideophycidae;Rhodymeniophycidae;Symphyocladia;";"0.0";"0";"2";"2";"0";"2";"0";"430522";"5766"
"LOK1378_1mm";"SILVA (only NR);Eukaryota;Archaeplastida;Rhodophyceae;Florideophycidae;Rhodymeniophycidae;Thuretia;";"0.0";"0";"1";"1";"0";"1";"0";"430523";"5766"
"LOK1378_1mm";"SILVA (only NR);Eukaryota;Archaeplastida;Rhodophyceae;Florideophycidae;Rhodymeniophycidae;Titanophora;";"0.0";"0";"1";"1";"0";"1";"0";"430523";"5766"
"LOK1378_1mm";"SILVA (only NR);Eukaryota;Archaeplastida;Rhodophyceae;Florideophycidae;Rhodymeniophycidae;Trematocarpus;";"0.0";"0";"1";"1";"0";"1";"0";"430523";"5766"
"LOK1378_1mm";"SILVA (only NR);Eukaryota;Archaeplastida;Rhodophyceae;Florideophycidae;Rhodymeniophycidae;Tsengia;";"0.0";"0";"1";"1";"0";"1";"0";"430523";"5766"
"LOK1378_1mm";"SILVA (only NR);Eukaryota;Archaeplastida;Rhodophyceae;Florideophycidae;Rhodymeniophycidae;Warrenia;";"0.0";"0";"1";"1";"0";"1";"0";"430523";"5766"
"LOK1378_1mm";"SILVA (only NR);Eukaryota;Archaeplastida;Rhodophyceae;Florideophycidae;Rhodymeniophycidae;Webervanbossea;";"0.0";"0";"1";"1";"0";"1";"0";"430523";"5766"
"LOK1378_1mm";"SILVA (only NR);Eukaryota;Archaeplastida;Rhodophyceae;Florideophycidae;Rhodymeniophycidae;Weeksia;";"0.0";"0";"1";"1";"0";"1";"0";"430523";"5766"
"LOK1378_1mm";"SILVA (only NR);Eukaryota;Archaeplastida;Rhodophyceae;Florideophycidae;Rhodymeniophycidae;Wetherbeella;";"0.0";"0";"1";"1";"0";"1";"0";"430523";"5766"
"LOK1378_1mm";"SILVA (only NR);Eukaryota;Archaeplastida;Rhodophyceae;Florideophycidae;Rhodymeniophycidae;Womersleyella;";"0.0";"0";"1";"1";"0";"1";"0";"430523";"5766"
"LOK1378_1mm";"SILVA (only NR);Eukaryota;Archaeplastida;Rhodophyceae;Florideophycidae;Rhodymeniophycidae;Wrangelia;";"0.0";"0";"6";"6";"0";"6";"0";"430518";"5766"
"LOK1378_1mm";"SILVA (only NR);Eukaryota;Archaeplastida;Rhodophyceae;Florideophycidae;Rhodymeniophycidae;Zymurgia;";"0.0";"0";"1";"1";"0";"1";"0";"430523";"5766"
"LOK1378_1mm";"SILVA (only NR);Eukaryota;Archaeplastida;Rhodophyceae;Porphyridiophyceae;";"0.0";"0";"8";"8";"0";"8";"0";"430516";"5766"
"LOK1378_1mm";"SILVA (only NR);Eukaryota;Archaeplastida;Rhodophyceae;Porphyridiophyceae;Flintiella;";"0.0";"0";"1";"1";"0";"1";"0";"430523";"5766"
"LOK1378_1mm";"SILVA (only NR);Eukaryota;Archaeplastida;Rhodophyceae;Porphyridiophyceae;Porphyridium;";"0.0";"0";"6";"6";"0";"6";"0";"430518";"5766"
"LOK1378_1mm";"SILVA (only NR);Eukaryota;Archaeplastida;Rhodophyceae;Porphyridiophyceae;Timspurckia;";"0.0";"0";"1";"1";"0";"1";"0";"430523";"5766"
"LOK1378_1mm";"SILVA (only NR);Eukaryota;Archaeplastida;Rhodophyceae;Rhodellophyceae;";"0.0";"0";"14";"14";"0";"14";"0";"430510";"5766"
"LOK1378_1mm";"SILVA (only NR);Eukaryota;Archaeplastida;Rhodophyceae;Rhodellophyceae;Bulboplastis;";"0.0";"0";"1";"1";"0";"1";"0";"430523";"5766"
"LOK1378_1mm";"SILVA (only NR);Eukaryota;Archaeplastida;Rhodophyceae;Rhodellophyceae;Corynoplastis;";"0.0";"0";"1";"1";"0";"1";"0";"430523";"5766"
"LOK1378_1mm";"SILVA (only NR);Eukaryota;Archaeplastida;Rhodophyceae;Rhodellophyceae;Dixoniella;";"0.0";"0";"4";"4";"0";"4";"0";"430520";"5766"
"LOK1378_1mm";"SILVA (only NR);Eukaryota;Archaeplastida;Rhodophyceae;Rhodellophyceae;Glaucosphaera;";"0.0";"0";"1";"1";"0";"1";"0";"430523";"5766"
"LOK1378_1mm";"SILVA (only NR);Eukaryota;Archaeplastida;Rhodophyceae;Rhodellophyceae;Neorhodella;";"0.0";"0";"2";"2";"0";"2";"0";"430522";"5766"
"LOK1378_1mm";"SILVA (only NR);Eukaryota;Archaeplastida;Rhodophyceae;Rhodellophyceae;Rhodella;";"0.0";"0";"5";"5";"0";"5";"0";"430519";"5766"
"LOK1378_1mm";"SILVA (only NR);Eukaryota;Archaeplastida;Rhodophyceae;Stylonematales;";"0.0";"0";"12";"12";"0";"12";"0";"430512";"5766"
"LOK1378_1mm";"SILVA (only NR);Eukaryota;Archaeplastida;Rhodophyceae;Stylonematales;Bangiopsis;";"0.0";"0";"1";"1";"0";"1";"0";"430523";"5766"
"LOK1378_1mm";"SILVA (only NR);Eukaryota;Archaeplastida;Rhodophyceae;Stylonematales;Chroodactylon;";"0.0";"0";"2";"2";"0";"2";"0";"430522";"5766"
"LOK1378_1mm";"SILVA (only NR);Eukaryota;Archaeplastida;Rhodophyceae;Stylonematales;Purpureofilum;";"0.0";"0";"1";"1";"0";"1";"0";"430523";"5766"
"LOK1378_1mm";"SILVA (only NR);Eukaryota;Archaeplastida;Rhodophyceae;Stylonematales;Rhodosorus;";"0.0";"0";"3";"3";"0";"3";"0";"430521";"5766"
"LOK1378_1mm";"SILVA (only NR);Eukaryota;Archaeplastida;Rhodophyceae;Stylonematales;Rhodospora;";"0.0";"0";"1";"1";"0";"1";"0";"430523";"5766"
"LOK1378_1mm";"SILVA (only NR);Eukaryota;Archaeplastida;Rhodophyceae;Stylonematales;Stylonema;";"0.0";"0";"3";"3";"0";"3";"0";"430521";"5766"
"LOK1378_1mm";"SILVA (only NR);Eukaryota;Archaeplastida;Rhodophyceae;Stylonematales;Tsunamia;";"0.0";"0";"1";"1";"0";"1";"0";"430523";"5766"
"LOK1378_1mm";"SILVA (only NR);Eukaryota;Cryptophyceae;";"0.0";"0";"289";"282";"0";"282";"7";"430242";"5766"
"LOK1378_1mm";"SILVA (only NR);Eukaryota;Cryptophyceae;Cryptomonadales;";"0.0";"0";"211";"208";"0";"208";"3";"430316";"5766"
"LOK1378_1mm";"SILVA (only NR);Eukaryota;Cryptophyceae;Cryptomonadales;Chroomonas;";"0.0";"0";"14";"14";"0";"14";"0";"430510";"5766"
"LOK1378_1mm";"SILVA (only NR);Eukaryota;Cryptophyceae;Cryptomonadales;Cryptomonas;";"0.0";"0";"81";"81";"0";"81";"0";"430443";"5766"
"LOK1378_1mm";"SILVA (only NR);Eukaryota;Cryptophyceae;Cryptomonadales;Falcomonas;";"0.0";"0";"1";"1";"0";"1";"0";"430523";"5766"
"LOK1378_1mm";"SILVA (only NR);Eukaryota;Cryptophyceae;Cryptomonadales;Geminigera;";"0.0";"0";"6";"6";"0";"6";"0";"430518";"5766"
"LOK1378_1mm";"SILVA (only NR);Eukaryota;Cryptophyceae;Cryptomonadales;Guillardia;";"0.0";"0";"6";"6";"0";"6";"0";"430518";"5766"
"LOK1378_1mm";"SILVA (only NR);Eukaryota;Cryptophyceae;Cryptomonadales;Hanusia;";"0.0";"0";"1";"1";"0";"1";"0";"430523";"5766"
"LOK1378_1mm";"SILVA (only NR);Eukaryota;Cryptophyceae;Cryptomonadales;Hemiselmis;";"0.0";"0";"14";"14";"0";"14";"0";"430510";"5766"
"LOK1378_1mm";"SILVA (only NR);Eukaryota;Cryptophyceae;Cryptomonadales;Komma;";"0.0";"0";"1";"1";"0";"1";"0";"430523";"5766"
"LOK1378_1mm";"SILVA (only NR);Eukaryota;Cryptophyceae;Cryptomonadales;Plagioselmis;";"0.0";"0";"4";"3";"0";"3";"1";"430521";"5766"
"LOK1378_1mm";"SILVA (only NR);Eukaryota;Cryptophyceae;Cryptomonadales;Proteomonas;";"0.0";"0";"2";"2";"0";"2";"0";"430522";"5766"
"LOK1378_1mm";"SILVA (only NR);Eukaryota;Cryptophyceae;Cryptomonadales;Rhodomonas;";"0.0";"0";"27";"27";"0";"27";"0";"430497";"5766"
"LOK1378_1mm";"SILVA (only NR);Eukaryota;Cryptophyceae;Cryptomonadales;Teleaulax;";"0.0";"0";"23";"21";"0";"21";"2";"430503";"5766"
"LOK1378_1mm";"SILVA (only NR);Eukaryota;Cryptophyceae;Cryptomonadales;uncultured;";"0.0";"0";"6";"6";"0";"6";"0";"430518";"5766"
"LOK1378_1mm";"SILVA (only NR);Eukaryota;Cryptophyceae;Goniomonas;";"0.0";"0";"13";"13";"0";"13";"0";"430511";"5766"
"LOK1378_1mm";"SILVA (only NR);Eukaryota;Cryptophyceae;Kathablepharidae;";"0.0";"0";"39";"37";"0";"37";"2";"430487";"5766"
"LOK1378_1mm";"SILVA (only NR);Eukaryota;Cryptophyceae;Kathablepharidae;Hatena;";"0.0";"0";"2";"2";"0";"2";"0";"430522";"5766"
"LOK1378_1mm";"SILVA (only NR);Eukaryota;Cryptophyceae;Kathablepharidae;Katablepharis;";"0.0";"0";"6";"5";"0";"5";"1";"430519";"5766"
"LOK1378_1mm";"SILVA (only NR);Eukaryota;Cryptophyceae;Kathablepharidae;Leucocryptos;";"0.0";"0";"13";"13";"0";"13";"0";"430511";"5766"
"LOK1378_1mm";"SILVA (only NR);Eukaryota;Cryptophyceae;Kathablepharidae;Roombia;";"0.0";"0";"1";"1";"0";"1";"0";"430523";"5766"
"LOK1378_1mm";"SILVA (only NR);Eukaryota;Cryptophyceae;Kathablepharidae;uncultured;";"0.0";"0";"14";"13";"0";"13";"1";"430511";"5766"
"LOK1378_1mm";"SILVA (only NR);Eukaryota;Cryptophyceae;uncultured;";"0.0";"0";"26";"24";"0";"24";"2";"430500";"5766"
"LOK1378_1mm";"SILVA (only NR);Eukaryota;Discoba;";"0.0";"0";"1032";"918";"0";"918";"114";"429606";"5766"
"LOK1378_1mm";"SILVA (only NR);Eukaryota;Discoba;Discicristata;";"0.0";"0";"963";"854";"0";"854";"109";"429670";"5766"
"LOK1378_1mm";"SILVA (only NR);Eukaryota;Discoba;Discicristata;Euglenozoa;";"0.0";"0";"911";"808";"0";"808";"103";"429716";"5766"
"LOK1378_1mm";"SILVA (only NR);Eukaryota;Discoba;Discicristata;Euglenozoa;Diplonemea;";"0.0";"0";"155";"121";"0";"121";"34";"430403";"5766"
"LOK1378_1mm";"SILVA (only NR);Eukaryota;Discoba;Discicristata;Euglenozoa;Diplonemea;Diplonema;";"0.0";"0";"9";"7";"0";"7";"2";"430517";"5766"
"LOK1378_1mm";"SILVA (only NR);Eukaryota;Discoba;Discicristata;Euglenozoa;Diplonemea;Rhynchopus;";"0.0";"0";"9";"8";"0";"8";"1";"430516";"5766"
"LOK1378_1mm";"SILVA (only NR);Eukaryota;Discoba;Discicristata;Euglenozoa;Diplonemea;SCM38C39 marine group;";"0.0";"0";"132";"102";"0";"102";"30";"430422";"5766"
"LOK1378_1mm";"SILVA (only NR);Eukaryota;Discoba;Discicristata;Euglenozoa;Euglenida;";"0.0";"0";"244";"239";"0";"239";"5";"430285";"5766"
"LOK1378_1mm";"SILVA (only NR);Eukaryota;Discoba;Discicristata;Euglenozoa;Euglenida;Aphagea;";"0.0";"0";"5";"5";"0";"5";"0";"430519";"5766"
"LOK1378_1mm";"SILVA (only NR);Eukaryota;Discoba;Discicristata;Euglenozoa;Euglenida;Aphagea;Distigma;";"0.0";"0";"1";"1";"0";"1";"0";"430523";"5766"
"LOK1378_1mm";"SILVA (only NR);Eukaryota;Discoba;Discicristata;Euglenozoa;Euglenida;Aphagea;Gyropaigne;";"0.0";"0";"1";"1";"0";"1";"0";"430523";"5766"
"LOK1378_1mm";"SILVA (only NR);Eukaryota;Discoba;Discicristata;Euglenozoa;Euglenida;Aphagea;Menoidium;";"0.0";"0";"1";"1";"0";"1";"0";"430523";"5766"
"LOK1378_1mm";"SILVA (only NR);Eukaryota;Discoba;Discicristata;Euglenozoa;Euglenida;Aphagea;Rhabdomonas;";"0.0";"0";"2";"2";"0";"2";"0";"430522";"5766"
"LOK1378_1mm";"SILVA (only NR);Eukaryota;Discoba;Discicristata;Euglenozoa;Euglenida;Euglenophyceae;";"0.0";"0";"218";"215";"0";"215";"3";"430309";"5766"
"LOK1378_1mm";"SILVA (only NR);Eukaryota;Discoba;Discicristata;Euglenozoa;Euglenida;Euglenophyceae;Euglenea;";"0.0";"0";"218";"215";"0";"215";"3";"430309";"5766"
"LOK1378_1mm";"SILVA (only NR);Eukaryota;Discoba;Discicristata;Euglenozoa;Euglenida;Euglenophyceae;Euglenea;Euglenaceae;";"0.0";"0";"97";"97";"0";"97";"0";"430427";"5766"
"LOK1378_1mm";"SILVA (only NR);Eukaryota;Discoba;Discicristata;Euglenozoa;Euglenida;Euglenophyceae;Euglenea;Euglenaceae;Colacium;";"0.0";"0";"7";"7";"0";"7";"0";"430517";"5766"
"LOK1378_1mm";"SILVA (only NR);Eukaryota;Discoba;Discicristata;Euglenozoa;Euglenida;Euglenophyceae;Euglenea;Euglenaceae;Cryptoglena;";"0.0";"0";"11";"11";"0";"11";"0";"430513";"5766"
"LOK1378_1mm";"SILVA (only NR);Eukaryota;Discoba;Discicristata;Euglenozoa;Euglenida;Euglenophyceae;Euglenea;Euglenaceae;Euglena;";"0.0";"0";"29";"29";"0";"29";"0";"430495";"5766"
"LOK1378_1mm";"SILVA (only NR);Eukaryota;Discoba;Discicristata;Euglenozoa;Euglenida;Euglenophyceae;Euglenea;Euglenaceae;Euglenaria;";"0.0";"0";"3";"3";"0";"3";"0";"430521";"5766"
"LOK1378_1mm";"SILVA (only NR);Eukaryota;Discoba;Discicristata;Euglenozoa;Euglenida;Euglenophyceae;Euglenea;Euglenaceae;Monomorphina;";"0.0";"0";"8";"8";"0";"8";"0";"430516";"5766"
"LOK1378_1mm";"SILVA (only NR);Eukaryota;Discoba;Discicristata;Euglenozoa;Euglenida;Euglenophyceae;Euglenea;Euglenaceae;Trachelomonas;";"0.0";"0";"39";"39";"0";"39";"0";"430485";"5766"
"LOK1378_1mm";"SILVA (only NR);Eukaryota;Discoba;Discicristata;Euglenozoa;Euglenida;Euglenophyceae;Euglenea;Phacaceae;";"0.0";"0";"110";"107";"0";"107";"3";"430417";"5766"
"LOK1378_1mm";"SILVA (only NR);Eukaryota;Discoba;Discicristata;Euglenozoa;Euglenida;Euglenophyceae;Euglenea;Phacaceae;Lepocinclis;";"0.0";"0";"28";"28";"0";"28";"0";"430496";"5766"
"LOK1378_1mm";"SILVA (only NR);Eukaryota;Discoba;Discicristata;Euglenozoa;Euglenida;Euglenophyceae;Euglenea;Phacaceae;Phacus;";"0.0";"0";"82";"79";"0";"79";"3";"430445";"5766"
"LOK1378_1mm";"SILVA (only NR);Eukaryota;Discoba;Discicristata;Euglenozoa;Euglenida;Euglenophyceae;Euglenea;Strombomonas;";"0.0";"0";"10";"10";"0";"10";"0";"430514";"5766"
"LOK1378_1mm";"SILVA (only NR);Eukaryota;Discoba;Discicristata;Euglenozoa;Euglenida;Heteronematina;";"0.0";"0";"21";"19";"0";"19";"2";"430505";"5766"
"LOK1378_1mm";"SILVA (only NR);Eukaryota;Discoba;Discicristata;Euglenozoa;Euglenida;Heteronematina;Notosolenus;";"0.0";"0";"2";"2";"0";"2";"0";"430522";"5766"
"LOK1378_1mm";"SILVA (only NR);Eukaryota;Discoba;Discicristata;Euglenozoa;Euglenida;Heteronematina;Petalomonas;";"0.0";"0";"19";"17";"0";"17";"2";"430507";"5766"
"LOK1378_1mm";"SILVA (only NR);Eukaryota;Discoba;Discicristata;Euglenozoa;Kinetoplastea;";"0.0";"0";"510";"446";"0";"446";"64";"430078";"5766"
"LOK1378_1mm";"SILVA (only NR);Eukaryota;Discoba;Discicristata;Euglenozoa;Kinetoplastea;Incertae Sedis;";"0.0";"0";"2";"2";"0";"2";"0";"430522";"5766"
"LOK1378_1mm";"SILVA (only NR);Eukaryota;Discoba;Discicristata;Euglenozoa;Kinetoplastea;Incertae Sedis;Hemistasia;";"0.0";"0";"2";"2";"0";"2";"0";"430522";"5766"
"LOK1378_1mm";"SILVA (only NR);Eukaryota;Discoba;Discicristata;Euglenozoa;Kinetoplastea;Metakinetoplastina;";"0.0";"0";"467";"418";"0";"418";"49";"430106";"5766"
"LOK1378_1mm";"SILVA (only NR);Eukaryota;Discoba;Discicristata;Euglenozoa;Kinetoplastea;Metakinetoplastina;Eubodonida;";"0.0";"0";"29";"24";"0";"24";"5";"430500";"5766"
"LOK1378_1mm";"SILVA (only NR);Eukaryota;Discoba;Discicristata;Euglenozoa;Kinetoplastea;Metakinetoplastina;Eubodonida;Bodo;";"0.0";"0";"29";"24";"0";"24";"5";"430500";"5766"
"LOK1378_1mm";"SILVA (only NR);Eukaryota;Discoba;Discicristata;Euglenozoa;Kinetoplastea;Metakinetoplastina;Neobodonida;";"0.0";"0";"125";"117";"0";"117";"8";"430407";"5766"
"LOK1378_1mm";"SILVA (only NR);Eukaryota;Discoba;Discicristata;Euglenozoa;Kinetoplastea;Metakinetoplastina;Neobodonida;Cruzella;";"0.0";"0";"1";"1";"0";"1";"0";"430523";"5766"
"LOK1378_1mm";"SILVA (only NR);Eukaryota;Discoba;Discicristata;Euglenozoa;Kinetoplastea;Metakinetoplastina;Neobodonida;Dimastigella;";"0.0";"0";"5";"5";"0";"5";"0";"430519";"5766"
"LOK1378_1mm";"SILVA (only NR);Eukaryota;Discoba;Discicristata;Euglenozoa;Kinetoplastea;Metakinetoplastina;Neobodonida;Lake Biwa clade;";"0.0";"0";"2";"2";"0";"2";"0";"430522";"5766"
"LOK1378_1mm";"SILVA (only NR);Eukaryota;Discoba;Discicristata;Euglenozoa;Kinetoplastea;Metakinetoplastina;Neobodonida;Neobodo;";"0.0";"0";"83";"77";"0";"77";"6";"430447";"5766"
"LOK1378_1mm";"SILVA (only NR);Eukaryota;Discoba;Discicristata;Euglenozoa;Kinetoplastea;Metakinetoplastina;Neobodonida;Rhynchobodo;";"0.0";"0";"12";"11";"0";"11";"1";"430513";"5766"
"LOK1378_1mm";"SILVA (only NR);Eukaryota;Discoba;Discicristata;Euglenozoa;Kinetoplastea;Metakinetoplastina;Neobodonida;Rhynchomonas;";"0.0";"0";"19";"19";"0";"19";"0";"430505";"5766"
"LOK1378_1mm";"SILVA (only NR);Eukaryota;Discoba;Discicristata;Euglenozoa;Kinetoplastea;Metakinetoplastina;Parabodonida;";"0.0";"0";"24";"20";"0";"20";"4";"430504";"5766"
"LOK1378_1mm";"SILVA (only NR);Eukaryota;Discoba;Discicristata;Euglenozoa;Kinetoplastea;Metakinetoplastina;Parabodonida;Cryptobia;";"0.0";"0";"5";"3";"0";"3";"2";"430521";"5766"
"LOK1378_1mm";"SILVA (only NR);Eukaryota;Discoba;Discicristata;Euglenozoa;Kinetoplastea;Metakinetoplastina;Parabodonida;Parabodo;";"0.0";"0";"12";"10";"0";"10";"2";"430514";"5766"
"LOK1378_1mm";"SILVA (only NR);Eukaryota;Discoba;Discicristata;Euglenozoa;Kinetoplastea;Metakinetoplastina;Trypanosomatida;";"0.0";"0";"288";"256";"0";"256";"32";"430268";"5766"
"LOK1378_1mm";"SILVA (only NR);Eukaryota;Discoba;Discicristata;Euglenozoa;Kinetoplastea;Metakinetoplastina;Trypanosomatida;Angomonas;";"0.0";"0";"4";"4";"0";"4";"0";"430520";"5766"
"LOK1378_1mm";"SILVA (only NR);Eukaryota;Discoba;Discicristata;Euglenozoa;Kinetoplastea;Metakinetoplastina;Trypanosomatida;Blastocrithidia;";"0.0";"0";"10";"10";"0";"10";"0";"430514";"5766"
"LOK1378_1mm";"SILVA (only NR);Eukaryota;Discoba;Discicristata;Euglenozoa;Kinetoplastea;Metakinetoplastina;Trypanosomatida;Blechomonas;";"0.0";"0";"6";"6";"0";"6";"0";"430518";"5766"
"LOK1378_1mm";"SILVA (only NR);Eukaryota;Discoba;Discicristata;Euglenozoa;Kinetoplastea;Metakinetoplastina;Trypanosomatida;Crithidia;";"0.0";"0";"11";"11";"0";"11";"0";"430513";"5766"
"LOK1378_1mm";"SILVA (only NR);Eukaryota;Discoba;Discicristata;Euglenozoa;Kinetoplastea;Metakinetoplastina;Trypanosomatida;Endotrypanum;";"0.0";"0";"11";"9";"0";"9";"2";"430515";"5766"
"LOK1378_1mm";"SILVA (only NR);Eukaryota;Discoba;Discicristata;Euglenozoa;Kinetoplastea;Metakinetoplastina;Trypanosomatida;Herpetomonas;";"0.0";"0";"27";"23";"0";"23";"4";"430501";"5766"
"LOK1378_1mm";"SILVA (only NR);Eukaryota;Discoba;Discicristata;Euglenozoa;Kinetoplastea;Metakinetoplastina;Trypanosomatida;Jaenimonas;";"0.0";"0";"2";"2";"0";"2";"0";"430522";"5766"
"LOK1378_1mm";"SILVA (only NR);Eukaryota;Discoba;Discicristata;Euglenozoa;Kinetoplastea;Metakinetoplastina;Trypanosomatida;Leishmania;";"0.0";"0";"3";"3";"0";"3";"0";"430521";"5766"
"LOK1378_1mm";"SILVA (only NR);Eukaryota;Discoba;Discicristata;Euglenozoa;Kinetoplastea;Metakinetoplastina;Trypanosomatida;Leptomonas;";"0.0";"0";"26";"23";"0";"23";"3";"430501";"5766"
"LOK1378_1mm";"SILVA (only NR);Eukaryota;Discoba;Discicristata;Euglenozoa;Kinetoplastea;Metakinetoplastina;Trypanosomatida;Paratrypanosoma;";"0.0";"0";"1";"1";"0";"1";"0";"430523";"5766"
"LOK1378_1mm";"SILVA (only NR);Eukaryota;Discoba;Discicristata;Euglenozoa;Kinetoplastea;Metakinetoplastina;Trypanosomatida;Phytomonas;";"0.0";"0";"7";"6";"0";"6";"1";"430518";"5766"
"LOK1378_1mm";"SILVA (only NR);Eukaryota;Discoba;Discicristata;Euglenozoa;Kinetoplastea;Metakinetoplastina;Trypanosomatida;Sergeia;";"0.0";"0";"2";"2";"0";"2";"0";"430522";"5766"
"LOK1378_1mm";"SILVA (only NR);Eukaryota;Discoba;Discicristata;Euglenozoa;Kinetoplastea;Metakinetoplastina;Trypanosomatida;Strigomonas;";"0.0";"0";"5";"5";"0";"5";"0";"430519";"5766"
"LOK1378_1mm";"SILVA (only NR);Eukaryota;Discoba;Discicristata;Euglenozoa;Kinetoplastea;Metakinetoplastina;Trypanosomatida;Trypanosoma;";"0.0";"0";"139";"122";"0";"122";"17";"430402";"5766"
"LOK1378_1mm";"SILVA (only NR);Eukaryota;Discoba;Discicristata;Euglenozoa;Kinetoplastea;Metakinetoplastina;Trypanosomatida;Wallaceina;";"0.0";"0";"1";"1";"0";"1";"0";"430523";"5766"
"LOK1378_1mm";"SILVA (only NR);Eukaryota;Discoba;Discicristata;Euglenozoa;Kinetoplastea;Metakinetoplastina;Trypanosomatida;Zelonia;";"0.0";"0";"1";"1";"0";"1";"0";"430523";"5766"
"LOK1378_1mm";"SILVA (only NR);Eukaryota;Discoba;Discicristata;Euglenozoa;Kinetoplastea;Prokinetoplastina;";"0.0";"0";"40";"25";"0";"25";"15";"430499";"5766"
"LOK1378_1mm";"SILVA (only NR);Eukaryota;Discoba;Discicristata;Euglenozoa;Kinetoplastea;Prokinetoplastina;Ichthyobodo;";"0.0";"0";"40";"25";"0";"25";"15";"430499";"5766"
"LOK1378_1mm";"SILVA (only NR);Eukaryota;Discoba;Discicristata;Heterolobosea;";"0.0";"0";"52";"46";"0";"46";"6";"430478";"5766"
"LOK1378_1mm";"SILVA (only NR);Eukaryota;Discoba;Discicristata;Heterolobosea;Tetramitia;";"0.0";"0";"52";"46";"0";"46";"6";"430478";"5766"
"LOK1378_1mm";"SILVA (only NR);Eukaryota;Discoba;Discicristata;Heterolobosea;Tetramitia;Allovahlkampfia;";"0.0";"0";"4";"4";"0";"4";"0";"430520";"5766"
"LOK1378_1mm";"SILVA (only NR);Eukaryota;Discoba;Discicristata;Heterolobosea;Tetramitia;Learamoeba;";"0.0";"0";"1";"1";"0";"1";"0";"430523";"5766"
"LOK1378_1mm";"SILVA (only NR);Eukaryota;Discoba;Discicristata;Heterolobosea;Tetramitia;Naegleria;";"0.0";"0";"21";"20";"0";"20";"1";"430504";"5766"
"LOK1378_1mm";"SILVA (only NR);Eukaryota;Discoba;Discicristata;Heterolobosea;Tetramitia;Neovahlkampfia;";"0.0";"0";"2";"2";"0";"2";"0";"430522";"5766"
"LOK1378_1mm";"SILVA (only NR);Eukaryota;Discoba;Discicristata;Heterolobosea;Tetramitia;Psalteriomonas;";"0.0";"0";"4";"3";"0";"3";"1";"430521";"5766"
"LOK1378_1mm";"SILVA (only NR);Eukaryota;Discoba;Discicristata;Heterolobosea;Tetramitia;Sawyeria;";"0.0";"0";"1";"1";"0";"1";"0";"430523";"5766"
"LOK1378_1mm";"SILVA (only NR);Eukaryota;Discoba;Discicristata;Heterolobosea;Tetramitia;Singhamoeba;";"0.0";"0";"2";"2";"0";"2";"0";"430522";"5766"
"LOK1378_1mm";"SILVA (only NR);Eukaryota;Discoba;Discicristata;Heterolobosea;Tetramitia;Tetramitus;";"0.0";"0";"8";"5";"0";"5";"3";"430519";"5766"
"LOK1378_1mm";"SILVA (only NR);Eukaryota;Discoba;Discicristata;Heterolobosea;Tetramitia;Vahlkampfia;";"0.0";"0";"4";"3";"0";"3";"1";"430521";"5766"
"LOK1378_1mm";"SILVA (only NR);Eukaryota;Discoba;Jakobida;";"0.0";"0";"64";"60";"0";"60";"4";"430464";"5766"
"LOK1378_1mm";"SILVA (only NR);Eukaryota;Discoba;Jakobida;Andalucia;";"0.0";"0";"38";"35";"0";"35";"3";"430489";"5766"
"LOK1378_1mm";"SILVA (only NR);Eukaryota;Discoba;Jakobida;Jakoba;";"0.0";"0";"2";"2";"0";"2";"0";"430522";"5766"
"LOK1378_1mm";"SILVA (only NR);Eukaryota;Discoba;Jakobida;Moramonas;";"0.0";"0";"1";"1";"0";"1";"0";"430523";"5766"
"LOK1378_1mm";"SILVA (only NR);Eukaryota;Discoba;Jakobida;RM1-SGM49;";"0.0";"0";"5";"5";"0";"5";"0";"430519";"5766"
"LOK1378_1mm";"SILVA (only NR);Eukaryota;Discoba;Jakobida;Reclinomonas;";"0.0";"0";"3";"3";"0";"3";"0";"430521";"5766"
"LOK1378_1mm";"SILVA (only NR);Eukaryota;Discoba;Jakobida;Seculamonas;";"0.0";"0";"1";"1";"0";"1";"0";"430523";"5766"
"LOK1378_1mm";"SILVA (only NR);Eukaryota;Discoba;Jakobida;uncultured;";"0.0";"0";"4";"3";"0";"3";"1";"430521";"5766"
"LOK1378_1mm";"SILVA (only NR);Eukaryota;Discoba;Malawimonas;";"0.0";"0";"1";"1";"0";"1";"0";"430523";"5766"
"LOK1378_1mm";"SILVA (only NR);Eukaryota;Excavata;";"0.0";"0";"389";"384";"0";"384";"5";"430140";"5766"
"LOK1378_1mm";"SILVA (only NR);Eukaryota;Excavata;Metamonada;";"0.0";"0";"389";"384";"0";"384";"5";"430140";"5766"
"LOK1378_1mm";"SILVA (only NR);Eukaryota;Excavata;Metamonada;Fornicata;";"0.0";"0";"21";"20";"0";"20";"1";"430504";"5766"
"LOK1378_1mm";"SILVA (only NR);Eukaryota;Excavata;Metamonada;Fornicata;Carpediomonas-like organisms;";"0.0";"0";"10";"9";"0";"9";"1";"430515";"5766"
"LOK1378_1mm";"SILVA (only NR);Eukaryota;Excavata;Metamonada;Fornicata;Carpediomonas-like organisms;Carpediemonas;";"0.0";"0";"3";"3";"0";"3";"0";"430521";"5766"
"LOK1378_1mm";"SILVA (only NR);Eukaryota;Excavata;Metamonada;Fornicata;Carpediomonas-like organisms;Dysnectes;";"0.0";"0";"2";"2";"0";"2";"0";"430522";"5766"
"LOK1378_1mm";"SILVA (only NR);Eukaryota;Excavata;Metamonada;Fornicata;Carpediomonas-like organisms;Ergobibamus;";"0.0";"0";"2";"2";"0";"2";"0";"430522";"5766"
"LOK1378_1mm";"SILVA (only NR);Eukaryota;Excavata;Metamonada;Fornicata;Diplomonadida;";"0.0";"0";"11";"11";"0";"11";"0";"430513";"5766"
"LOK1378_1mm";"SILVA (only NR);Eukaryota;Excavata;Metamonada;Fornicata;Diplomonadida;Giardiinae;";"0.0";"0";"11";"11";"0";"11";"0";"430513";"5766"
"LOK1378_1mm";"SILVA (only NR);Eukaryota;Excavata;Metamonada;Fornicata;Diplomonadida;Giardiinae;Giardia;";"0.0";"0";"11";"11";"0";"11";"0";"430513";"5766"
"LOK1378_1mm";"SILVA (only NR);Eukaryota;Excavata;Metamonada;Parabasalia;";"0.0";"0";"342";"338";"0";"338";"4";"430186";"5766"
"LOK1378_1mm";"SILVA (only NR);Eukaryota;Excavata;Metamonada;Parabasalia;Cristamonadea;";"0.0";"0";"60";"60";"0";"60";"0";"430464";"5766"
"LOK1378_1mm";"SILVA (only NR);Eukaryota;Excavata;Metamonada;Parabasalia;Cristamonadea;Calonympha;";"0.0";"0";"4";"4";"0";"4";"0";"430520";"5766"
"LOK1378_1mm";"SILVA (only NR);Eukaryota;Excavata;Metamonada;Parabasalia;Cristamonadea;Coronympha;";"0.0";"0";"4";"4";"0";"4";"0";"430520";"5766"
"LOK1378_1mm";"SILVA (only NR);Eukaryota;Excavata;Metamonada;Parabasalia;Cristamonadea;Deltotrichonympha;";"0.0";"0";"1";"1";"0";"1";"0";"430523";"5766"
"LOK1378_1mm";"SILVA (only NR);Eukaryota;Excavata;Metamonada;Parabasalia;Cristamonadea;Devescovina;";"0.0";"0";"15";"15";"0";"15";"0";"430509";"5766"
"LOK1378_1mm";"SILVA (only NR);Eukaryota;Excavata;Metamonada;Parabasalia;Cristamonadea;Foaina;";"0.0";"0";"4";"4";"0";"4";"0";"430520";"5766"
"LOK1378_1mm";"SILVA (only NR);Eukaryota;Excavata;Metamonada;Parabasalia;Cristamonadea;Gigantomonas;";"0.0";"0";"1";"1";"0";"1";"0";"430523";"5766"
"LOK1378_1mm";"SILVA (only NR);Eukaryota;Excavata;Metamonada;Parabasalia;Cristamonadea;Joenia;";"0.0";"0";"3";"3";"0";"3";"0";"430521";"5766"
"LOK1378_1mm";"SILVA (only NR);Eukaryota;Excavata;Metamonada;Parabasalia;Cristamonadea;Joenoides;";"0.0";"0";"1";"1";"0";"1";"0";"430523";"5766"
"LOK1378_1mm";"SILVA (only NR);Eukaryota;Excavata;Metamonada;Parabasalia;Cristamonadea;Kofoidia;";"0.0";"0";"2";"2";"0";"2";"0";"430522";"5766"
"LOK1378_1mm";"SILVA (only NR);Eukaryota;Excavata;Metamonada;Parabasalia;Cristamonadea;Koruga;";"0.0";"0";"1";"1";"0";"1";"0";"430523";"5766"
"LOK1378_1mm";"SILVA (only NR);Eukaryota;Excavata;Metamonada;Parabasalia;Cristamonadea;Lophomonas;";"0.0";"0";"1";"1";"0";"1";"0";"430523";"5766"
"LOK1378_1mm";"SILVA (only NR);Eukaryota;Excavata;Metamonada;Parabasalia;Cristamonadea;Metadevescovina;";"0.0";"0";"9";"9";"0";"9";"0";"430515";"5766"
"LOK1378_1mm";"SILVA (only NR);Eukaryota;Excavata;Metamonada;Parabasalia;Cristamonadea;Mixotricha;";"0.0";"0";"1";"1";"0";"1";"0";"430523";"5766"
"LOK1378_1mm";"SILVA (only NR);Eukaryota;Excavata;Metamonada;Parabasalia;Cristamonadea;Nk3 symbiont group;";"0.0";"0";"2";"2";"0";"2";"0";"430522";"5766"
"LOK1378_1mm";"SILVA (only NR);Eukaryota;Excavata;Metamonada;Parabasalia;Cristamonadea;Snyderella;";"0.0";"0";"4";"4";"0";"4";"0";"430520";"5766"
"LOK1378_1mm";"SILVA (only NR);Eukaryota;Excavata;Metamonada;Parabasalia;Cristamonadea;Stephanonympha;";"0.0";"0";"2";"2";"0";"2";"0";"430522";"5766"
"LOK1378_1mm";"SILVA (only NR);Eukaryota;Excavata;Metamonada;Parabasalia;Cryptotermes symbiont group;";"0.0";"0";"22";"22";"0";"22";"0";"430502";"5766"
"LOK1378_1mm";"SILVA (only NR);Eukaryota;Excavata;Metamonada;Parabasalia;Gf10 symbiont group;";"0.0";"0";"4";"4";"0";"4";"0";"430520";"5766"
"LOK1378_1mm";"SILVA (only NR);Eukaryota;Excavata;Metamonada;Parabasalia;Hypotrichomonadea;";"0.0";"0";"17";"17";"0";"17";"0";"430507";"5766"
"LOK1378_1mm";"SILVA (only NR);Eukaryota;Excavata;Metamonada;Parabasalia;Hypotrichomonadea;Hypotrichomonas;";"0.0";"0";"13";"13";"0";"13";"0";"430511";"5766"
"LOK1378_1mm";"SILVA (only NR);Eukaryota;Excavata;Metamonada;Parabasalia;Hypotrichomonadea;Trichomitus;";"0.0";"0";"4";"4";"0";"4";"0";"430520";"5766"
"LOK1378_1mm";"SILVA (only NR);Eukaryota;Excavata;Metamonada;Parabasalia;Spirotrichonymphea;";"0.0";"0";"36";"35";"0";"35";"1";"430489";"5766"
"LOK1378_1mm";"SILVA (only NR);Eukaryota;Excavata;Metamonada;Parabasalia;Spirotrichonymphea;Holomastigotoides;";"0.0";"0";"12";"11";"0";"11";"1";"430513";"5766"
"LOK1378_1mm";"SILVA (only NR);Eukaryota;Excavata;Metamonada;Parabasalia;Spirotrichonymphea;Spirotrichonympha;";"0.0";"0";"3";"3";"0";"3";"0";"430521";"5766"
"LOK1378_1mm";"SILVA (only NR);Eukaryota;Excavata;Metamonada;Parabasalia;Spirotrichonymphea;pool A symbiont group;";"0.0";"0";"18";"18";"0";"18";"0";"430506";"5766"
"LOK1378_1mm";"SILVA (only NR);Eukaryota;Excavata;Metamonada;Parabasalia;Trichomonadea;";"0.0";"0";"74";"72";"0";"72";"2";"430452";"5766"
"LOK1378_1mm";"SILVA (only NR);Eukaryota;Excavata;Metamonada;Parabasalia;Trichomonadea;Cochlosoma;";"0.0";"0";"1";"1";"0";"1";"0";"430523";"5766"
"LOK1378_1mm";"SILVA (only NR);Eukaryota;Excavata;Metamonada;Parabasalia;Trichomonadea;Ditrichomonas;";"0.0";"0";"2";"2";"0";"2";"0";"430522";"5766"
"LOK1378_1mm";"SILVA (only NR);Eukaryota;Excavata;Metamonada;Parabasalia;Trichomonadea;Hexamastix;";"0.0";"0";"5";"5";"0";"5";"0";"430519";"5766"
"LOK1378_1mm";"SILVA (only NR);Eukaryota;Excavata;Metamonada;Parabasalia;Trichomonadea;Honigbergiella;";"0.0";"0";"1";"1";"0";"1";"0";"430523";"5766"
"LOK1378_1mm";"SILVA (only NR);Eukaryota;Excavata;Metamonada;Parabasalia;Trichomonadea;Lacusteria;";"0.0";"0";"1";"1";"0";"1";"0";"430523";"5766"
"LOK1378_1mm";"SILVA (only NR);Eukaryota;Excavata;Metamonada;Parabasalia;Trichomonadea;Pentatrichomonas;";"0.0";"0";"2";"2";"0";"2";"0";"430522";"5766"
"LOK1378_1mm";"SILVA (only NR);Eukaryota;Excavata;Metamonada;Parabasalia;Trichomonadea;Pentatrichomonoides;";"0.0";"0";"1";"1";"0";"1";"0";"430523";"5766"
"LOK1378_1mm";"SILVA (only NR);Eukaryota;Excavata;Metamonada;Parabasalia;Trichomonadea;Pseudotrichomonas;";"0.0";"0";"2";"2";"0";"2";"0";"430522";"5766"
"LOK1378_1mm";"SILVA (only NR);Eukaryota;Excavata;Metamonada;Parabasalia;Trichomonadea;Pseudotrypanosoma;";"0.0";"0";"1";"1";"0";"1";"0";"430523";"5766"
"LOK1378_1mm";"SILVA (only NR);Eukaryota;Excavata;Metamonada;Parabasalia;Trichomonadea;Simplicimonas;";"0.0";"0";"6";"6";"0";"6";"0";"430518";"5766"
"LOK1378_1mm";"SILVA (only NR);Eukaryota;Excavata;Metamonada;Parabasalia;Trichomonadea;Tetratrichomonas;";"0.0";"0";"28";"28";"0";"28";"0";"430496";"5766"
"LOK1378_1mm";"SILVA (only NR);Eukaryota;Excavata;Metamonada;Parabasalia;Trichomonadea;Trichomitopsis;";"0.0";"0";"5";"5";"0";"5";"0";"430519";"5766"
"LOK1378_1mm";"SILVA (only NR);Eukaryota;Excavata;Metamonada;Parabasalia;Trichomonadea;Trichomonas;";"0.0";"0";"14";"13";"0";"13";"1";"430511";"5766"
"LOK1378_1mm";"SILVA (only NR);Eukaryota;Excavata;Metamonada;Parabasalia;Trichonymphea;";"0.0";"0";"97";"97";"0";"97";"0";"430427";"5766"
"LOK1378_1mm";"SILVA (only NR);Eukaryota;Excavata;Metamonada;Parabasalia;Trichonymphea;Barbulanympha;";"0.0";"0";"5";"5";"0";"5";"0";"430519";"5766"
"LOK1378_1mm";"SILVA (only NR);Eukaryota;Excavata;Metamonada;Parabasalia;Trichonymphea;Eucomonympha;";"0.0";"0";"4";"4";"0";"4";"0";"430520";"5766"
"LOK1378_1mm";"SILVA (only NR);Eukaryota;Excavata;Metamonada;Parabasalia;Trichonymphea;Pseudotrichonympha;";"0.0";"0";"23";"23";"0";"23";"0";"430501";"5766"
"LOK1378_1mm";"SILVA (only NR);Eukaryota;Excavata;Metamonada;Parabasalia;Trichonymphea;Staurojoenia;";"0.0";"0";"3";"3";"0";"3";"0";"430521";"5766"
"LOK1378_1mm";"SILVA (only NR);Eukaryota;Excavata;Metamonada;Parabasalia;Trichonymphea;Teranympha;";"0.0";"0";"12";"12";"0";"12";"0";"430512";"5766"
"LOK1378_1mm";"SILVA (only NR);Eukaryota;Excavata;Metamonada;Parabasalia;Trichonymphea;Trichonympha;";"0.0";"0";"47";"47";"0";"47";"0";"430477";"5766"
"LOK1378_1mm";"SILVA (only NR);Eukaryota;Excavata;Metamonada;Parabasalia;Tritrichomonadea;";"0.0";"0";"15";"15";"0";"15";"0";"430509";"5766"
"LOK1378_1mm";"SILVA (only NR);Eukaryota;Excavata;Metamonada;Parabasalia;Tritrichomonadea;Dientamoeba;";"0.0";"0";"1";"1";"0";"1";"0";"430523";"5766"
"LOK1378_1mm";"SILVA (only NR);Eukaryota;Excavata;Metamonada;Parabasalia;Tritrichomonadea;Histomonas;";"0.0";"0";"1";"1";"0";"1";"0";"430523";"5766"
"LOK1378_1mm";"SILVA (only NR);Eukaryota;Excavata;Metamonada;Parabasalia;Tritrichomonadea;Monocercomonas;";"0.0";"0";"5";"5";"0";"5";"0";"430519";"5766"
"LOK1378_1mm";"SILVA (only NR);Eukaryota;Excavata;Metamonada;Parabasalia;Tritrichomonadea;Parahistomonas;";"0.0";"0";"2";"2";"0";"2";"0";"430522";"5766"
"LOK1378_1mm";"SILVA (only NR);Eukaryota;Excavata;Metamonada;Parabasalia;Tritrichomonadea;Tritrichomonas;";"0.0";"0";"6";"6";"0";"6";"0";"430518";"5766"
"LOK1378_1mm";"SILVA (only NR);Eukaryota;Excavata;Metamonada;Parabasalia;uncultured;";"0.0";"0";"5";"4";"0";"4";"1";"430520";"5766"
"LOK1378_1mm";"SILVA (only NR);Eukaryota;Excavata;Metamonada;Preaxostyla;";"0.0";"0";"26";"26";"0";"26";"0";"430498";"5766"
"LOK1378_1mm";"SILVA (only NR);Eukaryota;Excavata;Metamonada;Preaxostyla;Oxymonadida;";"0.0";"0";"18";"18";"0";"18";"0";"430506";"5766"
"LOK1378_1mm";"SILVA (only NR);Eukaryota;Excavata;Metamonada;Preaxostyla;Oxymonadida;Blattamonas;";"0.0";"0";"4";"4";"0";"4";"0";"430520";"5766"
"LOK1378_1mm";"SILVA (only NR);Eukaryota;Excavata;Metamonada;Preaxostyla;Oxymonadida;Dinenympha;";"0.0";"0";"5";"5";"0";"5";"0";"430519";"5766"
"LOK1378_1mm";"SILVA (only NR);Eukaryota;Excavata;Metamonada;Preaxostyla;Oxymonadida;Pyrsonympha;";"0.0";"0";"2";"2";"0";"2";"0";"430522";"5766"
"LOK1378_1mm";"SILVA (only NR);Eukaryota;Excavata;Metamonada;Preaxostyla;Oxymonadida;Saccinobaculus;";"0.0";"0";"2";"2";"0";"2";"0";"430522";"5766"
"LOK1378_1mm";"SILVA (only NR);Eukaryota;Excavata;Metamonada;Preaxostyla;Paratrimastix;";"0.0";"0";"5";"5";"0";"5";"0";"430519";"5766"
"LOK1378_1mm";"SILVA (only NR);Eukaryota;Excavata;Metamonada;Preaxostyla;Trimastix;";"0.0";"0";"3";"3";"0";"3";"0";"430521";"5766"
"LOK1378_1mm";"SILVA (only NR);Eukaryota;Haptophyta;";"0.0";"0";"228";"224";"0";"224";"4";"430300";"5766"
"LOK1378_1mm";"SILVA (only NR);Eukaryota;Haptophyta;Pav3;";"0.0";"0";"2";"2";"0";"2";"0";"430522";"5766"
"LOK1378_1mm";"SILVA (only NR);Eukaryota;Haptophyta;Pavlovophyceae;";"0.0";"0";"38";"38";"0";"38";"0";"430486";"5766"
"LOK1378_1mm";"SILVA (only NR);Eukaryota;Haptophyta;Pavlovophyceae;AA5F1;";"0.0";"0";"4";"4";"0";"4";"0";"430520";"5766"
"LOK1378_1mm";"SILVA (only NR);Eukaryota;Haptophyta;Pavlovophyceae;Diacronema;";"0.0";"0";"9";"9";"0";"9";"0";"430515";"5766"
"LOK1378_1mm";"SILVA (only NR);Eukaryota;Haptophyta;Pavlovophyceae;Exanthemachrysis;";"0.0";"0";"5";"5";"0";"5";"0";"430519";"5766"
"LOK1378_1mm";"SILVA (only NR);Eukaryota;Haptophyta;Pavlovophyceae;Pavlova;";"0.0";"0";"12";"12";"0";"12";"0";"430512";"5766"
"LOK1378_1mm";"SILVA (only NR);Eukaryota;Haptophyta;Pavlovophyceae;Rebecca;";"0.0";"0";"6";"6";"0";"6";"0";"430518";"5766"
"LOK1378_1mm";"SILVA (only NR);Eukaryota;Haptophyta;Prymnesiophyceae;";"0.0";"0";"173";"169";"0";"169";"4";"430355";"5766"
"LOK1378_1mm";"SILVA (only NR);Eukaryota;Haptophyta;Prymnesiophyceae;Coccolithales;";"0.0";"0";"22";"22";"0";"22";"0";"430502";"5766"
"LOK1378_1mm";"SILVA (only NR);Eukaryota;Haptophyta;Prymnesiophyceae;Coccolithales;Algirosphaera;";"0.0";"0";"1";"1";"0";"1";"0";"430523";"5766"
"LOK1378_1mm";"SILVA (only NR);Eukaryota;Haptophyta;Prymnesiophyceae;Coccolithales;Coccolithus;";"0.0";"0";"1";"1";"0";"1";"0";"430523";"5766"
"LOK1378_1mm";"SILVA (only NR);Eukaryota;Haptophyta;Prymnesiophyceae;Coccolithales;Coronosphaera;";"0.0";"0";"2";"2";"0";"2";"0";"430522";"5766"
"LOK1378_1mm";"SILVA (only NR);Eukaryota;Haptophyta;Prymnesiophyceae;Coccolithales;Cruciplacolithus;";"0.0";"0";"1";"1";"0";"1";"0";"430523";"5766"
"LOK1378_1mm";"SILVA (only NR);Eukaryota;Haptophyta;Prymnesiophyceae;Coccolithales;Hymenomonas;";"0.0";"0";"1";"1";"0";"1";"0";"430523";"5766"
"LOK1378_1mm";"SILVA (only NR);Eukaryota;Haptophyta;Prymnesiophyceae;Coccolithales;Jomonlithus;";"0.0";"0";"1";"1";"0";"1";"0";"430523";"5766"
"LOK1378_1mm";"SILVA (only NR);Eukaryota;Haptophyta;Prymnesiophyceae;Coccolithales;Pleurochrysis;";"0.0";"0";"4";"4";"0";"4";"0";"430520";"5766"
"LOK1378_1mm";"SILVA (only NR);Eukaryota;Haptophyta;Prymnesiophyceae;Coccolithales;Reticulosphaera;";"0.0";"0";"2";"2";"0";"2";"0";"430522";"5766"
"LOK1378_1mm";"SILVA (only NR);Eukaryota;Haptophyta;Prymnesiophyceae;Coccolithales;Tergestiella;";"0.0";"0";"1";"1";"0";"1";"0";"430523";"5766"
"LOK1378_1mm";"SILVA (only NR);Eukaryota;Haptophyta;Prymnesiophyceae;Coccolithales;Umbilicosphaera;";"0.0";"0";"2";"2";"0";"2";"0";"430522";"5766"
"LOK1378_1mm";"SILVA (only NR);Eukaryota;Haptophyta;Prymnesiophyceae;Isochrysidales;";"0.0";"0";"14";"14";"0";"14";"0";"430510";"5766"
"LOK1378_1mm";"SILVA (only NR);Eukaryota;Haptophyta;Prymnesiophyceae;Isochrysidales;ESS2202;";"0.0";"0";"2";"2";"0";"2";"0";"430522";"5766"
"LOK1378_1mm";"SILVA (only NR);Eukaryota;Haptophyta;Prymnesiophyceae;Isochrysidales;Emiliania;";"0.0";"0";"2";"2";"0";"2";"0";"430522";"5766"
"LOK1378_1mm";"SILVA (only NR);Eukaryota;Haptophyta;Prymnesiophyceae;Isochrysidales;Isochrysis;";"0.0";"0";"10";"10";"0";"10";"0";"430514";"5766"
"LOK1378_1mm";"SILVA (only NR);Eukaryota;Haptophyta;Prymnesiophyceae;Phaeocystis;";"0.0";"0";"14";"13";"0";"13";"1";"430511";"5766"
"LOK1378_1mm";"SILVA (only NR);Eukaryota;Haptophyta;Prymnesiophyceae;Prymnesiales;";"0.0";"0";"116";"113";"0";"113";"3";"430411";"5766"
"LOK1378_1mm";"SILVA (only NR);Eukaryota;Haptophyta;Prymnesiophyceae;Prymnesiales;AI5F14RJ2A07;";"0.0";"0";"3";"3";"0";"3";"0";"430521";"5766"
"LOK1378_1mm";"SILVA (only NR);Eukaryota;Haptophyta;Prymnesiophyceae;Prymnesiales;Chrysocampanula;";"0.0";"0";"3";"3";"0";"3";"0";"430521";"5766"
"LOK1378_1mm";"SILVA (only NR);Eukaryota;Haptophyta;Prymnesiophyceae;Prymnesiales;Chrysochromulina;";"0.0";"0";"33";"30";"0";"30";"3";"430494";"5766"
"LOK1378_1mm";"SILVA (only NR);Eukaryota;Haptophyta;Prymnesiophyceae;Prymnesiales;Chrysoculter;";"0.0";"0";"6";"6";"0";"6";"0";"430518";"5766"
"LOK1378_1mm";"SILVA (only NR);Eukaryota;Haptophyta;Prymnesiophyceae;Prymnesiales;Haptolina;";"0.0";"0";"5";"5";"0";"5";"0";"430519";"5766"
"LOK1378_1mm";"SILVA (only NR);Eukaryota;Haptophyta;Prymnesiophyceae;Prymnesiales;Helicosphaera;";"0.0";"0";"1";"1";"0";"1";"0";"430523";"5766"
"LOK1378_1mm";"SILVA (only NR);Eukaryota;Haptophyta;Prymnesiophyceae;Prymnesiales;Imantonia;";"0.0";"0";"2";"2";"0";"2";"0";"430522";"5766"
"LOK1378_1mm";"SILVA (only NR);Eukaryota;Haptophyta;Prymnesiophyceae;Prymnesiales;OLI16029;";"0.0";"0";"21";"21";"0";"21";"0";"430503";"5766"
"LOK1378_1mm";"SILVA (only NR);Eukaryota;Haptophyta;Prymnesiophyceae;Prymnesiales;OLI51059;";"0.0";"0";"5";"5";"0";"5";"0";"430519";"5766"
"LOK1378_1mm";"SILVA (only NR);Eukaryota;Haptophyta;Prymnesiophyceae;Prymnesiales;Prymnesium;";"0.0";"0";"18";"18";"0";"18";"0";"430506";"5766"
"LOK1378_1mm";"SILVA (only NR);Eukaryota;Haptophyta;Prymnesiophyceae;Prymnesiales;Pseudohaptolina;";"0.0";"0";"2";"2";"0";"2";"0";"430522";"5766"
"LOK1378_1mm";"SILVA (only NR);Eukaryota;Haptophyta;Prymnesiophyceae;Prymnesiales;Scyphosphaera;";"0.0";"0";"1";"1";"0";"1";"0";"430523";"5766"
"LOK1378_1mm";"SILVA (only NR);Eukaryota;Haptophyta;Prymnesiophyceae;Prymnesiales;uncultured;";"0.0";"0";"3";"3";"0";"3";"0";"430521";"5766"
"LOK1378_1mm";"SILVA (only NR);Eukaryota;Haptophyta;Prymnesiophyceae;SGUH624;";"0.0";"0";"3";"3";"0";"3";"0";"430521";"5766"
"LOK1378_1mm";"SILVA (only NR);Eukaryota;Haptophyta;Prymnesiophyceae;uncultured;";"0.0";"0";"2";"2";"0";"2";"0";"430522";"5766"
"LOK1378_1mm";"SILVA (only NR);Eukaryota;Haptophyta;T58;";"0.0";"0";"3";"3";"0";"3";"0";"430521";"5766"
"LOK1378_1mm";"SILVA (only NR);Eukaryota;Haptophyta;uncultured;";"0.0";"0";"2";"2";"0";"2";"0";"430522";"5766"
"LOK1378_1mm";"SILVA (only NR);Eukaryota;Incertae Sedis;";"0.0";"0";"117";"111";"0";"111";"6";"430413";"5766"
"LOK1378_1mm";"SILVA (only NR);Eukaryota;Incertae Sedis;Ancyromonadida;";"0.0";"0";"11";"10";"0";"10";"1";"430514";"5766"
"LOK1378_1mm";"SILVA (only NR);Eukaryota;Incertae Sedis;Ancyromonadida;Ancyromonas;";"0.0";"0";"4";"4";"0";"4";"0";"430520";"5766"
"LOK1378_1mm";"SILVA (only NR);Eukaryota;Incertae Sedis;Ancyromonadida;Nutomonas;";"0.0";"0";"1";"1";"0";"1";"0";"430523";"5766"
"LOK1378_1mm";"SILVA (only NR);Eukaryota;Incertae Sedis;Apusomonadidae;";"0.0";"0";"8";"5";"0";"5";"3";"430519";"5766"
"LOK1378_1mm";"SILVA (only NR);Eukaryota;Incertae Sedis;Apusomonadidae;Amastigomonas;";"0.0";"0";"6";"3";"0";"3";"3";"430521";"5766"
"LOK1378_1mm";"SILVA (only NR);Eukaryota;Incertae Sedis;Apusomonadidae;Chelonemonas;";"0.0";"0";"2";"2";"0";"2";"0";"430522";"5766"
"LOK1378_1mm";"SILVA (only NR);Eukaryota;Incertae Sedis;Mantamonas;";"0.0";"0";"4";"4";"0";"4";"0";"430520";"5766"
"LOK1378_1mm";"SILVA (only NR);Eukaryota;Incertae Sedis;Palpitomonas;";"0.0";"0";"13";"13";"0";"13";"0";"430511";"5766"
"LOK1378_1mm";"SILVA (only NR);Eukaryota;Incertae Sedis;Palustrimonas;";"0.0";"0";"1";"1";"0";"1";"0";"430523";"5766"
"LOK1378_1mm";"SILVA (only NR);Eukaryota;Incertae Sedis;Telonema;";"0.0";"0";"78";"76";"0";"76";"2";"430448";"5766"
"LOK1378_1mm";"SILVA (only NR);Eukaryota;NAMAKO-1;";"0.0";"0";"3";"3";"0";"3";"0";"430521";"5766"
"LOK1378_1mm";"SILVA (only NR);Eukaryota;Picozoa;";"0.0";"0";"34";"33";"0";"33";"1";"430491";"5766"
"LOK1378_1mm";"SILVA (only NR);Eukaryota;Picozoa;Picomonadida;";"0.0";"0";"17";"17";"0";"17";"0";"430507";"5766"
"LOK1378_1mm";"SILVA (only NR);Eukaryota;Picozoa;Picomonadida;Picomonadidae;";"0.0";"0";"6";"6";"0";"6";"0";"430518";"5766"
"LOK1378_1mm";"SILVA (only NR);Eukaryota;Picozoa;Picomonadida;Picomonadidae;Picomonas;";"0.0";"0";"6";"6";"0";"6";"0";"430518";"5766"
"LOK1378_1mm";"SILVA (only NR);Eukaryota;SA1-3C06;";"0.0";"0";"4";"4";"0";"4";"0";"430520";"5766"
"LOK1378_1mm";"SILVA (only NR);Eukaryota;SAR;";"0.0";"0";"15220";"14367";"0";"14367";"853";"416157";"5766"
"LOK1378_1mm";"SILVA (only NR);Eukaryota;SAR;Alveolata;";"0.0";"0";"9140";"8721";"0";"8721";"419";"421803";"5766"
"LOK1378_1mm";"SILVA (only NR);Eukaryota;SAR;Alveolata;Acavomonidia;";"0.0";"0";"1";"1";"0";"1";"0";"430523";"5766"
"LOK1378_1mm";"SILVA (only NR);Eukaryota;SAR;Alveolata;Acavomonidia;Acavomonas;";"0.0";"0";"1";"1";"0";"1";"0";"430523";"5766"
"LOK1378_1mm";"SILVA (only NR);Eukaryota;SAR;Alveolata;Apicomplexa;";"0.0";"0";"1206";"977";"0";"977";"229";"429547";"5766"
"LOK1378_1mm";"SILVA (only NR);Eukaryota;SAR;Alveolata;Apicomplexa;Aconoidasida;";"0.0";"0";"487";"405";"0";"405";"82";"430119";"5766"
"LOK1378_1mm";"SILVA (only NR);Eukaryota;SAR;Alveolata;Apicomplexa;Aconoidasida;Haemosporoidia;";"0.0";"0";"198";"144";"0";"144";"54";"430380";"5766"
"LOK1378_1mm";"SILVA (only NR);Eukaryota;SAR;Alveolata;Apicomplexa;Aconoidasida;Haemosporoidia;Plasmodium;";"0.0";"0";"198";"144";"0";"144";"54";"430380";"5766"
"LOK1378_1mm";"SILVA (only NR);Eukaryota;SAR;Alveolata;Apicomplexa;Aconoidasida;Piroplasmorida;";"0.0";"0";"289";"261";"0";"261";"28";"430263";"5766"
"LOK1378_1mm";"SILVA (only NR);Eukaryota;SAR;Alveolata;Apicomplexa;Aconoidasida;Piroplasmorida;Babesia;";"0.0";"0";"141";"132";"0";"132";"9";"430392";"5766"
"LOK1378_1mm";"SILVA (only NR);Eukaryota;SAR;Alveolata;Apicomplexa;Aconoidasida;Piroplasmorida;Cardiosporidium;";"0.0";"0";"2";"2";"0";"2";"0";"430522";"5766"
"LOK1378_1mm";"SILVA (only NR);Eukaryota;SAR;Alveolata;Apicomplexa;Aconoidasida;Piroplasmorida;Cytauxzoon;";"0.0";"0";"4";"4";"0";"4";"0";"430520";"5766"
"LOK1378_1mm";"SILVA (only NR);Eukaryota;SAR;Alveolata;Apicomplexa;Aconoidasida;Piroplasmorida;Nephromyces;";"0.0";"0";"9";"3";"0";"3";"6";"430521";"5766"
"LOK1378_1mm";"SILVA (only NR);Eukaryota;SAR;Alveolata;Apicomplexa;Aconoidasida;Piroplasmorida;Theileria;";"0.0";"0";"120";"112";"0";"112";"8";"430412";"5766"
"LOK1378_1mm";"SILVA (only NR);Eukaryota;SAR;Alveolata;Apicomplexa;Aconoidasida;Piroplasmorida;uncultured;";"0.0";"0";"4";"2";"0";"2";"2";"430522";"5766"
"LOK1378_1mm";"SILVA (only NR);Eukaryota;SAR;Alveolata;Apicomplexa;Conoidasida;";"0.0";"0";"682";"540";"0";"540";"142";"429984";"5766"
"LOK1378_1mm";"SILVA (only NR);Eukaryota;SAR;Alveolata;Apicomplexa;Conoidasida;Coccidia;";"0.0";"0";"458";"329";"0";"329";"129";"430195";"5766"
"LOK1378_1mm";"SILVA (only NR);Eukaryota;SAR;Alveolata;Apicomplexa;Conoidasida;Coccidia;Adeleorina;";"0.0";"0";"69";"54";"0";"54";"15";"430470";"5766"
"LOK1378_1mm";"SILVA (only NR);Eukaryota;SAR;Alveolata;Apicomplexa;Conoidasida;Coccidia;Adeleorina;Adelina;";"0.0";"0";"2";"2";"0";"2";"0";"430522";"5766"
"LOK1378_1mm";"SILVA (only NR);Eukaryota;SAR;Alveolata;Apicomplexa;Conoidasida;Coccidia;Adeleorina;Dactylosoma;";"0.0";"0";"1";"1";"0";"1";"0";"430523";"5766"
"LOK1378_1mm";"SILVA (only NR);Eukaryota;SAR;Alveolata;Apicomplexa;Conoidasida;Coccidia;Adeleorina;Haemogregarina;";"0.0";"0";"5";"1";"0";"1";"4";"430523";"5766"
"LOK1378_1mm";"SILVA (only NR);Eukaryota;SAR;Alveolata;Apicomplexa;Conoidasida;Coccidia;Adeleorina;Hemolivia;";"0.0";"0";"7";"3";"0";"3";"4";"430521";"5766"
"LOK1378_1mm";"SILVA (only NR);Eukaryota;SAR;Alveolata;Apicomplexa;Conoidasida;Coccidia;Adeleorina;Hepatozoon;";"0.0";"0";"51";"45";"0";"45";"6";"430479";"5766"
"LOK1378_1mm";"SILVA (only NR);Eukaryota;SAR;Alveolata;Apicomplexa;Conoidasida;Coccidia;Adeleorina;Klossia;";"0.0";"0";"1";"1";"0";"1";"0";"430523";"5766"
"LOK1378_1mm";"SILVA (only NR);Eukaryota;SAR;Alveolata;Apicomplexa;Conoidasida;Coccidia;Eimeriorina;";"0.0";"0";"389";"275";"0";"275";"114";"430249";"5766"
"LOK1378_1mm";"SILVA (only NR);Eukaryota;SAR;Alveolata;Apicomplexa;Conoidasida;Coccidia;Eimeriorina;Acroeimeria;";"0.0";"0";"4";"1";"0";"1";"3";"430523";"5766"
"LOK1378_1mm";"SILVA (only NR);Eukaryota;SAR;Alveolata;Apicomplexa;Conoidasida;Coccidia;Eimeriorina;Aggregata;";"0.0";"0";"3";"3";"0";"3";"0";"430521";"5766"
"LOK1378_1mm";"SILVA (only NR);Eukaryota;SAR;Alveolata;Apicomplexa;Conoidasida;Coccidia;Eimeriorina;Besnoitia;";"0.0";"0";"3";"3";"0";"3";"0";"430521";"5766"
"LOK1378_1mm";"SILVA (only NR);Eukaryota;SAR;Alveolata;Apicomplexa;Conoidasida;Coccidia;Eimeriorina;Calyptosporidae;";"0.0";"0";"6";"6";"0";"6";"0";"430518";"5766"
"LOK1378_1mm";"SILVA (only NR);Eukaryota;SAR;Alveolata;Apicomplexa;Conoidasida;Coccidia;Eimeriorina;Caryospora;";"0.0";"0";"2";"1";"0";"1";"1";"430523";"5766"
"LOK1378_1mm";"SILVA (only NR);Eukaryota;SAR;Alveolata;Apicomplexa;Conoidasida;Coccidia;Eimeriorina;Choleoeimeria;";"0.0";"0";"2";"1";"0";"1";"1";"430523";"5766"
"LOK1378_1mm";"SILVA (only NR);Eukaryota;SAR;Alveolata;Apicomplexa;Conoidasida;Coccidia;Eimeriorina;Cyclospora;";"0.0";"0";"1";"1";"0";"1";"0";"430523";"5766"
"LOK1378_1mm";"SILVA (only NR);Eukaryota;SAR;Alveolata;Apicomplexa;Conoidasida;Coccidia;Eimeriorina;Cystoisospora;";"0.0";"0";"3";"3";"0";"3";"0";"430521";"5766"
"LOK1378_1mm";"SILVA (only NR);Eukaryota;SAR;Alveolata;Apicomplexa;Conoidasida;Coccidia;Eimeriorina;Eimeria;";"0.0";"0";"148";"90";"0";"90";"58";"430434";"5766"
"LOK1378_1mm";"SILVA (only NR);Eukaryota;SAR;Alveolata;Apicomplexa;Conoidasida;Coccidia;Eimeriorina;Goussia;";"0.0";"0";"25";"23";"0";"23";"2";"430501";"5766"
"LOK1378_1mm";"SILVA (only NR);Eukaryota;SAR;Alveolata;Apicomplexa;Conoidasida;Coccidia;Eimeriorina;Hyaloklossia;";"0.0";"0";"1";"0";"0";"0";"1";"430524";"5766"
"LOK1378_1mm";"SILVA (only NR);Eukaryota;SAR;Alveolata;Apicomplexa;Conoidasida;Coccidia;Eimeriorina;Isospora;";"0.0";"0";"2";"0";"0";"0";"2";"430524";"5766"
"LOK1378_1mm";"SILVA (only NR);Eukaryota;SAR;Alveolata;Apicomplexa;Conoidasida;Coccidia;Eimeriorina;Lankesterella;";"0.0";"0";"7";"2";"0";"2";"5";"430522";"5766"
"LOK1378_1mm";"SILVA (only NR);Eukaryota;SAR;Alveolata;Apicomplexa;Conoidasida;Coccidia;Eimeriorina;Margolisiella;";"0.0";"0";"5";"5";"0";"5";"0";"430519";"5766"
"LOK1378_1mm";"SILVA (only NR);Eukaryota;SAR;Alveolata;Apicomplexa;Conoidasida;Coccidia;Eimeriorina;Rhytidocystis;";"0.0";"0";"3";"3";"0";"3";"0";"430521";"5766"
"LOK1378_1mm";"SILVA (only NR);Eukaryota;SAR;Alveolata;Apicomplexa;Conoidasida;Coccidia;Eimeriorina;Sarcocystis;";"0.0";"0";"129";"112";"0";"112";"17";"430412";"5766"
"LOK1378_1mm";"SILVA (only NR);Eukaryota;SAR;Alveolata;Apicomplexa;Conoidasida;Coccidia;Eimeriorina;Toxoplasma;";"0.0";"0";"4";"4";"0";"4";"0";"430520";"5766"
"LOK1378_1mm";"SILVA (only NR);Eukaryota;SAR;Alveolata;Apicomplexa;Conoidasida;Coccidia;Eimeriorina;uncultured;";"0.0";"0";"8";"3";"0";"3";"5";"430521";"5766"
"LOK1378_1mm";"SILVA (only NR);Eukaryota;SAR;Alveolata;Apicomplexa;Conoidasida;Cryptosporida;";"0.0";"0";"43";"41";"0";"41";"2";"430483";"5766"
"LOK1378_1mm";"SILVA (only NR);Eukaryota;SAR;Alveolata;Apicomplexa;Conoidasida;Cryptosporida;Cryptosporidium;";"0.0";"0";"43";"41";"0";"41";"2";"430483";"5766"
"LOK1378_1mm";"SILVA (only NR);Eukaryota;SAR;Alveolata;Apicomplexa;Conoidasida;Gregarinasina;";"0.0";"0";"178";"167";"0";"167";"11";"430357";"5766"
"LOK1378_1mm";"SILVA (only NR);Eukaryota;SAR;Alveolata;Apicomplexa;Conoidasida;Gregarinasina;Archigregarinorida;";"0.0";"0";"33";"31";"0";"31";"2";"430493";"5766"
"LOK1378_1mm";"SILVA (only NR);Eukaryota;SAR;Alveolata;Apicomplexa;Conoidasida;Gregarinasina;Archigregarinorida;Filipodium;";"0.0";"0";"1";"1";"0";"1";"0";"430523";"5766"
"LOK1378_1mm";"SILVA (only NR);Eukaryota;SAR;Alveolata;Apicomplexa;Conoidasida;Gregarinasina;Archigregarinorida;Selenidium;";"0.0";"0";"32";"30";"0";"30";"2";"430494";"5766"
"LOK1378_1mm";"SILVA (only NR);Eukaryota;SAR;Alveolata;Apicomplexa;Conoidasida;Gregarinasina;BAQA40;";"0.0";"0";"4";"2";"0";"2";"2";"430522";"5766"
"LOK1378_1mm";"SILVA (only NR);Eukaryota;SAR;Alveolata;Apicomplexa;Conoidasida;Gregarinasina;Eugregarinorida;";"0.0";"0";"130";"123";"0";"123";"7";"430401";"5766"
"LOK1378_1mm";"SILVA (only NR);Eukaryota;SAR;Alveolata;Apicomplexa;Conoidasida;Gregarinasina;Eugregarinorida;Amoebogregarina;";"0.0";"0";"1";"1";"0";"1";"0";"430523";"5766"
"LOK1378_1mm";"SILVA (only NR);Eukaryota;SAR;Alveolata;Apicomplexa;Conoidasida;Gregarinasina;Eugregarinorida;Ascogregarina;";"0.0";"0";"4";"4";"0";"4";"0";"430520";"5766"
"LOK1378_1mm";"SILVA (only NR);Eukaryota;SAR;Alveolata;Apicomplexa;Conoidasida;Gregarinasina;Eugregarinorida;Colepismatophila;";"0.0";"0";"1";"1";"0";"1";"0";"430523";"5766"
"LOK1378_1mm";"SILVA (only NR);Eukaryota;SAR;Alveolata;Apicomplexa;Conoidasida;Gregarinasina;Eugregarinorida;D3P05A02;";"0.0";"0";"4";"1";"0";"1";"3";"430523";"5766"
"LOK1378_1mm";"SILVA (only NR);Eukaryota;SAR;Alveolata;Apicomplexa;Conoidasida;Gregarinasina;Eugregarinorida;D4P07G01;";"0.0";"0";"3";"2";"0";"2";"1";"430522";"5766"
"LOK1378_1mm";"SILVA (only NR);Eukaryota;SAR;Alveolata;Apicomplexa;Conoidasida;Gregarinasina;Eugregarinorida;Elev-18S-1089;";"0.0";"0";"4";"4";"0";"4";"0";"430520";"5766"
"LOK1378_1mm";"SILVA (only NR);Eukaryota;SAR;Alveolata;Apicomplexa;Conoidasida;Gregarinasina;Eugregarinorida;Geneiorhynchus;";"0.0";"0";"1";"1";"0";"1";"0";"430523";"5766"
"LOK1378_1mm";"SILVA (only NR);Eukaryota;SAR;Alveolata;Apicomplexa;Conoidasida;Gregarinasina;Eugregarinorida;Gregarina;";"0.0";"0";"13";"13";"0";"13";"0";"430511";"5766"
"LOK1378_1mm";"SILVA (only NR);Eukaryota;SAR;Alveolata;Apicomplexa;Conoidasida;Gregarinasina;Eugregarinorida;Hoplorhynchus;";"0.0";"0";"2";"1";"0";"1";"1";"430523";"5766"
"LOK1378_1mm";"SILVA (only NR);Eukaryota;SAR;Alveolata;Apicomplexa;Conoidasida;Gregarinasina;Eugregarinorida;LEMD098;";"0.0";"0";"9";"8";"0";"8";"1";"430516";"5766"
"LOK1378_1mm";"SILVA (only NR);Eukaryota;SAR;Alveolata;Apicomplexa;Conoidasida;Gregarinasina;Eugregarinorida;Lankesteria;";"0.0";"0";"15";"15";"0";"15";"0";"430509";"5766"
"LOK1378_1mm";"SILVA (only NR);Eukaryota;SAR;Alveolata;Apicomplexa;Conoidasida;Gregarinasina;Eugregarinorida;Lecudina;";"0.0";"0";"21";"21";"0";"21";"0";"430503";"5766"
"LOK1378_1mm";"SILVA (only NR);Eukaryota;SAR;Alveolata;Apicomplexa;Conoidasida;Gregarinasina;Eugregarinorida;Leidyana;";"0.0";"0";"3";"3";"0";"3";"0";"430521";"5766"
"LOK1378_1mm";"SILVA (only NR);Eukaryota;SAR;Alveolata;Apicomplexa;Conoidasida;Gregarinasina;Eugregarinorida;Monocystis;";"0.0";"0";"3";"3";"0";"3";"0";"430521";"5766"
"LOK1378_1mm";"SILVA (only NR);Eukaryota;SAR;Alveolata;Apicomplexa;Conoidasida;Gregarinasina;Eugregarinorida;Nematopsis;";"0.0";"0";"6";"6";"0";"6";"0";"430518";"5766"
"LOK1378_1mm";"SILVA (only NR);Eukaryota;SAR;Alveolata;Apicomplexa;Conoidasida;Gregarinasina;Eugregarinorida;Paraschneideria;";"0.0";"0";"2";"2";"0";"2";"0";"430522";"5766"
"LOK1378_1mm";"SILVA (only NR);Eukaryota;SAR;Alveolata;Apicomplexa;Conoidasida;Gregarinasina;Eugregarinorida;Prismatospora;";"0.0";"0";"1";"1";"0";"1";"0";"430523";"5766"
"LOK1378_1mm";"SILVA (only NR);Eukaryota;SAR;Alveolata;Apicomplexa;Conoidasida;Gregarinasina;Eugregarinorida;Protomagalhaensia;";"0.0";"0";"1";"1";"0";"1";"0";"430523";"5766"
"LOK1378_1mm";"SILVA (only NR);Eukaryota;SAR;Alveolata;Apicomplexa;Conoidasida;Gregarinasina;Eugregarinorida;Psychodiella;";"0.0";"0";"2";"2";"0";"2";"0";"430522";"5766"
"LOK1378_1mm";"SILVA (only NR);Eukaryota;SAR;Alveolata;Apicomplexa;Conoidasida;Gregarinasina;Eugregarinorida;Pterospora;";"0.0";"0";"2";"2";"0";"2";"0";"430522";"5766"
"LOK1378_1mm";"SILVA (only NR);Eukaryota;SAR;Alveolata;Apicomplexa;Conoidasida;Gregarinasina;Eugregarinorida;Stenophora;";"0.0";"0";"1";"1";"0";"1";"0";"430523";"5766"
"LOK1378_1mm";"SILVA (only NR);Eukaryota;SAR;Alveolata;Apicomplexa;Conoidasida;Gregarinasina;Eugregarinorida;Stylocephalus;";"0.0";"0";"2";"2";"0";"2";"0";"430522";"5766"
"LOK1378_1mm";"SILVA (only NR);Eukaryota;SAR;Alveolata;Apicomplexa;Conoidasida;Gregarinasina;Eugregarinorida;Syncystis;";"0.0";"0";"1";"1";"0";"1";"0";"430523";"5766"
"LOK1378_1mm";"SILVA (only NR);Eukaryota;SAR;Alveolata;Apicomplexa;Conoidasida;Gregarinasina;Eugregarinorida;Urospora;";"0.0";"0";"6";"5";"0";"5";"1";"430519";"5766"
"LOK1378_1mm";"SILVA (only NR);Eukaryota;SAR;Alveolata;Apicomplexa;Conoidasida;Gregarinasina;Eugregarinorida;Xiphocephalus;";"0.0";"0";"1";"1";"0";"1";"0";"430523";"5766"
"LOK1378_1mm";"SILVA (only NR);Eukaryota;SAR;Alveolata;Apicomplexa;Conoidasida;Gregarinasina;Eugregarinorida;uncultured;";"0.0";"0";"7";"7";"0";"7";"0";"430517";"5766"
"LOK1378_1mm";"SILVA (only NR);Eukaryota;SAR;Alveolata;Apicomplexa;Conoidasida;Gregarinasina;Neogregarinorida;";"0.0";"0";"8";"8";"0";"8";"0";"430516";"5766"
"LOK1378_1mm";"SILVA (only NR);Eukaryota;SAR;Alveolata;Apicomplexa;Conoidasida;Gregarinasina;Neogregarinorida;Apicystis;";"0.0";"0";"2";"2";"0";"2";"0";"430522";"5766"
"LOK1378_1mm";"SILVA (only NR);Eukaryota;SAR;Alveolata;Apicomplexa;Conoidasida;Gregarinasina;Neogregarinorida;Aranciocystis;";"0.0";"0";"1";"1";"0";"1";"0";"430523";"5766"
"LOK1378_1mm";"SILVA (only NR);Eukaryota;SAR;Alveolata;Apicomplexa;Conoidasida;Gregarinasina;Neogregarinorida;Mattesia;";"0.0";"0";"2";"2";"0";"2";"0";"430522";"5766"
"LOK1378_1mm";"SILVA (only NR);Eukaryota;SAR;Alveolata;Apicomplexa;Conoidasida;Gregarinasina;Neogregarinorida;Ophryocystis;";"0.0";"0";"1";"1";"0";"1";"0";"430523";"5766"
"LOK1378_1mm";"SILVA (only NR);Eukaryota;SAR;Alveolata;Apicomplexa;Novel Apicomplexa Class 1;";"0.0";"0";"17";"13";"0";"13";"4";"430511";"5766"
"LOK1378_1mm";"SILVA (only NR);Eukaryota;SAR;Alveolata;Apicomplexa;Novel Apicomplexa Class 2;";"0.0";"0";"18";"17";"0";"17";"1";"430507";"5766"
"LOK1378_1mm";"SILVA (only NR);Eukaryota;SAR;Alveolata;Ciliophora;";"0.0";"0";"2935";"2841";"0";"2841";"94";"427683";"5766"
"LOK1378_1mm";"SILVA (only NR);Eukaryota;SAR;Alveolata;Ciliophora;Intramacronucleata;";"0.0";"0";"2783";"2693";"0";"2693";"90";"427831";"5766"
"LOK1378_1mm";"SILVA (only NR);Eukaryota;SAR;Alveolata;Ciliophora;Intramacronucleata;Armophorea;";"0.0";"0";"83";"82";"0";"82";"1";"430442";"5766"
"LOK1378_1mm";"SILVA (only NR);Eukaryota;SAR;Alveolata;Ciliophora;Intramacronucleata;Armophorea;Armophorida;";"0.0";"0";"39";"39";"0";"39";"0";"430485";"5766"
"LOK1378_1mm";"SILVA (only NR);Eukaryota;SAR;Alveolata;Ciliophora;Intramacronucleata;Armophorea;Armophorida;Brachonella;";"0.0";"0";"10";"10";"0";"10";"0";"430514";"5766"
"LOK1378_1mm";"SILVA (only NR);Eukaryota;SAR;Alveolata;Ciliophora;Intramacronucleata;Armophorea;Armophorida;Caenomorpha;";"0.0";"0";"5";"5";"0";"5";"0";"430519";"5766"
"LOK1378_1mm";"SILVA (only NR);Eukaryota;SAR;Alveolata;Ciliophora;Intramacronucleata;Armophorea;Armophorida;Metopus;";"0.0";"0";"14";"14";"0";"14";"0";"430510";"5766"
"LOK1378_1mm";"SILVA (only NR);Eukaryota;SAR;Alveolata;Ciliophora;Intramacronucleata;Armophorea;Armophorida;Parametopidium;";"0.0";"0";"1";"1";"0";"1";"0";"430523";"5766"
"LOK1378_1mm";"SILVA (only NR);Eukaryota;SAR;Alveolata;Ciliophora;Intramacronucleata;Armophorea;Cariaco Basin group 1;";"0.0";"0";"9";"9";"0";"9";"0";"430515";"5766"
"LOK1378_1mm";"SILVA (only NR);Eukaryota;SAR;Alveolata;Ciliophora;Intramacronucleata;Armophorea;Cariaco Basin group 2;";"0.0";"0";"7";"7";"0";"7";"0";"430517";"5766"
"LOK1378_1mm";"SILVA (only NR);Eukaryota;SAR;Alveolata;Ciliophora;Intramacronucleata;Armophorea;Clevelandellida;";"0.0";"0";"15";"15";"0";"15";"0";"430509";"5766"
"LOK1378_1mm";"SILVA (only NR);Eukaryota;SAR;Alveolata;Ciliophora;Intramacronucleata;Armophorea;Clevelandellida;Clevelandella;";"0.0";"0";"5";"5";"0";"5";"0";"430519";"5766"
"LOK1378_1mm";"SILVA (only NR);Eukaryota;SAR;Alveolata;Ciliophora;Intramacronucleata;Armophorea;Clevelandellida;Nyctotheroides;";"0.0";"0";"4";"4";"0";"4";"0";"430520";"5766"
"LOK1378_1mm";"SILVA (only NR);Eukaryota;SAR;Alveolata;Ciliophora;Intramacronucleata;Armophorea;Clevelandellida;Nyctotherus;";"0.0";"0";"5";"5";"0";"5";"0";"430519";"5766"
"LOK1378_1mm";"SILVA (only NR);Eukaryota;SAR;Alveolata;Ciliophora;Intramacronucleata;Armophorea;uncultured;";"0.0";"0";"10";"9";"0";"9";"1";"430515";"5766"
"LOK1378_1mm";"SILVA (only NR);Eukaryota;SAR;Alveolata;Ciliophora;Intramacronucleata;Conthreep;";"0.0";"0";"1076";"1032";"0";"1032";"44";"429492";"5766"
"LOK1378_1mm";"SILVA (only NR);Eukaryota;SAR;Alveolata;Ciliophora;Intramacronucleata;Conthreep;Colpodea;";"0.0";"0";"117";"115";"0";"115";"2";"430409";"5766"
"LOK1378_1mm";"SILVA (only NR);Eukaryota;SAR;Alveolata;Ciliophora;Intramacronucleata;Conthreep;Colpodea;Bursariomorphida;";"0.0";"0";"12";"11";"0";"11";"1";"430513";"5766"
"LOK1378_1mm";"SILVA (only NR);Eukaryota;SAR;Alveolata;Ciliophora;Intramacronucleata;Conthreep;Colpodea;Bursariomorphida;Bryometopus;";"0.0";"0";"9";"8";"0";"8";"1";"430516";"5766"
"LOK1378_1mm";"SILVA (only NR);Eukaryota;SAR;Alveolata;Ciliophora;Intramacronucleata;Conthreep;Colpodea;Bursariomorphida;Bursaria;";"0.0";"0";"3";"3";"0";"3";"0";"430521";"5766"
"LOK1378_1mm";"SILVA (only NR);Eukaryota;SAR;Alveolata;Ciliophora;Intramacronucleata;Conthreep;Colpodea;Colpodida;";"0.0";"0";"68";"68";"0";"68";"0";"430456";"5766"
"LOK1378_1mm";"SILVA (only NR);Eukaryota;SAR;Alveolata;Ciliophora;Intramacronucleata;Conthreep;Colpodea;Colpodida;Bardeliella;";"0.0";"0";"1";"1";"0";"1";"0";"430523";"5766"
"LOK1378_1mm";"SILVA (only NR);Eukaryota;SAR;Alveolata;Ciliophora;Intramacronucleata;Conthreep;Colpodea;Colpodida;Bresslaua;";"0.0";"0";"1";"1";"0";"1";"0";"430523";"5766"
"LOK1378_1mm";"SILVA (only NR);Eukaryota;SAR;Alveolata;Ciliophora;Intramacronucleata;Conthreep;Colpodea;Colpodida;Bresslauides;";"0.0";"0";"2";"2";"0";"2";"0";"430522";"5766"
"LOK1378_1mm";"SILVA (only NR);Eukaryota;SAR;Alveolata;Ciliophora;Intramacronucleata;Conthreep;Colpodea;Colpodida;Bromeliothrix;";"0.0";"0";"3";"3";"0";"3";"0";"430521";"5766"
"LOK1378_1mm";"SILVA (only NR);Eukaryota;SAR;Alveolata;Ciliophora;Intramacronucleata;Conthreep;Colpodea;Colpodida;Bryophrya;";"0.0";"0";"1";"1";"0";"1";"0";"430523";"5766"
"LOK1378_1mm";"SILVA (only NR);Eukaryota;SAR;Alveolata;Ciliophora;Intramacronucleata;Conthreep;Colpodea;Colpodida;Bryophryoides;";"0.0";"0";"1";"1";"0";"1";"0";"430523";"5766"
"LOK1378_1mm";"SILVA (only NR);Eukaryota;SAR;Alveolata;Ciliophora;Intramacronucleata;Conthreep;Colpodea;Colpodida;Colpoda;";"0.0";"0";"17";"17";"0";"17";"0";"430507";"5766"
"LOK1378_1mm";"SILVA (only NR);Eukaryota;SAR;Alveolata;Ciliophora;Intramacronucleata;Conthreep;Colpodea;Colpodida;Exocolpoda;";"0.0";"0";"1";"1";"0";"1";"0";"430523";"5766"
"LOK1378_1mm";"SILVA (only NR);Eukaryota;SAR;Alveolata;Ciliophora;Intramacronucleata;Conthreep;Colpodea;Colpodida;Hausmanniella;";"0.0";"0";"1";"1";"0";"1";"0";"430523";"5766"
"LOK1378_1mm";"SILVA (only NR);Eukaryota;SAR;Alveolata;Ciliophora;Intramacronucleata;Conthreep;Colpodea;Colpodida;Ilsiella;";"0.0";"0";"1";"1";"0";"1";"0";"430523";"5766"
"LOK1378_1mm";"SILVA (only NR);Eukaryota;SAR;Alveolata;Ciliophora;Intramacronucleata;Conthreep;Colpodea;Colpodida;Jaroschia;";"0.0";"0";"1";"1";"0";"1";"0";"430523";"5766"
"LOK1378_1mm";"SILVA (only NR);Eukaryota;SAR;Alveolata;Ciliophora;Intramacronucleata;Conthreep;Colpodea;Colpodida;Kalometopia;";"0.0";"0";"1";"1";"0";"1";"0";"430523";"5766"
"LOK1378_1mm";"SILVA (only NR);Eukaryota;SAR;Alveolata;Ciliophora;Intramacronucleata;Conthreep;Colpodea;Colpodida;Maryna;";"0.0";"0";"3";"3";"0";"3";"0";"430521";"5766"
"LOK1378_1mm";"SILVA (only NR);Eukaryota;SAR;Alveolata;Ciliophora;Intramacronucleata;Conthreep;Colpodea;Colpodida;Mykophagophrys;";"0.0";"0";"1";"1";"0";"1";"0";"430523";"5766"
"LOK1378_1mm";"SILVA (only NR);Eukaryota;SAR;Alveolata;Ciliophora;Intramacronucleata;Conthreep;Colpodea;Colpodida;Notoxoma;";"0.0";"0";"2";"2";"0";"2";"0";"430522";"5766"
"LOK1378_1mm";"SILVA (only NR);Eukaryota;SAR;Alveolata;Ciliophora;Intramacronucleata;Conthreep;Colpodea;Colpodida;Pseudoplatyophrya;";"0.0";"0";"2";"2";"0";"2";"0";"430522";"5766"
"LOK1378_1mm";"SILVA (only NR);Eukaryota;SAR;Alveolata;Ciliophora;Intramacronucleata;Conthreep;Colpodea;Colpodida;Repoma;";"0.0";"0";"1";"1";"0";"1";"0";"430523";"5766"
"LOK1378_1mm";"SILVA (only NR);Eukaryota;SAR;Alveolata;Ciliophora;Intramacronucleata;Conthreep;Colpodea;Colpodida;uncultured;";"0.0";"0";"7";"7";"0";"7";"0";"430517";"5766"
"LOK1378_1mm";"SILVA (only NR);Eukaryota;SAR;Alveolata;Ciliophora;Intramacronucleata;Conthreep;Colpodea;Cyrtolophosidida;";"0.0";"0";"15";"14";"0";"14";"1";"430510";"5766"
"LOK1378_1mm";"SILVA (only NR);Eukaryota;SAR;Alveolata;Ciliophora;Intramacronucleata;Conthreep;Colpodea;Cyrtolophosidida;Aristerostoma;";"0.0";"0";"3";"3";"0";"3";"0";"430521";"5766"
"LOK1378_1mm";"SILVA (only NR);Eukaryota;SAR;Alveolata;Ciliophora;Intramacronucleata;Conthreep;Colpodea;Cyrtolophosidida;Cyrtolophosis;";"0.0";"0";"4";"4";"0";"4";"0";"430520";"5766"
"LOK1378_1mm";"SILVA (only NR);Eukaryota;SAR;Alveolata;Ciliophora;Intramacronucleata;Conthreep;Colpodea;Cyrtolophosidida;Microdiaphanosoma;";"0.0";"0";"3";"2";"0";"2";"1";"430522";"5766"
"LOK1378_1mm";"SILVA (only NR);Eukaryota;SAR;Alveolata;Ciliophora;Intramacronucleata;Conthreep;Colpodea;Platyophryida;";"0.0";"0";"18";"18";"0";"18";"0";"430506";"5766"
"LOK1378_1mm";"SILVA (only NR);Eukaryota;SAR;Alveolata;Ciliophora;Intramacronucleata;Conthreep;Colpodea;Platyophryida;Etoschophrya;";"0.0";"0";"1";"1";"0";"1";"0";"430523";"5766"
"LOK1378_1mm";"SILVA (only NR);Eukaryota;SAR;Alveolata;Ciliophora;Intramacronucleata;Conthreep;Colpodea;Platyophryida;Platyophrya;";"0.0";"0";"8";"8";"0";"8";"0";"430516";"5766"
"LOK1378_1mm";"SILVA (only NR);Eukaryota;SAR;Alveolata;Ciliophora;Intramacronucleata;Conthreep;Colpodea;Platyophryida;Platyophryides;";"0.0";"0";"2";"2";"0";"2";"0";"430522";"5766"
"LOK1378_1mm";"SILVA (only NR);Eukaryota;SAR;Alveolata;Ciliophora;Intramacronucleata;Conthreep;Colpodea;Platyophryida;Sorogena;";"0.0";"0";"1";"1";"0";"1";"0";"430523";"5766"
"LOK1378_1mm";"SILVA (only NR);Eukaryota;SAR;Alveolata;Ciliophora;Intramacronucleata;Conthreep;Colpodea;Platyophryida;Woodruffides;";"0.0";"0";"4";"4";"0";"4";"0";"430520";"5766"
"LOK1378_1mm";"SILVA (only NR);Eukaryota;SAR;Alveolata;Ciliophora;Intramacronucleata;Conthreep;Colpodea;uncultured;";"0.0";"0";"4";"4";"0";"4";"0";"430520";"5766"
"LOK1378_1mm";"SILVA (only NR);Eukaryota;SAR;Alveolata;Ciliophora;Intramacronucleata;Conthreep;IN2411;";"0.0";"0";"6";"6";"0";"6";"0";"430518";"5766"
"LOK1378_1mm";"SILVA (only NR);Eukaryota;SAR;Alveolata;Ciliophora;Intramacronucleata;Conthreep;Nassophorea;";"0.0";"0";"74";"71";"0";"71";"3";"430453";"5766"
"LOK1378_1mm";"SILVA (only NR);Eukaryota;SAR;Alveolata;Ciliophora;Intramacronucleata;Conthreep;Nassophorea;Colpodidium;";"0.0";"0";"3";"3";"0";"3";"0";"430521";"5766"
"LOK1378_1mm";"SILVA (only NR);Eukaryota;SAR;Alveolata;Ciliophora;Intramacronucleata;Conthreep;Nassophorea;Discotricha;";"0.0";"0";"8";"8";"0";"8";"0";"430516";"5766"
"LOK1378_1mm";"SILVA (only NR);Eukaryota;SAR;Alveolata;Ciliophora;Intramacronucleata;Conthreep;Nassophorea;Furgasonia;";"0.0";"0";"1";"1";"0";"1";"0";"430523";"5766"
"LOK1378_1mm";"SILVA (only NR);Eukaryota;SAR;Alveolata;Ciliophora;Intramacronucleata;Conthreep;Nassophorea;Leptopharynx;";"0.0";"0";"2";"2";"0";"2";"0";"430522";"5766"
"LOK1378_1mm";"SILVA (only NR);Eukaryota;SAR;Alveolata;Ciliophora;Intramacronucleata;Conthreep;Nassophorea;Obertrumia;";"0.0";"0";"4";"4";"0";"4";"0";"430520";"5766"
"LOK1378_1mm";"SILVA (only NR);Eukaryota;SAR;Alveolata;Ciliophora;Intramacronucleata;Conthreep;Nassophorea;Pseudomicrothorax;";"0.0";"0";"1";"1";"0";"1";"0";"430523";"5766"
"LOK1378_1mm";"SILVA (only NR);Eukaryota;SAR;Alveolata;Ciliophora;Intramacronucleata;Conthreep;Nassophorea;Trochiliopsis;";"0.0";"0";"1";"1";"0";"1";"0";"430523";"5766"
"LOK1378_1mm";"SILVA (only NR);Eukaryota;SAR;Alveolata;Ciliophora;Intramacronucleata;Conthreep;Nassophorea;Zosterodasys;";"0.0";"0";"10";"10";"0";"10";"0";"430514";"5766"
"LOK1378_1mm";"SILVA (only NR);Eukaryota;SAR;Alveolata;Ciliophora;Intramacronucleata;Conthreep;Nassophorea;uncultured;";"0.0";"0";"35";"34";"0";"34";"1";"430490";"5766"
"LOK1378_1mm";"SILVA (only NR);Eukaryota;SAR;Alveolata;Ciliophora;Intramacronucleata;Conthreep;Oligohymenophorea;";"0.0";"0";"587";"558";"0";"558";"29";"429966";"5766"
"LOK1378_1mm";"SILVA (only NR);Eukaryota;SAR;Alveolata;Ciliophora;Intramacronucleata;Conthreep;Oligohymenophorea;Apostomatia;";"0.0";"0";"31";"30";"0";"30";"1";"430494";"5766"
"LOK1378_1mm";"SILVA (only NR);Eukaryota;SAR;Alveolata;Ciliophora;Intramacronucleata;Conthreep;Oligohymenophorea;Apostomatia;Cinetochilum;";"0.0";"0";"2";"2";"0";"2";"0";"430522";"5766"
"LOK1378_1mm";"SILVA (only NR);Eukaryota;SAR;Alveolata;Ciliophora;Intramacronucleata;Conthreep;Oligohymenophorea;Apostomatia;Fusiforma;";"0.0";"0";"1";"1";"0";"1";"0";"430523";"5766"
"LOK1378_1mm";"SILVA (only NR);Eukaryota;SAR;Alveolata;Ciliophora;Intramacronucleata;Conthreep;Oligohymenophorea;Apostomatia;Gymnodinioides;";"0.0";"0";"2";"2";"0";"2";"0";"430522";"5766"
"LOK1378_1mm";"SILVA (only NR);Eukaryota;SAR;Alveolata;Ciliophora;Intramacronucleata;Conthreep;Oligohymenophorea;Apostomatia;Hyalophysa;";"0.0";"0";"6";"6";"0";"6";"0";"430518";"5766"
"LOK1378_1mm";"SILVA (only NR);Eukaryota;SAR;Alveolata;Ciliophora;Intramacronucleata;Conthreep;Oligohymenophorea;Apostomatia;Platynematum;";"0.0";"0";"1";"1";"0";"1";"0";"430523";"5766"
"LOK1378_1mm";"SILVA (only NR);Eukaryota;SAR;Alveolata;Ciliophora;Intramacronucleata;Conthreep;Oligohymenophorea;Apostomatia;Pseudocollinia;";"0.0";"0";"3";"3";"0";"3";"0";"430521";"5766"
"LOK1378_1mm";"SILVA (only NR);Eukaryota;SAR;Alveolata;Ciliophora;Intramacronucleata;Conthreep;Oligohymenophorea;Apostomatia;Vampyrophrya;";"0.0";"0";"1";"1";"0";"1";"0";"430523";"5766"
"LOK1378_1mm";"SILVA (only NR);Eukaryota;SAR;Alveolata;Ciliophora;Intramacronucleata;Conthreep;Oligohymenophorea;Apostomatia;uncultured;";"0.0";"0";"7";"7";"0";"7";"0";"430517";"5766"
"LOK1378_1mm";"SILVA (only NR);Eukaryota;SAR;Alveolata;Ciliophora;Intramacronucleata;Conthreep;Oligohymenophorea;Astomatia;";"0.0";"0";"6";"6";"0";"6";"0";"430518";"5766"
"LOK1378_1mm";"SILVA (only NR);Eukaryota;SAR;Alveolata;Ciliophora;Intramacronucleata;Conthreep;Oligohymenophorea;Astomatia;Anoplophrya;";"0.0";"0";"1";"1";"0";"1";"0";"430523";"5766"
"LOK1378_1mm";"SILVA (only NR);Eukaryota;SAR;Alveolata;Ciliophora;Intramacronucleata;Conthreep;Oligohymenophorea;Astomatia;Metaracoelophrya;";"0.0";"0";"2";"2";"0";"2";"0";"430522";"5766"
"LOK1378_1mm";"SILVA (only NR);Eukaryota;SAR;Alveolata;Ciliophora;Intramacronucleata;Conthreep;Oligohymenophorea;Astomatia;Metaradiophrya;";"0.0";"0";"1";"1";"0";"1";"0";"430523";"5766"
"LOK1378_1mm";"SILVA (only NR);Eukaryota;SAR;Alveolata;Ciliophora;Intramacronucleata;Conthreep;Oligohymenophorea;Astomatia;Njinella;";"0.0";"0";"1";"1";"0";"1";"0";"430523";"5766"
"LOK1378_1mm";"SILVA (only NR);Eukaryota;SAR;Alveolata;Ciliophora;Intramacronucleata;Conthreep;Oligohymenophorea;Astomatia;Paraclausilocola;";"0.0";"0";"1";"1";"0";"1";"0";"430523";"5766"
"LOK1378_1mm";"SILVA (only NR);Eukaryota;SAR;Alveolata;Ciliophora;Intramacronucleata;Conthreep;Oligohymenophorea;CV1-2A-17;";"0.0";"0";"6";"6";"0";"6";"0";"430518";"5766"
"LOK1378_1mm";"SILVA (only NR);Eukaryota;SAR;Alveolata;Ciliophora;Intramacronucleata;Conthreep;Oligohymenophorea;Hymenostomatia;";"0.0";"0";"31";"30";"0";"30";"1";"430494";"5766"
"LOK1378_1mm";"SILVA (only NR);Eukaryota;SAR;Alveolata;Ciliophora;Intramacronucleata;Conthreep;Oligohymenophorea;Hymenostomatia;Agolohymena;";"0.0";"0";"1";"1";"0";"1";"0";"430523";"5766"
"LOK1378_1mm";"SILVA (only NR);Eukaryota;SAR;Alveolata;Ciliophora;Intramacronucleata;Conthreep;Oligohymenophorea;Hymenostomatia;Bromeliophrya;";"0.0";"0";"4";"4";"0";"4";"0";"430520";"5766"
"LOK1378_1mm";"SILVA (only NR);Eukaryota;SAR;Alveolata;Ciliophora;Intramacronucleata;Conthreep;Oligohymenophorea;Hymenostomatia;Colpidium;";"0.0";"0";"1";"1";"0";"1";"0";"430523";"5766"
"LOK1378_1mm";"SILVA (only NR);Eukaryota;SAR;Alveolata;Ciliophora;Intramacronucleata;Conthreep;Oligohymenophorea;Hymenostomatia;Glaucoma;";"0.0";"0";"2";"2";"0";"2";"0";"430522";"5766"
"LOK1378_1mm";"SILVA (only NR);Eukaryota;SAR;Alveolata;Ciliophora;Intramacronucleata;Conthreep;Oligohymenophorea;Hymenostomatia;Ichthyophthirius;";"0.0";"0";"1";"1";"0";"1";"0";"430523";"5766"
"LOK1378_1mm";"SILVA (only NR);Eukaryota;SAR;Alveolata;Ciliophora;Intramacronucleata;Conthreep;Oligohymenophorea;Hymenostomatia;Ophryoglena;";"0.0";"0";"1";"1";"0";"1";"0";"430523";"5766"
"LOK1378_1mm";"SILVA (only NR);Eukaryota;SAR;Alveolata;Ciliophora;Intramacronucleata;Conthreep;Oligohymenophorea;Hymenostomatia;Tetrahymena;";"0.0";"0";"13";"12";"0";"12";"1";"430512";"5766"
"LOK1378_1mm";"SILVA (only NR);Eukaryota;SAR;Alveolata;Ciliophora;Intramacronucleata;Conthreep;Oligohymenophorea;Hymenostomatia;uncultured;";"0.0";"0";"2";"2";"0";"2";"0";"430522";"5766"
"LOK1378_1mm";"SILVA (only NR);Eukaryota;SAR;Alveolata;Ciliophora;Intramacronucleata;Conthreep;Oligohymenophorea;Peniculia;";"0.0";"0";"79";"76";"0";"76";"3";"430448";"5766"
"LOK1378_1mm";"SILVA (only NR);Eukaryota;SAR;Alveolata;Ciliophora;Intramacronucleata;Conthreep;Oligohymenophorea;Peniculia;Frontonia;";"0.0";"0";"25";"25";"0";"25";"0";"430499";"5766"
"LOK1378_1mm";"SILVA (only NR);Eukaryota;SAR;Alveolata;Ciliophora;Intramacronucleata;Conthreep;Oligohymenophorea;Peniculia;Lembadion;";"0.0";"0";"1";"1";"0";"1";"0";"430523";"5766"
"LOK1378_1mm";"SILVA (only NR);Eukaryota;SAR;Alveolata;Ciliophora;Intramacronucleata;Conthreep;Oligohymenophorea;Peniculia;Paramecium;";"0.0";"0";"29";"28";"0";"28";"1";"430496";"5766"
"LOK1378_1mm";"SILVA (only NR);Eukaryota;SAR;Alveolata;Ciliophora;Intramacronucleata;Conthreep;Oligohymenophorea;Peniculia;Stokesia;";"0.0";"0";"16";"15";"0";"15";"1";"430509";"5766"
"LOK1378_1mm";"SILVA (only NR);Eukaryota;SAR;Alveolata;Ciliophora;Intramacronucleata;Conthreep;Oligohymenophorea;Peniculia;uncultured;";"0.0";"0";"2";"1";"0";"1";"1";"430523";"5766"
"LOK1378_1mm";"SILVA (only NR);Eukaryota;SAR;Alveolata;Ciliophora;Intramacronucleata;Conthreep;Oligohymenophorea;Peritrichia;";"0.0";"0";"235";"229";"0";"229";"6";"430295";"5766"
"LOK1378_1mm";"SILVA (only NR);Eukaryota;SAR;Alveolata;Ciliophora;Intramacronucleata;Conthreep;Oligohymenophorea;Peritrichia;Apocarchesium;";"0.0";"0";"2";"2";"0";"2";"0";"430522";"5766"
"LOK1378_1mm";"SILVA (only NR);Eukaryota;SAR;Alveolata;Ciliophora;Intramacronucleata;Conthreep;Oligohymenophorea;Peritrichia;Astylozoon;";"0.0";"0";"1";"1";"0";"1";"0";"430523";"5766"
"LOK1378_1mm";"SILVA (only NR);Eukaryota;SAR;Alveolata;Ciliophora;Intramacronucleata;Conthreep;Oligohymenophorea;Peritrichia;Carchesium;";"0.0";"0";"2";"2";"0";"2";"0";"430522";"5766"
"LOK1378_1mm";"SILVA (only NR);Eukaryota;SAR;Alveolata;Ciliophora;Intramacronucleata;Conthreep;Oligohymenophorea;Peritrichia;Cothurnia;";"0.0";"0";"4";"4";"0";"4";"0";"430520";"5766"
"LOK1378_1mm";"SILVA (only NR);Eukaryota;SAR;Alveolata;Ciliophora;Intramacronucleata;Conthreep;Oligohymenophorea;Peritrichia;Epicarchesium;";"0.0";"0";"6";"6";"0";"6";"0";"430518";"5766"
"LOK1378_1mm";"SILVA (only NR);Eukaryota;SAR;Alveolata;Ciliophora;Intramacronucleata;Conthreep;Oligohymenophorea;Peritrichia;Epistylis;";"0.0";"0";"12";"11";"0";"11";"1";"430513";"5766"
"LOK1378_1mm";"SILVA (only NR);Eukaryota;SAR;Alveolata;Ciliophora;Intramacronucleata;Conthreep;Oligohymenophorea;Peritrichia;Opercularia;";"0.0";"0";"1";"1";"0";"1";"0";"430523";"5766"
"LOK1378_1mm";"SILVA (only NR);Eukaryota;SAR;Alveolata;Ciliophora;Intramacronucleata;Conthreep;Oligohymenophorea;Peritrichia;Ophrydium;";"0.0";"0";"1";"1";"0";"1";"0";"430523";"5766"
"LOK1378_1mm";"SILVA (only NR);Eukaryota;SAR;Alveolata;Ciliophora;Intramacronucleata;Conthreep;Oligohymenophorea;Peritrichia;Opisthonecta;";"0.0";"0";"3";"3";"0";"3";"0";"430521";"5766"
"LOK1378_1mm";"SILVA (only NR);Eukaryota;SAR;Alveolata;Ciliophora;Intramacronucleata;Conthreep;Oligohymenophorea;Peritrichia;Pseudepistylis;";"0.0";"0";"1";"1";"0";"1";"0";"430523";"5766"
"LOK1378_1mm";"SILVA (only NR);Eukaryota;SAR;Alveolata;Ciliophora;Intramacronucleata;Conthreep;Oligohymenophorea;Peritrichia;Pseudovorticella;";"0.0";"0";"19";"19";"0";"19";"0";"430505";"5766"
"LOK1378_1mm";"SILVA (only NR);Eukaryota;SAR;Alveolata;Ciliophora;Intramacronucleata;Conthreep;Oligohymenophorea;Peritrichia;Telotrochidium;";"0.0";"0";"25";"25";"0";"25";"0";"430499";"5766"
"LOK1378_1mm";"SILVA (only NR);Eukaryota;SAR;Alveolata;Ciliophora;Intramacronucleata;Conthreep;Oligohymenophorea;Peritrichia;Trichodina;";"0.0";"0";"22";"20";"0";"20";"2";"430504";"5766"
"LOK1378_1mm";"SILVA (only NR);Eukaryota;SAR;Alveolata;Ciliophora;Intramacronucleata;Conthreep;Oligohymenophorea;Peritrichia;Trichodinella;";"0.0";"0";"4";"4";"0";"4";"0";"430520";"5766"
"LOK1378_1mm";"SILVA (only NR);Eukaryota;SAR;Alveolata;Ciliophora;Intramacronucleata;Conthreep;Oligohymenophorea;Peritrichia;Urceolaria;";"0.0";"0";"5";"5";"0";"5";"0";"430519";"5766"
"LOK1378_1mm";"SILVA (only NR);Eukaryota;SAR;Alveolata;Ciliophora;Intramacronucleata;Conthreep;Oligohymenophorea;Peritrichia;Vaginicola;";"0.0";"0";"4";"4";"0";"4";"0";"430520";"5766"
"LOK1378_1mm";"SILVA (only NR);Eukaryota;SAR;Alveolata;Ciliophora;Intramacronucleata;Conthreep;Oligohymenophorea;Peritrichia;Vorticella;";"0.0";"0";"19";"19";"0";"19";"0";"430505";"5766"
"LOK1378_1mm";"SILVA (only NR);Eukaryota;SAR;Alveolata;Ciliophora;Intramacronucleata;Conthreep;Oligohymenophorea;Peritrichia;Zoothamnium;";"0.0";"0";"40";"39";"0";"39";"1";"430485";"5766"
"LOK1378_1mm";"SILVA (only NR);Eukaryota;SAR;Alveolata;Ciliophora;Intramacronucleata;Conthreep;Oligohymenophorea;Peritrichia;Zoothamnopsis;";"0.0";"0";"4";"4";"0";"4";"0";"430520";"5766"
"LOK1378_1mm";"SILVA (only NR);Eukaryota;SAR;Alveolata;Ciliophora;Intramacronucleata;Conthreep;Oligohymenophorea;Peritrichia;uncultured;";"0.0";"0";"17";"17";"0";"17";"0";"430507";"5766"
"LOK1378_1mm";"SILVA (only NR);Eukaryota;SAR;Alveolata;Ciliophora;Intramacronucleata;Conthreep;Oligohymenophorea;Scuticociliatia;";"0.0";"0";"190";"172";"0";"172";"18";"430352";"5766"
"LOK1378_1mm";"SILVA (only NR);Eukaryota;SAR;Alveolata;Ciliophora;Intramacronucleata;Conthreep;Oligohymenophorea;Scuticociliatia;Ancistrum;";"0.0";"0";"2";"2";"0";"2";"0";"430522";"5766"
"LOK1378_1mm";"SILVA (only NR);Eukaryota;SAR;Alveolata;Ciliophora;Intramacronucleata;Conthreep;Oligohymenophorea;Scuticociliatia;Anophryoides;";"0.0";"0";"1";"1";"0";"1";"0";"430523";"5766"
"LOK1378_1mm";"SILVA (only NR);Eukaryota;SAR;Alveolata;Ciliophora;Intramacronucleata;Conthreep;Oligohymenophorea;Scuticociliatia;Boveria;";"0.0";"0";"2";"2";"0";"2";"0";"430522";"5766"
"LOK1378_1mm";"SILVA (only NR);Eukaryota;SAR;Alveolata;Ciliophora;Intramacronucleata;Conthreep;Oligohymenophorea;Scuticociliatia;Cardiostomatella;";"0.0";"0";"5";"5";"0";"5";"0";"430519";"5766"
"LOK1378_1mm";"SILVA (only NR);Eukaryota;SAR;Alveolata;Ciliophora;Intramacronucleata;Conthreep;Oligohymenophorea;Scuticociliatia;Cohnilembus;";"0.0";"0";"1";"1";"0";"1";"0";"430523";"5766"
"LOK1378_1mm";"SILVA (only NR);Eukaryota;SAR;Alveolata;Ciliophora;Intramacronucleata;Conthreep;Oligohymenophorea;Scuticociliatia;Cristigera;";"0.0";"0";"4";"4";"0";"4";"0";"430520";"5766"
"LOK1378_1mm";"SILVA (only NR);Eukaryota;SAR;Alveolata;Ciliophora;Intramacronucleata;Conthreep;Oligohymenophorea;Scuticociliatia;Cyclidium;";"0.0";"0";"12";"11";"0";"11";"1";"430513";"5766"
"LOK1378_1mm";"SILVA (only NR);Eukaryota;SAR;Alveolata;Ciliophora;Intramacronucleata;Conthreep;Oligohymenophorea;Scuticociliatia;Dexiotricha;";"0.0";"0";"3";"3";"0";"3";"0";"430521";"5766"
"LOK1378_1mm";"SILVA (only NR);Eukaryota;SAR;Alveolata;Ciliophora;Intramacronucleata;Conthreep;Oligohymenophorea;Scuticociliatia;Dexitrichides;";"0.0";"0";"1";"1";"0";"1";"0";"430523";"5766"
"LOK1378_1mm";"SILVA (only NR);Eukaryota;SAR;Alveolata;Ciliophora;Intramacronucleata;Conthreep;Oligohymenophorea;Scuticociliatia;Entodiscus;";"0.0";"0";"1";"1";"0";"1";"0";"430523";"5766"
"LOK1378_1mm";"SILVA (only NR);Eukaryota;SAR;Alveolata;Ciliophora;Intramacronucleata;Conthreep;Oligohymenophorea;Scuticociliatia;Entorhipidium;";"0.0";"0";"1";"1";"0";"1";"0";"430523";"5766"
"LOK1378_1mm";"SILVA (only NR);Eukaryota;SAR;Alveolata;Ciliophora;Intramacronucleata;Conthreep;Oligohymenophorea;Scuticociliatia;Eurystomatella;";"0.0";"0";"1";"1";"0";"1";"0";"430523";"5766"
"LOK1378_1mm";"SILVA (only NR);Eukaryota;SAR;Alveolata;Ciliophora;Intramacronucleata;Conthreep;Oligohymenophorea;Scuticociliatia;Falcicyclidium;";"0.0";"0";"2";"2";"0";"2";"0";"430522";"5766"
"LOK1378_1mm";"SILVA (only NR);Eukaryota;SAR;Alveolata;Ciliophora;Intramacronucleata;Conthreep;Oligohymenophorea;Scuticociliatia;Hippocomos;";"0.0";"0";"1";"1";"0";"1";"0";"430523";"5766"
"LOK1378_1mm";"SILVA (only NR);Eukaryota;SAR;Alveolata;Ciliophora;Intramacronucleata;Conthreep;Oligohymenophorea;Scuticociliatia;Histiobalantium;";"0.0";"0";"3";"3";"0";"3";"0";"430521";"5766"
"LOK1378_1mm";"SILVA (only NR);Eukaryota;SAR;Alveolata;Ciliophora;Intramacronucleata;Conthreep;Oligohymenophorea;Scuticociliatia;Homalogastra;";"0.0";"0";"13";"12";"0";"12";"1";"430512";"5766"
"LOK1378_1mm";"SILVA (only NR);Eukaryota;SAR;Alveolata;Ciliophora;Intramacronucleata;Conthreep;Oligohymenophorea;Scuticociliatia;Mesanophrys;";"0.0";"0";"2";"2";"0";"2";"0";"430522";"5766"
"LOK1378_1mm";"SILVA (only NR);Eukaryota;SAR;Alveolata;Ciliophora;Intramacronucleata;Conthreep;Oligohymenophorea;Scuticociliatia;Metanophrys;";"0.0";"0";"3";"3";"0";"3";"0";"430521";"5766"
"LOK1378_1mm";"SILVA (only NR);Eukaryota;SAR;Alveolata;Ciliophora;Intramacronucleata;Conthreep;Oligohymenophorea;Scuticociliatia;Miamiensis;";"0.0";"0";"3";"3";"0";"3";"0";"430521";"5766"
"LOK1378_1mm";"SILVA (only NR);Eukaryota;SAR;Alveolata;Ciliophora;Intramacronucleata;Conthreep;Oligohymenophorea;Scuticociliatia;Paranophrys;";"0.0";"0";"2";"2";"0";"2";"0";"430522";"5766"
"LOK1378_1mm";"SILVA (only NR);Eukaryota;SAR;Alveolata;Ciliophora;Intramacronucleata;Conthreep;Oligohymenophorea;Scuticociliatia;Paratetrahymena;";"0.0";"0";"2";"2";"0";"2";"0";"430522";"5766"
"LOK1378_1mm";"SILVA (only NR);Eukaryota;SAR;Alveolata;Ciliophora;Intramacronucleata;Conthreep;Oligohymenophorea;Scuticociliatia;Parauronema;";"0.0";"0";"2";"2";"0";"2";"0";"430522";"5766"
"LOK1378_1mm";"SILVA (only NR);Eukaryota;SAR;Alveolata;Ciliophora;Intramacronucleata;Conthreep;Oligohymenophorea;Scuticociliatia;Philaster;";"0.0";"0";"4";"4";"0";"4";"0";"430520";"5766"
"LOK1378_1mm";"SILVA (only NR);Eukaryota;SAR;Alveolata;Ciliophora;Intramacronucleata;Conthreep;Oligohymenophorea;Scuticociliatia;Philasterides;";"0.0";"0";"1";"1";"0";"1";"0";"430523";"5766"
"LOK1378_1mm";"SILVA (only NR);Eukaryota;SAR;Alveolata;Ciliophora;Intramacronucleata;Conthreep;Oligohymenophorea;Scuticociliatia;Pleuronema;";"0.0";"0";"26";"23";"0";"23";"3";"430501";"5766"
"LOK1378_1mm";"SILVA (only NR);Eukaryota;SAR;Alveolata;Ciliophora;Intramacronucleata;Conthreep;Oligohymenophorea;Scuticociliatia;Porpostoma;";"0.0";"0";"1";"1";"0";"1";"0";"430523";"5766"
"LOK1378_1mm";"SILVA (only NR);Eukaryota;SAR;Alveolata;Ciliophora;Intramacronucleata;Conthreep;Oligohymenophorea;Scuticociliatia;Protocyclidium;";"0.0";"0";"7";"4";"0";"4";"3";"430520";"5766"
"LOK1378_1mm";"SILVA (only NR);Eukaryota;SAR;Alveolata;Ciliophora;Intramacronucleata;Conthreep;Oligohymenophorea;Scuticociliatia;Pseudocohnilembus;";"0.0";"0";"6";"6";"0";"6";"0";"430518";"5766"
"LOK1378_1mm";"SILVA (only NR);Eukaryota;SAR;Alveolata;Ciliophora;Intramacronucleata;Conthreep;Oligohymenophorea;Scuticociliatia;Pseudoplatynematum;";"0.0";"0";"1";"1";"0";"1";"0";"430523";"5766"
"LOK1378_1mm";"SILVA (only NR);Eukaryota;SAR;Alveolata;Ciliophora;Intramacronucleata;Conthreep;Oligohymenophorea;Scuticociliatia;Sathrophilus;";"0.0";"0";"2";"2";"0";"2";"0";"430522";"5766"
"LOK1378_1mm";"SILVA (only NR);Eukaryota;SAR;Alveolata;Ciliophora;Intramacronucleata;Conthreep;Oligohymenophorea;Scuticociliatia;Schizocalyptra;";"0.0";"0";"3";"3";"0";"3";"0";"430521";"5766"
"LOK1378_1mm";"SILVA (only NR);Eukaryota;SAR;Alveolata;Ciliophora;Intramacronucleata;Conthreep;Oligohymenophorea;Scuticociliatia;Schizocaryum;";"0.0";"0";"1";"1";"0";"1";"0";"430523";"5766"
"LOK1378_1mm";"SILVA (only NR);Eukaryota;SAR;Alveolata;Ciliophora;Intramacronucleata;Conthreep;Oligohymenophorea;Scuticociliatia;Thyrophylax;";"0.0";"0";"1";"1";"0";"1";"0";"430523";"5766"
"LOK1378_1mm";"SILVA (only NR);Eukaryota;SAR;Alveolata;Ciliophora;Intramacronucleata;Conthreep;Oligohymenophorea;Scuticociliatia;Uronema;";"0.0";"0";"4";"4";"0";"4";"0";"430520";"5766"
"LOK1378_1mm";"SILVA (only NR);Eukaryota;SAR;Alveolata;Ciliophora;Intramacronucleata;Conthreep;Oligohymenophorea;Scuticociliatia;Uronemella;";"0.0";"0";"2";"2";"0";"2";"0";"430522";"5766"
"LOK1378_1mm";"SILVA (only NR);Eukaryota;SAR;Alveolata;Ciliophora;Intramacronucleata;Conthreep;Oligohymenophorea;Scuticociliatia;Wilbertia;";"0.0";"0";"1";"1";"0";"1";"0";"430523";"5766"
"LOK1378_1mm";"SILVA (only NR);Eukaryota;SAR;Alveolata;Ciliophora;Intramacronucleata;Conthreep;Oligohymenophorea;Scuticociliatia;uncultured;";"0.0";"0";"44";"36";"0";"36";"8";"430488";"5766"
"LOK1378_1mm";"SILVA (only NR);Eukaryota;SAR;Alveolata;Ciliophora;Intramacronucleata;Conthreep;Oligohymenophorea;uncultured;";"0.0";"0";"2";"2";"0";"2";"0";"430522";"5766"
"LOK1378_1mm";"SILVA (only NR);Eukaryota;SAR;Alveolata;Ciliophora;Intramacronucleata;Conthreep;Phyllopharyngea;";"0.0";"0";"144";"141";"0";"141";"3";"430383";"5766"
"LOK1378_1mm";"SILVA (only NR);Eukaryota;SAR;Alveolata;Ciliophora;Intramacronucleata;Conthreep;Phyllopharyngea;Cyrtophoria;";"0.0";"0";"99";"98";"0";"98";"1";"430426";"5766"
"LOK1378_1mm";"SILVA (only NR);Eukaryota;SAR;Alveolata;Ciliophora;Intramacronucleata;Conthreep;Phyllopharyngea;Cyrtophoria;Aegyriana;";"0.0";"0";"2";"2";"0";"2";"0";"430522";"5766"
"LOK1378_1mm";"SILVA (only NR);Eukaryota;SAR;Alveolata;Ciliophora;Intramacronucleata;Conthreep;Phyllopharyngea;Cyrtophoria;Agnathodysteria;";"0.0";"0";"1";"1";"0";"1";"0";"430523";"5766"
"LOK1378_1mm";"SILVA (only NR);Eukaryota;SAR;Alveolata;Ciliophora;Intramacronucleata;Conthreep;Phyllopharyngea;Cyrtophoria;Brooklynella;";"0.0";"0";"1";"1";"0";"1";"0";"430523";"5766"
"LOK1378_1mm";"SILVA (only NR);Eukaryota;SAR;Alveolata;Ciliophora;Intramacronucleata;Conthreep;Phyllopharyngea;Cyrtophoria;Chilodochona;";"0.0";"0";"3";"3";"0";"3";"0";"430521";"5766"
"LOK1378_1mm";"SILVA (only NR);Eukaryota;SAR;Alveolata;Ciliophora;Intramacronucleata;Conthreep;Phyllopharyngea;Cyrtophoria;Chilodonella;";"0.0";"0";"5";"5";"0";"5";"0";"430519";"5766"
"LOK1378_1mm";"SILVA (only NR);Eukaryota;SAR;Alveolata;Ciliophora;Intramacronucleata;Conthreep;Phyllopharyngea;Cyrtophoria;Chlamydodon;";"0.0";"0";"9";"9";"0";"9";"0";"430515";"5766"
"LOK1378_1mm";"SILVA (only NR);Eukaryota;SAR;Alveolata;Ciliophora;Intramacronucleata;Conthreep;Phyllopharyngea;Cyrtophoria;Chlamydonella;";"0.0";"0";"2";"2";"0";"2";"0";"430522";"5766"
"LOK1378_1mm";"SILVA (only NR);Eukaryota;SAR;Alveolata;Ciliophora;Intramacronucleata;Conthreep;Phyllopharyngea;Cyrtophoria;Chlamydonellopsis;";"0.0";"0";"2";"2";"0";"2";"0";"430522";"5766"
"LOK1378_1mm";"SILVA (only NR);Eukaryota;SAR;Alveolata;Ciliophora;Intramacronucleata;Conthreep;Phyllopharyngea;Cyrtophoria;Coeloperix;";"0.0";"0";"4";"4";"0";"4";"0";"430520";"5766"
"LOK1378_1mm";"SILVA (only NR);Eukaryota;SAR;Alveolata;Ciliophora;Intramacronucleata;Conthreep;Phyllopharyngea;Cyrtophoria;Dysteria;";"0.0";"0";"17";"17";"0";"17";"0";"430507";"5766"
"LOK1378_1mm";"SILVA (only NR);Eukaryota;SAR;Alveolata;Ciliophora;Intramacronucleata;Conthreep;Phyllopharyngea;Cyrtophoria;Hartmannula;";"0.0";"0";"2";"2";"0";"2";"0";"430522";"5766"
"LOK1378_1mm";"SILVA (only NR);Eukaryota;SAR;Alveolata;Ciliophora;Intramacronucleata;Conthreep;Phyllopharyngea;Cyrtophoria;Heterohartmannula;";"0.0";"0";"1";"1";"0";"1";"0";"430523";"5766"
"LOK1378_1mm";"SILVA (only NR);Eukaryota;SAR;Alveolata;Ciliophora;Intramacronucleata;Conthreep;Phyllopharyngea;Cyrtophoria;Microxysma;";"0.0";"0";"1";"1";"0";"1";"0";"430523";"5766"
"LOK1378_1mm";"SILVA (only NR);Eukaryota;SAR;Alveolata;Ciliophora;Intramacronucleata;Conthreep;Phyllopharyngea;Cyrtophoria;Odontochlamys;";"0.0";"0";"1";"1";"0";"1";"0";"430523";"5766"
"LOK1378_1mm";"SILVA (only NR);Eukaryota;SAR;Alveolata;Ciliophora;Intramacronucleata;Conthreep;Phyllopharyngea;Cyrtophoria;Paracyrtophoron;";"0.0";"0";"1";"1";"0";"1";"0";"430523";"5766"
"LOK1378_1mm";"SILVA (only NR);Eukaryota;SAR;Alveolata;Ciliophora;Intramacronucleata;Conthreep;Phyllopharyngea;Cyrtophoria;Phascolodon;";"0.0";"0";"7";"6";"0";"6";"1";"430518";"5766"
"LOK1378_1mm";"SILVA (only NR);Eukaryota;SAR;Alveolata;Ciliophora;Intramacronucleata;Conthreep;Phyllopharyngea;Cyrtophoria;Pithites;";"0.0";"0";"12";"12";"0";"12";"0";"430512";"5766"
"LOK1378_1mm";"SILVA (only NR);Eukaryota;SAR;Alveolata;Ciliophora;Intramacronucleata;Conthreep;Phyllopharyngea;Cyrtophoria;Pseudochilodonopsis;";"0.0";"0";"5";"5";"0";"5";"0";"430519";"5766"
"LOK1378_1mm";"SILVA (only NR);Eukaryota;SAR;Alveolata;Ciliophora;Intramacronucleata;Conthreep;Phyllopharyngea;Cyrtophoria;Trichopodiella;";"0.0";"0";"1";"1";"0";"1";"0";"430523";"5766"
"LOK1378_1mm";"SILVA (only NR);Eukaryota;SAR;Alveolata;Ciliophora;Intramacronucleata;Conthreep;Phyllopharyngea;Cyrtophoria;Trithigmostoma;";"0.0";"0";"1";"1";"0";"1";"0";"430523";"5766"
"LOK1378_1mm";"SILVA (only NR);Eukaryota;SAR;Alveolata;Ciliophora;Intramacronucleata;Conthreep;Phyllopharyngea;Cyrtophoria;Trochilia;";"0.0";"0";"1";"1";"0";"1";"0";"430523";"5766"
"LOK1378_1mm";"SILVA (only NR);Eukaryota;SAR;Alveolata;Ciliophora;Intramacronucleata;Conthreep;Phyllopharyngea;Cyrtophoria;Trochilioides;";"0.0";"0";"1";"1";"0";"1";"0";"430523";"5766"
"LOK1378_1mm";"SILVA (only NR);Eukaryota;SAR;Alveolata;Ciliophora;Intramacronucleata;Conthreep;Phyllopharyngea;Cyrtophoria;Trochochilodon;";"0.0";"0";"1";"1";"0";"1";"0";"430523";"5766"
"LOK1378_1mm";"SILVA (only NR);Eukaryota;SAR;Alveolata;Ciliophora;Intramacronucleata;Conthreep;Phyllopharyngea;Hypocomatida;";"0.0";"0";"1";"1";"0";"1";"0";"430523";"5766"
"LOK1378_1mm";"SILVA (only NR);Eukaryota;SAR;Alveolata;Ciliophora;Intramacronucleata;Conthreep;Phyllopharyngea;Hypocomatida;Hypocoma;";"0.0";"0";"1";"1";"0";"1";"0";"430523";"5766"
"LOK1378_1mm";"SILVA (only NR);Eukaryota;SAR;Alveolata;Ciliophora;Intramacronucleata;Conthreep;Phyllopharyngea;Suctoria;";"0.0";"0";"43";"41";"0";"41";"2";"430483";"5766"
"LOK1378_1mm";"SILVA (only NR);Eukaryota;SAR;Alveolata;Ciliophora;Intramacronucleata;Conthreep;Phyllopharyngea;Suctoria;Acineta;";"0.0";"0";"7";"7";"0";"7";"0";"430517";"5766"
"LOK1378_1mm";"SILVA (only NR);Eukaryota;SAR;Alveolata;Ciliophora;Intramacronucleata;Conthreep;Phyllopharyngea;Suctoria;BOLA439;";"0.0";"0";"4";"4";"0";"4";"0";"430520";"5766"
"LOK1378_1mm";"SILVA (only NR);Eukaryota;SAR;Alveolata;Ciliophora;Intramacronucleata;Conthreep;Phyllopharyngea;Suctoria;Discophrya;";"0.0";"0";"1";"1";"0";"1";"0";"430523";"5766"
"LOK1378_1mm";"SILVA (only NR);Eukaryota;SAR;Alveolata;Ciliophora;Intramacronucleata;Conthreep;Phyllopharyngea;Suctoria;Ephelota;";"0.0";"0";"8";"7";"0";"7";"1";"430517";"5766"
"LOK1378_1mm";"SILVA (only NR);Eukaryota;SAR;Alveolata;Ciliophora;Intramacronucleata;Conthreep;Phyllopharyngea;Suctoria;Heliophrya;";"0.0";"0";"3";"3";"0";"3";"0";"430521";"5766"
"LOK1378_1mm";"SILVA (only NR);Eukaryota;SAR;Alveolata;Ciliophora;Intramacronucleata;Conthreep;Phyllopharyngea;Suctoria;Paracineta;";"0.0";"0";"5";"5";"0";"5";"0";"430519";"5766"
"LOK1378_1mm";"SILVA (only NR);Eukaryota;SAR;Alveolata;Ciliophora;Intramacronucleata;Conthreep;Phyllopharyngea;Suctoria;Tokophrya;";"0.0";"0";"8";"8";"0";"8";"0";"430516";"5766"
"LOK1378_1mm";"SILVA (only NR);Eukaryota;SAR;Alveolata;Ciliophora;Intramacronucleata;Conthreep;Plagiopylea;";"0.0";"0";"47";"43";"0";"43";"4";"430481";"5766"
"LOK1378_1mm";"SILVA (only NR);Eukaryota;SAR;Alveolata;Ciliophora;Intramacronucleata;Conthreep;Plagiopylea;Odontostomatida;";"0.0";"0";"12";"10";"0";"10";"2";"430514";"5766"
"LOK1378_1mm";"SILVA (only NR);Eukaryota;SAR;Alveolata;Ciliophora;Intramacronucleata;Conthreep;Plagiopylea;Odontostomatida;Epalxella;";"0.0";"0";"12";"10";"0";"10";"2";"430514";"5766"
"LOK1378_1mm";"SILVA (only NR);Eukaryota;SAR;Alveolata;Ciliophora;Intramacronucleata;Conthreep;Plagiopylea;Plagiopylida;";"0.0";"0";"34";"33";"0";"33";"1";"430491";"5766"
"LOK1378_1mm";"SILVA (only NR);Eukaryota;SAR;Alveolata;Ciliophora;Intramacronucleata;Conthreep;Plagiopylea;Plagiopylida;FV36-2C12;";"0.0";"0";"3";"3";"0";"3";"0";"430521";"5766"
"LOK1378_1mm";"SILVA (only NR);Eukaryota;SAR;Alveolata;Ciliophora;Intramacronucleata;Conthreep;Plagiopylea;Plagiopylida;Lechriopyla;";"0.0";"0";"6";"6";"0";"6";"0";"430518";"5766"
"LOK1378_1mm";"SILVA (only NR);Eukaryota;SAR;Alveolata;Ciliophora;Intramacronucleata;Conthreep;Plagiopylea;Plagiopylida;Parasonderia;";"0.0";"0";"3";"3";"0";"3";"0";"430521";"5766"
"LOK1378_1mm";"SILVA (only NR);Eukaryota;SAR;Alveolata;Ciliophora;Intramacronucleata;Conthreep;Plagiopylea;Plagiopylida;Plagiopyla;";"0.0";"0";"4";"4";"0";"4";"0";"430520";"5766"
"LOK1378_1mm";"SILVA (only NR);Eukaryota;SAR;Alveolata;Ciliophora;Intramacronucleata;Conthreep;Plagiopylea;Plagiopylida;RM1-SG02;";"0.0";"0";"2";"2";"0";"2";"0";"430522";"5766"
"LOK1378_1mm";"SILVA (only NR);Eukaryota;SAR;Alveolata;Ciliophora;Intramacronucleata;Conthreep;Plagiopylea;Plagiopylida;Trimyema;";"0.0";"0";"13";"12";"0";"12";"1";"430512";"5766"
"LOK1378_1mm";"SILVA (only NR);Eukaryota;SAR;Alveolata;Ciliophora;Intramacronucleata;Conthreep;Prostomatea;";"0.0";"0";"99";"96";"0";"96";"3";"430428";"5766"
"LOK1378_1mm";"SILVA (only NR);Eukaryota;SAR;Alveolata;Ciliophora;Intramacronucleata;Conthreep;Prostomatea;Coleps;";"0.0";"0";"6";"6";"0";"6";"0";"430518";"5766"
"LOK1378_1mm";"SILVA (only NR);Eukaryota;SAR;Alveolata;Ciliophora;Intramacronucleata;Conthreep;Prostomatea;Cryptocaryon;";"0.0";"0";"68";"65";"0";"65";"3";"430459";"5766"
"LOK1378_1mm";"SILVA (only NR);Eukaryota;SAR;Alveolata;Ciliophora;Intramacronucleata;Conthreep;Prostomatea;Levicoleps;";"0.0";"0";"2";"2";"0";"2";"0";"430522";"5766"
"LOK1378_1mm";"SILVA (only NR);Eukaryota;SAR;Alveolata;Ciliophora;Intramacronucleata;Conthreep;Prostomatea;Nolandia;";"0.0";"0";"2";"2";"0";"2";"0";"430522";"5766"
"LOK1378_1mm";"SILVA (only NR);Eukaryota;SAR;Alveolata;Ciliophora;Intramacronucleata;Conthreep;Prostomatea;Pinacocoleps;";"0.0";"0";"1";"1";"0";"1";"0";"430523";"5766"
"LOK1378_1mm";"SILVA (only NR);Eukaryota;SAR;Alveolata;Ciliophora;Intramacronucleata;Conthreep;Prostomatea;Placus;";"0.0";"0";"3";"3";"0";"3";"0";"430521";"5766"
"LOK1378_1mm";"SILVA (only NR);Eukaryota;SAR;Alveolata;Ciliophora;Intramacronucleata;Conthreep;Prostomatea;Plagiopogon;";"0.0";"0";"1";"1";"0";"1";"0";"430523";"5766"
"LOK1378_1mm";"SILVA (only NR);Eukaryota;SAR;Alveolata;Ciliophora;Intramacronucleata;Conthreep;Prostomatea;Prorodon;";"0.0";"0";"10";"10";"0";"10";"0";"430514";"5766"
"LOK1378_1mm";"SILVA (only NR);Eukaryota;SAR;Alveolata;Ciliophora;Intramacronucleata;Conthreep;Prostomatea;Spathidiopsis;";"0.0";"0";"1";"1";"0";"1";"0";"430523";"5766"
"LOK1378_1mm";"SILVA (only NR);Eukaryota;SAR;Alveolata;Ciliophora;Intramacronucleata;Conthreep;Prostomatea;Tiarina;";"0.0";"0";"2";"2";"0";"2";"0";"430522";"5766"
"LOK1378_1mm";"SILVA (only NR);Eukaryota;SAR;Alveolata;Ciliophora;Intramacronucleata;Litostomatea;";"0.0";"0";"450";"436";"0";"436";"14";"430088";"5766"
"LOK1378_1mm";"SILVA (only NR);Eukaryota;SAR;Alveolata;Ciliophora;Intramacronucleata;Litostomatea;Haptoria;";"0.0";"0";"169";"168";"0";"168";"1";"430356";"5766"
"LOK1378_1mm";"SILVA (only NR);Eukaryota;SAR;Alveolata;Ciliophora;Intramacronucleata;Litostomatea;Haptoria;Acineria;";"0.0";"0";"2";"2";"0";"2";"0";"430522";"5766"
"LOK1378_1mm";"SILVA (only NR);Eukaryota;SAR;Alveolata;Ciliophora;Intramacronucleata;Litostomatea;Haptoria;Amphileptus;";"0.0";"0";"5";"5";"0";"5";"0";"430519";"5766"
"LOK1378_1mm";"SILVA (only NR);Eukaryota;SAR;Alveolata;Ciliophora;Intramacronucleata;Litostomatea;Haptoria;Apobryophyllum;";"0.0";"0";"3";"3";"0";"3";"0";"430521";"5766"
"LOK1378_1mm";"SILVA (only NR);Eukaryota;SAR;Alveolata;Ciliophora;Intramacronucleata;Litostomatea;Haptoria;Arcuospathidium;";"0.0";"0";"9";"9";"0";"9";"0";"430515";"5766"
"LOK1378_1mm";"SILVA (only NR);Eukaryota;SAR;Alveolata;Ciliophora;Intramacronucleata;Litostomatea;Haptoria;Balantidion;";"0.0";"0";"1";"1";"0";"1";"0";"430523";"5766"
"LOK1378_1mm";"SILVA (only NR);Eukaryota;SAR;Alveolata;Ciliophora;Intramacronucleata;Litostomatea;Haptoria;Chaenea;";"0.0";"0";"6";"6";"0";"6";"0";"430518";"5766"
"LOK1378_1mm";"SILVA (only NR);Eukaryota;SAR;Alveolata;Ciliophora;Intramacronucleata;Litostomatea;Haptoria;Didinium;";"0.0";"0";"17";"16";"0";"16";"1";"430508";"5766"
"LOK1378_1mm";"SILVA (only NR);Eukaryota;SAR;Alveolata;Ciliophora;Intramacronucleata;Litostomatea;Haptoria;Dileptus;";"0.0";"0";"6";"6";"0";"6";"0";"430518";"5766"
"LOK1378_1mm";"SILVA (only NR);Eukaryota;SAR;Alveolata;Ciliophora;Intramacronucleata;Litostomatea;Haptoria;Dimacrocaryon;";"0.0";"0";"1";"1";"0";"1";"0";"430523";"5766"
"LOK1378_1mm";"SILVA (only NR);Eukaryota;SAR;Alveolata;Ciliophora;Intramacronucleata;Litostomatea;Haptoria;Enchelys;";"0.0";"0";"2";"2";"0";"2";"0";"430522";"5766"
"LOK1378_1mm";"SILVA (only NR);Eukaryota;SAR;Alveolata;Ciliophora;Intramacronucleata;Litostomatea;Haptoria;Epiphyllum;";"0.0";"0";"4";"4";"0";"4";"0";"430520";"5766"
"LOK1378_1mm";"SILVA (only NR);Eukaryota;SAR;Alveolata;Ciliophora;Intramacronucleata;Litostomatea;Haptoria;Epispathidium;";"0.0";"0";"2";"2";"0";"2";"0";"430522";"5766"
"LOK1378_1mm";"SILVA (only NR);Eukaryota;SAR;Alveolata;Ciliophora;Intramacronucleata;Litostomatea;Haptoria;Helicoprorodon;";"0.0";"0";"2";"2";"0";"2";"0";"430522";"5766"
"LOK1378_1mm";"SILVA (only NR);Eukaryota;SAR;Alveolata;Ciliophora;Intramacronucleata;Litostomatea;Haptoria;Hemiophrys;";"0.0";"0";"6";"6";"0";"6";"0";"430518";"5766"
"LOK1378_1mm";"SILVA (only NR);Eukaryota;SAR;Alveolata;Ciliophora;Intramacronucleata;Litostomatea;Haptoria;Homalozoon;";"0.0";"0";"2";"2";"0";"2";"0";"430522";"5766"
"LOK1378_1mm";"SILVA (only NR);Eukaryota;SAR;Alveolata;Ciliophora;Intramacronucleata;Litostomatea;Haptoria;Lacrymaria;";"0.0";"0";"2";"2";"0";"2";"0";"430522";"5766"
"LOK1378_1mm";"SILVA (only NR);Eukaryota;SAR;Alveolata;Ciliophora;Intramacronucleata;Litostomatea;Haptoria;Lagynophrya;";"0.0";"0";"1";"1";"0";"1";"0";"430523";"5766"
"LOK1378_1mm";"SILVA (only NR);Eukaryota;SAR;Alveolata;Ciliophora;Intramacronucleata;Litostomatea;Haptoria;Litonotus;";"0.0";"0";"6";"6";"0";"6";"0";"430518";"5766"
"LOK1378_1mm";"SILVA (only NR);Eukaryota;SAR;Alveolata;Ciliophora;Intramacronucleata;Litostomatea;Haptoria;Loxophyllum;";"0.0";"0";"9";"9";"0";"9";"0";"430515";"5766"
"LOK1378_1mm";"SILVA (only NR);Eukaryota;SAR;Alveolata;Ciliophora;Intramacronucleata;Litostomatea;Haptoria;Microdileptus;";"0.0";"0";"1";"1";"0";"1";"0";"430523";"5766"
"LOK1378_1mm";"SILVA (only NR);Eukaryota;SAR;Alveolata;Ciliophora;Intramacronucleata;Litostomatea;Haptoria;Monilicaryon;";"0.0";"0";"1";"1";"0";"1";"0";"430523";"5766"
"LOK1378_1mm";"SILVA (only NR);Eukaryota;SAR;Alveolata;Ciliophora;Intramacronucleata;Litostomatea;Haptoria;Phialina;";"0.0";"0";"3";"3";"0";"3";"0";"430521";"5766"
"LOK1378_1mm";"SILVA (only NR);Eukaryota;SAR;Alveolata;Ciliophora;Intramacronucleata;Litostomatea;Haptoria;Protospathidium;";"0.0";"0";"1";"1";"0";"1";"0";"430523";"5766"
"LOK1378_1mm";"SILVA (only NR);Eukaryota;SAR;Alveolata;Ciliophora;Intramacronucleata;Litostomatea;Haptoria;Pseudoholophrya;";"0.0";"0";"1";"1";"0";"1";"0";"430523";"5766"
"LOK1378_1mm";"SILVA (only NR);Eukaryota;SAR;Alveolata;Ciliophora;Intramacronucleata;Litostomatea;Haptoria;Pseudomonilicaryon;";"0.0";"0";"3";"3";"0";"3";"0";"430521";"5766"
"LOK1378_1mm";"SILVA (only NR);Eukaryota;SAR;Alveolata;Ciliophora;Intramacronucleata;Litostomatea;Haptoria;Rurikoplites;";"0.0";"0";"4";"4";"0";"4";"0";"430520";"5766"
"LOK1378_1mm";"SILVA (only NR);Eukaryota;SAR;Alveolata;Ciliophora;Intramacronucleata;Litostomatea;Haptoria;Spathidium;";"0.0";"0";"8";"8";"0";"8";"0";"430516";"5766"
"LOK1378_1mm";"SILVA (only NR);Eukaryota;SAR;Alveolata;Ciliophora;Intramacronucleata;Litostomatea;Haptoria;Teuthophrys;";"0.0";"0";"1";"1";"0";"1";"0";"430523";"5766"
"LOK1378_1mm";"SILVA (only NR);Eukaryota;SAR;Alveolata;Ciliophora;Intramacronucleata;Litostomatea;Haptoria;Trachelius;";"0.0";"0";"1";"1";"0";"1";"0";"430523";"5766"
"LOK1378_1mm";"SILVA (only NR);Eukaryota;SAR;Alveolata;Ciliophora;Intramacronucleata;Litostomatea;Haptoria;Trachelotractus;";"0.0";"0";"4";"4";"0";"4";"0";"430520";"5766"
"LOK1378_1mm";"SILVA (only NR);Eukaryota;SAR;Alveolata;Ciliophora;Intramacronucleata;Litostomatea;Haptoria;uncultured;";"0.0";"0";"7";"7";"0";"7";"0";"430517";"5766"
"LOK1378_1mm";"SILVA (only NR);Eukaryota;SAR;Alveolata;Ciliophora;Intramacronucleata;Litostomatea;Mesodiniidae;";"0.0";"0";"64";"51";"0";"51";"13";"430473";"5766"
"LOK1378_1mm";"SILVA (only NR);Eukaryota;SAR;Alveolata;Ciliophora;Intramacronucleata;Litostomatea;Mesodiniidae;FV18-2A2;";"0.0";"0";"5";"2";"0";"2";"3";"430522";"5766"
"LOK1378_1mm";"SILVA (only NR);Eukaryota;SAR;Alveolata;Ciliophora;Intramacronucleata;Litostomatea;Mesodiniidae;Mesodinium;";"0.0";"0";"4";"3";"0";"3";"1";"430521";"5766"
"LOK1378_1mm";"SILVA (only NR);Eukaryota;SAR;Alveolata;Ciliophora;Intramacronucleata;Litostomatea;Mesodiniidae;Myrionecta;";"0.0";"0";"21";"19";"0";"19";"2";"430505";"5766"
"LOK1378_1mm";"SILVA (only NR);Eukaryota;SAR;Alveolata;Ciliophora;Intramacronucleata;Litostomatea;Mesodiniidae;uncultured;";"0.0";"0";"19";"14";"0";"14";"5";"430510";"5766"
"LOK1378_1mm";"SILVA (only NR);Eukaryota;SAR;Alveolata;Ciliophora;Intramacronucleata;Litostomatea;Trichostomatia;";"0.0";"0";"215";"215";"0";"215";"0";"430309";"5766"
"LOK1378_1mm";"SILVA (only NR);Eukaryota;SAR;Alveolata;Ciliophora;Intramacronucleata;Litostomatea;Trichostomatia;Alloiozona;";"0.0";"0";"1";"1";"0";"1";"0";"430523";"5766"
"LOK1378_1mm";"SILVA (only NR);Eukaryota;SAR;Alveolata;Ciliophora;Intramacronucleata;Litostomatea;Trichostomatia;Amylovorax;";"0.0";"0";"2";"2";"0";"2";"0";"430522";"5766"
"LOK1378_1mm";"SILVA (only NR);Eukaryota;SAR;Alveolata;Ciliophora;Intramacronucleata;Litostomatea;Trichostomatia;Balantidium;";"0.0";"0";"7";"7";"0";"7";"0";"430517";"5766"
"LOK1378_1mm";"SILVA (only NR);Eukaryota;SAR;Alveolata;Ciliophora;Intramacronucleata;Litostomatea;Trichostomatia;Bandia;";"0.0";"0";"3";"3";"0";"3";"0";"430521";"5766"
"LOK1378_1mm";"SILVA (only NR);Eukaryota;SAR;Alveolata;Ciliophora;Intramacronucleata;Litostomatea;Trichostomatia;Bitricha;";"0.0";"0";"2";"2";"0";"2";"0";"430522";"5766"
"LOK1378_1mm";"SILVA (only NR);Eukaryota;SAR;Alveolata;Ciliophora;Intramacronucleata;Litostomatea;Trichostomatia;Blepharocorys;";"0.0";"0";"8";"8";"0";"8";"0";"430516";"5766"
"LOK1378_1mm";"SILVA (only NR);Eukaryota;SAR;Alveolata;Ciliophora;Intramacronucleata;Litostomatea;Trichostomatia;Bundleia;";"0.0";"0";"5";"5";"0";"5";"0";"430519";"5766"
"LOK1378_1mm";"SILVA (only NR);Eukaryota;SAR;Alveolata;Ciliophora;Intramacronucleata;Litostomatea;Trichostomatia;Buxtonella;";"0.0";"0";"1";"1";"0";"1";"0";"430523";"5766"
"LOK1378_1mm";"SILVA (only NR);Eukaryota;SAR;Alveolata;Ciliophora;Intramacronucleata;Litostomatea;Trichostomatia;Charonina;";"0.0";"0";"1";"1";"0";"1";"0";"430523";"5766"
"LOK1378_1mm";"SILVA (only NR);Eukaryota;SAR;Alveolata;Ciliophora;Intramacronucleata;Litostomatea;Trichostomatia;Cochliatoxum;";"0.0";"0";"1";"1";"0";"1";"0";"430523";"5766"
"LOK1378_1mm";"SILVA (only NR);Eukaryota;SAR;Alveolata;Ciliophora;Intramacronucleata;Litostomatea;Trichostomatia;Cycloposthium;";"0.0";"0";"2";"2";"0";"2";"0";"430522";"5766"
"LOK1378_1mm";"SILVA (only NR);Eukaryota;SAR;Alveolata;Ciliophora;Intramacronucleata;Litostomatea;Trichostomatia;Dasytricha;";"0.0";"0";"22";"22";"0";"22";"0";"430502";"5766"
"LOK1378_1mm";"SILVA (only NR);Eukaryota;SAR;Alveolata;Ciliophora;Intramacronucleata;Litostomatea;Trichostomatia;Diplodinium;";"0.0";"0";"11";"11";"0";"11";"0";"430513";"5766"
"LOK1378_1mm";"SILVA (only NR);Eukaryota;SAR;Alveolata;Ciliophora;Intramacronucleata;Litostomatea;Trichostomatia;Diploplastron;";"0.0";"0";"1";"1";"0";"1";"0";"430523";"5766"
"LOK1378_1mm";"SILVA (only NR);Eukaryota;SAR;Alveolata;Ciliophora;Intramacronucleata;Litostomatea;Trichostomatia;Ditoxum;";"0.0";"0";"1";"1";"0";"1";"0";"430523";"5766"
"LOK1378_1mm";"SILVA (only NR);Eukaryota;SAR;Alveolata;Ciliophora;Intramacronucleata;Litostomatea;Trichostomatia;Enoploplastron;";"0.0";"0";"1";"1";"0";"1";"0";"430523";"5766"
"LOK1378_1mm";"SILVA (only NR);Eukaryota;SAR;Alveolata;Ciliophora;Intramacronucleata;Litostomatea;Trichostomatia;Entodinium;";"0.0";"0";"63";"63";"0";"63";"0";"430461";"5766"
"LOK1378_1mm";"SILVA (only NR);Eukaryota;SAR;Alveolata;Ciliophora;Intramacronucleata;Litostomatea;Trichostomatia;Eremoplastron;";"0.0";"0";"2";"2";"0";"2";"0";"430522";"5766"
"LOK1378_1mm";"SILVA (only NR);Eukaryota;SAR;Alveolata;Ciliophora;Intramacronucleata;Litostomatea;Trichostomatia;Eudiplodinium;";"0.0";"0";"2";"2";"0";"2";"0";"430522";"5766"
"LOK1378_1mm";"SILVA (only NR);Eukaryota;SAR;Alveolata;Ciliophora;Intramacronucleata;Litostomatea;Trichostomatia;Gassovskiella;";"0.0";"0";"1";"1";"0";"1";"0";"430523";"5766"
"LOK1378_1mm";"SILVA (only NR);Eukaryota;SAR;Alveolata;Ciliophora;Intramacronucleata;Litostomatea;Trichostomatia;Helicozoster;";"0.0";"0";"1";"1";"0";"1";"0";"430523";"5766"
"LOK1378_1mm";"SILVA (only NR);Eukaryota;SAR;Alveolata;Ciliophora;Intramacronucleata;Litostomatea;Trichostomatia;Hemiprorodon;";"0.0";"0";"1";"1";"0";"1";"0";"430523";"5766"
"LOK1378_1mm";"SILVA (only NR);Eukaryota;SAR;Alveolata;Ciliophora;Intramacronucleata;Litostomatea;Trichostomatia;Isotricha;";"0.0";"0";"8";"8";"0";"8";"0";"430516";"5766"
"LOK1378_1mm";"SILVA (only NR);Eukaryota;SAR;Alveolata;Ciliophora;Intramacronucleata;Litostomatea;Trichostomatia;Latteuria;";"0.0";"0";"2";"2";"0";"2";"0";"430522";"5766"
"LOK1378_1mm";"SILVA (only NR);Eukaryota;SAR;Alveolata;Ciliophora;Intramacronucleata;Litostomatea;Trichostomatia;Macropodinium;";"0.0";"0";"4";"4";"0";"4";"0";"430520";"5766"
"LOK1378_1mm";"SILVA (only NR);Eukaryota;SAR;Alveolata;Ciliophora;Intramacronucleata;Litostomatea;Trichostomatia;Metadinium;";"0.0";"0";"4";"4";"0";"4";"0";"430520";"5766"
"LOK1378_1mm";"SILVA (only NR);Eukaryota;SAR;Alveolata;Ciliophora;Intramacronucleata;Litostomatea;Trichostomatia;Neobalantidium;";"0.0";"0";"2";"2";"0";"2";"0";"430522";"5766"
"LOK1378_1mm";"SILVA (only NR);Eukaryota;SAR;Alveolata;Ciliophora;Intramacronucleata;Litostomatea;Trichostomatia;Ophryoscolex;";"0.0";"0";"14";"14";"0";"14";"0";"430510";"5766"
"LOK1378_1mm";"SILVA (only NR);Eukaryota;SAR;Alveolata;Ciliophora;Intramacronucleata;Litostomatea;Trichostomatia;Polycosta;";"0.0";"0";"1";"1";"0";"1";"0";"430523";"5766"
"LOK1378_1mm";"SILVA (only NR);Eukaryota;SAR;Alveolata;Ciliophora;Intramacronucleata;Litostomatea;Trichostomatia;Polydiniella;";"0.0";"0";"1";"1";"0";"1";"0";"430523";"5766"
"LOK1378_1mm";"SILVA (only NR);Eukaryota;SAR;Alveolata;Ciliophora;Intramacronucleata;Litostomatea;Trichostomatia;Polyplastron;";"0.0";"0";"11";"11";"0";"11";"0";"430513";"5766"
"LOK1378_1mm";"SILVA (only NR);Eukaryota;SAR;Alveolata;Ciliophora;Intramacronucleata;Litostomatea;Trichostomatia;Raabena;";"0.0";"0";"1";"1";"0";"1";"0";"430523";"5766"
"LOK1378_1mm";"SILVA (only NR);Eukaryota;SAR;Alveolata;Ciliophora;Intramacronucleata;Litostomatea;Trichostomatia;Spirodinium;";"0.0";"0";"1";"1";"0";"1";"0";"430523";"5766"
"LOK1378_1mm";"SILVA (only NR);Eukaryota;SAR;Alveolata;Ciliophora;Intramacronucleata;Litostomatea;Trichostomatia;Tetratoxum;";"0.0";"0";"1";"1";"0";"1";"0";"430523";"5766"
"LOK1378_1mm";"SILVA (only NR);Eukaryota;SAR;Alveolata;Ciliophora;Intramacronucleata;Litostomatea;Trichostomatia;Triadinium;";"0.0";"0";"2";"2";"0";"2";"0";"430522";"5766"
"LOK1378_1mm";"SILVA (only NR);Eukaryota;SAR;Alveolata;Ciliophora;Intramacronucleata;Litostomatea;Trichostomatia;Tripalmaria;";"0.0";"0";"1";"1";"0";"1";"0";"430523";"5766"
"LOK1378_1mm";"SILVA (only NR);Eukaryota;SAR;Alveolata;Ciliophora;Intramacronucleata;Litostomatea;Trichostomatia;Triplumaria;";"0.0";"0";"3";"3";"0";"3";"0";"430521";"5766"
"LOK1378_1mm";"SILVA (only NR);Eukaryota;SAR;Alveolata;Ciliophora;Intramacronucleata;Litostomatea;Trichostomatia;Troglodytella;";"0.0";"0";"1";"1";"0";"1";"0";"430523";"5766"
"LOK1378_1mm";"SILVA (only NR);Eukaryota;SAR;Alveolata;Ciliophora;Intramacronucleata;Litostomatea;Trichostomatia;uncultured;";"0.0";"0";"2";"2";"0";"2";"0";"430522";"5766"
"LOK1378_1mm";"SILVA (only NR);Eukaryota;SAR;Alveolata;Ciliophora;Intramacronucleata;Spirotrichea;";"0.0";"0";"1174";"1143";"0";"1143";"31";"429381";"5766"
"LOK1378_1mm";"SILVA (only NR);Eukaryota;SAR;Alveolata;Ciliophora;Intramacronucleata;Spirotrichea;Choreotrichia;";"0.0";"0";"249";"237";"0";"237";"12";"430287";"5766"
"LOK1378_1mm";"SILVA (only NR);Eukaryota;SAR;Alveolata;Ciliophora;Intramacronucleata;Spirotrichea;Choreotrichia;Amphorellopsis;";"0.0";"0";"4";"4";"0";"4";"0";"430520";"5766"
"LOK1378_1mm";"SILVA (only NR);Eukaryota;SAR;Alveolata;Ciliophora;Intramacronucleata;Spirotrichea;Choreotrichia;Ascampbelliella;";"0.0";"0";"1";"1";"0";"1";"0";"430523";"5766"
"LOK1378_1mm";"SILVA (only NR);Eukaryota;SAR;Alveolata;Ciliophora;Intramacronucleata;Spirotrichea;Choreotrichia;Codonella;";"0.0";"0";"2";"2";"0";"2";"0";"430522";"5766"
"LOK1378_1mm";"SILVA (only NR);Eukaryota;SAR;Alveolata;Ciliophora;Intramacronucleata;Spirotrichea;Choreotrichia;Codonellopsis;";"0.0";"0";"5";"5";"0";"5";"0";"430519";"5766"
"LOK1378_1mm";"SILVA (only NR);Eukaryota;SAR;Alveolata;Ciliophora;Intramacronucleata;Spirotrichea;Choreotrichia;Cyttarocylis;";"0.0";"0";"1";"1";"0";"1";"0";"430523";"5766"
"LOK1378_1mm";"SILVA (only NR);Eukaryota;SAR;Alveolata;Ciliophora;Intramacronucleata;Spirotrichea;Choreotrichia;Epiplocylis;";"0.0";"0";"1";"1";"0";"1";"0";"430523";"5766"
"LOK1378_1mm";"SILVA (only NR);Eukaryota;SAR;Alveolata;Ciliophora;Intramacronucleata;Spirotrichea;Choreotrichia;Epiplocyloides;";"0.0";"0";"1";"1";"0";"1";"0";"430523";"5766"
"LOK1378_1mm";"SILVA (only NR);Eukaryota;SAR;Alveolata;Ciliophora;Intramacronucleata;Spirotrichea;Choreotrichia;Eutintinnus;";"0.0";"0";"10";"9";"0";"9";"1";"430515";"5766"
"LOK1378_1mm";"SILVA (only NR);Eukaryota;SAR;Alveolata;Ciliophora;Intramacronucleata;Spirotrichea;Choreotrichia;Favella;";"0.0";"0";"3";"3";"0";"3";"0";"430521";"5766"
"LOK1378_1mm";"SILVA (only NR);Eukaryota;SAR;Alveolata;Ciliophora;Intramacronucleata;Spirotrichea;Choreotrichia;Helicostomella;";"0.0";"0";"3";"3";"0";"3";"0";"430521";"5766"
"LOK1378_1mm";"SILVA (only NR);Eukaryota;SAR;Alveolata;Ciliophora;Intramacronucleata;Spirotrichea;Choreotrichia;Leprotintinnus;";"0.0";"0";"1";"1";"0";"1";"0";"430523";"5766"
"LOK1378_1mm";"SILVA (only NR);Eukaryota;SAR;Alveolata;Ciliophora;Intramacronucleata;Spirotrichea;Choreotrichia;Metacylis;";"0.0";"0";"6";"5";"0";"5";"1";"430519";"5766"
"LOK1378_1mm";"SILVA (only NR);Eukaryota;SAR;Alveolata;Ciliophora;Intramacronucleata;Spirotrichea;Choreotrichia;Parastrombidinopsis;";"0.0";"0";"4";"3";"0";"3";"1";"430521";"5766"
"LOK1378_1mm";"SILVA (only NR);Eukaryota;SAR;Alveolata;Ciliophora;Intramacronucleata;Spirotrichea;Choreotrichia;Pelagostrobilidium;";"0.0";"0";"12";"11";"0";"11";"1";"430513";"5766"
"LOK1378_1mm";"SILVA (only NR);Eukaryota;SAR;Alveolata;Ciliophora;Intramacronucleata;Spirotrichea;Choreotrichia;Rimostrombidium;";"0.0";"0";"8";"8";"0";"8";"0";"430516";"5766"
"LOK1378_1mm";"SILVA (only NR);Eukaryota;SAR;Alveolata;Ciliophora;Intramacronucleata;Spirotrichea;Choreotrichia;Salpingacantha;";"0.0";"0";"1";"1";"0";"1";"0";"430523";"5766"
"LOK1378_1mm";"SILVA (only NR);Eukaryota;SAR;Alveolata;Ciliophora;Intramacronucleata;Spirotrichea;Choreotrichia;Salpingella;";"0.0";"0";"3";"3";"0";"3";"0";"430521";"5766"
"LOK1378_1mm";"SILVA (only NR);Eukaryota;SAR;Alveolata;Ciliophora;Intramacronucleata;Spirotrichea;Choreotrichia;Steenstrupiella;";"0.0";"0";"7";"6";"0";"6";"1";"430518";"5766"
"LOK1378_1mm";"SILVA (only NR);Eukaryota;SAR;Alveolata;Ciliophora;Intramacronucleata;Spirotrichea;Choreotrichia;Stenosemella;";"0.0";"0";"2";"2";"0";"2";"0";"430522";"5766"
"LOK1378_1mm";"SILVA (only NR);Eukaryota;SAR;Alveolata;Ciliophora;Intramacronucleata;Spirotrichea;Choreotrichia;Strobilidium;";"0.0";"0";"1";"1";"0";"1";"0";"430523";"5766"
"LOK1378_1mm";"SILVA (only NR);Eukaryota;SAR;Alveolata;Ciliophora;Intramacronucleata;Spirotrichea;Choreotrichia;Strombidinopsis;";"0.0";"0";"3";"3";"0";"3";"0";"430521";"5766"
"LOK1378_1mm";"SILVA (only NR);Eukaryota;SAR;Alveolata;Ciliophora;Intramacronucleata;Spirotrichea;Choreotrichia;Tintinnidium;";"0.0";"0";"9";"9";"0";"9";"0";"430515";"5766"
"LOK1378_1mm";"SILVA (only NR);Eukaryota;SAR;Alveolata;Ciliophora;Intramacronucleata;Spirotrichea;Choreotrichia;Tintinnopsis;";"0.0";"0";"30";"29";"0";"29";"1";"430495";"5766"
"LOK1378_1mm";"SILVA (only NR);Eukaryota;SAR;Alveolata;Ciliophora;Intramacronucleata;Spirotrichea;Choreotrichia;Undella;";"0.0";"0";"1";"1";"0";"1";"0";"430523";"5766"
"LOK1378_1mm";"SILVA (only NR);Eukaryota;SAR;Alveolata;Ciliophora;Intramacronucleata;Spirotrichea;Choreotrichia;Xystonella;";"0.0";"0";"3";"2";"0";"2";"1";"430522";"5766"
"LOK1378_1mm";"SILVA (only NR);Eukaryota;SAR;Alveolata;Ciliophora;Intramacronucleata;Spirotrichea;Choreotrichia;uncultured;";"0.0";"0";"97";"94";"0";"94";"3";"430430";"5766"
"LOK1378_1mm";"SILVA (only NR);Eukaryota;SAR;Alveolata;Ciliophora;Intramacronucleata;Spirotrichea;Euplotia;";"0.0";"0";"130";"128";"0";"128";"2";"430396";"5766"
"LOK1378_1mm";"SILVA (only NR);Eukaryota;SAR;Alveolata;Ciliophora;Intramacronucleata;Spirotrichea;Euplotia;Apodiophrys;";"0.0";"0";"1";"1";"0";"1";"0";"430523";"5766"
"LOK1378_1mm";"SILVA (only NR);Eukaryota;SAR;Alveolata;Ciliophora;Intramacronucleata;Spirotrichea;Euplotia;Aspidisca;";"0.0";"0";"35";"34";"0";"34";"1";"430490";"5766"
"LOK1378_1mm";"SILVA (only NR);Eukaryota;SAR;Alveolata;Ciliophora;Intramacronucleata;Spirotrichea;Euplotia;Certesia;";"0.0";"0";"1";"1";"0";"1";"0";"430523";"5766"
"LOK1378_1mm";"SILVA (only NR);Eukaryota;SAR;Alveolata;Ciliophora;Intramacronucleata;Spirotrichea;Euplotia;Diophrys;";"0.0";"0";"9";"9";"0";"9";"0";"430515";"5766"
"LOK1378_1mm";"SILVA (only NR);Eukaryota;SAR;Alveolata;Ciliophora;Intramacronucleata;Spirotrichea;Euplotia;Discocephalus;";"0.0";"0";"4";"4";"0";"4";"0";"430520";"5766"
"LOK1378_1mm";"SILVA (only NR);Eukaryota;SAR;Alveolata;Ciliophora;Intramacronucleata;Spirotrichea;Euplotia;Euplotes;";"0.0";"0";"73";"72";"0";"72";"1";"430452";"5766"
"LOK1378_1mm";"SILVA (only NR);Eukaryota;SAR;Alveolata;Ciliophora;Intramacronucleata;Spirotrichea;Euplotia;Euplotidium;";"0.0";"0";"2";"2";"0";"2";"0";"430522";"5766"
"LOK1378_1mm";"SILVA (only NR);Eukaryota;SAR;Alveolata;Ciliophora;Intramacronucleata;Spirotrichea;Euplotia;Gastrocirrhus;";"0.0";"0";"1";"1";"0";"1";"0";"430523";"5766"
"LOK1378_1mm";"SILVA (only NR);Eukaryota;SAR;Alveolata;Ciliophora;Intramacronucleata;Spirotrichea;Euplotia;Paradiophrys;";"0.0";"0";"2";"2";"0";"2";"0";"430522";"5766"
"LOK1378_1mm";"SILVA (only NR);Eukaryota;SAR;Alveolata;Ciliophora;Intramacronucleata;Spirotrichea;Euplotia;Prodiscocephalus;";"0.0";"0";"1";"1";"0";"1";"0";"430523";"5766"
"LOK1378_1mm";"SILVA (only NR);Eukaryota;SAR;Alveolata;Ciliophora;Intramacronucleata;Spirotrichea;Hypotrichia;";"0.0";"0";"308";"300";"0";"300";"8";"430224";"5766"
"LOK1378_1mm";"SILVA (only NR);Eukaryota;SAR;Alveolata;Ciliophora;Intramacronucleata;Spirotrichea;Hypotrichia;Amphisiella;";"0.0";"0";"5";"5";"0";"5";"0";"430519";"5766"
"LOK1378_1mm";"SILVA (only NR);Eukaryota;SAR;Alveolata;Ciliophora;Intramacronucleata;Spirotrichea;Hypotrichia;Anteholosticha;";"0.0";"0";"2";"2";"0";"2";"0";"430522";"5766"
"LOK1378_1mm";"SILVA (only NR);Eukaryota;SAR;Alveolata;Ciliophora;Intramacronucleata;Spirotrichea;Hypotrichia;Apogastrostyla;";"0.0";"0";"1";"1";"0";"1";"0";"430523";"5766"
"LOK1378_1mm";"SILVA (only NR);Eukaryota;SAR;Alveolata;Ciliophora;Intramacronucleata;Spirotrichea;Hypotrichia;Apoholosticha;";"0.0";"0";"1";"1";"0";"1";"0";"430523";"5766"
"LOK1378_1mm";"SILVA (only NR);Eukaryota;SAR;Alveolata;Ciliophora;Intramacronucleata;Spirotrichea;Hypotrichia;Apokeronopsis;";"0.0";"0";"5";"5";"0";"5";"0";"430519";"5766"
"LOK1378_1mm";"SILVA (only NR);Eukaryota;SAR;Alveolata;Ciliophora;Intramacronucleata;Spirotrichea;Hypotrichia;Arcuseries;";"0.0";"0";"1";"1";"0";"1";"0";"430523";"5766"
"LOK1378_1mm";"SILVA (only NR);Eukaryota;SAR;Alveolata;Ciliophora;Intramacronucleata;Spirotrichea;Hypotrichia;Atractos;";"0.0";"0";"1";"1";"0";"1";"0";"430523";"5766"
"LOK1378_1mm";"SILVA (only NR);Eukaryota;SAR;Alveolata;Ciliophora;Intramacronucleata;Spirotrichea;Hypotrichia;Birojimia;";"0.0";"0";"1";"1";"0";"1";"0";"430523";"5766"
"LOK1378_1mm";"SILVA (only NR);Eukaryota;SAR;Alveolata;Ciliophora;Intramacronucleata;Spirotrichea;Hypotrichia;Cyrtohymena;";"0.0";"0";"1";"1";"0";"1";"0";"430523";"5766"
"LOK1378_1mm";"SILVA (only NR);Eukaryota;SAR;Alveolata;Ciliophora;Intramacronucleata;Spirotrichea;Hypotrichia;Deviata;";"0.0";"0";"2";"2";"0";"2";"0";"430522";"5766"
"LOK1378_1mm";"SILVA (only NR);Eukaryota;SAR;Alveolata;Ciliophora;Intramacronucleata;Spirotrichea;Hypotrichia;Diaxonella;";"0.0";"0";"1";"1";"0";"1";"0";"430523";"5766"
"LOK1378_1mm";"SILVA (only NR);Eukaryota;SAR;Alveolata;Ciliophora;Intramacronucleata;Spirotrichea;Hypotrichia;Engelmanniella;";"0.0";"0";"1";"1";"0";"1";"0";"430523";"5766"
"LOK1378_1mm";"SILVA (only NR);Eukaryota;SAR;Alveolata;Ciliophora;Intramacronucleata;Spirotrichea;Hypotrichia;Epiclintes;";"0.0";"0";"3";"3";"0";"3";"0";"430521";"5766"
"LOK1378_1mm";"SILVA (only NR);Eukaryota;SAR;Alveolata;Ciliophora;Intramacronucleata;Spirotrichea;Hypotrichia;Gonostomum;";"0.0";"0";"13";"13";"0";"13";"0";"430511";"5766"
"LOK1378_1mm";"SILVA (only NR);Eukaryota;SAR;Alveolata;Ciliophora;Intramacronucleata;Spirotrichea;Hypotrichia;Halteria;";"0.0";"0";"14";"12";"0";"12";"2";"430512";"5766"
"LOK1378_1mm";"SILVA (only NR);Eukaryota;SAR;Alveolata;Ciliophora;Intramacronucleata;Spirotrichea;Hypotrichia;Hemicycliostyla;";"0.0";"0";"1";"1";"0";"1";"0";"430523";"5766"
"LOK1378_1mm";"SILVA (only NR);Eukaryota;SAR;Alveolata;Ciliophora;Intramacronucleata;Spirotrichea;Hypotrichia;Hemigastrostyla;";"0.0";"0";"3";"3";"0";"3";"0";"430521";"5766"
"LOK1378_1mm";"SILVA (only NR);Eukaryota;SAR;Alveolata;Ciliophora;Intramacronucleata;Spirotrichea;Hypotrichia;Hemiurosoma;";"0.0";"0";"1";"1";"0";"1";"0";"430523";"5766"
"LOK1378_1mm";"SILVA (only NR);Eukaryota;SAR;Alveolata;Ciliophora;Intramacronucleata;Spirotrichea;Hypotrichia;Hemiurosomoida;";"0.0";"0";"4";"4";"0";"4";"0";"430520";"5766"
"LOK1378_1mm";"SILVA (only NR);Eukaryota;SAR;Alveolata;Ciliophora;Intramacronucleata;Spirotrichea;Hypotrichia;Heterokeronopsis;";"0.0";"0";"1";"1";"0";"1";"0";"430523";"5766"
"LOK1378_1mm";"SILVA (only NR);Eukaryota;SAR;Alveolata;Ciliophora;Intramacronucleata;Spirotrichea;Hypotrichia;Histriculus;";"0.0";"0";"1";"1";"0";"1";"0";"430523";"5766"
"LOK1378_1mm";"SILVA (only NR);Eukaryota;SAR;Alveolata;Ciliophora;Intramacronucleata;Spirotrichea;Hypotrichia;Holosticha;";"0.0";"0";"16";"16";"0";"16";"0";"430508";"5766"
"LOK1378_1mm";"SILVA (only NR);Eukaryota;SAR;Alveolata;Ciliophora;Intramacronucleata;Spirotrichea;Hypotrichia;Holostichides;";"0.0";"0";"1";"1";"0";"1";"0";"430523";"5766"
"LOK1378_1mm";"SILVA (only NR);Eukaryota;SAR;Alveolata;Ciliophora;Intramacronucleata;Spirotrichea;Hypotrichia;Hypotrichidium;";"0.0";"0";"1";"1";"0";"1";"0";"430523";"5766"
"LOK1378_1mm";"SILVA (only NR);Eukaryota;SAR;Alveolata;Ciliophora;Intramacronucleata;Spirotrichea;Hypotrichia;Kahliella;";"0.0";"0";"1";"1";"0";"1";"0";"430523";"5766"
"LOK1378_1mm";"SILVA (only NR);Eukaryota;SAR;Alveolata;Ciliophora;Intramacronucleata;Spirotrichea;Hypotrichia;Kleinstyla;";"0.0";"0";"1";"1";"0";"1";"0";"430523";"5766"
"LOK1378_1mm";"SILVA (only NR);Eukaryota;SAR;Alveolata;Ciliophora;Intramacronucleata;Spirotrichea;Hypotrichia;Laurentiella;";"0.0";"0";"1";"1";"0";"1";"0";"430523";"5766"
"LOK1378_1mm";"SILVA (only NR);Eukaryota;SAR;Alveolata;Ciliophora;Intramacronucleata;Spirotrichea;Hypotrichia;Meseres;";"0.0";"0";"1";"1";"0";"1";"0";"430523";"5766"
"LOK1378_1mm";"SILVA (only NR);Eukaryota;SAR;Alveolata;Ciliophora;Intramacronucleata;Spirotrichea;Hypotrichia;Metaurostylopsis;";"0.0";"0";"4";"4";"0";"4";"0";"430520";"5766"
"LOK1378_1mm";"SILVA (only NR);Eukaryota;SAR;Alveolata;Ciliophora;Intramacronucleata;Spirotrichea;Hypotrichia;Monocoronella;";"0.0";"0";"1";"1";"0";"1";"0";"430523";"5766"
"LOK1378_1mm";"SILVA (only NR);Eukaryota;SAR;Alveolata;Ciliophora;Intramacronucleata;Spirotrichea;Hypotrichia;Neobakuella;";"0.0";"0";"1";"1";"0";"1";"0";"430523";"5766"
"LOK1378_1mm";"SILVA (only NR);Eukaryota;SAR;Alveolata;Ciliophora;Intramacronucleata;Spirotrichea;Hypotrichia;Neokeronopsis;";"0.0";"0";"1";"1";"0";"1";"0";"430523";"5766"
"LOK1378_1mm";"SILVA (only NR);Eukaryota;SAR;Alveolata;Ciliophora;Intramacronucleata;Spirotrichea;Hypotrichia;Neourostylopsis;";"0.0";"0";"1";"1";"0";"1";"0";"430523";"5766"
"LOK1378_1mm";"SILVA (only NR);Eukaryota;SAR;Alveolata;Ciliophora;Intramacronucleata;Spirotrichea;Hypotrichia;Nothoholosticha;";"0.0";"0";"1";"1";"0";"1";"0";"430523";"5766"
"LOK1378_1mm";"SILVA (only NR);Eukaryota;SAR;Alveolata;Ciliophora;Intramacronucleata;Spirotrichea;Hypotrichia;Notohymena;";"0.0";"0";"3";"3";"0";"3";"0";"430521";"5766"
"LOK1378_1mm";"SILVA (only NR);Eukaryota;SAR;Alveolata;Ciliophora;Intramacronucleata;Spirotrichea;Hypotrichia;Onychodromopsis;";"0.0";"0";"1";"1";"0";"1";"0";"430523";"5766"
"LOK1378_1mm";"SILVA (only NR);Eukaryota;SAR;Alveolata;Ciliophora;Intramacronucleata;Spirotrichea;Hypotrichia;Onychodromus;";"0.0";"0";"2";"2";"0";"2";"0";"430522";"5766"
"LOK1378_1mm";"SILVA (only NR);Eukaryota;SAR;Alveolata;Ciliophora;Intramacronucleata;Spirotrichea;Hypotrichia;Oxytricha;";"0.0";"0";"10";"10";"0";"10";"0";"430514";"5766"
"LOK1378_1mm";"SILVA (only NR);Eukaryota;SAR;Alveolata;Ciliophora;Intramacronucleata;Spirotrichea;Hypotrichia;Parabirojimia;";"0.0";"0";"2";"2";"0";"2";"0";"430522";"5766"
"LOK1378_1mm";"SILVA (only NR);Eukaryota;SAR;Alveolata;Ciliophora;Intramacronucleata;Spirotrichea;Hypotrichia;Parasterkiella;";"0.0";"0";"3";"2";"0";"2";"1";"430522";"5766"
"LOK1378_1mm";"SILVA (only NR);Eukaryota;SAR;Alveolata;Ciliophora;Intramacronucleata;Spirotrichea;Hypotrichia;Paraurosomoida;";"0.0";"0";"1";"1";"0";"1";"0";"430523";"5766"
"LOK1378_1mm";"SILVA (only NR);Eukaryota;SAR;Alveolata;Ciliophora;Intramacronucleata;Spirotrichea;Hypotrichia;Paraurostyla;";"0.0";"0";"3";"3";"0";"3";"0";"430521";"5766"
"LOK1378_1mm";"SILVA (only NR);Eukaryota;SAR;Alveolata;Ciliophora;Intramacronucleata;Spirotrichea;Hypotrichia;Paruroleptus;";"0.0";"0";"3";"3";"0";"3";"0";"430521";"5766"
"LOK1378_1mm";"SILVA (only NR);Eukaryota;SAR;Alveolata;Ciliophora;Intramacronucleata;Spirotrichea;Hypotrichia;Perisincirra;";"0.0";"0";"1";"1";"0";"1";"0";"430523";"5766"
"LOK1378_1mm";"SILVA (only NR);Eukaryota;SAR;Alveolata;Ciliophora;Intramacronucleata;Spirotrichea;Hypotrichia;Plagiotoma;";"0.0";"0";"1";"1";"0";"1";"0";"430523";"5766"
"LOK1378_1mm";"SILVA (only NR);Eukaryota;SAR;Alveolata;Ciliophora;Intramacronucleata;Spirotrichea;Hypotrichia;Ponturostyla;";"0.0";"0";"1";"1";"0";"1";"0";"430523";"5766"
"LOK1378_1mm";"SILVA (only NR);Eukaryota;SAR;Alveolata;Ciliophora;Intramacronucleata;Spirotrichea;Hypotrichia;Protogastrostyla;";"0.0";"0";"2";"2";"0";"2";"0";"430522";"5766"
"LOK1378_1mm";"SILVA (only NR);Eukaryota;SAR;Alveolata;Ciliophora;Intramacronucleata;Spirotrichea;Hypotrichia;Psammomitra;";"0.0";"0";"1";"1";"0";"1";"0";"430523";"5766"
"LOK1378_1mm";"SILVA (only NR);Eukaryota;SAR;Alveolata;Ciliophora;Intramacronucleata;Spirotrichea;Hypotrichia;Pseudoamphisiella;";"0.0";"0";"4";"4";"0";"4";"0";"430520";"5766"
"LOK1378_1mm";"SILVA (only NR);Eukaryota;SAR;Alveolata;Ciliophora;Intramacronucleata;Spirotrichea;Hypotrichia;Pseudogastrostyla;";"0.0";"0";"1";"1";"0";"1";"0";"430523";"5766"
"LOK1378_1mm";"SILVA (only NR);Eukaryota;SAR;Alveolata;Ciliophora;Intramacronucleata;Spirotrichea;Hypotrichia;Pseudokahliella;";"0.0";"0";"1";"1";"0";"1";"0";"430523";"5766"
"LOK1378_1mm";"SILVA (only NR);Eukaryota;SAR;Alveolata;Ciliophora;Intramacronucleata;Spirotrichea;Hypotrichia;Pseudokeronopsis;";"0.0";"0";"4";"4";"0";"4";"0";"430520";"5766"
"LOK1378_1mm";"SILVA (only NR);Eukaryota;SAR;Alveolata;Ciliophora;Intramacronucleata;Spirotrichea;Hypotrichia;Pseudouroleptus;";"0.0";"0";"6";"6";"0";"6";"0";"430518";"5766"
"LOK1378_1mm";"SILVA (only NR);Eukaryota;SAR;Alveolata;Ciliophora;Intramacronucleata;Spirotrichea;Hypotrichia;Pseudourostyla;";"0.0";"0";"8";"8";"0";"8";"0";"430516";"5766"
"LOK1378_1mm";"SILVA (only NR);Eukaryota;SAR;Alveolata;Ciliophora;Intramacronucleata;Spirotrichea;Hypotrichia;Rigidothrix;";"0.0";"0";"1";"1";"0";"1";"0";"430523";"5766"
"LOK1378_1mm";"SILVA (only NR);Eukaryota;SAR;Alveolata;Ciliophora;Intramacronucleata;Spirotrichea;Hypotrichia;Rubrioxytricha;";"0.0";"0";"1";"1";"0";"1";"0";"430523";"5766"
"LOK1378_1mm";"SILVA (only NR);Eukaryota;SAR;Alveolata;Ciliophora;Intramacronucleata;Spirotrichea;Hypotrichia;Spirotrachelostyla;";"0.0";"0";"3";"3";"0";"3";"0";"430521";"5766"
"LOK1378_1mm";"SILVA (only NR);Eukaryota;SAR;Alveolata;Ciliophora;Intramacronucleata;Spirotrichea;Hypotrichia;Steinia;";"0.0";"0";"1";"1";"0";"1";"0";"430523";"5766"
"LOK1378_1mm";"SILVA (only NR);Eukaryota;SAR;Alveolata;Ciliophora;Intramacronucleata;Spirotrichea;Hypotrichia;Sterkiella;";"0.0";"0";"6";"6";"0";"6";"0";"430518";"5766"
"LOK1378_1mm";"SILVA (only NR);Eukaryota;SAR;Alveolata;Ciliophora;Intramacronucleata;Spirotrichea;Hypotrichia;Stichotricha;";"0.0";"0";"2";"2";"0";"2";"0";"430522";"5766"
"LOK1378_1mm";"SILVA (only NR);Eukaryota;SAR;Alveolata;Ciliophora;Intramacronucleata;Spirotrichea;Hypotrichia;Strongylidium;";"0.0";"0";"2";"2";"0";"2";"0";"430522";"5766"
"LOK1378_1mm";"SILVA (only NR);Eukaryota;SAR;Alveolata;Ciliophora;Intramacronucleata;Spirotrichea;Hypotrichia;Stylonychia;";"0.0";"0";"14";"14";"0";"14";"0";"430510";"5766"
"LOK1378_1mm";"SILVA (only NR);Eukaryota;SAR;Alveolata;Ciliophora;Intramacronucleata;Spirotrichea;Hypotrichia;Tachysoma;";"0.0";"0";"1";"1";"0";"1";"0";"430523";"5766"
"LOK1378_1mm";"SILVA (only NR);Eukaryota;SAR;Alveolata;Ciliophora;Intramacronucleata;Spirotrichea;Hypotrichia;Tetmemena;";"0.0";"0";"1";"1";"0";"1";"0";"430523";"5766"
"LOK1378_1mm";"SILVA (only NR);Eukaryota;SAR;Alveolata;Ciliophora;Intramacronucleata;Spirotrichea;Hypotrichia;Thigmokeronopsis;";"0.0";"0";"2";"2";"0";"2";"0";"430522";"5766"
"LOK1378_1mm";"SILVA (only NR);Eukaryota;SAR;Alveolata;Ciliophora;Intramacronucleata;Spirotrichea;Hypotrichia;Trachelostyla;";"0.0";"0";"2";"2";"0";"2";"0";"430522";"5766"
"LOK1378_1mm";"SILVA (only NR);Eukaryota;SAR;Alveolata;Ciliophora;Intramacronucleata;Spirotrichea;Hypotrichia;Trichototaxis;";"0.0";"0";"1";"1";"0";"1";"0";"430523";"5766"
"LOK1378_1mm";"SILVA (only NR);Eukaryota;SAR;Alveolata;Ciliophora;Intramacronucleata;Spirotrichea;Hypotrichia;Tunicothrix;";"0.0";"0";"2";"2";"0";"2";"0";"430522";"5766"
"LOK1378_1mm";"SILVA (only NR);Eukaryota;SAR;Alveolata;Ciliophora;Intramacronucleata;Spirotrichea;Hypotrichia;Uroleptopsis;";"0.0";"0";"1";"1";"0";"1";"0";"430523";"5766"
"LOK1378_1mm";"SILVA (only NR);Eukaryota;SAR;Alveolata;Ciliophora;Intramacronucleata;Spirotrichea;Hypotrichia;Uroleptus;";"0.0";"0";"4";"4";"0";"4";"0";"430520";"5766"
"LOK1378_1mm";"SILVA (only NR);Eukaryota;SAR;Alveolata;Ciliophora;Intramacronucleata;Spirotrichea;Hypotrichia;Uronychia;";"0.0";"0";"6";"5";"0";"5";"1";"430519";"5766"
"LOK1378_1mm";"SILVA (only NR);Eukaryota;SAR;Alveolata;Ciliophora;Intramacronucleata;Spirotrichea;Hypotrichia;Urosoma;";"0.0";"0";"4";"4";"0";"4";"0";"430520";"5766"
"LOK1378_1mm";"SILVA (only NR);Eukaryota;SAR;Alveolata;Ciliophora;Intramacronucleata;Spirotrichea;Hypotrichia;Urosomoida;";"0.0";"0";"1";"1";"0";"1";"0";"430523";"5766"
"LOK1378_1mm";"SILVA (only NR);Eukaryota;SAR;Alveolata;Ciliophora;Intramacronucleata;Spirotrichea;Hypotrichia;Urospinula;";"0.0";"0";"1";"1";"0";"1";"0";"430523";"5766"
"LOK1378_1mm";"SILVA (only NR);Eukaryota;SAR;Alveolata;Ciliophora;Intramacronucleata;Spirotrichea;Hypotrichia;Urostyla;";"0.0";"0";"2";"2";"0";"2";"0";"430522";"5766"
"LOK1378_1mm";"SILVA (only NR);Eukaryota;SAR;Alveolata;Ciliophora;Intramacronucleata;Spirotrichea;Hypotrichia;uncultured;";"0.0";"0";"15";"15";"0";"15";"0";"430509";"5766"
"LOK1378_1mm";"SILVA (only NR);Eukaryota;SAR;Alveolata;Ciliophora;Intramacronucleata;Spirotrichea;Licnophoria;";"0.0";"0";"3";"3";"0";"3";"0";"430521";"5766"
"LOK1378_1mm";"SILVA (only NR);Eukaryota;SAR;Alveolata;Ciliophora;Intramacronucleata;Spirotrichea;Licnophoria;Licnophora;";"0.0";"0";"3";"3";"0";"3";"0";"430521";"5766"
"LOK1378_1mm";"SILVA (only NR);Eukaryota;SAR;Alveolata;Ciliophora;Intramacronucleata;Spirotrichea;Oligotrichia;";"0.0";"0";"432";"427";"0";"427";"5";"430097";"5766"
"LOK1378_1mm";"SILVA (only NR);Eukaryota;SAR;Alveolata;Ciliophora;Intramacronucleata;Spirotrichea;Oligotrichia;Antestrombidium;";"0.0";"0";"1";"1";"0";"1";"0";"430523";"5766"
"LOK1378_1mm";"SILVA (only NR);Eukaryota;SAR;Alveolata;Ciliophora;Intramacronucleata;Spirotrichea;Oligotrichia;Apostrombidium;";"0.0";"0";"1";"1";"0";"1";"0";"430523";"5766"
"LOK1378_1mm";"SILVA (only NR);Eukaryota;SAR;Alveolata;Ciliophora;Intramacronucleata;Spirotrichea;Oligotrichia;Novistrombidium;";"0.0";"0";"2";"2";"0";"2";"0";"430522";"5766"
"LOK1378_1mm";"SILVA (only NR);Eukaryota;SAR;Alveolata;Ciliophora;Intramacronucleata;Spirotrichea;Oligotrichia;Omegastrombidium;";"0.0";"0";"1";"1";"0";"1";"0";"430523";"5766"
"LOK1378_1mm";"SILVA (only NR);Eukaryota;SAR;Alveolata;Ciliophora;Intramacronucleata;Spirotrichea;Oligotrichia;Parallelostrombidium;";"0.0";"0";"6";"6";"0";"6";"0";"430518";"5766"
"LOK1378_1mm";"SILVA (only NR);Eukaryota;SAR;Alveolata;Ciliophora;Intramacronucleata;Spirotrichea;Oligotrichia;Pseudotontonia;";"0.0";"0";"38";"38";"0";"38";"0";"430486";"5766"
"LOK1378_1mm";"SILVA (only NR);Eukaryota;SAR;Alveolata;Ciliophora;Intramacronucleata;Spirotrichea;Oligotrichia;Sinistrostrombidium;";"0.0";"0";"5";"5";"0";"5";"0";"430519";"5766"
"LOK1378_1mm";"SILVA (only NR);Eukaryota;SAR;Alveolata;Ciliophora;Intramacronucleata;Spirotrichea;Oligotrichia;Spirostrombidium;";"0.0";"0";"22";"22";"0";"22";"0";"430502";"5766"
"LOK1378_1mm";"SILVA (only NR);Eukaryota;SAR;Alveolata;Ciliophora;Intramacronucleata;Spirotrichea;Oligotrichia;Spirotontonia;";"0.0";"0";"68";"68";"0";"68";"0";"430456";"5766"
"LOK1378_1mm";"SILVA (only NR);Eukaryota;SAR;Alveolata;Ciliophora;Intramacronucleata;Spirotrichea;Oligotrichia;Strombidium;";"0.0";"0";"210";"209";"0";"209";"1";"430315";"5766"
"LOK1378_1mm";"SILVA (only NR);Eukaryota;SAR;Alveolata;Ciliophora;Intramacronucleata;Spirotrichea;Oligotrichia;Varistrombidium;";"0.0";"0";"3";"3";"0";"3";"0";"430521";"5766"
"LOK1378_1mm";"SILVA (only NR);Eukaryota;SAR;Alveolata;Ciliophora;Intramacronucleata;Spirotrichea;Oligotrichia;uncultured;";"0.0";"0";"51";"49";"0";"49";"2";"430475";"5766"
"LOK1378_1mm";"SILVA (only NR);Eukaryota;SAR;Alveolata;Ciliophora;Intramacronucleata;Spirotrichea;Oxytrichidae;";"0.0";"0";"38";"34";"0";"34";"4";"430490";"5766"
"LOK1378_1mm";"SILVA (only NR);Eukaryota;SAR;Alveolata;Ciliophora;Intramacronucleata;Spirotrichea;Phacodinium;";"0.0";"0";"1";"1";"0";"1";"0";"430523";"5766"
"LOK1378_1mm";"SILVA (only NR);Eukaryota;SAR;Alveolata;Ciliophora;Intramacronucleata;Spirotrichea;Protocruzia;";"0.0";"0";"7";"7";"0";"7";"0";"430517";"5766"
"LOK1378_1mm";"SILVA (only NR);Eukaryota;SAR;Alveolata;Ciliophora;Intramacronucleata;Spirotrichea;Protohypotrichia;";"0.0";"0";"3";"3";"0";"3";"0";"430521";"5766"
"LOK1378_1mm";"SILVA (only NR);Eukaryota;SAR;Alveolata;Ciliophora;Intramacronucleata;Spirotrichea;Protohypotrichia;Caryotricha;";"0.0";"0";"2";"2";"0";"2";"0";"430522";"5766"
"LOK1378_1mm";"SILVA (only NR);Eukaryota;SAR;Alveolata;Ciliophora;Intramacronucleata;Spirotrichea;Protohypotrichia;Kiitricha;";"0.0";"0";"1";"1";"0";"1";"0";"430523";"5766"
"LOK1378_1mm";"SILVA (only NR);Eukaryota;SAR;Alveolata;Ciliophora;Postciliodesmatophora;";"0.0";"0";"149";"145";"0";"145";"4";"430379";"5766"
"LOK1378_1mm";"SILVA (only NR);Eukaryota;SAR;Alveolata;Ciliophora;Postciliodesmatophora;Heterotrichea;";"0.0";"0";"90";"87";"0";"87";"3";"430437";"5766"
"LOK1378_1mm";"SILVA (only NR);Eukaryota;SAR;Alveolata;Ciliophora;Postciliodesmatophora;Heterotrichea;Anigsteinia;";"0.0";"0";"3";"3";"0";"3";"0";"430521";"5766"
"LOK1378_1mm";"SILVA (only NR);Eukaryota;SAR;Alveolata;Ciliophora;Postciliodesmatophora;Heterotrichea;Blepharisma;";"0.0";"0";"15";"15";"0";"15";"0";"430509";"5766"
"LOK1378_1mm";"SILVA (only NR);Eukaryota;SAR;Alveolata;Ciliophora;Postciliodesmatophora;Heterotrichea;Chattonidium;";"0.0";"0";"1";"1";"0";"1";"0";"430523";"5766"
"LOK1378_1mm";"SILVA (only NR);Eukaryota;SAR;Alveolata;Ciliophora;Postciliodesmatophora;Heterotrichea;Climacostomum;";"0.0";"0";"3";"3";"0";"3";"0";"430521";"5766"
"LOK1378_1mm";"SILVA (only NR);Eukaryota;SAR;Alveolata;Ciliophora;Postciliodesmatophora;Heterotrichea;Condylostentor;";"0.0";"0";"2";"2";"0";"2";"0";"430522";"5766"
"LOK1378_1mm";"SILVA (only NR);Eukaryota;SAR;Alveolata;Ciliophora;Postciliodesmatophora;Heterotrichea;Condylostoma;";"0.0";"0";"9";"9";"0";"9";"0";"430515";"5766"
"LOK1378_1mm";"SILVA (only NR);Eukaryota;SAR;Alveolata;Ciliophora;Postciliodesmatophora;Heterotrichea;Eufolliculina;";"0.0";"0";"6";"5";"0";"5";"1";"430519";"5766"
"LOK1378_1mm";"SILVA (only NR);Eukaryota;SAR;Alveolata;Ciliophora;Postciliodesmatophora;Heterotrichea;Fabrea;";"0.0";"0";"2";"2";"0";"2";"0";"430522";"5766"
"LOK1378_1mm";"SILVA (only NR);Eukaryota;SAR;Alveolata;Ciliophora;Postciliodesmatophora;Heterotrichea;Maristentor;";"0.0";"0";"1";"1";"0";"1";"0";"430523";"5766"
"LOK1378_1mm";"SILVA (only NR);Eukaryota;SAR;Alveolata;Ciliophora;Postciliodesmatophora;Heterotrichea;Peritromus;";"0.0";"0";"7";"6";"0";"6";"1";"430518";"5766"
"LOK1378_1mm";"SILVA (only NR);Eukaryota;SAR;Alveolata;Ciliophora;Postciliodesmatophora;Heterotrichea;Spirostomum;";"0.0";"0";"13";"12";"0";"12";"1";"430512";"5766"
"LOK1378_1mm";"SILVA (only NR);Eukaryota;SAR;Alveolata;Ciliophora;Postciliodesmatophora;Heterotrichea;Stentor;";"0.0";"0";"18";"18";"0";"18";"0";"430506";"5766"
"LOK1378_1mm";"SILVA (only NR);Eukaryota;SAR;Alveolata;Ciliophora;Postciliodesmatophora;Heterotrichea;uncultured;";"0.0";"0";"4";"4";"0";"4";"0";"430520";"5766"
"LOK1378_1mm";"SILVA (only NR);Eukaryota;SAR;Alveolata;Ciliophora;Postciliodesmatophora;Karyorelictea;";"0.0";"0";"58";"57";"0";"57";"1";"430467";"5766"
"LOK1378_1mm";"SILVA (only NR);Eukaryota;SAR;Alveolata;Ciliophora;Postciliodesmatophora;Karyorelictea;Apotrachelocerca;";"0.0";"0";"1";"1";"0";"1";"0";"430523";"5766"
"LOK1378_1mm";"SILVA (only NR);Eukaryota;SAR;Alveolata;Ciliophora;Postciliodesmatophora;Karyorelictea;Corlissina;";"0.0";"0";"1";"1";"0";"1";"0";"430523";"5766"
"LOK1378_1mm";"SILVA (only NR);Eukaryota;SAR;Alveolata;Ciliophora;Postciliodesmatophora;Karyorelictea;Geleia;";"0.0";"0";"3";"3";"0";"3";"0";"430521";"5766"
"LOK1378_1mm";"SILVA (only NR);Eukaryota;SAR;Alveolata;Ciliophora;Postciliodesmatophora;Karyorelictea;Kentrophoros;";"0.0";"0";"22";"21";"0";"21";"1";"430503";"5766"
"LOK1378_1mm";"SILVA (only NR);Eukaryota;SAR;Alveolata;Ciliophora;Postciliodesmatophora;Karyorelictea;Kovalevaia;";"0.0";"0";"2";"2";"0";"2";"0";"430522";"5766"
"LOK1378_1mm";"SILVA (only NR);Eukaryota;SAR;Alveolata;Ciliophora;Postciliodesmatophora;Karyorelictea;Loxodes;";"0.0";"0";"2";"2";"0";"2";"0";"430522";"5766"
"LOK1378_1mm";"SILVA (only NR);Eukaryota;SAR;Alveolata;Ciliophora;Postciliodesmatophora;Karyorelictea;Parduczia;";"0.0";"0";"2";"2";"0";"2";"0";"430522";"5766"
"LOK1378_1mm";"SILVA (only NR);Eukaryota;SAR;Alveolata;Ciliophora;Postciliodesmatophora;Karyorelictea;Remanella;";"0.0";"0";"8";"8";"0";"8";"0";"430516";"5766"
"LOK1378_1mm";"SILVA (only NR);Eukaryota;SAR;Alveolata;Ciliophora;Postciliodesmatophora;Karyorelictea;Trachelocerca;";"0.0";"0";"1";"1";"0";"1";"0";"430523";"5766"
"LOK1378_1mm";"SILVA (only NR);Eukaryota;SAR;Alveolata;Ciliophora;Postciliodesmatophora;Karyorelictea;Tracheloraphis;";"0.0";"0";"10";"10";"0";"10";"0";"430514";"5766"
"LOK1378_1mm";"SILVA (only NR);Eukaryota;SAR;Alveolata;Ciliophora;Postciliodesmatophora;Karyorelictea;Wilbertomorpha;";"0.0";"0";"1";"1";"0";"1";"0";"430523";"5766"
"LOK1378_1mm";"SILVA (only NR);Eukaryota;SAR;Alveolata;Dinoflagellata;";"0.0";"0";"1815";"1763";"0";"1763";"52";"428761";"5766"
"LOK1378_1mm";"SILVA (only NR);Eukaryota;SAR;Alveolata;Dinoflagellata;Dinophyceae;";"0.0";"0";"1747";"1696";"0";"1696";"51";"428828";"5766"
"LOK1378_1mm";"SILVA (only NR);Eukaryota;SAR;Alveolata;Dinoflagellata;Dinophyceae;Dinophysiales;";"0.0";"0";"40";"39";"0";"39";"1";"430485";"5766"
"LOK1378_1mm";"SILVA (only NR);Eukaryota;SAR;Alveolata;Dinoflagellata;Dinophyceae;Dinophysiales;Amphisolenia;";"0.0";"0";"2";"2";"0";"2";"0";"430522";"5766"
"LOK1378_1mm";"SILVA (only NR);Eukaryota;SAR;Alveolata;Dinoflagellata;Dinophyceae;Dinophysiales;Dinophysis;";"0.0";"0";"7";"7";"0";"7";"0";"430517";"5766"
"LOK1378_1mm";"SILVA (only NR);Eukaryota;SAR;Alveolata;Dinoflagellata;Dinophyceae;Dinophysiales;Ornithocercus;";"0.0";"0";"2";"2";"0";"2";"0";"430522";"5766"
"LOK1378_1mm";"SILVA (only NR);Eukaryota;SAR;Alveolata;Dinoflagellata;Dinophyceae;Dinophysiales;Phalacroma;";"0.0";"0";"6";"6";"0";"6";"0";"430518";"5766"
"LOK1378_1mm";"SILVA (only NR);Eukaryota;SAR;Alveolata;Dinoflagellata;Dinophyceae;Dinophysiales;Pseudophalacroma;";"0.0";"0";"1";"1";"0";"1";"0";"430523";"5766"
"LOK1378_1mm";"SILVA (only NR);Eukaryota;SAR;Alveolata;Dinoflagellata;Dinophyceae;Dinophysiales;Sinophysis;";"0.0";"0";"19";"18";"0";"18";"1";"430506";"5766"
"LOK1378_1mm";"SILVA (only NR);Eukaryota;SAR;Alveolata;Dinoflagellata;Dinophyceae;Dinophysiales;Triposolenia;";"0.0";"0";"1";"1";"0";"1";"0";"430523";"5766"
"LOK1378_1mm";"SILVA (only NR);Eukaryota;SAR;Alveolata;Dinoflagellata;Dinophyceae;Gymnodiniphycidae;";"0.0";"0";"844";"812";"0";"812";"32";"429712";"5766"
"LOK1378_1mm";"SILVA (only NR);Eukaryota;SAR;Alveolata;Dinoflagellata;Dinophyceae;Gymnodiniphycidae;Amphidinium;";"0.0";"0";"51";"49";"0";"49";"2";"430475";"5766"
"LOK1378_1mm";"SILVA (only NR);Eukaryota;SAR;Alveolata;Dinoflagellata;Dinophyceae;Gymnodiniphycidae;Ankistrodinium;";"0.0";"0";"1";"1";"0";"1";"0";"430523";"5766"
"LOK1378_1mm";"SILVA (only NR);Eukaryota;SAR;Alveolata;Dinoflagellata;Dinophyceae;Gymnodiniphycidae;Gymnodinium clade;";"0.0";"0";"212";"209";"0";"209";"3";"430315";"5766"
"LOK1378_1mm";"SILVA (only NR);Eukaryota;SAR;Alveolata;Dinoflagellata;Dinophyceae;Gymnodiniphycidae;Gymnodinium clade;Chytriodinium;";"0.0";"0";"7";"7";"0";"7";"0";"430517";"5766"
"LOK1378_1mm";"SILVA (only NR);Eukaryota;SAR;Alveolata;Dinoflagellata;Dinophyceae;Gymnodiniphycidae;Gymnodinium clade;Erythropsidinium;";"0.0";"0";"37";"37";"0";"37";"0";"430487";"5766"
"LOK1378_1mm";"SILVA (only NR);Eukaryota;SAR;Alveolata;Dinoflagellata;Dinophyceae;Gymnodiniphycidae;Gymnodinium clade;Gymnodinium;";"0.0";"0";"59";"59";"0";"59";"0";"430465";"5766"
"LOK1378_1mm";"SILVA (only NR);Eukaryota;SAR;Alveolata;Dinoflagellata;Dinophyceae;Gymnodiniphycidae;Gymnodinium clade;Gymnoxanthella;";"0.0";"0";"3";"3";"0";"3";"0";"430521";"5766"
"LOK1378_1mm";"SILVA (only NR);Eukaryota;SAR;Alveolata;Dinoflagellata;Dinophyceae;Gymnodiniphycidae;Gymnodinium clade;Gyrodiniellum;";"0.0";"0";"18";"18";"0";"18";"0";"430506";"5766"
"LOK1378_1mm";"SILVA (only NR);Eukaryota;SAR;Alveolata;Dinoflagellata;Dinophyceae;Gymnodiniphycidae;Gymnodinium clade;Lepidodinium;";"0.0";"0";"8";"8";"0";"8";"0";"430516";"5766"
"LOK1378_1mm";"SILVA (only NR);Eukaryota;SAR;Alveolata;Dinoflagellata;Dinophyceae;Gymnodiniphycidae;Gymnodinium clade;Nematodinium;";"0.0";"0";"2";"2";"0";"2";"0";"430522";"5766"
"LOK1378_1mm";"SILVA (only NR);Eukaryota;SAR;Alveolata;Dinoflagellata;Dinophyceae;Gymnodiniphycidae;Gymnodinium clade;Nusuttodinium;";"0.0";"0";"8";"8";"0";"8";"0";"430516";"5766"
"LOK1378_1mm";"SILVA (only NR);Eukaryota;SAR;Alveolata;Dinoflagellata;Dinophyceae;Gymnodiniphycidae;Gymnodinium clade;Paragymnodinium;";"0.0";"0";"7";"7";"0";"7";"0";"430517";"5766"
"LOK1378_1mm";"SILVA (only NR);Eukaryota;SAR;Alveolata;Dinoflagellata;Dinophyceae;Gymnodiniphycidae;Gymnodinium clade;Pellucidodinium;";"0.0";"0";"2";"2";"0";"2";"0";"430522";"5766"
"LOK1378_1mm";"SILVA (only NR);Eukaryota;SAR;Alveolata;Dinoflagellata;Dinophyceae;Gymnodiniphycidae;Gymnodinium clade;Pheopolykrikos;";"0.0";"0";"2";"2";"0";"2";"0";"430522";"5766"
"LOK1378_1mm";"SILVA (only NR);Eukaryota;SAR;Alveolata;Dinoflagellata;Dinophyceae;Gymnodiniphycidae;Gymnodinium clade;Polykrikos;";"0.0";"0";"7";"6";"0";"6";"1";"430518";"5766"
"LOK1378_1mm";"SILVA (only NR);Eukaryota;SAR;Alveolata;Dinoflagellata;Dinophyceae;Gymnodiniphycidae;Gymnodinium clade;Proterythropsis;";"0.0";"0";"1";"1";"0";"1";"0";"430523";"5766"
"LOK1378_1mm";"SILVA (only NR);Eukaryota;SAR;Alveolata;Dinoflagellata;Dinophyceae;Gymnodiniphycidae;Gymnodinium clade;Spiniferodinium;";"0.0";"0";"2";"2";"0";"2";"0";"430522";"5766"
"LOK1378_1mm";"SILVA (only NR);Eukaryota;SAR;Alveolata;Dinoflagellata;Dinophyceae;Gymnodiniphycidae;Gymnodinium clade;Warnowia;";"0.0";"0";"3";"3";"0";"3";"0";"430521";"5766"
"LOK1378_1mm";"SILVA (only NR);Eukaryota;SAR;Alveolata;Dinoflagellata;Dinophyceae;Gymnodiniphycidae;Gymnodinium clade;Woloszynskia;";"0.0";"0";"11";"11";"0";"11";"0";"430513";"5766"
"LOK1378_1mm";"SILVA (only NR);Eukaryota;SAR;Alveolata;Dinoflagellata;Dinophyceae;Gymnodiniphycidae;Gymnodinium clade;uncultured;";"0.0";"0";"22";"20";"0";"20";"2";"430504";"5766"
"LOK1378_1mm";"SILVA (only NR);Eukaryota;SAR;Alveolata;Dinoflagellata;Dinophyceae;Gymnodiniphycidae;Gyrodinium;";"0.0";"0";"217";"209";"0";"209";"8";"430315";"5766"
"LOK1378_1mm";"SILVA (only NR);Eukaryota;SAR;Alveolata;Dinoflagellata;Dinophyceae;Gymnodiniphycidae;Incertae Sedis;";"0.0";"0";"42";"38";"0";"38";"4";"430486";"5766"
"LOK1378_1mm";"SILVA (only NR);Eukaryota;SAR;Alveolata;Dinoflagellata;Dinophyceae;Gymnodiniphycidae;Incertae Sedis;Akashiwo;";"0.0";"0";"19";"19";"0";"19";"0";"430505";"5766"
"LOK1378_1mm";"SILVA (only NR);Eukaryota;SAR;Alveolata;Dinoflagellata;Dinophyceae;Gymnodiniphycidae;Incertae Sedis;Apicoporus;";"0.0";"0";"5";"5";"0";"5";"0";"430519";"5766"
"LOK1378_1mm";"SILVA (only NR);Eukaryota;SAR;Alveolata;Dinoflagellata;Dinophyceae;Gymnodiniphycidae;Incertae Sedis;Cochlodinium;";"0.0";"0";"18";"14";"0";"14";"4";"430510";"5766"
"LOK1378_1mm";"SILVA (only NR);Eukaryota;SAR;Alveolata;Dinoflagellata;Dinophyceae;Gymnodiniphycidae;Kareniaceae;";"0.0";"0";"122";"116";"0";"116";"6";"430408";"5766"
"LOK1378_1mm";"SILVA (only NR);Eukaryota;SAR;Alveolata;Dinoflagellata;Dinophyceae;Gymnodiniphycidae;Kareniaceae;Karenia;";"0.0";"0";"4";"3";"0";"3";"1";"430521";"5766"
"LOK1378_1mm";"SILVA (only NR);Eukaryota;SAR;Alveolata;Dinoflagellata;Dinophyceae;Gymnodiniphycidae;Kareniaceae;Karlodinium;";"0.0";"0";"112";"107";"0";"107";"5";"430417";"5766"
"LOK1378_1mm";"SILVA (only NR);Eukaryota;SAR;Alveolata;Dinoflagellata;Dinophyceae;Gymnodiniphycidae;Kareniaceae;Takayama;";"0.0";"0";"4";"4";"0";"4";"0";"430520";"5766"
"LOK1378_1mm";"SILVA (only NR);Eukaryota;SAR;Alveolata;Dinoflagellata;Dinophyceae;Gymnodiniphycidae;Katodinium;";"0.0";"0";"9";"9";"0";"9";"0";"430515";"5766"
"LOK1378_1mm";"SILVA (only NR);Eukaryota;SAR;Alveolata;Dinoflagellata;Dinophyceae;Gymnodiniphycidae;Moestrupia;";"0.0";"0";"3";"3";"0";"3";"0";"430521";"5766"
"LOK1378_1mm";"SILVA (only NR);Eukaryota;SAR;Alveolata;Dinoflagellata;Dinophyceae;Gymnodiniphycidae;Ptychodiscus;";"0.0";"0";"9";"9";"0";"9";"0";"430515";"5766"
"LOK1378_1mm";"SILVA (only NR);Eukaryota;SAR;Alveolata;Dinoflagellata;Dinophyceae;Gymnodiniphycidae;Suessiaceae;";"0.0";"0";"146";"138";"0";"138";"8";"430386";"5766"
"LOK1378_1mm";"SILVA (only NR);Eukaryota;SAR;Alveolata;Dinoflagellata;Dinophyceae;Gymnodiniphycidae;Suessiaceae;Ansanella;";"0.0";"0";"1";"1";"0";"1";"0";"430523";"5766"
"LOK1378_1mm";"SILVA (only NR);Eukaryota;SAR;Alveolata;Dinoflagellata;Dinophyceae;Gymnodiniphycidae;Suessiaceae;Biecheleria;";"0.0";"0";"16";"14";"0";"14";"2";"430510";"5766"
"LOK1378_1mm";"SILVA (only NR);Eukaryota;SAR;Alveolata;Dinoflagellata;Dinophyceae;Gymnodiniphycidae;Suessiaceae;Pelagodinium;";"0.0";"0";"13";"13";"0";"13";"0";"430511";"5766"
"LOK1378_1mm";"SILVA (only NR);Eukaryota;SAR;Alveolata;Dinoflagellata;Dinophyceae;Gymnodiniphycidae;Suessiaceae;Polarella;";"0.0";"0";"4";"4";"0";"4";"0";"430520";"5766"
"LOK1378_1mm";"SILVA (only NR);Eukaryota;SAR;Alveolata;Dinoflagellata;Dinophyceae;Gymnodiniphycidae;Suessiaceae;Protodinium;";"0.0";"0";"2";"2";"0";"2";"0";"430522";"5766"
"LOK1378_1mm";"SILVA (only NR);Eukaryota;SAR;Alveolata;Dinoflagellata;Dinophyceae;Gymnodiniphycidae;Suessiaceae;Symbiodinium;";"0.0";"0";"103";"98";"0";"98";"5";"430426";"5766"
"LOK1378_1mm";"SILVA (only NR);Eukaryota;SAR;Alveolata;Dinoflagellata;Dinophyceae;Gymnodiniphycidae;Suessiaceae;uncultured;";"0.0";"0";"5";"4";"0";"4";"1";"430520";"5766"
"LOK1378_1mm";"SILVA (only NR);Eukaryota;SAR;Alveolata;Dinoflagellata;Dinophyceae;Gymnodiniphycidae;Tovelliaceae;";"0.0";"0";"5";"5";"0";"5";"0";"430519";"5766"
"LOK1378_1mm";"SILVA (only NR);Eukaryota;SAR;Alveolata;Dinoflagellata;Dinophyceae;Gymnodiniphycidae;Tovelliaceae;Esoptrodinium;";"0.0";"0";"2";"2";"0";"2";"0";"430522";"5766"
"LOK1378_1mm";"SILVA (only NR);Eukaryota;SAR;Alveolata;Dinoflagellata;Dinophyceae;Gymnodiniphycidae;Tovelliaceae;Jadwigia;";"0.0";"0";"3";"3";"0";"3";"0";"430521";"5766"
"LOK1378_1mm";"SILVA (only NR);Eukaryota;SAR;Alveolata;Dinoflagellata;Dinophyceae;Gymnodiniphycidae;uncultured;";"0.0";"0";"17";"17";"0";"17";"0";"430507";"5766"
"LOK1378_1mm";"SILVA (only NR);Eukaryota;SAR;Alveolata;Dinoflagellata;Dinophyceae;Incertae Sedis;";"0.0";"0";"8";"8";"0";"8";"0";"430516";"5766"
"LOK1378_1mm";"SILVA (only NR);Eukaryota;SAR;Alveolata;Dinoflagellata;Dinophyceae;Incertae Sedis;Ailadinium;";"0.0";"0";"1";"1";"0";"1";"0";"430523";"5766"
"LOK1378_1mm";"SILVA (only NR);Eukaryota;SAR;Alveolata;Dinoflagellata;Dinophyceae;Incertae Sedis;Halostylodinium;";"0.0";"0";"2";"2";"0";"2";"0";"430522";"5766"
"LOK1378_1mm";"SILVA (only NR);Eukaryota;SAR;Alveolata;Dinoflagellata;Dinophyceae;Incertae Sedis;Madanidinium;";"0.0";"0";"2";"2";"0";"2";"0";"430522";"5766"
"LOK1378_1mm";"SILVA (only NR);Eukaryota;SAR;Alveolata;Dinoflagellata;Dinophyceae;Incertae Sedis;Pileidinium;";"0.0";"0";"1";"1";"0";"1";"0";"430523";"5766"
"LOK1378_1mm";"SILVA (only NR);Eukaryota;SAR;Alveolata;Dinoflagellata;Dinophyceae;Incertae Sedis;Sabulodinium;";"0.0";"0";"2";"2";"0";"2";"0";"430522";"5766"
"LOK1378_1mm";"SILVA (only NR);Eukaryota;SAR;Alveolata;Dinoflagellata;Dinophyceae;Peridiniphycidae;";"0.0";"0";"584";"574";"0";"574";"10";"429950";"5766"
"LOK1378_1mm";"SILVA (only NR);Eukaryota;SAR;Alveolata;Dinoflagellata;Dinophyceae;Peridiniphycidae;Gonyaulacales;";"0.0";"0";"312";"306";"0";"306";"6";"430218";"5766"
"LOK1378_1mm";"SILVA (only NR);Eukaryota;SAR;Alveolata;Dinoflagellata;Dinophyceae;Peridiniphycidae;Gonyaulacales;Adenoides;";"0.0";"0";"2";"2";"0";"2";"0";"430522";"5766"
"LOK1378_1mm";"SILVA (only NR);Eukaryota;SAR;Alveolata;Dinoflagellata;Dinophyceae;Peridiniphycidae;Gonyaulacales;Alexandrium;";"0.0";"0";"42";"40";"0";"40";"2";"430484";"5766"
"LOK1378_1mm";"SILVA (only NR);Eukaryota;SAR;Alveolata;Dinoflagellata;Dinophyceae;Peridiniphycidae;Gonyaulacales;Amphidoma;";"0.0";"0";"1";"1";"0";"1";"0";"430523";"5766"
"LOK1378_1mm";"SILVA (only NR);Eukaryota;SAR;Alveolata;Dinoflagellata;Dinophyceae;Peridiniphycidae;Gonyaulacales;Amylax;";"0.0";"0";"1";"1";"0";"1";"0";"430523";"5766"
"LOK1378_1mm";"SILVA (only NR);Eukaryota;SAR;Alveolata;Dinoflagellata;Dinophyceae;Peridiniphycidae;Gonyaulacales;Azadinium;";"0.0";"0";"114";"113";"0";"113";"1";"430411";"5766"
"LOK1378_1mm";"SILVA (only NR);Eukaryota;SAR;Alveolata;Dinoflagellata;Dinophyceae;Peridiniphycidae;Gonyaulacales;Ceratium;";"0.0";"0";"11";"11";"0";"11";"0";"430513";"5766"
"LOK1378_1mm";"SILVA (only NR);Eukaryota;SAR;Alveolata;Dinoflagellata;Dinophyceae;Peridiniphycidae;Gonyaulacales;Ceratocorys;";"0.0";"0";"2";"2";"0";"2";"0";"430522";"5766"
"LOK1378_1mm";"SILVA (only NR);Eukaryota;SAR;Alveolata;Dinoflagellata;Dinophyceae;Peridiniphycidae;Gonyaulacales;Coolia;";"0.0";"0";"5";"5";"0";"5";"0";"430519";"5766"
"LOK1378_1mm";"SILVA (only NR);Eukaryota;SAR;Alveolata;Dinoflagellata;Dinophyceae;Peridiniphycidae;Gonyaulacales;Dapsilidinium;";"0.0";"0";"1";"1";"0";"1";"0";"430523";"5766"
"LOK1378_1mm";"SILVA (only NR);Eukaryota;SAR;Alveolata;Dinoflagellata;Dinophyceae;Peridiniphycidae;Gonyaulacales;Fragilidium;";"0.0";"0";"3";"3";"0";"3";"0";"430521";"5766"
"LOK1378_1mm";"SILVA (only NR);Eukaryota;SAR;Alveolata;Dinoflagellata;Dinophyceae;Peridiniphycidae;Gonyaulacales;Gambierdiscus;";"0.0";"0";"64";"64";"0";"64";"0";"430460";"5766"
"LOK1378_1mm";"SILVA (only NR);Eukaryota;SAR;Alveolata;Dinoflagellata;Dinophyceae;Peridiniphycidae;Gonyaulacales;Goniodoma;";"0.0";"0";"1";"1";"0";"1";"0";"430523";"5766"
"LOK1378_1mm";"SILVA (only NR);Eukaryota;SAR;Alveolata;Dinoflagellata;Dinophyceae;Peridiniphycidae;Gonyaulacales;Gonyaulax;";"0.0";"0";"24";"22";"0";"22";"2";"430502";"5766"
"LOK1378_1mm";"SILVA (only NR);Eukaryota;SAR;Alveolata;Dinoflagellata;Dinophyceae;Peridiniphycidae;Gonyaulacales;Grammatodinium;";"0.0";"0";"1";"1";"0";"1";"0";"430523";"5766"
"LOK1378_1mm";"SILVA (only NR);Eukaryota;SAR;Alveolata;Dinoflagellata;Dinophyceae;Peridiniphycidae;Gonyaulacales;Heterodinium;";"0.0";"0";"8";"8";"0";"8";"0";"430516";"5766"
"LOK1378_1mm";"SILVA (only NR);Eukaryota;SAR;Alveolata;Dinoflagellata;Dinophyceae;Peridiniphycidae;Gonyaulacales;Lingulodinium;";"0.0";"0";"6";"5";"0";"5";"1";"430519";"5766"
"LOK1378_1mm";"SILVA (only NR);Eukaryota;SAR;Alveolata;Dinoflagellata;Dinophyceae;Peridiniphycidae;Gonyaulacales;Neoceratium;";"0.0";"0";"7";"7";"0";"7";"0";"430517";"5766"
"LOK1378_1mm";"SILVA (only NR);Eukaryota;SAR;Alveolata;Dinoflagellata;Dinophyceae;Peridiniphycidae;Gonyaulacales;Ostreopsis;";"0.0";"0";"7";"7";"0";"7";"0";"430517";"5766"
"LOK1378_1mm";"SILVA (only NR);Eukaryota;SAR;Alveolata;Dinoflagellata;Dinophyceae;Peridiniphycidae;Gonyaulacales;Posoniella;";"0.0";"0";"1";"1";"0";"1";"0";"430523";"5766"
"LOK1378_1mm";"SILVA (only NR);Eukaryota;SAR;Alveolata;Dinoflagellata;Dinophyceae;Peridiniphycidae;Gonyaulacales;Protoceratium;";"0.0";"0";"2";"2";"0";"2";"0";"430522";"5766"
"LOK1378_1mm";"SILVA (only NR);Eukaryota;SAR;Alveolata;Dinoflagellata;Dinophyceae;Peridiniphycidae;Gonyaulacales;Pyrocystis;";"0.0";"0";"2";"2";"0";"2";"0";"430522";"5766"
"LOK1378_1mm";"SILVA (only NR);Eukaryota;SAR;Alveolata;Dinoflagellata;Dinophyceae;Peridiniphycidae;Gonyaulacales;Pyrodinium;";"0.0";"0";"2";"2";"0";"2";"0";"430522";"5766"
"LOK1378_1mm";"SILVA (only NR);Eukaryota;SAR;Alveolata;Dinoflagellata;Dinophyceae;Peridiniphycidae;Gonyaulacales;Pyrophacus;";"0.0";"0";"1";"1";"0";"1";"0";"430523";"5766"
"LOK1378_1mm";"SILVA (only NR);Eukaryota;SAR;Alveolata;Dinoflagellata;Dinophyceae;Peridiniphycidae;Gonyaulacales;Pyxidinopsis;";"0.0";"0";"1";"1";"0";"1";"0";"430523";"5766"
"LOK1378_1mm";"SILVA (only NR);Eukaryota;SAR;Alveolata;Dinoflagellata;Dinophyceae;Peridiniphycidae;Gonyaulacales;Thecadinium;";"0.0";"0";"1";"1";"0";"1";"0";"430523";"5766"
"LOK1378_1mm";"SILVA (only NR);Eukaryota;SAR;Alveolata;Dinoflagellata;Dinophyceae;Peridiniphycidae;Gonyaulacales;uncultured;";"0.0";"0";"2";"2";"0";"2";"0";"430522";"5766"
"LOK1378_1mm";"SILVA (only NR);Eukaryota;SAR;Alveolata;Dinoflagellata;Dinophyceae;Peridiniphycidae;Peridiniales;";"0.0";"0";"204";"204";"0";"204";"0";"430320";"5766"
"LOK1378_1mm";"SILVA (only NR);Eukaryota;SAR;Alveolata;Dinoflagellata;Dinophyceae;Peridiniphycidae;Peridiniales;Aduncodinium;";"0.0";"0";"3";"3";"0";"3";"0";"430521";"5766"
"LOK1378_1mm";"SILVA (only NR);Eukaryota;SAR;Alveolata;Dinoflagellata;Dinophyceae;Peridiniphycidae;Peridiniales;Amphidiniella;";"0.0";"0";"1";"1";"0";"1";"0";"430523";"5766"
"LOK1378_1mm";"SILVA (only NR);Eukaryota;SAR;Alveolata;Dinoflagellata;Dinophyceae;Peridiniphycidae;Peridiniales;Amphidiniopsis;";"0.0";"0";"17";"17";"0";"17";"0";"430507";"5766"
"LOK1378_1mm";"SILVA (only NR);Eukaryota;SAR;Alveolata;Dinoflagellata;Dinophyceae;Peridiniphycidae;Peridiniales;Archaeperidinium;";"0.0";"0";"1";"1";"0";"1";"0";"430523";"5766"
"LOK1378_1mm";"SILVA (only NR);Eukaryota;SAR;Alveolata;Dinoflagellata;Dinophyceae;Peridiniphycidae;Peridiniales;Balechina;";"0.0";"0";"3";"3";"0";"3";"0";"430521";"5766"
"LOK1378_1mm";"SILVA (only NR);Eukaryota;SAR;Alveolata;Dinoflagellata;Dinophyceae;Peridiniphycidae;Peridiniales;Blixaea;";"0.0";"0";"1";"1";"0";"1";"0";"430523";"5766"
"LOK1378_1mm";"SILVA (only NR);Eukaryota;SAR;Alveolata;Dinoflagellata;Dinophyceae;Peridiniphycidae;Peridiniales;Crypthecodinium;";"0.0";"0";"4";"4";"0";"4";"0";"430520";"5766"
"LOK1378_1mm";"SILVA (only NR);Eukaryota;SAR;Alveolata;Dinoflagellata;Dinophyceae;Peridiniphycidae;Peridiniales;Cystodinium;";"0.0";"0";"1";"1";"0";"1";"0";"430523";"5766"
"LOK1378_1mm";"SILVA (only NR);Eukaryota;SAR;Alveolata;Dinoflagellata;Dinophyceae;Peridiniphycidae;Peridiniales;Diplopsalis;";"0.0";"0";"1";"1";"0";"1";"0";"430523";"5766"
"LOK1378_1mm";"SILVA (only NR);Eukaryota;SAR;Alveolata;Dinoflagellata;Dinophyceae;Peridiniphycidae;Peridiniales;Diplosalopsis;";"0.0";"0";"1";"1";"0";"1";"0";"430523";"5766"
"LOK1378_1mm";"SILVA (only NR);Eukaryota;SAR;Alveolata;Dinoflagellata;Dinophyceae;Peridiniphycidae;Peridiniales;Durinskia;";"0.0";"0";"6";"6";"0";"6";"0";"430518";"5766"
"LOK1378_1mm";"SILVA (only NR);Eukaryota;SAR;Alveolata;Dinoflagellata;Dinophyceae;Peridiniphycidae;Peridiniales;Galeidinium;";"0.0";"0";"1";"1";"0";"1";"0";"430523";"5766"
"LOK1378_1mm";"SILVA (only NR);Eukaryota;SAR;Alveolata;Dinoflagellata;Dinophyceae;Peridiniphycidae;Peridiniales;Glenodiniopsis;";"0.0";"0";"2";"2";"0";"2";"0";"430522";"5766"
"LOK1378_1mm";"SILVA (only NR);Eukaryota;SAR;Alveolata;Dinoflagellata;Dinophyceae;Peridiniphycidae;Peridiniales;Glenodinium;";"0.0";"0";"3";"3";"0";"3";"0";"430521";"5766"
"LOK1378_1mm";"SILVA (only NR);Eukaryota;SAR;Alveolata;Dinoflagellata;Dinophyceae;Peridiniphycidae;Peridiniales;Gotoius;";"0.0";"0";"1";"1";"0";"1";"0";"430523";"5766"
"LOK1378_1mm";"SILVA (only NR);Eukaryota;SAR;Alveolata;Dinoflagellata;Dinophyceae;Peridiniphycidae;Peridiniales;Hemidinium;";"0.0";"0";"1";"1";"0";"1";"0";"430523";"5766"
"LOK1378_1mm";"SILVA (only NR);Eukaryota;SAR;Alveolata;Dinoflagellata;Dinophyceae;Peridiniphycidae;Peridiniales;Herdmania;";"0.0";"0";"2";"2";"0";"2";"0";"430522";"5766"
"LOK1378_1mm";"SILVA (only NR);Eukaryota;SAR;Alveolata;Dinoflagellata;Dinophyceae;Peridiniphycidae;Peridiniales;Heterocapsa;";"0.0";"0";"29";"29";"0";"29";"0";"430495";"5766"
"LOK1378_1mm";"SILVA (only NR);Eukaryota;SAR;Alveolata;Dinoflagellata;Dinophyceae;Peridiniphycidae;Peridiniales;Islandinium;";"0.0";"0";"5";"5";"0";"5";"0";"430519";"5766"
"LOK1378_1mm";"SILVA (only NR);Eukaryota;SAR;Alveolata;Dinoflagellata;Dinophyceae;Peridiniphycidae;Peridiniales;Kryptoperidinium;";"0.0";"0";"2";"2";"0";"2";"0";"430522";"5766"
"LOK1378_1mm";"SILVA (only NR);Eukaryota;SAR;Alveolata;Dinoflagellata;Dinophyceae;Peridiniphycidae;Peridiniales;Niea;";"0.0";"0";"2";"2";"0";"2";"0";"430522";"5766"
"LOK1378_1mm";"SILVA (only NR);Eukaryota;SAR;Alveolata;Dinoflagellata;Dinophyceae;Peridiniphycidae;Peridiniales;Peridiniopsis;";"0.0";"0";"3";"3";"0";"3";"0";"430521";"5766"
"LOK1378_1mm";"SILVA (only NR);Eukaryota;SAR;Alveolata;Dinoflagellata;Dinophyceae;Peridiniphycidae;Peridiniales;Peridinium;";"0.0";"0";"32";"32";"0";"32";"0";"430492";"5766"
"LOK1378_1mm";"SILVA (only NR);Eukaryota;SAR;Alveolata;Dinoflagellata;Dinophyceae;Peridiniphycidae;Peridiniales;Preperidinium;";"0.0";"0";"1";"1";"0";"1";"0";"430523";"5766"
"LOK1378_1mm";"SILVA (only NR);Eukaryota;SAR;Alveolata;Dinoflagellata;Dinophyceae;Peridiniphycidae;Peridiniales;Protoperidinium;";"0.0";"0";"62";"62";"0";"62";"0";"430462";"5766"
"LOK1378_1mm";"SILVA (only NR);Eukaryota;SAR;Alveolata;Dinoflagellata;Dinophyceae;Peridiniphycidae;Peridiniales;Pyramidodinium;";"0.0";"0";"2";"2";"0";"2";"0";"430522";"5766"
"LOK1378_1mm";"SILVA (only NR);Eukaryota;SAR;Alveolata;Dinoflagellata;Dinophyceae;Peridiniphycidae;Peridiniales;Qia;";"0.0";"0";"1";"1";"0";"1";"0";"430523";"5766"
"LOK1378_1mm";"SILVA (only NR);Eukaryota;SAR;Alveolata;Dinoflagellata;Dinophyceae;Peridiniphycidae;Peridiniales;Stylodinium;";"0.0";"0";"1";"1";"0";"1";"0";"430523";"5766"
"LOK1378_1mm";"SILVA (only NR);Eukaryota;SAR;Alveolata;Dinoflagellata;Dinophyceae;Peridiniphycidae;Peridiniales;Thecate;";"0.0";"0";"1";"1";"0";"1";"0";"430523";"5766"
"LOK1378_1mm";"SILVA (only NR);Eukaryota;SAR;Alveolata;Dinoflagellata;Dinophyceae;Peridiniphycidae;Peridiniales;uncultured;";"0.0";"0";"7";"7";"0";"7";"0";"430517";"5766"
"LOK1378_1mm";"SILVA (only NR);Eukaryota;SAR;Alveolata;Dinoflagellata;Dinophyceae;Peridiniphycidae;Podolampadaceae;";"0.0";"0";"10";"10";"0";"10";"0";"430514";"5766"
"LOK1378_1mm";"SILVA (only NR);Eukaryota;SAR;Alveolata;Dinoflagellata;Dinophyceae;Peridiniphycidae;Podolampadaceae;Lessardia;";"0.0";"0";"6";"6";"0";"6";"0";"430518";"5766"
"LOK1378_1mm";"SILVA (only NR);Eukaryota;SAR;Alveolata;Dinoflagellata;Dinophyceae;Peridiniphycidae;Podolampadaceae;Podolampas;";"0.0";"0";"1";"1";"0";"1";"0";"430523";"5766"
"LOK1378_1mm";"SILVA (only NR);Eukaryota;SAR;Alveolata;Dinoflagellata;Dinophyceae;Peridiniphycidae;Podolampadaceae;Roscoffia;";"0.0";"0";"2";"2";"0";"2";"0";"430522";"5766"
"LOK1378_1mm";"SILVA (only NR);Eukaryota;SAR;Alveolata;Dinoflagellata;Dinophyceae;Peridiniphycidae;Thoracosphaeraceae;";"0.0";"0";"58";"54";"0";"54";"4";"430470";"5766"
"LOK1378_1mm";"SILVA (only NR);Eukaryota;SAR;Alveolata;Dinoflagellata;Dinophyceae;Peridiniphycidae;Thoracosphaeraceae;Cryptoperidiniopsis;";"0.0";"0";"5";"5";"0";"5";"0";"430519";"5766"
"LOK1378_1mm";"SILVA (only NR);Eukaryota;SAR;Alveolata;Dinoflagellata;Dinophyceae;Peridiniphycidae;Thoracosphaeraceae;Gloeodinium;";"0.0";"0";"2";"1";"0";"1";"1";"430523";"5766"
"LOK1378_1mm";"SILVA (only NR);Eukaryota;SAR;Alveolata;Dinoflagellata;Dinophyceae;Peridiniphycidae;Thoracosphaeraceae;Oodinium;";"0.0";"0";"8";"6";"0";"6";"2";"430518";"5766"
"LOK1378_1mm";"SILVA (only NR);Eukaryota;SAR;Alveolata;Dinoflagellata;Dinophyceae;Peridiniphycidae;Thoracosphaeraceae;Pentapharsodinium;";"0.0";"0";"6";"6";"0";"6";"0";"430518";"5766"
"LOK1378_1mm";"SILVA (only NR);Eukaryota;SAR;Alveolata;Dinoflagellata;Dinophyceae;Peridiniphycidae;Thoracosphaeraceae;Pfiesteria;";"0.0";"0";"9";"9";"0";"9";"0";"430515";"5766"
"LOK1378_1mm";"SILVA (only NR);Eukaryota;SAR;Alveolata;Dinoflagellata;Dinophyceae;Peridiniphycidae;Thoracosphaeraceae;Scrippsiella;";"0.0";"0";"14";"13";"0";"13";"1";"430511";"5766"
"LOK1378_1mm";"SILVA (only NR);Eukaryota;SAR;Alveolata;Dinoflagellata;Dinophyceae;Peridiniphycidae;Thoracosphaeraceae;Stoeckeria;";"0.0";"0";"1";"1";"0";"1";"0";"430523";"5766"
"LOK1378_1mm";"SILVA (only NR);Eukaryota;SAR;Alveolata;Dinoflagellata;Dinophyceae;Peridiniphycidae;Thoracosphaeraceae;Thoracosphaera;";"0.0";"0";"2";"2";"0";"2";"0";"430522";"5766"
"LOK1378_1mm";"SILVA (only NR);Eukaryota;SAR;Alveolata;Dinoflagellata;Dinophyceae;Peridiniphycidae;Thoracosphaeraceae;Tintinnophagus;";"0.0";"0";"1";"1";"0";"1";"0";"430523";"5766"
"LOK1378_1mm";"SILVA (only NR);Eukaryota;SAR;Alveolata;Dinoflagellata;Dinophyceae;Peridiniphycidae;Thoracosphaeraceae;uncultured;";"0.0";"0";"5";"5";"0";"5";"0";"430519";"5766"
"LOK1378_1mm";"SILVA (only NR);Eukaryota;SAR;Alveolata;Dinoflagellata;Dinophyceae;Prorocentrales;";"0.0";"0";"44";"42";"0";"42";"2";"430482";"5766"
"LOK1378_1mm";"SILVA (only NR);Eukaryota;SAR;Alveolata;Dinoflagellata;Dinophyceae;Prorocentrales;Plagiodinium;";"0.0";"0";"3";"3";"0";"3";"0";"430521";"5766"
"LOK1378_1mm";"SILVA (only NR);Eukaryota;SAR;Alveolata;Dinoflagellata;Dinophyceae;Prorocentrales;Prorocentrum;";"0.0";"0";"41";"39";"0";"39";"2";"430485";"5766"
"LOK1378_1mm";"SILVA (only NR);Eukaryota;SAR;Alveolata;Dinoflagellata;Dinophyceae;uncultured;";"0.0";"0";"194";"192";"0";"192";"2";"430332";"5766"
"LOK1378_1mm";"SILVA (only NR);Eukaryota;SAR;Alveolata;Dinoflagellata;Incertae Sedis;";"0.0";"0";"39";"39";"0";"39";"0";"430485";"5766"
"LOK1378_1mm";"SILVA (only NR);Eukaryota;SAR;Alveolata;Dinoflagellata;Incertae Sedis;Blastodinium;";"0.0";"0";"24";"24";"0";"24";"0";"430500";"5766"
"LOK1378_1mm";"SILVA (only NR);Eukaryota;SAR;Alveolata;Dinoflagellata;Incertae Sedis;Haplozoon;";"0.0";"0";"7";"7";"0";"7";"0";"430517";"5766"
"LOK1378_1mm";"SILVA (only NR);Eukaryota;SAR;Alveolata;Dinoflagellata;Incertae Sedis;Paulsenella;";"0.0";"0";"1";"1";"0";"1";"0";"430523";"5766"
"LOK1378_1mm";"SILVA (only NR);Eukaryota;SAR;Alveolata;Dinoflagellata;Noctilucales;";"0.0";"0";"11";"10";"0";"10";"1";"430514";"5766"
"LOK1378_1mm";"SILVA (only NR);Eukaryota;SAR;Alveolata;Dinoflagellata;Noctilucales;Abedinium;";"0.0";"0";"4";"4";"0";"4";"0";"430520";"5766"
"LOK1378_1mm";"SILVA (only NR);Eukaryota;SAR;Alveolata;Dinoflagellata;Noctilucales;Kofoidinium;";"0.0";"0";"1";"1";"0";"1";"0";"430523";"5766"
"LOK1378_1mm";"SILVA (only NR);Eukaryota;SAR;Alveolata;Dinoflagellata;Noctilucales;Noctiluca;";"0.0";"0";"2";"2";"0";"2";"0";"430522";"5766"
"LOK1378_1mm";"SILVA (only NR);Eukaryota;SAR;Alveolata;Dinoflagellata;Noctilucales;Spatulodinium;";"0.0";"0";"1";"1";"0";"1";"0";"430523";"5766"
"LOK1378_1mm";"SILVA (only NR);Eukaryota;SAR;Alveolata;Dinoflagellata;uncultured;";"0.0";"0";"11";"11";"0";"11";"0";"430513";"5766"
"LOK1378_1mm";"SILVA (only NR);Eukaryota;SAR;Alveolata;Incertae Sedis;";"0.0";"0";"7";"7";"0";"7";"0";"430517";"5766"
"LOK1378_1mm";"SILVA (only NR);Eukaryota;SAR;Alveolata;Incertae Sedis;Colponema;";"0.0";"0";"7";"7";"0";"7";"0";"430517";"5766"
"LOK1378_1mm";"SILVA (only NR);Eukaryota;SAR;Alveolata;Protalveolata;";"0.0";"0";"3050";"3008";"0";"3008";"42";"427516";"5766"
"LOK1378_1mm";"SILVA (only NR);Eukaryota;SAR;Alveolata;Protalveolata;Chromerida;";"0.0";"0";"3";"3";"0";"3";"0";"430521";"5766"
"LOK1378_1mm";"SILVA (only NR);Eukaryota;SAR;Alveolata;Protalveolata;Chromerida;Chromera;";"0.0";"0";"3";"3";"0";"3";"0";"430521";"5766"
"LOK1378_1mm";"SILVA (only NR);Eukaryota;SAR;Alveolata;Protalveolata;Colpodellida;";"0.0";"0";"228";"225";"0";"225";"3";"430299";"5766"
"LOK1378_1mm";"SILVA (only NR);Eukaryota;SAR;Alveolata;Protalveolata;Colpodellida;Colpodella;";"0.0";"0";"222";"219";"0";"219";"3";"430305";"5766"
"LOK1378_1mm";"SILVA (only NR);Eukaryota;SAR;Alveolata;Protalveolata;Colpodellida;Voromonas;";"0.0";"0";"2";"2";"0";"2";"0";"430522";"5766"
"LOK1378_1mm";"SILVA (only NR);Eukaryota;SAR;Alveolata;Protalveolata;Incertae Sedis;";"0.0";"0";"10";"10";"0";"10";"0";"430514";"5766"
"LOK1378_1mm";"SILVA (only NR);Eukaryota;SAR;Alveolata;Protalveolata;Incertae Sedis;Ellobiopsidae;";"0.0";"0";"10";"10";"0";"10";"0";"430514";"5766"
"LOK1378_1mm";"SILVA (only NR);Eukaryota;SAR;Alveolata;Protalveolata;Incertae Sedis;Ellobiopsidae;Ellobiopsis;";"0.0";"0";"5";"5";"0";"5";"0";"430519";"5766"
"LOK1378_1mm";"SILVA (only NR);Eukaryota;SAR;Alveolata;Protalveolata;Incertae Sedis;Ellobiopsidae;Thalassomyces;";"0.0";"0";"3";"3";"0";"3";"0";"430521";"5766"
"LOK1378_1mm";"SILVA (only NR);Eukaryota;SAR;Alveolata;Protalveolata;Incertae Sedis;Ellobiopsidae;uncultured;";"0.0";"0";"2";"2";"0";"2";"0";"430522";"5766"
"LOK1378_1mm";"SILVA (only NR);Eukaryota;SAR;Alveolata;Protalveolata;Oxyrrhis;";"0.0";"0";"12";"12";"0";"12";"0";"430512";"5766"
"LOK1378_1mm";"SILVA (only NR);Eukaryota;SAR;Alveolata;Protalveolata;Perkinsidae;";"0.0";"0";"75";"68";"0";"68";"7";"430456";"5766"
"LOK1378_1mm";"SILVA (only NR);Eukaryota;SAR;Alveolata;Protalveolata;Perkinsidae;A31;";"0.0";"0";"41";"36";"0";"36";"5";"430488";"5766"
"LOK1378_1mm";"SILVA (only NR);Eukaryota;SAR;Alveolata;Protalveolata;Perkinsidae;Parvilucifera;";"0.0";"0";"26";"25";"0";"25";"1";"430499";"5766"
"LOK1378_1mm";"SILVA (only NR);Eukaryota;SAR;Alveolata;Protalveolata;Perkinsidae;Perkinsus;";"0.0";"0";"6";"6";"0";"6";"0";"430518";"5766"
"LOK1378_1mm";"SILVA (only NR);Eukaryota;SAR;Alveolata;Protalveolata;Syndiniales;";"0.0";"0";"2722";"2690";"0";"2690";"32";"427834";"5766"
"LOK1378_1mm";"SILVA (only NR);Eukaryota;SAR;Alveolata;Protalveolata;Syndiniales;Amoebophrya;";"0.0";"0";"222";"219";"0";"219";"3";"430305";"5766"
"LOK1378_1mm";"SILVA (only NR);Eukaryota;SAR;Alveolata;Protalveolata;Syndiniales;Duboscquella;";"0.0";"0";"47";"47";"0";"47";"0";"430477";"5766"
"LOK1378_1mm";"SILVA (only NR);Eukaryota;SAR;Alveolata;Protalveolata;Syndiniales;Hematodinium;";"0.0";"0";"10";"10";"0";"10";"0";"430514";"5766"
"LOK1378_1mm";"SILVA (only NR);Eukaryota;SAR;Alveolata;Protalveolata;Syndiniales;Syndiniales Group I;";"0.0";"0";"757";"750";"0";"750";"7";"429774";"5766"
"LOK1378_1mm";"SILVA (only NR);Eukaryota;SAR;Alveolata;Protalveolata;Syndiniales;Syndiniales Group II;";"0.0";"0";"1469";"1450";"0";"1450";"19";"429074";"5766"
"LOK1378_1mm";"SILVA (only NR);Eukaryota;SAR;Alveolata;Protalveolata;Syndiniales;Syndiniales Group III;";"0.0";"0";"52";"51";"0";"51";"1";"430473";"5766"
"LOK1378_1mm";"SILVA (only NR);Eukaryota;SAR;Alveolata;Protalveolata;Syndiniales;Syndiniales Group V;";"0.0";"0";"36";"35";"0";"35";"1";"430489";"5766"
"LOK1378_1mm";"SILVA (only NR);Eukaryota;SAR;Alveolata;Protalveolata;Syndiniales;Syndinium;";"0.0";"0";"6";"6";"0";"6";"0";"430518";"5766"
"LOK1378_1mm";"SILVA (only NR);Eukaryota;SAR;Alveolata;Protalveolata;Syndiniales;uncultured;";"0.0";"0";"50";"50";"0";"50";"0";"430474";"5766"
"LOK1378_1mm";"SILVA (only NR);Eukaryota;SAR;Alveolata;uncultured;";"0.0";"0";"116";"114";"0";"114";"2";"430410";"5766"
"LOK1378_1mm";"SILVA (only NR);Eukaryota;SAR;Rhizaria;";"0.0";"0";"2522";"2307";"0";"2307";"215";"428217";"5766"
"LOK1378_1mm";"SILVA (only NR);Eukaryota;SAR;Rhizaria;Cercozoa;";"0.0";"0";"1374";"1179";"0";"1179";"195";"429345";"5766"
"LOK1378_1mm";"SILVA (only NR);Eukaryota;SAR;Rhizaria;Cercozoa;Ascetosporea;";"0.0";"0";"49";"43";"0";"43";"6";"430481";"5766"
"LOK1378_1mm";"SILVA (only NR);Eukaryota;SAR;Rhizaria;Cercozoa;Ascetosporea;Haplosporida;";"0.0";"0";"38";"36";"0";"36";"2";"430488";"5766"
"LOK1378_1mm";"SILVA (only NR);Eukaryota;SAR;Rhizaria;Cercozoa;Ascetosporea;Haplosporida;Bonamia;";"0.0";"0";"5";"5";"0";"5";"0";"430519";"5766"
"LOK1378_1mm";"SILVA (only NR);Eukaryota;SAR;Rhizaria;Cercozoa;Ascetosporea;Haplosporida;Haplosporidium;";"0.0";"0";"14";"13";"0";"13";"1";"430511";"5766"
"LOK1378_1mm";"SILVA (only NR);Eukaryota;SAR;Rhizaria;Cercozoa;Ascetosporea;Haplosporida;Minchinia;";"0.0";"0";"10";"10";"0";"10";"0";"430514";"5766"
"LOK1378_1mm";"SILVA (only NR);Eukaryota;SAR;Rhizaria;Cercozoa;Ascetosporea;Haplosporida;Urosporidium;";"0.0";"0";"4";"4";"0";"4";"0";"430520";"5766"
"LOK1378_1mm";"SILVA (only NR);Eukaryota;SAR;Rhizaria;Cercozoa;Ascetosporea;Paradiniidae;";"0.0";"0";"5";"3";"0";"3";"2";"430521";"5766"
"LOK1378_1mm";"SILVA (only NR);Eukaryota;SAR;Rhizaria;Cercozoa;Ascetosporea;Paradiniidae;Paradinium;";"0.0";"0";"5";"3";"0";"3";"2";"430521";"5766"
"LOK1378_1mm";"SILVA (only NR);Eukaryota;SAR;Rhizaria;Cercozoa;Basal Group T;";"0.0";"0";"14";"12";"0";"12";"2";"430512";"5766"
"LOK1378_1mm";"SILVA (only NR);Eukaryota;SAR;Rhizaria;Cercozoa;Cercomonadidae;";"0.0";"0";"184";"165";"0";"165";"19";"430359";"5766"
"LOK1378_1mm";"SILVA (only NR);Eukaryota;SAR;Rhizaria;Cercozoa;Cercomonadidae;Cavernomonas;";"0.0";"0";"2";"2";"0";"2";"0";"430522";"5766"
"LOK1378_1mm";"SILVA (only NR);Eukaryota;SAR;Rhizaria;Cercozoa;Cercomonadidae;Cercomonas;";"0.0";"0";"89";"77";"0";"77";"12";"430447";"5766"
"LOK1378_1mm";"SILVA (only NR);Eukaryota;SAR;Rhizaria;Cercozoa;Cercomonadidae;Eocercomonas;";"0.0";"0";"2";"2";"0";"2";"0";"430522";"5766"
"LOK1378_1mm";"SILVA (only NR);Eukaryota;SAR;Rhizaria;Cercozoa;Cercomonadidae;Metabolomonas;";"0.0";"0";"2";"2";"0";"2";"0";"430522";"5766"
"LOK1378_1mm";"SILVA (only NR);Eukaryota;SAR;Rhizaria;Cercozoa;Cercomonadidae;Paracercomonas;";"0.0";"0";"15";"15";"0";"15";"0";"430509";"5766"
"LOK1378_1mm";"SILVA (only NR);Eukaryota;SAR;Rhizaria;Cercozoa;Cercomonadidae;uncultured;";"0.0";"0";"52";"47";"0";"47";"5";"430477";"5766"
"LOK1378_1mm";"SILVA (only NR);Eukaryota;SAR;Rhizaria;Cercozoa;Chlorarachniophyta;";"0.0";"0";"60";"60";"0";"60";"0";"430464";"5766"
"LOK1378_1mm";"SILVA (only NR);Eukaryota;SAR;Rhizaria;Cercozoa;Chlorarachniophyta;Amorphochlora;";"0.0";"0";"2";"2";"0";"2";"0";"430522";"5766"
"LOK1378_1mm";"SILVA (only NR);Eukaryota;SAR;Rhizaria;Cercozoa;Chlorarachniophyta;Bigelowiella;";"0.0";"0";"9";"9";"0";"9";"0";"430515";"5766"
"LOK1378_1mm";"SILVA (only NR);Eukaryota;SAR;Rhizaria;Cercozoa;Chlorarachniophyta;Chlorarachnion;";"0.0";"0";"5";"5";"0";"5";"0";"430519";"5766"
"LOK1378_1mm";"SILVA (only NR);Eukaryota;SAR;Rhizaria;Cercozoa;Chlorarachniophyta;Gymnochlora;";"0.0";"0";"6";"6";"0";"6";"0";"430518";"5766"
"LOK1378_1mm";"SILVA (only NR);Eukaryota;SAR;Rhizaria;Cercozoa;Chlorarachniophyta;Lotharella;";"0.0";"0";"13";"13";"0";"13";"0";"430511";"5766"
"LOK1378_1mm";"SILVA (only NR);Eukaryota;SAR;Rhizaria;Cercozoa;Chlorarachniophyta;Minorisa;";"0.0";"0";"6";"6";"0";"6";"0";"430518";"5766"
"LOK1378_1mm";"SILVA (only NR);Eukaryota;SAR;Rhizaria;Cercozoa;Chlorarachniophyta;NOR26;";"0.0";"0";"7";"7";"0";"7";"0";"430517";"5766"
"LOK1378_1mm";"SILVA (only NR);Eukaryota;SAR;Rhizaria;Cercozoa;Chlorarachniophyta;uncultured;";"0.0";"0";"9";"9";"0";"9";"0";"430515";"5766"
"LOK1378_1mm";"SILVA (only NR);Eukaryota;SAR;Rhizaria;Cercozoa;Clathrulinidae;";"0.0";"0";"3";"3";"0";"3";"0";"430521";"5766"
"LOK1378_1mm";"SILVA (only NR);Eukaryota;SAR;Rhizaria;Cercozoa;Clathrulinidae;Hedriocystis;";"0.0";"0";"3";"3";"0";"3";"0";"430521";"5766"
"LOK1378_1mm";"SILVA (only NR);Eukaryota;SAR;Rhizaria;Cercozoa;Cyranomonas;";"0.0";"0";"5";"4";"0";"4";"1";"430520";"5766"
"LOK1378_1mm";"SILVA (only NR);Eukaryota;SAR;Rhizaria;Cercozoa;Glissomonadida;";"0.0";"0";"138";"125";"0";"125";"13";"430399";"5766"
"LOK1378_1mm";"SILVA (only NR);Eukaryota;SAR;Rhizaria;Cercozoa;Glissomonadida;Allantion;";"0.0";"0";"6";"5";"0";"5";"1";"430519";"5766"
"LOK1378_1mm";"SILVA (only NR);Eukaryota;SAR;Rhizaria;Cercozoa;Glissomonadida;Bodomorpha;";"0.0";"0";"10";"9";"0";"9";"1";"430515";"5766"
"LOK1378_1mm";"SILVA (only NR);Eukaryota;SAR;Rhizaria;Cercozoa;Glissomonadida;Heteromita;";"0.0";"0";"95";"85";"0";"85";"10";"430439";"5766"
"LOK1378_1mm";"SILVA (only NR);Eukaryota;SAR;Rhizaria;Cercozoa;Glissomonadida;Orciraptor;";"0.0";"0";"2";"2";"0";"2";"0";"430522";"5766"
"LOK1378_1mm";"SILVA (only NR);Eukaryota;SAR;Rhizaria;Cercozoa;Glissomonadida;Proleptomonas;";"0.0";"0";"4";"4";"0";"4";"0";"430520";"5766"
"LOK1378_1mm";"SILVA (only NR);Eukaryota;SAR;Rhizaria;Cercozoa;Glissomonadida;Viridiraptor;";"0.0";"0";"2";"2";"0";"2";"0";"430522";"5766"
"LOK1378_1mm";"SILVA (only NR);Eukaryota;SAR;Rhizaria;Cercozoa;Glissomonadida;uncultured;";"0.0";"0";"8";"8";"0";"8";"0";"430516";"5766"
"LOK1378_1mm";"SILVA (only NR);Eukaryota;SAR;Rhizaria;Cercozoa;Granofilosea;";"0.0";"0";"10";"10";"0";"10";"0";"430514";"5766"
"LOK1378_1mm";"SILVA (only NR);Eukaryota;SAR;Rhizaria;Cercozoa;Granofilosea;Massisteria;";"0.0";"0";"10";"10";"0";"10";"0";"430514";"5766"
"LOK1378_1mm";"SILVA (only NR);Eukaryota;SAR;Rhizaria;Cercozoa;Gromia;";"0.0";"0";"9";"9";"0";"9";"0";"430515";"5766"
"LOK1378_1mm";"SILVA (only NR);Eukaryota;SAR;Rhizaria;Cercozoa;Imbricatea;";"0.0";"0";"187";"162";"0";"162";"25";"430362";"5766"
"LOK1378_1mm";"SILVA (only NR);Eukaryota;SAR;Rhizaria;Cercozoa;Imbricatea;Auranticordis;";"0.0";"0";"1";"1";"0";"1";"0";"430523";"5766"
"LOK1378_1mm";"SILVA (only NR);Eukaryota;SAR;Rhizaria;Cercozoa;Imbricatea;Marimonadida;";"0.0";"0";"18";"16";"0";"16";"2";"430508";"5766"
"LOK1378_1mm";"SILVA (only NR);Eukaryota;SAR;Rhizaria;Cercozoa;Imbricatea;Marimonadida;BB01-173;";"0.0";"0";"3";"2";"0";"2";"1";"430522";"5766"
"LOK1378_1mm";"SILVA (only NR);Eukaryota;SAR;Rhizaria;Cercozoa;Imbricatea;Marimonadida;NAMAKO-15;";"0.0";"0";"4";"4";"0";"4";"0";"430520";"5766"
"LOK1378_1mm";"SILVA (only NR);Eukaryota;SAR;Rhizaria;Cercozoa;Imbricatea;Marimonadida;Pseudopirsonia;";"0.0";"0";"8";"7";"0";"7";"1";"430517";"5766"
"LOK1378_1mm";"SILVA (only NR);Eukaryota;SAR;Rhizaria;Cercozoa;Imbricatea;Novel Clade 3;";"0.0";"0";"4";"0";"0";"0";"4";"430524";"5766"
"LOK1378_1mm";"SILVA (only NR);Eukaryota;SAR;Rhizaria;Cercozoa;Imbricatea;Nudifila;";"0.0";"0";"7";"7";"0";"7";"0";"430517";"5766"
"LOK1378_1mm";"SILVA (only NR);Eukaryota;SAR;Rhizaria;Cercozoa;Imbricatea;Silicofilosea;";"0.0";"0";"151";"134";"0";"134";"17";"430390";"5766"
"LOK1378_1mm";"SILVA (only NR);Eukaryota;SAR;Rhizaria;Cercozoa;Imbricatea;Silicofilosea;Euglyphida;";"0.0";"0";"99";"87";"0";"87";"12";"430437";"5766"
"LOK1378_1mm";"SILVA (only NR);Eukaryota;SAR;Rhizaria;Cercozoa;Imbricatea;Silicofilosea;Euglyphida;Assulinidae;";"0.0";"0";"3";"3";"0";"3";"0";"430521";"5766"
"LOK1378_1mm";"SILVA (only NR);Eukaryota;SAR;Rhizaria;Cercozoa;Imbricatea;Silicofilosea;Euglyphida;Assulinidae;Assulina;";"0.0";"0";"1";"1";"0";"1";"0";"430523";"5766"
"LOK1378_1mm";"SILVA (only NR);Eukaryota;SAR;Rhizaria;Cercozoa;Imbricatea;Silicofilosea;Euglyphida;Assulinidae;Placocista;";"0.0";"0";"2";"2";"0";"2";"0";"430522";"5766"
"LOK1378_1mm";"SILVA (only NR);Eukaryota;SAR;Rhizaria;Cercozoa;Imbricatea;Silicofilosea;Euglyphida;Cyphoderiidae;";"0.0";"0";"15";"11";"0";"11";"4";"430513";"5766"
"LOK1378_1mm";"SILVA (only NR);Eukaryota;SAR;Rhizaria;Cercozoa;Imbricatea;Silicofilosea;Euglyphida;Cyphoderiidae;Corythionella;";"0.0";"0";"1";"1";"0";"1";"0";"430523";"5766"
"LOK1378_1mm";"SILVA (only NR);Eukaryota;SAR;Rhizaria;Cercozoa;Imbricatea;Silicofilosea;Euglyphida;Cyphoderiidae;Cyphoderia;";"0.0";"0";"10";"8";"0";"8";"2";"430516";"5766"
"LOK1378_1mm";"SILVA (only NR);Eukaryota;SAR;Rhizaria;Cercozoa;Imbricatea;Silicofilosea;Euglyphida;Euglyphidae;";"0.0";"0";"12";"12";"0";"12";"0";"430512";"5766"
"LOK1378_1mm";"SILVA (only NR);Eukaryota;SAR;Rhizaria;Cercozoa;Imbricatea;Silicofilosea;Euglyphida;Euglyphidae;Euglypha;";"0.0";"0";"12";"12";"0";"12";"0";"430512";"5766"
"LOK1378_1mm";"SILVA (only NR);Eukaryota;SAR;Rhizaria;Cercozoa;Imbricatea;Silicofilosea;Euglyphida;Incertae Sedis;";"0.0";"0";"7";"6";"0";"6";"1";"430518";"5766"
"LOK1378_1mm";"SILVA (only NR);Eukaryota;SAR;Rhizaria;Cercozoa;Imbricatea;Silicofilosea;Euglyphida;Incertae Sedis;Sphenoderia;";"0.0";"0";"4";"4";"0";"4";"0";"430520";"5766"
"LOK1378_1mm";"SILVA (only NR);Eukaryota;SAR;Rhizaria;Cercozoa;Imbricatea;Silicofilosea;Euglyphida;Incertae Sedis;Tracheleuglypha;";"0.0";"0";"2";"1";"0";"1";"1";"430523";"5766"
"LOK1378_1mm";"SILVA (only NR);Eukaryota;SAR;Rhizaria;Cercozoa;Imbricatea;Silicofilosea;Euglyphida;Incertae Sedis;Trachelocorythion;";"0.0";"0";"1";"1";"0";"1";"0";"430523";"5766"
"LOK1378_1mm";"SILVA (only NR);Eukaryota;SAR;Rhizaria;Cercozoa;Imbricatea;Silicofilosea;Euglyphida;Paulinellidae;";"0.0";"0";"15";"14";"0";"14";"1";"430510";"5766"
"LOK1378_1mm";"SILVA (only NR);Eukaryota;SAR;Rhizaria;Cercozoa;Imbricatea;Silicofilosea;Euglyphida;Paulinellidae;Paulinella;";"0.0";"0";"15";"14";"0";"14";"1";"430510";"5766"
"LOK1378_1mm";"SILVA (only NR);Eukaryota;SAR;Rhizaria;Cercozoa;Imbricatea;Silicofilosea;Euglyphida;Trinematidae;";"0.0";"0";"33";"32";"0";"32";"1";"430492";"5766"
"LOK1378_1mm";"SILVA (only NR);Eukaryota;SAR;Rhizaria;Cercozoa;Imbricatea;Silicofilosea;Euglyphida;Trinematidae;Corythion;";"0.0";"0";"1";"1";"0";"1";"0";"430523";"5766"
"LOK1378_1mm";"SILVA (only NR);Eukaryota;SAR;Rhizaria;Cercozoa;Imbricatea;Silicofilosea;Euglyphida;Trinematidae;Trinema;";"0.0";"0";"23";"23";"0";"23";"0";"430501";"5766"
"LOK1378_1mm";"SILVA (only NR);Eukaryota;SAR;Rhizaria;Cercozoa;Imbricatea;Silicofilosea;Euglyphida;Trinematidae;uncultured;";"0.0";"0";"5";"4";"0";"4";"1";"430520";"5766"
"LOK1378_1mm";"SILVA (only NR);Eukaryota;SAR;Rhizaria;Cercozoa;Imbricatea;Silicofilosea;Euglyphida;uncultured;";"0.0";"0";"8";"6";"0";"6";"2";"430518";"5766"
"LOK1378_1mm";"SILVA (only NR);Eukaryota;SAR;Rhizaria;Cercozoa;Imbricatea;Silicofilosea;Thaumatomonadida;";"0.0";"0";"52";"47";"0";"47";"5";"430477";"5766"
"LOK1378_1mm";"SILVA (only NR);Eukaryota;SAR;Rhizaria;Cercozoa;Imbricatea;Silicofilosea;Thaumatomonadida;Peregriniidae;";"0.0";"0";"18";"18";"0";"18";"0";"430506";"5766"
"LOK1378_1mm";"SILVA (only NR);Eukaryota;SAR;Rhizaria;Cercozoa;Imbricatea;Silicofilosea;Thaumatomonadida;Peregriniidae;CCe;";"0.0";"0";"2";"2";"0";"2";"0";"430522";"5766"
"LOK1378_1mm";"SILVA (only NR);Eukaryota;SAR;Rhizaria;Cercozoa;Imbricatea;Silicofilosea;Thaumatomonadida;Peregriniidae;D2P04A09;";"0.0";"0";"6";"6";"0";"6";"0";"430518";"5766"
"LOK1378_1mm";"SILVA (only NR);Eukaryota;SAR;Rhizaria;Cercozoa;Imbricatea;Silicofilosea;Thaumatomonadida;Peregriniidae;Esquamula;";"0.0";"0";"1";"1";"0";"1";"0";"430523";"5766"
"LOK1378_1mm";"SILVA (only NR);Eukaryota;SAR;Rhizaria;Cercozoa;Imbricatea;Silicofilosea;Thaumatomonadida;Peregriniidae;Gyromitus;";"0.0";"0";"5";"5";"0";"5";"0";"430519";"5766"
"LOK1378_1mm";"SILVA (only NR);Eukaryota;SAR;Rhizaria;Cercozoa;Imbricatea;Silicofilosea;Thaumatomonadida;Thaumatomonadidae;";"0.0";"0";"34";"29";"0";"29";"5";"430495";"5766"
"LOK1378_1mm";"SILVA (only NR);Eukaryota;SAR;Rhizaria;Cercozoa;Imbricatea;Silicofilosea;Thaumatomonadida;Thaumatomonadidae;Allas;";"0.0";"0";"5";"4";"0";"4";"1";"430520";"5766"
"LOK1378_1mm";"SILVA (only NR);Eukaryota;SAR;Rhizaria;Cercozoa;Imbricatea;Silicofilosea;Thaumatomonadida;Thaumatomonadidae;Thaumatomastix;";"0.0";"0";"7";"5";"0";"5";"2";"430519";"5766"
"LOK1378_1mm";"SILVA (only NR);Eukaryota;SAR;Rhizaria;Cercozoa;Imbricatea;Silicofilosea;Thaumatomonadida;Thaumatomonadidae;Thaumatomonas;";"0.0";"0";"5";"5";"0";"5";"0";"430519";"5766"
"LOK1378_1mm";"SILVA (only NR);Eukaryota;SAR;Rhizaria;Cercozoa;Imbricatea;Silicofilosea;Thaumatomonadida;Thaumatomonadidae;uncultured;";"0.0";"0";"10";"9";"0";"9";"1";"430515";"5766"
"LOK1378_1mm";"SILVA (only NR);Eukaryota;SAR;Rhizaria;Cercozoa;Imbricatea;Spongomonadida;";"0.0";"0";"6";"4";"0";"4";"2";"430520";"5766"
"LOK1378_1mm";"SILVA (only NR);Eukaryota;SAR;Rhizaria;Cercozoa;Imbricatea;Spongomonadida;Spongomonas;";"0.0";"0";"6";"4";"0";"4";"2";"430520";"5766"
"LOK1378_1mm";"SILVA (only NR);Eukaryota;SAR;Rhizaria;Cercozoa;Incertae Sedis;";"0.0";"0";"49";"39";"0";"39";"10";"430485";"5766"
"LOK1378_1mm";"SILVA (only NR);Eukaryota;SAR;Rhizaria;Cercozoa;Incertae Sedis;Cholamonas;";"0.0";"0";"1";"1";"0";"1";"0";"430523";"5766"
"LOK1378_1mm";"SILVA (only NR);Eukaryota;SAR;Rhizaria;Cercozoa;Incertae Sedis;Gymnophrys;";"0.0";"0";"24";"20";"0";"20";"4";"430504";"5766"
"LOK1378_1mm";"SILVA (only NR);Eukaryota;SAR;Rhizaria;Cercozoa;Incertae Sedis;Kraken;";"0.0";"0";"11";"10";"0";"10";"1";"430514";"5766"
"LOK1378_1mm";"SILVA (only NR);Eukaryota;SAR;Rhizaria;Cercozoa;Incertae Sedis;Metromonas;";"0.0";"0";"1";"1";"0";"1";"0";"430523";"5766"
"LOK1378_1mm";"SILVA (only NR);Eukaryota;SAR;Rhizaria;Cercozoa;Incertae Sedis;Reticulamoeba;";"0.0";"0";"7";"2";"0";"2";"5";"430522";"5766"
"LOK1378_1mm";"SILVA (only NR);Eukaryota;SAR;Rhizaria;Cercozoa;Incertae Sedis;Sainouron;";"0.0";"0";"1";"1";"0";"1";"0";"430523";"5766"
"LOK1378_1mm";"SILVA (only NR);Eukaryota;SAR;Rhizaria;Cercozoa;Incertae Sedis;Trachyrhizium;";"0.0";"0";"1";"1";"0";"1";"0";"430523";"5766"
"LOK1378_1mm";"SILVA (only NR);Eukaryota;SAR;Rhizaria;Cercozoa;Metromonadea;";"0.0";"0";"6";"5";"0";"5";"1";"430519";"5766"
"LOK1378_1mm";"SILVA (only NR);Eukaryota;SAR;Rhizaria;Cercozoa;Metromonadea;Metopion;";"0.0";"0";"2";"1";"0";"1";"1";"430523";"5766"
"LOK1378_1mm";"SILVA (only NR);Eukaryota;SAR;Rhizaria;Cercozoa;Metromonadea;Micrometopion;";"0.0";"0";"4";"4";"0";"4";"0";"430520";"5766"
"LOK1378_1mm";"SILVA (only NR);Eukaryota;SAR;Rhizaria;Cercozoa;Novel Clade 10;";"0.0";"0";"29";"29";"0";"29";"0";"430495";"5766"
"LOK1378_1mm";"SILVA (only NR);Eukaryota;SAR;Rhizaria;Cercozoa;Novel Clade 12;";"0.0";"0";"13";"12";"0";"12";"1";"430512";"5766"
"LOK1378_1mm";"SILVA (only NR);Eukaryota;SAR;Rhizaria;Cercozoa;Novel Clade 2;";"0.0";"0";"31";"24";"0";"24";"7";"430500";"5766"
"LOK1378_1mm";"SILVA (only NR);Eukaryota;SAR;Rhizaria;Cercozoa;Novel Clade 4;";"0.0";"0";"2";"0";"0";"0";"2";"430524";"5766"
"LOK1378_1mm";"SILVA (only NR);Eukaryota;SAR;Rhizaria;Cercozoa;Novel Clade Gran-1;";"0.0";"0";"4";"0";"0";"0";"4";"430524";"5766"
"LOK1378_1mm";"SILVA (only NR);Eukaryota;SAR;Rhizaria;Cercozoa;Novel Clade Gran-3;";"0.0";"0";"18";"10";"0";"10";"8";"430514";"5766"
"LOK1378_1mm";"SILVA (only NR);Eukaryota;SAR;Rhizaria;Cercozoa;Novel Clade Gran-4;";"0.0";"0";"8";"4";"0";"4";"4";"430520";"5766"
"LOK1378_1mm";"SILVA (only NR);Eukaryota;SAR;Rhizaria;Cercozoa;Novel Clade Gran-5;";"0.0";"0";"3";"1";"0";"1";"2";"430523";"5766"
"LOK1378_1mm";"SILVA (only NR);Eukaryota;SAR;Rhizaria;Cercozoa;Novel Clade Gran-6;";"0.0";"0";"2";"0";"0";"0";"2";"430524";"5766"
"LOK1378_1mm";"SILVA (only NR);Eukaryota;SAR;Rhizaria;Cercozoa;Pansomonadida;";"0.0";"0";"1";"1";"0";"1";"0";"430523";"5766"
"LOK1378_1mm";"SILVA (only NR);Eukaryota;SAR;Rhizaria;Cercozoa;Pansomonadida;Aurigamonas;";"0.0";"0";"1";"1";"0";"1";"0";"430523";"5766"
"LOK1378_1mm";"SILVA (only NR);Eukaryota;SAR;Rhizaria;Cercozoa;Phaeocalpida;";"0.0";"0";"2";"2";"0";"2";"0";"430522";"5766"
"LOK1378_1mm";"SILVA (only NR);Eukaryota;SAR;Rhizaria;Cercozoa;Phaeocalpida;Porospathis;";"0.0";"0";"1";"1";"0";"1";"0";"430523";"5766"
"LOK1378_1mm";"SILVA (only NR);Eukaryota;SAR;Rhizaria;Cercozoa;Phaeocalpida;Tuscaretta;";"0.0";"0";"1";"1";"0";"1";"0";"430523";"5766"
"LOK1378_1mm";"SILVA (only NR);Eukaryota;SAR;Rhizaria;Cercozoa;Phaeoconchia;";"0.0";"0";"4";"3";"0";"3";"1";"430521";"5766"
"LOK1378_1mm";"SILVA (only NR);Eukaryota;SAR;Rhizaria;Cercozoa;Phaeoconchia;Coelodendrum;";"0.0";"0";"2";"2";"0";"2";"0";"430522";"5766"
"LOK1378_1mm";"SILVA (only NR);Eukaryota;SAR;Rhizaria;Cercozoa;Phaeocystina;";"0.0";"0";"3";"3";"0";"3";"0";"430521";"5766"
"LOK1378_1mm";"SILVA (only NR);Eukaryota;SAR;Rhizaria;Cercozoa;Phaeocystina;Aulacantha;";"0.0";"0";"2";"2";"0";"2";"0";"430522";"5766"
"LOK1378_1mm";"SILVA (only NR);Eukaryota;SAR;Rhizaria;Cercozoa;Phaeocystina;Auloceros;";"0.0";"0";"1";"1";"0";"1";"0";"430523";"5766"
"LOK1378_1mm";"SILVA (only NR);Eukaryota;SAR;Rhizaria;Cercozoa;Phaeogromia;";"0.0";"0";"6";"5";"0";"5";"1";"430519";"5766"
"LOK1378_1mm";"SILVA (only NR);Eukaryota;SAR;Rhizaria;Cercozoa;Phaeogromia;Challengeron;";"0.0";"0";"2";"1";"0";"1";"1";"430523";"5766"
"LOK1378_1mm";"SILVA (only NR);Eukaryota;SAR;Rhizaria;Cercozoa;Phaeogromia;Medusetta;";"0.0";"0";"1";"1";"0";"1";"0";"430523";"5766"
"LOK1378_1mm";"SILVA (only NR);Eukaryota;SAR;Rhizaria;Cercozoa;Phaeogromia;Protocystis;";"0.0";"0";"2";"2";"0";"2";"0";"430522";"5766"
"LOK1378_1mm";"SILVA (only NR);Eukaryota;SAR;Rhizaria;Cercozoa;Phytomyxea;";"0.0";"0";"49";"26";"0";"26";"23";"430498";"5766"
"LOK1378_1mm";"SILVA (only NR);Eukaryota;SAR;Rhizaria;Cercozoa;Phytomyxea;Ligniera;";"0.0";"0";"1";"0";"0";"0";"1";"430524";"5766"
"LOK1378_1mm";"SILVA (only NR);Eukaryota;SAR;Rhizaria;Cercozoa;Phytomyxea;Maullinia;";"0.0";"0";"4";"4";"0";"4";"0";"430520";"5766"
"LOK1378_1mm";"SILVA (only NR);Eukaryota;SAR;Rhizaria;Cercozoa;Phytomyxea;Phagomyxa;";"0.0";"0";"2";"2";"0";"2";"0";"430522";"5766"
"LOK1378_1mm";"SILVA (only NR);Eukaryota;SAR;Rhizaria;Cercozoa;Phytomyxea;Plasmodiophora;";"0.0";"0";"4";"3";"0";"3";"1";"430521";"5766"
"LOK1378_1mm";"SILVA (only NR);Eukaryota;SAR;Rhizaria;Cercozoa;Phytomyxea;Polymyxa;";"0.0";"0";"15";"4";"0";"4";"11";"430520";"5766"
"LOK1378_1mm";"SILVA (only NR);Eukaryota;SAR;Rhizaria;Cercozoa;Phytomyxea;Sorosphaerula;";"0.0";"0";"2";"1";"0";"1";"1";"430523";"5766"
"LOK1378_1mm";"SILVA (only NR);Eukaryota;SAR;Rhizaria;Cercozoa;Phytomyxea;Spongospora;";"0.0";"0";"3";"2";"0";"2";"1";"430522";"5766"
"LOK1378_1mm";"SILVA (only NR);Eukaryota;SAR;Rhizaria;Cercozoa;Phytomyxea;Woronina;";"0.0";"0";"2";"1";"0";"1";"1";"430523";"5766"
"LOK1378_1mm";"SILVA (only NR);Eukaryota;SAR;Rhizaria;Cercozoa;Phytomyxea;uncultured;";"0.0";"0";"9";"6";"0";"6";"3";"430518";"5766"
"LOK1378_1mm";"SILVA (only NR);Eukaryota;SAR;Rhizaria;Cercozoa;Thecofilosea;";"0.0";"0";"246";"206";"0";"206";"40";"430318";"5766"
"LOK1378_1mm";"SILVA (only NR);Eukaryota;SAR;Rhizaria;Cercozoa;Thecofilosea;Cryomonadida;";"0.0";"0";"83";"70";"0";"70";"13";"430454";"5766"
"LOK1378_1mm";"SILVA (only NR);Eukaryota;SAR;Rhizaria;Cercozoa;Thecofilosea;Cryomonadida;Protaspidae;";"0.0";"0";"41";"33";"0";"33";"8";"430491";"5766"
"LOK1378_1mm";"SILVA (only NR);Eukaryota;SAR;Rhizaria;Cercozoa;Thecofilosea;Cryomonadida;Protaspidae;Cryothecomonas;";"0.0";"0";"15";"15";"0";"15";"0";"430509";"5766"
"LOK1378_1mm";"SILVA (only NR);Eukaryota;SAR;Rhizaria;Cercozoa;Thecofilosea;Cryomonadida;Protaspidae;Protaspis;";"0.0";"0";"26";"18";"0";"18";"8";"430506";"5766"
"LOK1378_1mm";"SILVA (only NR);Eukaryota;SAR;Rhizaria;Cercozoa;Thecofilosea;Cryomonadida;Rhizaspididae;";"0.0";"0";"32";"29";"0";"29";"3";"430495";"5766"
"LOK1378_1mm";"SILVA (only NR);Eukaryota;SAR;Rhizaria;Cercozoa;Thecofilosea;Cryomonadida;Rhizaspididae;Rhogostoma;";"0.0";"0";"32";"29";"0";"29";"3";"430495";"5766"
"LOK1378_1mm";"SILVA (only NR);Eukaryota;SAR;Rhizaria;Cercozoa;Thecofilosea;Cryomonadida;Ventrifissuridae;";"0.0";"0";"10";"8";"0";"8";"2";"430516";"5766"
"LOK1378_1mm";"SILVA (only NR);Eukaryota;SAR;Rhizaria;Cercozoa;Thecofilosea;Cryomonadida;Ventrifissuridae;Ventrifissura;";"0.0";"0";"3";"3";"0";"3";"0";"430521";"5766"
"LOK1378_1mm";"SILVA (only NR);Eukaryota;SAR;Rhizaria;Cercozoa;Thecofilosea;Ebriacea;";"0.0";"0";"21";"19";"0";"19";"2";"430505";"5766"
"LOK1378_1mm";"SILVA (only NR);Eukaryota;SAR;Rhizaria;Cercozoa;Thecofilosea;Ebriacea;Ebria;";"0.0";"0";"21";"19";"0";"19";"2";"430505";"5766"
"LOK1378_1mm";"SILVA (only NR);Eukaryota;SAR;Rhizaria;Cercozoa;Thecofilosea;Incertae Sedis;";"0.0";"0";"12";"8";"0";"8";"4";"430516";"5766"
"LOK1378_1mm";"SILVA (only NR);Eukaryota;SAR;Rhizaria;Cercozoa;Thecofilosea;Incertae Sedis;Lecythium;";"0.0";"0";"10";"7";"0";"7";"3";"430517";"5766"
"LOK1378_1mm";"SILVA (only NR);Eukaryota;SAR;Rhizaria;Cercozoa;Thecofilosea;Incertae Sedis;Pseudodifflugia;";"0.0";"0";"2";"1";"0";"1";"1";"430523";"5766"
"LOK1378_1mm";"SILVA (only NR);Eukaryota;SAR;Rhizaria;Cercozoa;Thecofilosea;Phaeosphaerida;";"0.0";"0";"3";"3";"0";"3";"0";"430521";"5766"
"LOK1378_1mm";"SILVA (only NR);Eukaryota;SAR;Rhizaria;Cercozoa;Thecofilosea;Phaeosphaerida;Aulosphaera;";"0.0";"0";"3";"3";"0";"3";"0";"430521";"5766"
"LOK1378_1mm";"SILVA (only NR);Eukaryota;SAR;Rhizaria;Cercozoa;Thecofilosea;uncultured;";"0.0";"0";"116";"97";"0";"97";"19";"430427";"5766"
"LOK1378_1mm";"SILVA (only NR);Eukaryota;SAR;Rhizaria;Cercozoa;Vampyrellidae;";"0.0";"0";"87";"81";"0";"81";"6";"430443";"5766"
"LOK1378_1mm";"SILVA (only NR);Eukaryota;SAR;Rhizaria;Cercozoa;Vampyrellidae;Arachnula;";"0.0";"0";"1";"1";"0";"1";"0";"430523";"5766"
"LOK1378_1mm";"SILVA (only NR);Eukaryota;SAR;Rhizaria;Cercozoa;Vampyrellidae;Leptophrys;";"0.0";"0";"3";"2";"0";"2";"1";"430522";"5766"
"LOK1378_1mm";"SILVA (only NR);Eukaryota;SAR;Rhizaria;Cercozoa;Vampyrellidae;Vampyrella;";"0.0";"0";"3";"3";"0";"3";"0";"430521";"5766"
"LOK1378_1mm";"SILVA (only NR);Eukaryota;SAR;Rhizaria;Cercozoa;Vampyrellidae;uncultured;";"0.0";"0";"31";"27";"0";"27";"4";"430497";"5766"
"LOK1378_1mm";"SILVA (only NR);Eukaryota;SAR;Rhizaria;Cercozoa;uncultured;";"0.0";"0";"127";"112";"0";"112";"15";"430412";"5766"
"LOK1378_1mm";"SILVA (only NR);Eukaryota;SAR;Rhizaria;Retaria;";"0.0";"0";"1148";"1128";"0";"1128";"20";"429396";"5766"
"LOK1378_1mm";"SILVA (only NR);Eukaryota;SAR;Rhizaria;Retaria;Acantharia;";"0.0";"0";"120";"117";"0";"117";"3";"430407";"5766"
"LOK1378_1mm";"SILVA (only NR);Eukaryota;SAR;Rhizaria;Retaria;Acantharia;Acantharea Group I;";"0.0";"0";"36";"36";"0";"36";"0";"430488";"5766"
"LOK1378_1mm";"SILVA (only NR);Eukaryota;SAR;Rhizaria;Retaria;Acantharia;Acantharea Group II;";"0.0";"0";"11";"10";"0";"10";"1";"430514";"5766"
"LOK1378_1mm";"SILVA (only NR);Eukaryota;SAR;Rhizaria;Retaria;Acantharia;Acantharea Group VI;";"0.0";"0";"7";"7";"0";"7";"0";"430517";"5766"
"LOK1378_1mm";"SILVA (only NR);Eukaryota;SAR;Rhizaria;Retaria;Acantharia;Arthracanthida;";"0.0";"0";"21";"21";"0";"21";"0";"430503";"5766"
"LOK1378_1mm";"SILVA (only NR);Eukaryota;SAR;Rhizaria;Retaria;Acantharia;Arthracanthida;Acanthostaurus;";"0.0";"0";"1";"1";"0";"1";"0";"430523";"5766"
"LOK1378_1mm";"SILVA (only NR);Eukaryota;SAR;Rhizaria;Retaria;Acantharia;Arthracanthida;Amphilonche;";"0.0";"0";"1";"1";"0";"1";"0";"430523";"5766"
"LOK1378_1mm";"SILVA (only NR);Eukaryota;SAR;Rhizaria;Retaria;Acantharia;Arthracanthida;Hexaconus;";"0.0";"0";"3";"3";"0";"3";"0";"430521";"5766"
"LOK1378_1mm";"SILVA (only NR);Eukaryota;SAR;Rhizaria;Retaria;Acantharia;Arthracanthida;Phyllostaurus;";"0.0";"0";"6";"6";"0";"6";"0";"430518";"5766"
"LOK1378_1mm";"SILVA (only NR);Eukaryota;SAR;Rhizaria;Retaria;Acantharia;Arthracanthida;uncultured;";"0.0";"0";"4";"4";"0";"4";"0";"430520";"5766"
"LOK1378_1mm";"SILVA (only NR);Eukaryota;SAR;Rhizaria;Retaria;Acantharia;Chaunocanthida;";"0.0";"0";"22";"22";"0";"22";"0";"430502";"5766"
"LOK1378_1mm";"SILVA (only NR);Eukaryota;SAR;Rhizaria;Retaria;Acantharia;Chaunocanthida;Acanthocyrta;";"0.0";"0";"1";"1";"0";"1";"0";"430523";"5766"
"LOK1378_1mm";"SILVA (only NR);Eukaryota;SAR;Rhizaria;Retaria;Acantharia;Chaunocanthida;Amphiacon;";"0.0";"0";"3";"3";"0";"3";"0";"430521";"5766"
"LOK1378_1mm";"SILVA (only NR);Eukaryota;SAR;Rhizaria;Retaria;Acantharia;Chaunocanthida;Heteracon;";"0.0";"0";"1";"1";"0";"1";"0";"430523";"5766"
"LOK1378_1mm";"SILVA (only NR);Eukaryota;SAR;Rhizaria;Retaria;Acantharia;Holocanthida;";"0.0";"0";"4";"4";"0";"4";"0";"430520";"5766"
"LOK1378_1mm";"SILVA (only NR);Eukaryota;SAR;Rhizaria;Retaria;Acantharia;Holocanthida;Acanthocolla;";"0.0";"0";"1";"1";"0";"1";"0";"430523";"5766"
"LOK1378_1mm";"SILVA (only NR);Eukaryota;SAR;Rhizaria;Retaria;Acantharia;Holocanthida;Trizona;";"0.0";"0";"1";"1";"0";"1";"0";"430523";"5766"
"LOK1378_1mm";"SILVA (only NR);Eukaryota;SAR;Rhizaria;Retaria;Acantharia;SSRPB68;";"0.0";"0";"7";"6";"0";"6";"1";"430518";"5766"
"LOK1378_1mm";"SILVA (only NR);Eukaryota;SAR;Rhizaria;Retaria;Acantharia;Symphyacanthida;";"0.0";"0";"2";"2";"0";"2";"0";"430522";"5766"
"LOK1378_1mm";"SILVA (only NR);Eukaryota;SAR;Rhizaria;Retaria;Acantharia;Symphyacanthida;Amphibelone;";"0.0";"0";"2";"2";"0";"2";"0";"430522";"5766"
"LOK1378_1mm";"SILVA (only NR);Eukaryota;SAR;Rhizaria;Retaria;Acantharia;uncultured;";"0.0";"0";"4";"4";"0";"4";"0";"430520";"5766"
"LOK1378_1mm";"SILVA (only NR);Eukaryota;SAR;Rhizaria;Retaria;Foraminifera;";"0.0";"0";"67";"58";"0";"58";"9";"430466";"5766"
"LOK1378_1mm";"SILVA (only NR);Eukaryota;SAR;Rhizaria;Retaria;Foraminifera;Globothalamea;";"0.0";"0";"37";"37";"0";"37";"0";"430487";"5766"
"LOK1378_1mm";"SILVA (only NR);Eukaryota;SAR;Rhizaria;Retaria;Foraminifera;Globothalamea;Rotaliida;";"0.0";"0";"37";"37";"0";"37";"0";"430487";"5766"
"LOK1378_1mm";"SILVA (only NR);Eukaryota;SAR;Rhizaria;Retaria;Foraminifera;Globothalamea;Rotaliida;Alabaminidae;";"0.0";"0";"1";"1";"0";"1";"0";"430523";"5766"
"LOK1378_1mm";"SILVA (only NR);Eukaryota;SAR;Rhizaria;Retaria;Foraminifera;Globothalamea;Rotaliida;Alabaminidae;Oridorsalis;";"0.0";"0";"1";"1";"0";"1";"0";"430523";"5766"
"LOK1378_1mm";"SILVA (only NR);Eukaryota;SAR;Rhizaria;Retaria;Foraminifera;Globothalamea;Rotaliida;Buliminidae;";"0.0";"0";"2";"2";"0";"2";"0";"430522";"5766"
"LOK1378_1mm";"SILVA (only NR);Eukaryota;SAR;Rhizaria;Retaria;Foraminifera;Globothalamea;Rotaliida;Buliminidae;Bulimina;";"0.0";"0";"1";"1";"0";"1";"0";"430523";"5766"
"LOK1378_1mm";"SILVA (only NR);Eukaryota;SAR;Rhizaria;Retaria;Foraminifera;Globothalamea;Rotaliida;Buliminidae;Globobulimina;";"0.0";"0";"1";"1";"0";"1";"0";"430523";"5766"
"LOK1378_1mm";"SILVA (only NR);Eukaryota;SAR;Rhizaria;Retaria;Foraminifera;Globothalamea;Rotaliida;Calcarinidae;";"0.0";"0";"3";"3";"0";"3";"0";"430521";"5766"
"LOK1378_1mm";"SILVA (only NR);Eukaryota;SAR;Rhizaria;Retaria;Foraminifera;Globothalamea;Rotaliida;Calcarinidae;Calcarina;";"0.0";"0";"2";"2";"0";"2";"0";"430522";"5766"
"LOK1378_1mm";"SILVA (only NR);Eukaryota;SAR;Rhizaria;Retaria;Foraminifera;Globothalamea;Rotaliida;Calcarinidae;Schlumbergerella;";"0.0";"0";"1";"1";"0";"1";"0";"430523";"5766"
"LOK1378_1mm";"SILVA (only NR);Eukaryota;SAR;Rhizaria;Retaria;Foraminifera;Globothalamea;Rotaliida;Cibicididae;";"0.0";"0";"5";"5";"0";"5";"0";"430519";"5766"
"LOK1378_1mm";"SILVA (only NR);Eukaryota;SAR;Rhizaria;Retaria;Foraminifera;Globothalamea;Rotaliida;Cibicididae;Cibicides;";"0.0";"0";"2";"2";"0";"2";"0";"430522";"5766"
"LOK1378_1mm";"SILVA (only NR);Eukaryota;SAR;Rhizaria;Retaria;Foraminifera;Globothalamea;Rotaliida;Cibicididae;Cibicidoides;";"0.0";"0";"3";"3";"0";"3";"0";"430521";"5766"
"LOK1378_1mm";"SILVA (only NR);Eukaryota;SAR;Rhizaria;Retaria;Foraminifera;Globothalamea;Rotaliida;Elphidiidae;";"0.0";"0";"4";"4";"0";"4";"0";"430520";"5766"
"LOK1378_1mm";"SILVA (only NR);Eukaryota;SAR;Rhizaria;Retaria;Foraminifera;Globothalamea;Rotaliida;Elphidiidae;Elphidium;";"0.0";"0";"4";"4";"0";"4";"0";"430520";"5766"
"LOK1378_1mm";"SILVA (only NR);Eukaryota;SAR;Rhizaria;Retaria;Foraminifera;Globothalamea;Rotaliida;Nonionidae;";"0.0";"0";"3";"3";"0";"3";"0";"430521";"5766"
"LOK1378_1mm";"SILVA (only NR);Eukaryota;SAR;Rhizaria;Retaria;Foraminifera;Globothalamea;Rotaliida;Nonionidae;Haynesina;";"0.0";"0";"1";"1";"0";"1";"0";"430523";"5766"
"LOK1378_1mm";"SILVA (only NR);Eukaryota;SAR;Rhizaria;Retaria;Foraminifera;Globothalamea;Rotaliida;Nonionidae;Pullenia;";"0.0";"0";"2";"2";"0";"2";"0";"430522";"5766"
"LOK1378_1mm";"SILVA (only NR);Eukaryota;SAR;Rhizaria;Retaria;Foraminifera;Globothalamea;Rotaliida;Nummulitidae;";"0.0";"0";"9";"9";"0";"9";"0";"430515";"5766"
"LOK1378_1mm";"SILVA (only NR);Eukaryota;SAR;Rhizaria;Retaria;Foraminifera;Globothalamea;Rotaliida;Nummulitidae;Cycloclypeus;";"0.0";"0";"1";"1";"0";"1";"0";"430523";"5766"
"LOK1378_1mm";"SILVA (only NR);Eukaryota;SAR;Rhizaria;Retaria;Foraminifera;Globothalamea;Rotaliida;Nummulitidae;Heterostegina;";"0.0";"0";"1";"1";"0";"1";"0";"430523";"5766"
"LOK1378_1mm";"SILVA (only NR);Eukaryota;SAR;Rhizaria;Retaria;Foraminifera;Globothalamea;Rotaliida;Nummulitidae;Nummulites;";"0.0";"0";"1";"1";"0";"1";"0";"430523";"5766"
"LOK1378_1mm";"SILVA (only NR);Eukaryota;SAR;Rhizaria;Retaria;Foraminifera;Globothalamea;Rotaliida;Nummulitidae;Operculina;";"0.0";"0";"5";"5";"0";"5";"0";"430519";"5766"
"LOK1378_1mm";"SILVA (only NR);Eukaryota;SAR;Rhizaria;Retaria;Foraminifera;Globothalamea;Rotaliida;Nummulitidae;Planoperculina;";"0.0";"0";"1";"1";"0";"1";"0";"430523";"5766"
"LOK1378_1mm";"SILVA (only NR);Eukaryota;SAR;Rhizaria;Retaria;Foraminifera;Globothalamea;Rotaliida;Pseudoparrellidae;";"0.0";"0";"2";"2";"0";"2";"0";"430522";"5766"
"LOK1378_1mm";"SILVA (only NR);Eukaryota;SAR;Rhizaria;Retaria;Foraminifera;Globothalamea;Rotaliida;Pseudoparrellidae;Epistominella;";"0.0";"0";"2";"2";"0";"2";"0";"430522";"5766"
"LOK1378_1mm";"SILVA (only NR);Eukaryota;SAR;Rhizaria;Retaria;Foraminifera;Globothalamea;Rotaliida;Rotaliidae;";"0.0";"0";"3";"3";"0";"3";"0";"430521";"5766"
"LOK1378_1mm";"SILVA (only NR);Eukaryota;SAR;Rhizaria;Retaria;Foraminifera;Globothalamea;Rotaliida;Rotaliidae;Ammonia;";"0.0";"0";"2";"2";"0";"2";"0";"430522";"5766"
"LOK1378_1mm";"SILVA (only NR);Eukaryota;SAR;Rhizaria;Retaria;Foraminifera;Globothalamea;Rotaliida;Rotaliidae;Pararotalia;";"0.0";"0";"1";"1";"0";"1";"0";"430523";"5766"
"LOK1378_1mm";"SILVA (only NR);Eukaryota;SAR;Rhizaria;Retaria;Foraminifera;Globothalamea;Rotaliida;Stainforthiidae;";"0.0";"0";"2";"2";"0";"2";"0";"430522";"5766"
"LOK1378_1mm";"SILVA (only NR);Eukaryota;SAR;Rhizaria;Retaria;Foraminifera;Globothalamea;Rotaliida;Stainforthiidae;Stainforthia;";"0.0";"0";"2";"2";"0";"2";"0";"430522";"5766"
"LOK1378_1mm";"SILVA (only NR);Eukaryota;SAR;Rhizaria;Retaria;Foraminifera;Tubothalamea;";"0.0";"0";"30";"21";"0";"21";"9";"430503";"5766"
"LOK1378_1mm";"SILVA (only NR);Eukaryota;SAR;Rhizaria;Retaria;Foraminifera;Tubothalamea;Miliolida;";"0.0";"0";"30";"21";"0";"21";"9";"430503";"5766"
"LOK1378_1mm";"SILVA (only NR);Eukaryota;SAR;Rhizaria;Retaria;Foraminifera;Tubothalamea;Miliolida;Amphisorus;";"0.0";"0";"6";"4";"0";"4";"2";"430520";"5766"
"LOK1378_1mm";"SILVA (only NR);Eukaryota;SAR;Rhizaria;Retaria;Foraminifera;Tubothalamea;Miliolida;Androsina;";"0.0";"0";"1";"1";"0";"1";"0";"430523";"5766"
"LOK1378_1mm";"SILVA (only NR);Eukaryota;SAR;Rhizaria;Retaria;Foraminifera;Tubothalamea;Miliolida;Archaias;";"0.0";"0";"2";"2";"0";"2";"0";"430522";"5766"
"LOK1378_1mm";"SILVA (only NR);Eukaryota;SAR;Rhizaria;Retaria;Foraminifera;Tubothalamea;Miliolida;Cyclorbiculina;";"0.0";"0";"1";"1";"0";"1";"0";"430523";"5766"
"LOK1378_1mm";"SILVA (only NR);Eukaryota;SAR;Rhizaria;Retaria;Foraminifera;Tubothalamea;Miliolida;Dendritina;";"0.0";"0";"1";"1";"0";"1";"0";"430523";"5766"
"LOK1378_1mm";"SILVA (only NR);Eukaryota;SAR;Rhizaria;Retaria;Foraminifera;Tubothalamea;Miliolida;Laevipeneroplis;";"0.0";"0";"3";"3";"0";"3";"0";"430521";"5766"
"LOK1378_1mm";"SILVA (only NR);Eukaryota;SAR;Rhizaria;Retaria;Foraminifera;Tubothalamea;Miliolida;Marginopora;";"0.0";"0";"4";"1";"0";"1";"3";"430523";"5766"
"LOK1378_1mm";"SILVA (only NR);Eukaryota;SAR;Rhizaria;Retaria;Foraminifera;Tubothalamea;Miliolida;Sorites;";"0.0";"0";"8";"4";"0";"4";"4";"430520";"5766"
"LOK1378_1mm";"SILVA (only NR);Eukaryota;SAR;Rhizaria;Retaria;Polycystinea;";"0.0";"0";"713";"708";"0";"708";"5";"429816";"5766"
"LOK1378_1mm";"SILVA (only NR);Eukaryota;SAR;Rhizaria;Retaria;Polycystinea;Collodaria;";"0.0";"0";"71";"67";"0";"67";"4";"430457";"5766"
"LOK1378_1mm";"SILVA (only NR);Eukaryota;SAR;Rhizaria;Retaria;Polycystinea;Collodaria;AT8-54;";"0.0";"0";"15";"15";"0";"15";"0";"430509";"5766"
"LOK1378_1mm";"SILVA (only NR);Eukaryota;SAR;Rhizaria;Retaria;Polycystinea;Collodaria;Collophidium;";"0.0";"0";"8";"8";"0";"8";"0";"430516";"5766"
"LOK1378_1mm";"SILVA (only NR);Eukaryota;SAR;Rhizaria;Retaria;Polycystinea;Collodaria;Collosphaera;";"0.0";"0";"6";"6";"0";"6";"0";"430518";"5766"
"LOK1378_1mm";"SILVA (only NR);Eukaryota;SAR;Rhizaria;Retaria;Polycystinea;Collodaria;Collozoum;";"0.0";"0";"9";"8";"0";"8";"1";"430516";"5766"
"LOK1378_1mm";"SILVA (only NR);Eukaryota;SAR;Rhizaria;Retaria;Polycystinea;Collodaria;Disolenia;";"0.0";"0";"3";"2";"0";"2";"1";"430522";"5766"
"LOK1378_1mm";"SILVA (only NR);Eukaryota;SAR;Rhizaria;Retaria;Polycystinea;Collodaria;E84;";"0.0";"0";"4";"4";"0";"4";"0";"430520";"5766"
"LOK1378_1mm";"SILVA (only NR);Eukaryota;SAR;Rhizaria;Retaria;Polycystinea;Collodaria;Rhaphidozoum;";"0.0";"0";"2";"2";"0";"2";"0";"430522";"5766"
"LOK1378_1mm";"SILVA (only NR);Eukaryota;SAR;Rhizaria;Retaria;Polycystinea;Collodaria;Siphonosphaera;";"0.0";"0";"6";"5";"0";"5";"1";"430519";"5766"
"LOK1378_1mm";"SILVA (only NR);Eukaryota;SAR;Rhizaria;Retaria;Polycystinea;Collodaria;Sphaerozoum;";"0.0";"0";"3";"3";"0";"3";"0";"430521";"5766"
"LOK1378_1mm";"SILVA (only NR);Eukaryota;SAR;Rhizaria;Retaria;Polycystinea;Collodaria;Thalassicolla;";"0.0";"0";"4";"4";"0";"4";"0";"430520";"5766"
"LOK1378_1mm";"SILVA (only NR);Eukaryota;SAR;Rhizaria;Retaria;Polycystinea;Nassellaria;";"0.0";"0";"40";"40";"0";"40";"0";"430484";"5766"
"LOK1378_1mm";"SILVA (only NR);Eukaryota;SAR;Rhizaria;Retaria;Polycystinea;Nassellaria;Asp-05;";"0.0";"0";"2";"2";"0";"2";"0";"430522";"5766"
"LOK1378_1mm";"SILVA (only NR);Eukaryota;SAR;Rhizaria;Retaria;Polycystinea;Nassellaria;Ceratospyris;";"0.0";"0";"10";"10";"0";"10";"0";"430514";"5766"
"LOK1378_1mm";"SILVA (only NR);Eukaryota;SAR;Rhizaria;Retaria;Polycystinea;Nassellaria;Eucyrtidium;";"0.0";"0";"3";"3";"0";"3";"0";"430521";"5766"
"LOK1378_1mm";"SILVA (only NR);Eukaryota;SAR;Rhizaria;Retaria;Polycystinea;Nassellaria;Pseudocubus;";"0.0";"0";"15";"15";"0";"15";"0";"430509";"5766"
"LOK1378_1mm";"SILVA (only NR);Eukaryota;SAR;Rhizaria;Retaria;Polycystinea;Nassellaria;Pterocanium;";"0.0";"0";"1";"1";"0";"1";"0";"430523";"5766"
"LOK1378_1mm";"SILVA (only NR);Eukaryota;SAR;Rhizaria;Retaria;Polycystinea;Nassellaria;Pterocorys;";"0.0";"0";"4";"4";"0";"4";"0";"430520";"5766"
"LOK1378_1mm";"SILVA (only NR);Eukaryota;SAR;Rhizaria;Retaria;Polycystinea;Spumellaria;";"0.0";"0";"598";"598";"0";"598";"0";"429926";"5766"
"LOK1378_1mm";"SILVA (only NR);Eukaryota;SAR;Rhizaria;Retaria;Polycystinea;Spumellaria;Actinomma;";"0.0";"0";"8";"8";"0";"8";"0";"430516";"5766"
"LOK1378_1mm";"SILVA (only NR);Eukaryota;SAR;Rhizaria;Retaria;Polycystinea;Spumellaria;Astrosphaera;";"0.0";"0";"17";"17";"0";"17";"0";"430507";"5766"
"LOK1378_1mm";"SILVA (only NR);Eukaryota;SAR;Rhizaria;Retaria;Polycystinea;Spumellaria;Cladococcus;";"0.0";"0";"111";"111";"0";"111";"0";"430413";"5766"
"LOK1378_1mm";"SILVA (only NR);Eukaryota;SAR;Rhizaria;Retaria;Polycystinea;Spumellaria;Dictyocoryne;";"0.0";"0";"2";"2";"0";"2";"0";"430522";"5766"
"LOK1378_1mm";"SILVA (only NR);Eukaryota;SAR;Rhizaria;Retaria;Polycystinea;Spumellaria;Didymocyrtis;";"0.0";"0";"1";"1";"0";"1";"0";"430523";"5766"
"LOK1378_1mm";"SILVA (only NR);Eukaryota;SAR;Rhizaria;Retaria;Polycystinea;Spumellaria;Hexacontium;";"0.0";"0";"10";"10";"0";"10";"0";"430514";"5766"
"LOK1378_1mm";"SILVA (only NR);Eukaryota;SAR;Rhizaria;Retaria;Polycystinea;Spumellaria;Larcopyle;";"0.0";"0";"2";"2";"0";"2";"0";"430522";"5766"
"LOK1378_1mm";"SILVA (only NR);Eukaryota;SAR;Rhizaria;Retaria;Polycystinea;Spumellaria;Phorticium;";"0.0";"0";"1";"1";"0";"1";"0";"430523";"5766"
"LOK1378_1mm";"SILVA (only NR);Eukaryota;SAR;Rhizaria;Retaria;Polycystinea;Spumellaria;Rhizosphaera;";"0.0";"0";"11";"11";"0";"11";"0";"430513";"5766"
"LOK1378_1mm";"SILVA (only NR);Eukaryota;SAR;Rhizaria;Retaria;Polycystinea;Spumellaria;Spongocore;";"0.0";"0";"1";"1";"0";"1";"0";"430523";"5766"
"LOK1378_1mm";"SILVA (only NR);Eukaryota;SAR;Rhizaria;Retaria;Polycystinea;Spumellaria;Spongodiscus;";"0.0";"0";"2";"2";"0";"2";"0";"430522";"5766"
"LOK1378_1mm";"SILVA (only NR);Eukaryota;SAR;Rhizaria;Retaria;Polycystinea;Spumellaria;Spongopyle;";"0.0";"0";"1";"1";"0";"1";"0";"430523";"5766"
"LOK1378_1mm";"SILVA (only NR);Eukaryota;SAR;Rhizaria;Retaria;Polycystinea;Spumellaria;Spongotrochus;";"0.0";"0";"3";"3";"0";"3";"0";"430521";"5766"
"LOK1378_1mm";"SILVA (only NR);Eukaryota;SAR;Rhizaria;Retaria;Polycystinea;Spumellaria;Streblacantha;";"0.0";"0";"1";"1";"0";"1";"0";"430523";"5766"
"LOK1378_1mm";"SILVA (only NR);Eukaryota;SAR;Rhizaria;Retaria;Polycystinea;Spumellaria;Stylochlamydium;";"0.0";"0";"2";"2";"0";"2";"0";"430522";"5766"
"LOK1378_1mm";"SILVA (only NR);Eukaryota;SAR;Rhizaria;Retaria;Polycystinea;Spumellaria;Stylodictya;";"0.0";"0";"1";"1";"0";"1";"0";"430523";"5766"
"LOK1378_1mm";"SILVA (only NR);Eukaryota;SAR;Rhizaria;Retaria;Polycystinea;Spumellaria;Tetrapyle;";"0.0";"0";"2";"2";"0";"2";"0";"430522";"5766"
"LOK1378_1mm";"SILVA (only NR);Eukaryota;SAR;Rhizaria;Retaria;Polycystinea;Spumellaria;Triastrum;";"0.0";"0";"14";"14";"0";"14";"0";"430510";"5766"
"LOK1378_1mm";"SILVA (only NR);Eukaryota;SAR;Rhizaria;Retaria;Polycystinea;Spumellaria;uncultured;";"0.0";"0";"385";"385";"0";"385";"0";"430139";"5766"
"LOK1378_1mm";"SILVA (only NR);Eukaryota;SAR;Rhizaria;Retaria;RAD A;";"0.0";"0";"47";"45";"0";"45";"2";"430479";"5766"
"LOK1378_1mm";"SILVA (only NR);Eukaryota;SAR;Rhizaria;Retaria;RAD B;";"0.0";"0";"177";"176";"0";"176";"1";"430348";"5766"
"LOK1378_1mm";"SILVA (only NR);Eukaryota;SAR;Rhizaria;Retaria;RAD C;";"0.0";"0";"19";"19";"0";"19";"0";"430505";"5766"
"LOK1378_1mm";"SILVA (only NR);Eukaryota;SAR;Rhizaria;Retaria;uncultured;";"0.0";"0";"4";"4";"0";"4";"0";"430520";"5766"
"LOK1378_1mm";"SILVA (only NR);Eukaryota;SAR;Stramenopiles;";"0.0";"0";"3556";"3337";"0";"3337";"219";"427187";"5766"
"LOK1378_1mm";"SILVA (only NR);Eukaryota;SAR;Stramenopiles;Bicosoecida;";"0.0";"0";"143";"134";"0";"134";"9";"430390";"5766"
"LOK1378_1mm";"SILVA (only NR);Eukaryota;SAR;Stramenopiles;Bicosoecida;Adriamonas;";"0.0";"0";"1";"1";"0";"1";"0";"430523";"5766"
"LOK1378_1mm";"SILVA (only NR);Eukaryota;SAR;Stramenopiles;Bicosoecida;Bicosoeca;";"0.0";"0";"27";"26";"0";"26";"1";"430498";"5766"
"LOK1378_1mm";"SILVA (only NR);Eukaryota;SAR;Stramenopiles;Bicosoecida;CH1-2B-3;";"0.0";"0";"16";"16";"0";"16";"0";"430508";"5766"
"LOK1378_1mm";"SILVA (only NR);Eukaryota;SAR;Stramenopiles;Bicosoecida;Caecitellus;";"0.0";"0";"10";"10";"0";"10";"0";"430514";"5766"
"LOK1378_1mm";"SILVA (only NR);Eukaryota;SAR;Stramenopiles;Bicosoecida;Cafeteria;";"0.0";"0";"13";"12";"0";"12";"1";"430512";"5766"
"LOK1378_1mm";"SILVA (only NR);Eukaryota;SAR;Stramenopiles;Bicosoecida;Halocafeteria;";"0.0";"0";"13";"12";"0";"12";"1";"430512";"5766"
"LOK1378_1mm";"SILVA (only NR);Eukaryota;SAR;Stramenopiles;Bicosoecida;K4;";"0.0";"0";"3";"3";"0";"3";"0";"430521";"5766"
"LOK1378_1mm";"SILVA (only NR);Eukaryota;SAR;Stramenopiles;Bicosoecida;LG08-10;";"0.0";"0";"19";"19";"0";"19";"0";"430505";"5766"
"LOK1378_1mm";"SILVA (only NR);Eukaryota;SAR;Stramenopiles;Bicosoecida;P34.6;";"0.0";"0";"3";"2";"0";"2";"1";"430522";"5766"
"LOK1378_1mm";"SILVA (only NR);Eukaryota;SAR;Stramenopiles;Bicosoecida;Paramonas;";"0.0";"0";"2";"2";"0";"2";"0";"430522";"5766"
"LOK1378_1mm";"SILVA (only NR);Eukaryota;SAR;Stramenopiles;Bicosoecida;Pseudobodo;";"0.0";"0";"5";"5";"0";"5";"0";"430519";"5766"
"LOK1378_1mm";"SILVA (only NR);Eukaryota;SAR;Stramenopiles;Bicosoecida;Rictus;";"0.0";"0";"2";"1";"0";"1";"1";"430523";"5766"
"LOK1378_1mm";"SILVA (only NR);Eukaryota;SAR;Stramenopiles;Bicosoecida;Siluania;";"0.0";"0";"1";"1";"0";"1";"0";"430523";"5766"
"LOK1378_1mm";"SILVA (only NR);Eukaryota;SAR;Stramenopiles;Bicosoecida;uncultured;";"0.0";"0";"13";"10";"0";"10";"3";"430514";"5766"
"LOK1378_1mm";"SILVA (only NR);Eukaryota;SAR;Stramenopiles;Hyphochytriomycetes;";"0.0";"0";"7";"7";"0";"7";"0";"430517";"5766"
"LOK1378_1mm";"SILVA (only NR);Eukaryota;SAR;Stramenopiles;Hyphochytriomycetes;Hyphochytriales;";"0.0";"0";"7";"7";"0";"7";"0";"430517";"5766"
"LOK1378_1mm";"SILVA (only NR);Eukaryota;SAR;Stramenopiles;Hyphochytriomycetes;Hyphochytriales;Hyphochytrium;";"0.0";"0";"1";"1";"0";"1";"0";"430523";"5766"
"LOK1378_1mm";"SILVA (only NR);Eukaryota;SAR;Stramenopiles;Hyphochytriomycetes;Hyphochytriales;Rhizidiomyces;";"0.0";"0";"1";"1";"0";"1";"0";"430523";"5766"
"LOK1378_1mm";"SILVA (only NR);Eukaryota;SAR;Stramenopiles;Incertae Sedis;";"0.0";"0";"101";"98";"0";"98";"3";"430426";"5766"
"LOK1378_1mm";"SILVA (only NR);Eukaryota;SAR;Stramenopiles;Incertae Sedis;Blastocystis;";"0.0";"0";"80";"78";"0";"78";"2";"430446";"5766"
"LOK1378_1mm";"SILVA (only NR);Eukaryota;SAR;Stramenopiles;Incertae Sedis;Cantina;";"0.0";"0";"1";"1";"0";"1";"0";"430523";"5766"
"LOK1378_1mm";"SILVA (only NR);Eukaryota;SAR;Stramenopiles;Incertae Sedis;Developayella;";"0.0";"0";"2";"2";"0";"2";"0";"430522";"5766"
"LOK1378_1mm";"SILVA (only NR);Eukaryota;SAR;Stramenopiles;Incertae Sedis;Develorapax;";"0.0";"0";"1";"1";"0";"1";"0";"430523";"5766"
"LOK1378_1mm";"SILVA (only NR);Eukaryota;SAR;Stramenopiles;Incertae Sedis;Pirsonia;";"0.0";"0";"16";"15";"0";"15";"1";"430509";"5766"
"LOK1378_1mm";"SILVA (only NR);Eukaryota;SAR;Stramenopiles;Labyrinthulomycetes;";"0.0";"0";"392";"325";"0";"325";"67";"430199";"5766"
"LOK1378_1mm";"SILVA (only NR);Eukaryota;SAR;Stramenopiles;Labyrinthulomycetes;Amphitraemidae;";"0.0";"0";"9";"7";"0";"7";"2";"430517";"5766"
"LOK1378_1mm";"SILVA (only NR);Eukaryota;SAR;Stramenopiles;Labyrinthulomycetes;Amphitraemidae;Amphitrema;";"0.0";"0";"1";"0";"0";"0";"1";"430524";"5766"
"LOK1378_1mm";"SILVA (only NR);Eukaryota;SAR;Stramenopiles;Labyrinthulomycetes;Amphitraemidae;Archerella;";"0.0";"0";"1";"0";"0";"0";"1";"430524";"5766"
"LOK1378_1mm";"SILVA (only NR);Eukaryota;SAR;Stramenopiles;Labyrinthulomycetes;Incertae Sedis;";"0.0";"0";"1";"1";"0";"1";"0";"430523";"5766"
"LOK1378_1mm";"SILVA (only NR);Eukaryota;SAR;Stramenopiles;Labyrinthulomycetes;Incertae Sedis;Stellarchytrium;";"0.0";"0";"1";"1";"0";"1";"0";"430523";"5766"
"LOK1378_1mm";"SILVA (only NR);Eukaryota;SAR;Stramenopiles;Labyrinthulomycetes;Labyrinthulaceae;";"0.0";"0";"21";"20";"0";"20";"1";"430504";"5766"
"LOK1378_1mm";"SILVA (only NR);Eukaryota;SAR;Stramenopiles;Labyrinthulomycetes;Labyrinthulaceae;Labyrinthula;";"0.0";"0";"21";"20";"0";"20";"1";"430504";"5766"
"LOK1378_1mm";"SILVA (only NR);Eukaryota;SAR;Stramenopiles;Labyrinthulomycetes;Thraustochytriaceae;";"0.0";"0";"268";"228";"0";"228";"40";"430296";"5766"
"LOK1378_1mm";"SILVA (only NR);Eukaryota;SAR;Stramenopiles;Labyrinthulomycetes;Thraustochytriaceae;Aplanochytrium;";"0.0";"0";"44";"38";"0";"38";"6";"430486";"5766"
"LOK1378_1mm";"SILVA (only NR);Eukaryota;SAR;Stramenopiles;Labyrinthulomycetes;Thraustochytriaceae;Aurantiochytrium;";"0.0";"0";"36";"30";"0";"30";"6";"430494";"5766"
"LOK1378_1mm";"SILVA (only NR);Eukaryota;SAR;Stramenopiles;Labyrinthulomycetes;Thraustochytriaceae;Labyrinthuloides;";"0.0";"0";"7";"6";"0";"6";"1";"430518";"5766"
"LOK1378_1mm";"SILVA (only NR);Eukaryota;SAR;Stramenopiles;Labyrinthulomycetes;Thraustochytriaceae;Monorhizochytrium;";"0.0";"0";"1";"1";"0";"1";"0";"430523";"5766"
"LOK1378_1mm";"SILVA (only NR);Eukaryota;SAR;Stramenopiles;Labyrinthulomycetes;Thraustochytriaceae;Oblongichytrium;";"0.0";"0";"1";"0";"0";"0";"1";"430524";"5766"
"LOK1378_1mm";"SILVA (only NR);Eukaryota;SAR;Stramenopiles;Labyrinthulomycetes;Thraustochytriaceae;Parietichytrium;";"0.0";"0";"14";"13";"0";"13";"1";"430511";"5766"
"LOK1378_1mm";"SILVA (only NR);Eukaryota;SAR;Stramenopiles;Labyrinthulomycetes;Thraustochytriaceae;Schizochytrium;";"0.0";"0";"13";"12";"0";"12";"1";"430512";"5766"
"LOK1378_1mm";"SILVA (only NR);Eukaryota;SAR;Stramenopiles;Labyrinthulomycetes;Thraustochytriaceae;Sicyoidochytrium;";"0.0";"0";"6";"5";"0";"5";"1";"430519";"5766"
"LOK1378_1mm";"SILVA (only NR);Eukaryota;SAR;Stramenopiles;Labyrinthulomycetes;Thraustochytriaceae;Thraustochytrium;";"0.0";"0";"90";"83";"0";"83";"7";"430441";"5766"
"LOK1378_1mm";"SILVA (only NR);Eukaryota;SAR;Stramenopiles;Labyrinthulomycetes;Thraustochytriaceae;Ulkenia;";"0.0";"0";"13";"10";"0";"10";"3";"430514";"5766"
"LOK1378_1mm";"SILVA (only NR);Eukaryota;SAR;Stramenopiles;Labyrinthulomycetes;Thraustochytriaceae;uncultured;";"0.0";"0";"27";"14";"0";"14";"13";"430510";"5766"
"LOK1378_1mm";"SILVA (only NR);Eukaryota;SAR;Stramenopiles;Labyrinthulomycetes;uncultured;";"0.0";"0";"85";"63";"0";"63";"22";"430461";"5766"
"LOK1378_1mm";"SILVA (only NR);Eukaryota;SAR;Stramenopiles;MAST-11;";"0.0";"0";"5";"5";"0";"5";"0";"430519";"5766"
"LOK1378_1mm";"SILVA (only NR);Eukaryota;SAR;Stramenopiles;MAST-12;";"0.0";"0";"40";"35";"0";"35";"5";"430489";"5766"
"LOK1378_1mm";"SILVA (only NR);Eukaryota;SAR;Stramenopiles;MAST-12;MAST-12A;";"0.0";"0";"11";"10";"0";"10";"1";"430514";"5766"
"LOK1378_1mm";"SILVA (only NR);Eukaryota;SAR;Stramenopiles;MAST-12;MAST-12B;";"0.0";"0";"3";"3";"0";"3";"0";"430521";"5766"
"LOK1378_1mm";"SILVA (only NR);Eukaryota;SAR;Stramenopiles;MAST-12;MAST-12C;";"0.0";"0";"11";"10";"0";"10";"1";"430514";"5766"
"LOK1378_1mm";"SILVA (only NR);Eukaryota;SAR;Stramenopiles;MAST-12;MAST-12D;";"0.0";"0";"3";"2";"0";"2";"1";"430522";"5766"
"LOK1378_1mm";"SILVA (only NR);Eukaryota;SAR;Stramenopiles;MAST-16;";"0.0";"0";"2";"2";"0";"2";"0";"430522";"5766"
"LOK1378_1mm";"SILVA (only NR);Eukaryota;SAR;Stramenopiles;MAST-1;";"0.0";"0";"30";"30";"0";"30";"0";"430494";"5766"
"LOK1378_1mm";"SILVA (only NR);Eukaryota;SAR;Stramenopiles;MAST-1;MAST-1A;";"0.0";"0";"8";"8";"0";"8";"0";"430516";"5766"
"LOK1378_1mm";"SILVA (only NR);Eukaryota;SAR;Stramenopiles;MAST-1;MAST-1B;";"0.0";"0";"2";"2";"0";"2";"0";"430522";"5766"
"LOK1378_1mm";"SILVA (only NR);Eukaryota;SAR;Stramenopiles;MAST-1;MAST-1C;";"0.0";"0";"12";"12";"0";"12";"0";"430512";"5766"
"LOK1378_1mm";"SILVA (only NR);Eukaryota;SAR;Stramenopiles;MAST-1;MAST-1D;";"0.0";"0";"5";"5";"0";"5";"0";"430519";"5766"
"LOK1378_1mm";"SILVA (only NR);Eukaryota;SAR;Stramenopiles;MAST-22;";"0.0";"0";"10";"6";"0";"6";"4";"430518";"5766"
"LOK1378_1mm";"SILVA (only NR);Eukaryota;SAR;Stramenopiles;MAST-22;MAST-22A;";"0.0";"0";"2";"2";"0";"2";"0";"430522";"5766"
"LOK1378_1mm";"SILVA (only NR);Eukaryota;SAR;Stramenopiles;MAST-22;MAST-22B;";"0.0";"0";"3";"1";"0";"1";"2";"430523";"5766"
"LOK1378_1mm";"SILVA (only NR);Eukaryota;SAR;Stramenopiles;MAST-22;MAST-22C;";"0.0";"0";"3";"1";"0";"1";"2";"430523";"5766"
"LOK1378_1mm";"SILVA (only NR);Eukaryota;SAR;Stramenopiles;MAST-23;";"0.0";"0";"2";"2";"0";"2";"0";"430522";"5766"
"LOK1378_1mm";"SILVA (only NR);Eukaryota;SAR;Stramenopiles;MAST-24;";"0.0";"0";"2";"1";"0";"1";"1";"430523";"5766"
"LOK1378_1mm";"SILVA (only NR);Eukaryota;SAR;Stramenopiles;MAST-2;";"0.0";"0";"6";"4";"0";"4";"2";"430520";"5766"
"LOK1378_1mm";"SILVA (only NR);Eukaryota;SAR;Stramenopiles;MAST-3;";"0.0";"0";"128";"126";"0";"126";"2";"430398";"5766"
"LOK1378_1mm";"SILVA (only NR);Eukaryota;SAR;Stramenopiles;MAST-3;MAST-3A;";"0.0";"0";"9";"9";"0";"9";"0";"430515";"5766"
"LOK1378_1mm";"SILVA (only NR);Eukaryota;SAR;Stramenopiles;MAST-3;MAST-3B;";"0.0";"0";"13";"13";"0";"13";"0";"430511";"5766"
"LOK1378_1mm";"SILVA (only NR);Eukaryota;SAR;Stramenopiles;MAST-3;MAST-3C;";"0.0";"0";"13";"13";"0";"13";"0";"430511";"5766"
"LOK1378_1mm";"SILVA (only NR);Eukaryota;SAR;Stramenopiles;MAST-3;MAST-3D;";"0.0";"0";"10";"10";"0";"10";"0";"430514";"5766"
"LOK1378_1mm";"SILVA (only NR);Eukaryota;SAR;Stramenopiles;MAST-3;MAST-3E;";"0.0";"0";"12";"12";"0";"12";"0";"430512";"5766"
"LOK1378_1mm";"SILVA (only NR);Eukaryota;SAR;Stramenopiles;MAST-3;MAST-3F;";"0.0";"0";"19";"19";"0";"19";"0";"430505";"5766"
"LOK1378_1mm";"SILVA (only NR);Eukaryota;SAR;Stramenopiles;MAST-3;MAST-3I;";"0.0";"0";"20";"20";"0";"20";"0";"430504";"5766"
"LOK1378_1mm";"SILVA (only NR);Eukaryota;SAR;Stramenopiles;MAST-3;MAST-3J;";"0.0";"0";"14";"13";"0";"13";"1";"430511";"5766"
"LOK1378_1mm";"SILVA (only NR);Eukaryota;SAR;Stramenopiles;MAST-3;MAST-3K;";"0.0";"0";"5";"5";"0";"5";"0";"430519";"5766"
"LOK1378_1mm";"SILVA (only NR);Eukaryota;SAR;Stramenopiles;MAST-3;MAST-3L;";"0.0";"0";"3";"3";"0";"3";"0";"430521";"5766"
"LOK1378_1mm";"SILVA (only NR);Eukaryota;SAR;Stramenopiles;MAST-4;";"0.0";"0";"28";"28";"0";"28";"0";"430496";"5766"
"LOK1378_1mm";"SILVA (only NR);Eukaryota;SAR;Stramenopiles;MAST-4;MAST-4A;";"0.0";"0";"3";"3";"0";"3";"0";"430521";"5766"
"LOK1378_1mm";"SILVA (only NR);Eukaryota;SAR;Stramenopiles;MAST-4;MAST-4D;";"0.0";"0";"3";"3";"0";"3";"0";"430521";"5766"
"LOK1378_1mm";"SILVA (only NR);Eukaryota;SAR;Stramenopiles;MAST-4;MAST-4F;";"0.0";"0";"5";"5";"0";"5";"0";"430519";"5766"
"LOK1378_1mm";"SILVA (only NR);Eukaryota;SAR;Stramenopiles;MAST-6;";"0.0";"0";"5";"5";"0";"5";"0";"430519";"5766"
"LOK1378_1mm";"SILVA (only NR);Eukaryota;SAR;Stramenopiles;MAST-7;";"0.0";"0";"27";"27";"0";"27";"0";"430497";"5766"
"LOK1378_1mm";"SILVA (only NR);Eukaryota;SAR;Stramenopiles;MAST-7;MAST-7A;";"0.0";"0";"11";"11";"0";"11";"0";"430513";"5766"
"LOK1378_1mm";"SILVA (only NR);Eukaryota;SAR;Stramenopiles;MAST-7;MAST-7B;";"0.0";"0";"6";"6";"0";"6";"0";"430518";"5766"
"LOK1378_1mm";"SILVA (only NR);Eukaryota;SAR;Stramenopiles;MAST-7;MAST-7D;";"0.0";"0";"5";"5";"0";"5";"0";"430519";"5766"
"LOK1378_1mm";"SILVA (only NR);Eukaryota;SAR;Stramenopiles;MAST-8;";"0.0";"0";"17";"17";"0";"17";"0";"430507";"5766"
"LOK1378_1mm";"SILVA (only NR);Eukaryota;SAR;Stramenopiles;MAST-8;MAST-8D;";"0.0";"0";"6";"6";"0";"6";"0";"430518";"5766"
"LOK1378_1mm";"SILVA (only NR);Eukaryota;SAR;Stramenopiles;MAST-9;";"0.0";"0";"13";"13";"0";"13";"0";"430511";"5766"
"LOK1378_1mm";"SILVA (only NR);Eukaryota;SAR;Stramenopiles;MAST-9;MAST-9A;";"0.0";"0";"6";"6";"0";"6";"0";"430518";"5766"
"LOK1378_1mm";"SILVA (only NR);Eukaryota;SAR;Stramenopiles;Ochrophyta;";"0.0";"0";"2392";"2281";"0";"2281";"111";"428243";"5766"
"LOK1378_1mm";"SILVA (only NR);Eukaryota;SAR;Stramenopiles;Ochrophyta;ANT37-16;";"0.0";"0";"4";"4";"0";"4";"0";"430520";"5766"
"LOK1378_1mm";"SILVA (only NR);Eukaryota;SAR;Stramenopiles;Ochrophyta;Aurearenophyceae;";"0.0";"0";"1";"1";"0";"1";"0";"430523";"5766"
"LOK1378_1mm";"SILVA (only NR);Eukaryota;SAR;Stramenopiles;Ochrophyta;Aurearenophyceae;Aurearena;";"0.0";"0";"1";"1";"0";"1";"0";"430523";"5766"
"LOK1378_1mm";"SILVA (only NR);Eukaryota;SAR;Stramenopiles;Ochrophyta;Bolidomonas;";"0.0";"0";"25";"23";"0";"23";"2";"430501";"5766"
"LOK1378_1mm";"SILVA (only NR);Eukaryota;SAR;Stramenopiles;Ochrophyta;Chrysomerophyceae;";"0.0";"0";"3";"3";"0";"3";"0";"430521";"5766"
"LOK1378_1mm";"SILVA (only NR);Eukaryota;SAR;Stramenopiles;Ochrophyta;Chrysomerophyceae;Antarctosaccion;";"0.0";"0";"1";"1";"0";"1";"0";"430523";"5766"
"LOK1378_1mm";"SILVA (only NR);Eukaryota;SAR;Stramenopiles;Ochrophyta;Chrysomerophyceae;Chrysowaernella;";"0.0";"0";"1";"1";"0";"1";"0";"430523";"5766"
"LOK1378_1mm";"SILVA (only NR);Eukaryota;SAR;Stramenopiles;Ochrophyta;Chrysomerophyceae;Giraudyopsis;";"0.0";"0";"1";"1";"0";"1";"0";"430523";"5766"
"LOK1378_1mm";"SILVA (only NR);Eukaryota;SAR;Stramenopiles;Ochrophyta;Chrysophyceae;";"0.0";"0";"489";"454";"0";"454";"35";"430070";"5766"
"LOK1378_1mm";"SILVA (only NR);Eukaryota;SAR;Stramenopiles;Ochrophyta;Chrysophyceae;A-3-62;";"0.0";"0";"2";"1";"0";"1";"1";"430523";"5766"
"LOK1378_1mm";"SILVA (only NR);Eukaryota;SAR;Stramenopiles;Ochrophyta;Chrysophyceae;Chromulinales;";"0.0";"0";"97";"86";"0";"86";"11";"430438";"5766"
"LOK1378_1mm";"SILVA (only NR);Eukaryota;SAR;Stramenopiles;Ochrophyta;Chrysophyceae;Chromulinales;Chromulina;";"0.0";"0";"5";"5";"0";"5";"0";"430519";"5766"
"LOK1378_1mm";"SILVA (only NR);Eukaryota;SAR;Stramenopiles;Ochrophyta;Chrysophyceae;Chromulinales;Chrysamoeba;";"0.0";"0";"6";"5";"0";"5";"1";"430519";"5766"
"LOK1378_1mm";"SILVA (only NR);Eukaryota;SAR;Stramenopiles;Ochrophyta;Chrysophyceae;Chromulinales;Chrysochaete;";"0.0";"0";"2";"2";"0";"2";"0";"430522";"5766"
"LOK1378_1mm";"SILVA (only NR);Eukaryota;SAR;Stramenopiles;Ochrophyta;Chrysophyceae;Chromulinales;Chrysoxys;";"0.0";"0";"2";"2";"0";"2";"0";"430522";"5766"
"LOK1378_1mm";"SILVA (only NR);Eukaryota;SAR;Stramenopiles;Ochrophyta;Chrysophyceae;Chromulinales;Cyclonexis;";"0.0";"0";"1";"1";"0";"1";"0";"430523";"5766"
"LOK1378_1mm";"SILVA (only NR);Eukaryota;SAR;Stramenopiles;Ochrophyta;Chrysophyceae;Chromulinales;JBNA46;";"0.0";"0";"4";"4";"0";"4";"0";"430520";"5766"
"LOK1378_1mm";"SILVA (only NR);Eukaryota;SAR;Stramenopiles;Ochrophyta;Chrysophyceae;Chromulinales;Oikomonas;";"0.0";"0";"5";"3";"0";"3";"2";"430521";"5766"
"LOK1378_1mm";"SILVA (only NR);Eukaryota;SAR;Stramenopiles;Ochrophyta;Chrysophyceae;Chromulinales;Phaeoplaca;";"0.0";"0";"2";"2";"0";"2";"0";"430522";"5766"
"LOK1378_1mm";"SILVA (only NR);Eukaryota;SAR;Stramenopiles;Ochrophyta;Chrysophyceae;Chromulinales;Poterioochromonas;";"0.0";"0";"7";"6";"0";"6";"1";"430518";"5766"
"LOK1378_1mm";"SILVA (only NR);Eukaryota;SAR;Stramenopiles;Ochrophyta;Chrysophyceae;Chromulinales;Poteriospumella;";"0.0";"0";"2";"2";"0";"2";"0";"430522";"5766"
"LOK1378_1mm";"SILVA (only NR);Eukaryota;SAR;Stramenopiles;Ochrophyta;Chrysophyceae;Chromulinales;Spumella;";"0.0";"0";"29";"26";"0";"26";"3";"430498";"5766"
"LOK1378_1mm";"SILVA (only NR);Eukaryota;SAR;Stramenopiles;Ochrophyta;Chrysophyceae;Chromulinales;Uroglena;";"0.0";"0";"6";"6";"0";"6";"0";"430518";"5766"
"LOK1378_1mm";"SILVA (only NR);Eukaryota;SAR;Stramenopiles;Ochrophyta;Chrysophyceae;Chromulinales;eukaryotic;";"0.0";"0";"2";"1";"0";"1";"1";"430523";"5766"
"LOK1378_1mm";"SILVA (only NR);Eukaryota;SAR;Stramenopiles;Ochrophyta;Chrysophyceae;Chromulinales;uncultured;";"0.0";"0";"16";"15";"0";"15";"1";"430509";"5766"
"LOK1378_1mm";"SILVA (only NR);Eukaryota;SAR;Stramenopiles;Ochrophyta;Chrysophyceae;Chrysocapsales;";"0.0";"0";"8";"8";"0";"8";"0";"430516";"5766"
"LOK1378_1mm";"SILVA (only NR);Eukaryota;SAR;Stramenopiles;Ochrophyta;Chrysophyceae;Chrysocapsales;Chrysocapsa;";"0.0";"0";"2";"2";"0";"2";"0";"430522";"5766"
"LOK1378_1mm";"SILVA (only NR);Eukaryota;SAR;Stramenopiles;Ochrophyta;Chrysophyceae;Chrysocapsales;Chrysonebula;";"0.0";"0";"3";"3";"0";"3";"0";"430521";"5766"
"LOK1378_1mm";"SILVA (only NR);Eukaryota;SAR;Stramenopiles;Ochrophyta;Chrysophyceae;Chrysocapsales;Hydrurus;";"0.0";"0";"3";"3";"0";"3";"0";"430521";"5766"
"LOK1378_1mm";"SILVA (only NR);Eukaryota;SAR;Stramenopiles;Ochrophyta;Chrysophyceae;Chrysosphaerales;";"0.0";"0";"1";"1";"0";"1";"0";"430523";"5766"
"LOK1378_1mm";"SILVA (only NR);Eukaryota;SAR;Stramenopiles;Ochrophyta;Chrysophyceae;Chrysosphaerales;Chrysosphaera;";"0.0";"0";"1";"1";"0";"1";"0";"430523";"5766"
"LOK1378_1mm";"SILVA (only NR);Eukaryota;SAR;Stramenopiles;Ochrophyta;Chrysophyceae;Hibberdiales;";"0.0";"0";"6";"6";"0";"6";"0";"430518";"5766"
"LOK1378_1mm";"SILVA (only NR);Eukaryota;SAR;Stramenopiles;Ochrophyta;Chrysophyceae;Hibberdiales;Chromophyton;";"0.0";"0";"2";"2";"0";"2";"0";"430522";"5766"
"LOK1378_1mm";"SILVA (only NR);Eukaryota;SAR;Stramenopiles;Ochrophyta;Chrysophyceae;Hibberdiales;Chrysopodocystis;";"0.0";"0";"2";"2";"0";"2";"0";"430522";"5766"
"LOK1378_1mm";"SILVA (only NR);Eukaryota;SAR;Stramenopiles;Ochrophyta;Chrysophyceae;Hibberdiales;Hibberdia;";"0.0";"0";"1";"1";"0";"1";"0";"430523";"5766"
"LOK1378_1mm";"SILVA (only NR);Eukaryota;SAR;Stramenopiles;Ochrophyta;Chrysophyceae;Hibberdiales;Lagynion;";"0.0";"0";"1";"1";"0";"1";"0";"430523";"5766"
"LOK1378_1mm";"SILVA (only NR);Eukaryota;SAR;Stramenopiles;Ochrophyta;Chrysophyceae;Incertae Sedis;";"0.0";"0";"5";"5";"0";"5";"0";"430519";"5766"
"LOK1378_1mm";"SILVA (only NR);Eukaryota;SAR;Stramenopiles;Ochrophyta;Chrysophyceae;Incertae Sedis;Chlamydomyxa;";"0.0";"0";"5";"5";"0";"5";"0";"430519";"5766"
"LOK1378_1mm";"SILVA (only NR);Eukaryota;SAR;Stramenopiles;Ochrophyta;Chrysophyceae;Ochromonadales;";"0.0";"0";"124";"120";"0";"120";"4";"430404";"5766"
"LOK1378_1mm";"SILVA (only NR);Eukaryota;SAR;Stramenopiles;Ochrophyta;Chrysophyceae;Ochromonadales;Chrysolepidomonas;";"0.0";"0";"1";"1";"0";"1";"0";"430523";"5766"
"LOK1378_1mm";"SILVA (only NR);Eukaryota;SAR;Stramenopiles;Ochrophyta;Chrysophyceae;Ochromonadales;Chrysonephele;";"0.0";"0";"1";"1";"0";"1";"0";"430523";"5766"
"LOK1378_1mm";"SILVA (only NR);Eukaryota;SAR;Stramenopiles;Ochrophyta;Chrysophyceae;Ochromonadales;Dinobryon;";"0.0";"0";"9";"9";"0";"9";"0";"430515";"5766"
"LOK1378_1mm";"SILVA (only NR);Eukaryota;SAR;Stramenopiles;Ochrophyta;Chrysophyceae;Ochromonadales;Epipyxis;";"0.0";"0";"5";"5";"0";"5";"0";"430519";"5766"
"LOK1378_1mm";"SILVA (only NR);Eukaryota;SAR;Stramenopiles;Ochrophyta;Chrysophyceae;Ochromonadales;Ochromonas;";"0.0";"0";"37";"34";"0";"34";"3";"430490";"5766"
"LOK1378_1mm";"SILVA (only NR);Eukaryota;SAR;Stramenopiles;Ochrophyta;Chrysophyceae;Ochromonadales;Paraphysomonas;";"0.0";"0";"63";"62";"0";"62";"1";"430462";"5766"
"LOK1378_1mm";"SILVA (only NR);Eukaryota;SAR;Stramenopiles;Ochrophyta;Chrysophyceae;Ochromonadales;uncultured;";"0.0";"0";"7";"7";"0";"7";"0";"430517";"5766"
"LOK1378_1mm";"SILVA (only NR);Eukaryota;SAR;Stramenopiles;Ochrophyta;Chrysophyceae;P34.45;";"0.0";"0";"13";"9";"0";"9";"4";"430515";"5766"
"LOK1378_1mm";"SILVA (only NR);Eukaryota;SAR;Stramenopiles;Ochrophyta;Chrysophyceae;P34.48;";"0.0";"0";"12";"10";"0";"10";"2";"430514";"5766"
"LOK1378_1mm";"SILVA (only NR);Eukaryota;SAR;Stramenopiles;Ochrophyta;Chrysophyceae;Synurales;";"0.0";"0";"47";"47";"0";"47";"0";"430477";"5766"
"LOK1378_1mm";"SILVA (only NR);Eukaryota;SAR;Stramenopiles;Ochrophyta;Chrysophyceae;Synurales;Mallomonas;";"0.0";"0";"30";"30";"0";"30";"0";"430494";"5766"
"LOK1378_1mm";"SILVA (only NR);Eukaryota;SAR;Stramenopiles;Ochrophyta;Chrysophyceae;Synurales;Synura;";"0.0";"0";"15";"15";"0";"15";"0";"430509";"5766"
"LOK1378_1mm";"SILVA (only NR);Eukaryota;SAR;Stramenopiles;Ochrophyta;Chrysophyceae;Synurales;Tessellaria;";"0.0";"0";"2";"2";"0";"2";"0";"430522";"5766"
"LOK1378_1mm";"SILVA (only NR);Eukaryota;SAR;Stramenopiles;Ochrophyta;Chrysophyceae;uncultured;";"0.0";"0";"156";"143";"0";"143";"13";"430381";"5766"
"LOK1378_1mm";"SILVA (only NR);Eukaryota;SAR;Stramenopiles;Ochrophyta;Diatomea;";"0.0";"0";"1571";"1504";"0";"1504";"67";"429020";"5766"
"LOK1378_1mm";"SILVA (only NR);Eukaryota;SAR;Stramenopiles;Ochrophyta;Diatomea;Bacillariophytina;";"0.0";"0";"1283";"1223";"0";"1223";"60";"429301";"5766"
"LOK1378_1mm";"SILVA (only NR);Eukaryota;SAR;Stramenopiles;Ochrophyta;Diatomea;Bacillariophytina;Bacillariophyceae;";"0.0";"0";"900";"844";"0";"844";"56";"429680";"5766"
"LOK1378_1mm";"SILVA (only NR);Eukaryota;SAR;Stramenopiles;Ochrophyta;Diatomea;Bacillariophytina;Bacillariophyceae;Achnanthes;";"0.0";"0";"5";"5";"0";"5";"0";"430519";"5766"
"LOK1378_1mm";"SILVA (only NR);Eukaryota;SAR;Stramenopiles;Ochrophyta;Diatomea;Bacillariophytina;Bacillariophyceae;Achnanthidium;";"0.0";"0";"8";"8";"0";"8";"0";"430516";"5766"
"LOK1378_1mm";"SILVA (only NR);Eukaryota;SAR;Stramenopiles;Ochrophyta;Diatomea;Bacillariophytina;Bacillariophyceae;Amphipleura;";"0.0";"0";"1";"1";"0";"1";"0";"430523";"5766"
"LOK1378_1mm";"SILVA (only NR);Eukaryota;SAR;Stramenopiles;Ochrophyta;Diatomea;Bacillariophytina;Bacillariophyceae;Amphiprora;";"0.0";"0";"1";"1";"0";"1";"0";"430523";"5766"
"LOK1378_1mm";"SILVA (only NR);Eukaryota;SAR;Stramenopiles;Ochrophyta;Diatomea;Bacillariophytina;Bacillariophyceae;Amphora;";"0.0";"0";"114";"114";"0";"114";"0";"430410";"5766"
"LOK1378_1mm";"SILVA (only NR);Eukaryota;SAR;Stramenopiles;Ochrophyta;Diatomea;Bacillariophytina;Bacillariophyceae;Anomoeoneis;";"0.0";"0";"3";"2";"0";"2";"1";"430522";"5766"
"LOK1378_1mm";"SILVA (only NR);Eukaryota;SAR;Stramenopiles;Ochrophyta;Diatomea;Bacillariophytina;Bacillariophyceae;Asterionella;";"0.0";"0";"2";"2";"0";"2";"0";"430522";"5766"
"LOK1378_1mm";"SILVA (only NR);Eukaryota;SAR;Stramenopiles;Ochrophyta;Diatomea;Bacillariophytina;Bacillariophyceae;Asterionellopsis;";"0.0";"0";"1";"1";"0";"1";"0";"430523";"5766"
"LOK1378_1mm";"SILVA (only NR);Eukaryota;SAR;Stramenopiles;Ochrophyta;Diatomea;Bacillariophytina;Bacillariophyceae;Asteroplanus;";"0.0";"0";"1";"1";"0";"1";"0";"430523";"5766"
"LOK1378_1mm";"SILVA (only NR);Eukaryota;SAR;Stramenopiles;Ochrophyta;Diatomea;Bacillariophytina;Bacillariophyceae;Auricula;";"0.0";"0";"5";"4";"0";"4";"1";"430520";"5766"
"LOK1378_1mm";"SILVA (only NR);Eukaryota;SAR;Stramenopiles;Ochrophyta;Diatomea;Bacillariophytina;Bacillariophyceae;Bacillaria;";"0.0";"0";"5";"5";"0";"5";"0";"430519";"5766"
"LOK1378_1mm";"SILVA (only NR);Eukaryota;SAR;Stramenopiles;Ochrophyta;Diatomea;Bacillariophytina;Bacillariophyceae;Biremis;";"0.0";"0";"4";"4";"0";"4";"0";"430520";"5766"
"LOK1378_1mm";"SILVA (only NR);Eukaryota;SAR;Stramenopiles;Ochrophyta;Diatomea;Bacillariophytina;Bacillariophyceae;Campylodiscus;";"0.0";"0";"20";"20";"0";"20";"0";"430504";"5766"
"LOK1378_1mm";"SILVA (only NR);Eukaryota;SAR;Stramenopiles;Ochrophyta;Diatomea;Bacillariophytina;Bacillariophyceae;Carinasigma;";"0.0";"0";"1";"1";"0";"1";"0";"430523";"5766"
"LOK1378_1mm";"SILVA (only NR);Eukaryota;SAR;Stramenopiles;Ochrophyta;Diatomea;Bacillariophytina;Bacillariophyceae;Climaconeis;";"0.0";"0";"3";"3";"0";"3";"0";"430521";"5766"
"LOK1378_1mm";"SILVA (only NR);Eukaryota;SAR;Stramenopiles;Ochrophyta;Diatomea;Bacillariophytina;Bacillariophyceae;Cocconeis;";"0.0";"0";"9";"8";"0";"8";"1";"430516";"5766"
"LOK1378_1mm";"SILVA (only NR);Eukaryota;SAR;Stramenopiles;Ochrophyta;Diatomea;Bacillariophytina;Bacillariophyceae;Craspedostauros;";"0.0";"0";"2";"1";"0";"1";"1";"430523";"5766"
"LOK1378_1mm";"SILVA (only NR);Eukaryota;SAR;Stramenopiles;Ochrophyta;Diatomea;Bacillariophytina;Bacillariophyceae;Craticula;";"0.0";"0";"4";"4";"0";"4";"0";"430520";"5766"
"LOK1378_1mm";"SILVA (only NR);Eukaryota;SAR;Stramenopiles;Ochrophyta;Diatomea;Bacillariophytina;Bacillariophyceae;Cylindrotheca;";"0.0";"0";"16";"12";"0";"12";"4";"430512";"5766"
"LOK1378_1mm";"SILVA (only NR);Eukaryota;SAR;Stramenopiles;Ochrophyta;Diatomea;Bacillariophytina;Bacillariophyceae;Cymatopleura;";"0.0";"0";"3";"3";"0";"3";"0";"430521";"5766"
"LOK1378_1mm";"SILVA (only NR);Eukaryota;SAR;Stramenopiles;Ochrophyta;Diatomea;Bacillariophytina;Bacillariophyceae;Cymbella;";"0.0";"0";"17";"16";"0";"16";"1";"430508";"5766"
"LOK1378_1mm";"SILVA (only NR);Eukaryota;SAR;Stramenopiles;Ochrophyta;Diatomea;Bacillariophytina;Bacillariophyceae;Cymbellonitzschia;";"0.0";"0";"2";"2";"0";"2";"0";"430522";"5766"
"LOK1378_1mm";"SILVA (only NR);Eukaryota;SAR;Stramenopiles;Ochrophyta;Diatomea;Bacillariophytina;Bacillariophyceae;Cymbopleura;";"0.0";"0";"2";"2";"0";"2";"0";"430522";"5766"
"LOK1378_1mm";"SILVA (only NR);Eukaryota;SAR;Stramenopiles;Ochrophyta;Diatomea;Bacillariophytina;Bacillariophyceae;Diadesmis;";"0.0";"0";"1";"1";"0";"1";"0";"430523";"5766"
"LOK1378_1mm";"SILVA (only NR);Eukaryota;SAR;Stramenopiles;Ochrophyta;Diatomea;Bacillariophytina;Bacillariophyceae;Diatoma;";"0.0";"0";"5";"5";"0";"5";"0";"430519";"5766"
"LOK1378_1mm";"SILVA (only NR);Eukaryota;SAR;Stramenopiles;Ochrophyta;Diatomea;Bacillariophytina;Bacillariophyceae;Dickieia;";"0.0";"0";"3";"3";"0";"3";"0";"430521";"5766"
"LOK1378_1mm";"SILVA (only NR);Eukaryota;SAR;Stramenopiles;Ochrophyta;Diatomea;Bacillariophytina;Bacillariophyceae;Diploneis;";"0.0";"0";"8";"8";"0";"8";"0";"430516";"5766"
"LOK1378_1mm";"SILVA (only NR);Eukaryota;SAR;Stramenopiles;Ochrophyta;Diatomea;Bacillariophytina;Bacillariophyceae;Encyonema;";"0.0";"0";"6";"6";"0";"6";"0";"430518";"5766"
"LOK1378_1mm";"SILVA (only NR);Eukaryota;SAR;Stramenopiles;Ochrophyta;Diatomea;Bacillariophytina;Bacillariophyceae;Entomoneis;";"0.0";"0";"20";"19";"0";"19";"1";"430505";"5766"
"LOK1378_1mm";"SILVA (only NR);Eukaryota;SAR;Stramenopiles;Ochrophyta;Diatomea;Bacillariophytina;Bacillariophyceae;Epithemia;";"0.0";"0";"3";"3";"0";"3";"0";"430521";"5766"
"LOK1378_1mm";"SILVA (only NR);Eukaryota;SAR;Stramenopiles;Ochrophyta;Diatomea;Bacillariophytina;Bacillariophyceae;Eucocconeis;";"0.0";"0";"1";"1";"0";"1";"0";"430523";"5766"
"LOK1378_1mm";"SILVA (only NR);Eukaryota;SAR;Stramenopiles;Ochrophyta;Diatomea;Bacillariophytina;Bacillariophyceae;Eunotia;";"0.0";"0";"14";"13";"0";"13";"1";"430511";"5766"
"LOK1378_1mm";"SILVA (only NR);Eukaryota;SAR;Stramenopiles;Ochrophyta;Diatomea;Bacillariophytina;Bacillariophyceae;Fistulifera;";"0.0";"0";"7";"7";"0";"7";"0";"430517";"5766"
"LOK1378_1mm";"SILVA (only NR);Eukaryota;SAR;Stramenopiles;Ochrophyta;Diatomea;Bacillariophytina;Bacillariophyceae;Fragilariopsis;";"0.0";"0";"23";"22";"0";"22";"1";"430502";"5766"
"LOK1378_1mm";"SILVA (only NR);Eukaryota;SAR;Stramenopiles;Ochrophyta;Diatomea;Bacillariophytina;Bacillariophyceae;Frustulia;";"0.0";"0";"7";"7";"0";"7";"0";"430517";"5766"
"LOK1378_1mm";"SILVA (only NR);Eukaryota;SAR;Stramenopiles;Ochrophyta;Diatomea;Bacillariophytina;Bacillariophyceae;Geissleria;";"0.0";"0";"1";"1";"0";"1";"0";"430523";"5766"
"LOK1378_1mm";"SILVA (only NR);Eukaryota;SAR;Stramenopiles;Ochrophyta;Diatomea;Bacillariophytina;Bacillariophyceae;Gomphonema;";"0.0";"0";"12";"12";"0";"12";"0";"430512";"5766"
"LOK1378_1mm";"SILVA (only NR);Eukaryota;SAR;Stramenopiles;Ochrophyta;Diatomea;Bacillariophytina;Bacillariophyceae;Gyrosigma;";"0.0";"0";"4";"3";"0";"3";"1";"430521";"5766"
"LOK1378_1mm";"SILVA (only NR);Eukaryota;SAR;Stramenopiles;Ochrophyta;Diatomea;Bacillariophytina;Bacillariophyceae;Hantzschia;";"0.0";"0";"14";"2";"0";"2";"12";"430522";"5766"
"LOK1378_1mm";"SILVA (only NR);Eukaryota;SAR;Stramenopiles;Ochrophyta;Diatomea;Bacillariophytina;Bacillariophyceae;Haslea;";"0.0";"0";"6";"6";"0";"6";"0";"430518";"5766"
"LOK1378_1mm";"SILVA (only NR);Eukaryota;SAR;Stramenopiles;Ochrophyta;Diatomea;Bacillariophytina;Bacillariophyceae;Humidophila;";"0.0";"0";"2";"1";"0";"1";"1";"430523";"5766"
"LOK1378_1mm";"SILVA (only NR);Eukaryota;SAR;Stramenopiles;Ochrophyta;Diatomea;Bacillariophytina;Bacillariophyceae;Lemnicula;";"0.0";"0";"4";"4";"0";"4";"0";"430520";"5766"
"LOK1378_1mm";"SILVA (only NR);Eukaryota;SAR;Stramenopiles;Ochrophyta;Diatomea;Bacillariophytina;Bacillariophyceae;Luticola;";"0.0";"0";"6";"3";"0";"3";"3";"430521";"5766"
"LOK1378_1mm";"SILVA (only NR);Eukaryota;SAR;Stramenopiles;Ochrophyta;Diatomea;Bacillariophytina;Bacillariophyceae;Meuniera;";"0.0";"0";"1";"1";"0";"1";"0";"430523";"5766"
"LOK1378_1mm";"SILVA (only NR);Eukaryota;SAR;Stramenopiles;Ochrophyta;Diatomea;Bacillariophytina;Bacillariophyceae;Navicula;";"0.0";"0";"72";"69";"0";"69";"3";"430455";"5766"
"LOK1378_1mm";"SILVA (only NR);Eukaryota;SAR;Stramenopiles;Ochrophyta;Diatomea;Bacillariophytina;Bacillariophyceae;Neidium;";"0.0";"0";"2";"2";"0";"2";"0";"430522";"5766"
"LOK1378_1mm";"SILVA (only NR);Eukaryota;SAR;Stramenopiles;Ochrophyta;Diatomea;Bacillariophytina;Bacillariophyceae;Nitzschia;";"0.0";"0";"79";"70";"0";"70";"9";"430454";"5766"
"LOK1378_1mm";"SILVA (only NR);Eukaryota;SAR;Stramenopiles;Ochrophyta;Diatomea;Bacillariophytina;Bacillariophyceae;Parlibellus;";"0.0";"0";"4";"4";"0";"4";"0";"430520";"5766"
"LOK1378_1mm";"SILVA (only NR);Eukaryota;SAR;Stramenopiles;Ochrophyta;Diatomea;Bacillariophytina;Bacillariophyceae;Pauliella;";"0.0";"0";"4";"4";"0";"4";"0";"430520";"5766"
"LOK1378_1mm";"SILVA (only NR);Eukaryota;SAR;Stramenopiles;Ochrophyta;Diatomea;Bacillariophytina;Bacillariophyceae;Phaeodactylum;";"0.0";"0";"2";"1";"0";"1";"1";"430523";"5766"
"LOK1378_1mm";"SILVA (only NR);Eukaryota;SAR;Stramenopiles;Ochrophyta;Diatomea;Bacillariophytina;Bacillariophyceae;Pinnularia;";"0.0";"0";"55";"53";"0";"53";"2";"430471";"5766"
"LOK1378_1mm";"SILVA (only NR);Eukaryota;SAR;Stramenopiles;Ochrophyta;Diatomea;Bacillariophytina;Bacillariophyceae;Placoneis;";"0.0";"0";"7";"7";"0";"7";"0";"430517";"5766"
"LOK1378_1mm";"SILVA (only NR);Eukaryota;SAR;Stramenopiles;Ochrophyta;Diatomea;Bacillariophytina;Bacillariophyceae;Planothidium;";"0.0";"0";"12";"11";"0";"11";"1";"430513";"5766"
"LOK1378_1mm";"SILVA (only NR);Eukaryota;SAR;Stramenopiles;Ochrophyta;Diatomea;Bacillariophytina;Bacillariophyceae;Pleurosigma;";"0.0";"0";"14";"14";"0";"14";"0";"430510";"5766"
"LOK1378_1mm";"SILVA (only NR);Eukaryota;SAR;Stramenopiles;Ochrophyta;Diatomea;Bacillariophytina;Bacillariophyceae;Protokeelia;";"0.0";"0";"1";"1";"0";"1";"0";"430523";"5766"
"LOK1378_1mm";"SILVA (only NR);Eukaryota;SAR;Stramenopiles;Ochrophyta;Diatomea;Bacillariophytina;Bacillariophyceae;Psammodictyon;";"0.0";"0";"3";"3";"0";"3";"0";"430521";"5766"
"LOK1378_1mm";"SILVA (only NR);Eukaryota;SAR;Stramenopiles;Ochrophyta;Diatomea;Bacillariophytina;Bacillariophyceae;Pseudo-nitzschia;";"0.0";"0";"31";"30";"0";"30";"1";"430494";"5766"
"LOK1378_1mm";"SILVA (only NR);Eukaryota;SAR;Stramenopiles;Ochrophyta;Diatomea;Bacillariophytina;Bacillariophyceae;Reimeria;";"0.0";"0";"1";"1";"0";"1";"0";"430523";"5766"
"LOK1378_1mm";"SILVA (only NR);Eukaryota;SAR;Stramenopiles;Ochrophyta;Diatomea;Bacillariophytina;Bacillariophyceae;Rhaphoneis;";"0.0";"0";"16";"14";"0";"14";"2";"430510";"5766"
"LOK1378_1mm";"SILVA (only NR);Eukaryota;SAR;Stramenopiles;Ochrophyta;Diatomea;Bacillariophytina;Bacillariophyceae;Rhoicosphenia;";"0.0";"0";"4";"4";"0";"4";"0";"430520";"5766"
"LOK1378_1mm";"SILVA (only NR);Eukaryota;SAR;Stramenopiles;Ochrophyta;Diatomea;Bacillariophytina;Bacillariophyceae;Rhopalodia;";"0.0";"0";"3";"3";"0";"3";"0";"430521";"5766"
"LOK1378_1mm";"SILVA (only NR);Eukaryota;SAR;Stramenopiles;Ochrophyta;Diatomea;Bacillariophytina;Bacillariophyceae;Scoliopleura;";"0.0";"0";"1";"1";"0";"1";"0";"430523";"5766"
"LOK1378_1mm";"SILVA (only NR);Eukaryota;SAR;Stramenopiles;Ochrophyta;Diatomea;Bacillariophytina;Bacillariophyceae;Sellaphoraceae;";"0.0";"0";"33";"33";"0";"33";"0";"430491";"5766"
"LOK1378_1mm";"SILVA (only NR);Eukaryota;SAR;Stramenopiles;Ochrophyta;Diatomea;Bacillariophytina;Bacillariophyceae;Sellaphoraceae;Eolimna;";"0.0";"0";"3";"3";"0";"3";"0";"430521";"5766"
"LOK1378_1mm";"SILVA (only NR);Eukaryota;SAR;Stramenopiles;Ochrophyta;Diatomea;Bacillariophytina;Bacillariophyceae;Sellaphoraceae;Fallacia;";"0.0";"0";"4";"4";"0";"4";"0";"430520";"5766"
"LOK1378_1mm";"SILVA (only NR);Eukaryota;SAR;Stramenopiles;Ochrophyta;Diatomea;Bacillariophytina;Bacillariophyceae;Sellaphoraceae;Sellaphora;";"0.0";"0";"17";"17";"0";"17";"0";"430507";"5766"
"LOK1378_1mm";"SILVA (only NR);Eukaryota;SAR;Stramenopiles;Ochrophyta;Diatomea;Bacillariophytina;Bacillariophyceae;Stauroneis;";"0.0";"0";"4";"4";"0";"4";"0";"430520";"5766"
"LOK1378_1mm";"SILVA (only NR);Eukaryota;SAR;Stramenopiles;Ochrophyta;Diatomea;Bacillariophytina;Bacillariophyceae;Staurotropis;";"0.0";"0";"1";"1";"0";"1";"0";"430523";"5766"
"LOK1378_1mm";"SILVA (only NR);Eukaryota;SAR;Stramenopiles;Ochrophyta;Diatomea;Bacillariophytina;Bacillariophyceae;Stenopterobia;";"0.0";"0";"2";"2";"0";"2";"0";"430522";"5766"
"LOK1378_1mm";"SILVA (only NR);Eukaryota;SAR;Stramenopiles;Ochrophyta;Diatomea;Bacillariophytina;Bacillariophyceae;Surirella;";"0.0";"0";"18";"17";"0";"17";"1";"430507";"5766"
"LOK1378_1mm";"SILVA (only NR);Eukaryota;SAR;Stramenopiles;Ochrophyta;Diatomea;Bacillariophytina;Bacillariophyceae;Thalassiophysa;";"0.0";"0";"1";"1";"0";"1";"0";"430523";"5766"
"LOK1378_1mm";"SILVA (only NR);Eukaryota;SAR;Stramenopiles;Ochrophyta;Diatomea;Bacillariophytina;Bacillariophyceae;Tryblionella;";"0.0";"0";"2";"2";"0";"2";"0";"430522";"5766"
"LOK1378_1mm";"SILVA (only NR);Eukaryota;SAR;Stramenopiles;Ochrophyta;Diatomea;Bacillariophytina;Bacillariophyceae;Undatella;";"0.0";"0";"2";"2";"0";"2";"0";"430522";"5766"
"LOK1378_1mm";"SILVA (only NR);Eukaryota;SAR;Stramenopiles;Ochrophyta;Diatomea;Bacillariophytina;Bacillariophyceae;uncultured;";"0.0";"0";"9";"7";"0";"7";"2";"430517";"5766"
"LOK1378_1mm";"SILVA (only NR);Eukaryota;SAR;Stramenopiles;Ochrophyta;Diatomea;Bacillariophytina;Mediophyceae;";"0.0";"0";"383";"379";"0";"379";"4";"430145";"5766"
"LOK1378_1mm";"SILVA (only NR);Eukaryota;SAR;Stramenopiles;Ochrophyta;Diatomea;Bacillariophytina;Mediophyceae;Arcocellulus;";"0.0";"0";"12";"11";"0";"11";"1";"430513";"5766"
"LOK1378_1mm";"SILVA (only NR);Eukaryota;SAR;Stramenopiles;Ochrophyta;Diatomea;Bacillariophytina;Mediophyceae;Attheya;";"0.0";"0";"2";"2";"0";"2";"0";"430522";"5766"
"LOK1378_1mm";"SILVA (only NR);Eukaryota;SAR;Stramenopiles;Ochrophyta;Diatomea;Bacillariophytina;Mediophyceae;Bellerochea;";"0.0";"0";"5";"5";"0";"5";"0";"430519";"5766"
"LOK1378_1mm";"SILVA (only NR);Eukaryota;SAR;Stramenopiles;Ochrophyta;Diatomea;Bacillariophytina;Mediophyceae;Biddulphia;";"0.0";"0";"2";"2";"0";"2";"0";"430522";"5766"
"LOK1378_1mm";"SILVA (only NR);Eukaryota;SAR;Stramenopiles;Ochrophyta;Diatomea;Bacillariophytina;Mediophyceae;Biddulphiopsis;";"0.0";"0";"7";"7";"0";"7";"0";"430517";"5766"
"LOK1378_1mm";"SILVA (only NR);Eukaryota;SAR;Stramenopiles;Ochrophyta;Diatomea;Bacillariophytina;Mediophyceae;Brockmanniella;";"0.0";"0";"2";"2";"0";"2";"0";"430522";"5766"
"LOK1378_1mm";"SILVA (only NR);Eukaryota;SAR;Stramenopiles;Ochrophyta;Diatomea;Bacillariophytina;Mediophyceae;Campylosira;";"0.0";"0";"1";"1";"0";"1";"0";"430523";"5766"
"LOK1378_1mm";"SILVA (only NR);Eukaryota;SAR;Stramenopiles;Ochrophyta;Diatomea;Bacillariophytina;Mediophyceae;Cerataulina;";"0.0";"0";"2";"2";"0";"2";"0";"430522";"5766"
"LOK1378_1mm";"SILVA (only NR);Eukaryota;SAR;Stramenopiles;Ochrophyta;Diatomea;Bacillariophytina;Mediophyceae;Chaetoceros;";"0.0";"0";"86";"85";"0";"85";"1";"430439";"5766"
"LOK1378_1mm";"SILVA (only NR);Eukaryota;SAR;Stramenopiles;Ochrophyta;Diatomea;Bacillariophytina;Mediophyceae;Cyclotella;";"0.0";"0";"20";"20";"0";"20";"0";"430504";"5766"
"LOK1378_1mm";"SILVA (only NR);Eukaryota;SAR;Stramenopiles;Ochrophyta;Diatomea;Bacillariophytina;Mediophyceae;Cymatosira;";"0.0";"0";"2";"2";"0";"2";"0";"430522";"5766"
"LOK1378_1mm";"SILVA (only NR);Eukaryota;SAR;Stramenopiles;Ochrophyta;Diatomea;Bacillariophytina;Mediophyceae;Dimeregramma;";"0.0";"0";"4";"3";"0";"3";"1";"430521";"5766"
"LOK1378_1mm";"SILVA (only NR);Eukaryota;SAR;Stramenopiles;Ochrophyta;Diatomea;Bacillariophytina;Mediophyceae;Discostella;";"0.0";"0";"3";"3";"0";"3";"0";"430521";"5766"
"LOK1378_1mm";"SILVA (only NR);Eukaryota;SAR;Stramenopiles;Ochrophyta;Diatomea;Bacillariophytina;Mediophyceae;Ditylum;";"0.0";"0";"2";"2";"0";"2";"0";"430522";"5766"
"LOK1378_1mm";"SILVA (only NR);Eukaryota;SAR;Stramenopiles;Ochrophyta;Diatomea;Bacillariophytina;Mediophyceae;Eucampia;";"0.0";"0";"2";"2";"0";"2";"0";"430522";"5766"
"LOK1378_1mm";"SILVA (only NR);Eukaryota;SAR;Stramenopiles;Ochrophyta;Diatomea;Bacillariophytina;Mediophyceae;Eunotogramma;";"0.0";"0";"1";"1";"0";"1";"0";"430523";"5766"
"LOK1378_1mm";"SILVA (only NR);Eukaryota;SAR;Stramenopiles;Ochrophyta;Diatomea;Bacillariophytina;Mediophyceae;Extubocellulus;";"0.0";"0";"1";"1";"0";"1";"0";"430523";"5766"
"LOK1378_1mm";"SILVA (only NR);Eukaryota;SAR;Stramenopiles;Ochrophyta;Diatomea;Bacillariophytina;Mediophyceae;Helicotheca;";"0.0";"0";"2";"2";"0";"2";"0";"430522";"5766"
"LOK1378_1mm";"SILVA (only NR);Eukaryota;SAR;Stramenopiles;Ochrophyta;Diatomea;Bacillariophytina;Mediophyceae;Hemiaulus;";"0.0";"0";"1";"1";"0";"1";"0";"430523";"5766"
"LOK1378_1mm";"SILVA (only NR);Eukaryota;SAR;Stramenopiles;Ochrophyta;Diatomea;Bacillariophytina;Mediophyceae;Isthmia;";"0.0";"0";"1";"1";"0";"1";"0";"430523";"5766"
"LOK1378_1mm";"SILVA (only NR);Eukaryota;SAR;Stramenopiles;Ochrophyta;Diatomea;Bacillariophytina;Mediophyceae;Lambertocellus;";"0.0";"0";"1";"1";"0";"1";"0";"430523";"5766"
"LOK1378_1mm";"SILVA (only NR);Eukaryota;SAR;Stramenopiles;Ochrophyta;Diatomea;Bacillariophytina;Mediophyceae;Lampriscus;";"0.0";"0";"3";"3";"0";"3";"0";"430521";"5766"
"LOK1378_1mm";"SILVA (only NR);Eukaryota;SAR;Stramenopiles;Ochrophyta;Diatomea;Bacillariophytina;Mediophyceae;Lauderia;";"0.0";"0";"2";"2";"0";"2";"0";"430522";"5766"
"LOK1378_1mm";"SILVA (only NR);Eukaryota;SAR;Stramenopiles;Ochrophyta;Diatomea;Bacillariophytina;Mediophyceae;Leyanella;";"0.0";"0";"2";"2";"0";"2";"0";"430522";"5766"
"LOK1378_1mm";"SILVA (only NR);Eukaryota;SAR;Stramenopiles;Ochrophyta;Diatomea;Bacillariophytina;Mediophyceae;Lithodesmium;";"0.0";"0";"2";"2";"0";"2";"0";"430522";"5766"
"LOK1378_1mm";"SILVA (only NR);Eukaryota;SAR;Stramenopiles;Ochrophyta;Diatomea;Bacillariophytina;Mediophyceae;Mastodiscus;";"0.0";"0";"1";"1";"0";"1";"0";"430523";"5766"
"LOK1378_1mm";"SILVA (only NR);Eukaryota;SAR;Stramenopiles;Ochrophyta;Diatomea;Bacillariophytina;Mediophyceae;Mediopyxis;";"0.0";"0";"1";"1";"0";"1";"0";"430523";"5766"
"LOK1378_1mm";"SILVA (only NR);Eukaryota;SAR;Stramenopiles;Ochrophyta;Diatomea;Bacillariophytina;Mediophyceae;Minidiscus;";"0.0";"0";"1";"1";"0";"1";"0";"430523";"5766"
"LOK1378_1mm";"SILVA (only NR);Eukaryota;SAR;Stramenopiles;Ochrophyta;Diatomea;Bacillariophytina;Mediophyceae;Minutocellus;";"0.0";"0";"3";"3";"0";"3";"0";"430521";"5766"
"LOK1378_1mm";"SILVA (only NR);Eukaryota;SAR;Stramenopiles;Ochrophyta;Diatomea;Bacillariophytina;Mediophyceae;Odontella;";"0.0";"0";"8";"8";"0";"8";"0";"430516";"5766"
"LOK1378_1mm";"SILVA (only NR);Eukaryota;SAR;Stramenopiles;Ochrophyta;Diatomea;Bacillariophytina;Mediophyceae;Papiliocellulus;";"0.0";"0";"3";"3";"0";"3";"0";"430521";"5766"
"LOK1378_1mm";"SILVA (only NR);Eukaryota;SAR;Stramenopiles;Ochrophyta;Diatomea;Bacillariophytina;Mediophyceae;Plagiogramma;";"0.0";"0";"2";"2";"0";"2";"0";"430522";"5766"
"LOK1378_1mm";"SILVA (only NR);Eukaryota;SAR;Stramenopiles;Ochrophyta;Diatomea;Bacillariophytina;Mediophyceae;Plagiogrammopsis;";"0.0";"0";"1";"1";"0";"1";"0";"430523";"5766"
"LOK1378_1mm";"SILVA (only NR);Eukaryota;SAR;Stramenopiles;Ochrophyta;Diatomea;Bacillariophytina;Mediophyceae;Planktoniella;";"0.0";"0";"1";"1";"0";"1";"0";"430523";"5766"
"LOK1378_1mm";"SILVA (only NR);Eukaryota;SAR;Stramenopiles;Ochrophyta;Diatomea;Bacillariophytina;Mediophyceae;Pleurosira;";"0.0";"0";"2";"2";"0";"2";"0";"430522";"5766"
"LOK1378_1mm";"SILVA (only NR);Eukaryota;SAR;Stramenopiles;Ochrophyta;Diatomea;Bacillariophytina;Mediophyceae;Porosira;";"0.0";"0";"4";"4";"0";"4";"0";"430520";"5766"
"LOK1378_1mm";"SILVA (only NR);Eukaryota;SAR;Stramenopiles;Ochrophyta;Diatomea;Bacillariophytina;Mediophyceae;Psammogramma;";"0.0";"0";"1";"1";"0";"1";"0";"430523";"5766"
"LOK1378_1mm";"SILVA (only NR);Eukaryota;SAR;Stramenopiles;Ochrophyta;Diatomea;Bacillariophytina;Mediophyceae;Psammoneis;";"0.0";"0";"1";"1";"0";"1";"0";"430523";"5766"
"LOK1378_1mm";"SILVA (only NR);Eukaryota;SAR;Stramenopiles;Ochrophyta;Diatomea;Bacillariophytina;Mediophyceae;Roundia;";"0.0";"0";"2";"2";"0";"2";"0";"430522";"5766"
"LOK1378_1mm";"SILVA (only NR);Eukaryota;SAR;Stramenopiles;Ochrophyta;Diatomea;Bacillariophytina;Mediophyceae;Skeletonema;";"0.0";"0";"40";"40";"0";"40";"0";"430484";"5766"
"LOK1378_1mm";"SILVA (only NR);Eukaryota;SAR;Stramenopiles;Ochrophyta;Diatomea;Bacillariophytina;Mediophyceae;Stephanodiscus;";"0.0";"0";"4";"4";"0";"4";"0";"430520";"5766"
"LOK1378_1mm";"SILVA (only NR);Eukaryota;SAR;Stramenopiles;Ochrophyta;Diatomea;Bacillariophytina;Mediophyceae;Talaroneis;";"0.0";"0";"1";"1";"0";"1";"0";"430523";"5766"
"LOK1378_1mm";"SILVA (only NR);Eukaryota;SAR;Stramenopiles;Ochrophyta;Diatomea;Bacillariophytina;Mediophyceae;Terpsinoe;";"0.0";"0";"2";"2";"0";"2";"0";"430522";"5766"
"LOK1378_1mm";"SILVA (only NR);Eukaryota;SAR;Stramenopiles;Ochrophyta;Diatomea;Bacillariophytina;Mediophyceae;Thalassiosira;";"0.0";"0";"97";"96";"0";"96";"1";"430428";"5766"
"LOK1378_1mm";"SILVA (only NR);Eukaryota;SAR;Stramenopiles;Ochrophyta;Diatomea;Bacillariophytina;Mediophyceae;Toxarium;";"0.0";"0";"2";"2";"0";"2";"0";"430522";"5766"
"LOK1378_1mm";"SILVA (only NR);Eukaryota;SAR;Stramenopiles;Ochrophyta;Diatomea;Bacillariophytina;Mediophyceae;Triceratium;";"0.0";"0";"5";"5";"0";"5";"0";"430519";"5766"
"LOK1378_1mm";"SILVA (only NR);Eukaryota;SAR;Stramenopiles;Ochrophyta;Diatomea;Bacillariophytina;Mediophyceae;uncultured;";"0.0";"0";"6";"6";"0";"6";"0";"430518";"5766"
"LOK1378_1mm";"SILVA (only NR);Eukaryota;SAR;Stramenopiles;Ochrophyta;Diatomea;Coscinodiscophytina;";"0.0";"0";"256";"252";"0";"252";"4";"430272";"5766"
"LOK1378_1mm";"SILVA (only NR);Eukaryota;SAR;Stramenopiles;Ochrophyta;Diatomea;Coscinodiscophytina;Actinocyclus;";"0.0";"0";"8";"8";"0";"8";"0";"430516";"5766"
"LOK1378_1mm";"SILVA (only NR);Eukaryota;SAR;Stramenopiles;Ochrophyta;Diatomea;Coscinodiscophytina;Actinoptychus;";"0.0";"0";"3";"3";"0";"3";"0";"430521";"5766"
"LOK1378_1mm";"SILVA (only NR);Eukaryota;SAR;Stramenopiles;Ochrophyta;Diatomea;Coscinodiscophytina;Aulacodiscus;";"0.0";"0";"2";"2";"0";"2";"0";"430522";"5766"
"LOK1378_1mm";"SILVA (only NR);Eukaryota;SAR;Stramenopiles;Ochrophyta;Diatomea;Coscinodiscophytina;Corethrids;";"0.0";"0";"4";"4";"0";"4";"0";"430520";"5766"
"LOK1378_1mm";"SILVA (only NR);Eukaryota;SAR;Stramenopiles;Ochrophyta;Diatomea;Coscinodiscophytina;Corethrids;Corethron;";"0.0";"0";"4";"4";"0";"4";"0";"430520";"5766"
"LOK1378_1mm";"SILVA (only NR);Eukaryota;SAR;Stramenopiles;Ochrophyta;Diatomea;Coscinodiscophytina;Coscinodiscus;";"0.0";"0";"8";"8";"0";"8";"0";"430516";"5766"
"LOK1378_1mm";"SILVA (only NR);Eukaryota;SAR;Stramenopiles;Ochrophyta;Diatomea;Coscinodiscophytina;Fragilariales;";"0.0";"0";"166";"162";"0";"162";"4";"430362";"5766"
"LOK1378_1mm";"SILVA (only NR);Eukaryota;SAR;Stramenopiles;Ochrophyta;Diatomea;Coscinodiscophytina;Fragilariales;Ardissonea;";"0.0";"0";"2";"2";"0";"2";"0";"430522";"5766"
"LOK1378_1mm";"SILVA (only NR);Eukaryota;SAR;Stramenopiles;Ochrophyta;Diatomea;Coscinodiscophytina;Fragilariales;Astrosyne;";"0.0";"0";"1";"1";"0";"1";"0";"430523";"5766"
"LOK1378_1mm";"SILVA (only NR);Eukaryota;SAR;Stramenopiles;Ochrophyta;Diatomea;Coscinodiscophytina;Fragilariales;Berkeleya;";"0.0";"0";"1";"1";"0";"1";"0";"430523";"5766"
"LOK1378_1mm";"SILVA (only NR);Eukaryota;SAR;Stramenopiles;Ochrophyta;Diatomea;Coscinodiscophytina;Fragilariales;Catacombas;";"0.0";"0";"1";"1";"0";"1";"0";"430523";"5766"
"LOK1378_1mm";"SILVA (only NR);Eukaryota;SAR;Stramenopiles;Ochrophyta;Diatomea;Coscinodiscophytina;Fragilariales;Climacosphenia;";"0.0";"0";"1";"1";"0";"1";"0";"430523";"5766"
"LOK1378_1mm";"SILVA (only NR);Eukaryota;SAR;Stramenopiles;Ochrophyta;Diatomea;Coscinodiscophytina;Fragilariales;Cyclophora;";"0.0";"0";"5";"5";"0";"5";"0";"430519";"5766"
"LOK1378_1mm";"SILVA (only NR);Eukaryota;SAR;Stramenopiles;Ochrophyta;Diatomea;Coscinodiscophytina;Fragilariales;Falcula;";"0.0";"0";"1";"1";"0";"1";"0";"430523";"5766"
"LOK1378_1mm";"SILVA (only NR);Eukaryota;SAR;Stramenopiles;Ochrophyta;Diatomea;Coscinodiscophytina;Fragilariales;Florella;";"0.0";"0";"1";"1";"0";"1";"0";"430523";"5766"
"LOK1378_1mm";"SILVA (only NR);Eukaryota;SAR;Stramenopiles;Ochrophyta;Diatomea;Coscinodiscophytina;Fragilariales;Fragilaria;";"0.0";"0";"18";"18";"0";"18";"0";"430506";"5766"
"LOK1378_1mm";"SILVA (only NR);Eukaryota;SAR;Stramenopiles;Ochrophyta;Diatomea;Coscinodiscophytina;Fragilariales;Fragilariaceae;";"0.0";"0";"2";"2";"0";"2";"0";"430522";"5766"
"LOK1378_1mm";"SILVA (only NR);Eukaryota;SAR;Stramenopiles;Ochrophyta;Diatomea;Coscinodiscophytina;Fragilariales;Fragilariaceae;Perideraion;";"0.0";"0";"2";"2";"0";"2";"0";"430522";"5766"
"LOK1378_1mm";"SILVA (only NR);Eukaryota;SAR;Stramenopiles;Ochrophyta;Diatomea;Coscinodiscophytina;Fragilariales;Fragilariforma;";"0.0";"0";"1";"1";"0";"1";"0";"430523";"5766"
"LOK1378_1mm";"SILVA (only NR);Eukaryota;SAR;Stramenopiles;Ochrophyta;Diatomea;Coscinodiscophytina;Fragilariales;Gedaniella;";"0.0";"0";"1";"1";"0";"1";"0";"430523";"5766"
"LOK1378_1mm";"SILVA (only NR);Eukaryota;SAR;Stramenopiles;Ochrophyta;Diatomea;Coscinodiscophytina;Fragilariales;Grammatophora;";"0.0";"0";"3";"3";"0";"3";"0";"430521";"5766"
"LOK1378_1mm";"SILVA (only NR);Eukaryota;SAR;Stramenopiles;Ochrophyta;Diatomea;Coscinodiscophytina;Fragilariales;Grammonema;";"0.0";"0";"3";"3";"0";"3";"0";"430521";"5766"
"LOK1378_1mm";"SILVA (only NR);Eukaryota;SAR;Stramenopiles;Ochrophyta;Diatomea;Coscinodiscophytina;Fragilariales;Hanicella;";"0.0";"0";"1";"1";"0";"1";"0";"430523";"5766"
"LOK1378_1mm";"SILVA (only NR);Eukaryota;SAR;Stramenopiles;Ochrophyta;Diatomea;Coscinodiscophytina;Fragilariales;Hyalosira;";"0.0";"0";"5";"5";"0";"5";"0";"430519";"5766"
"LOK1378_1mm";"SILVA (only NR);Eukaryota;SAR;Stramenopiles;Ochrophyta;Diatomea;Coscinodiscophytina;Fragilariales;Hyalosynedra;";"0.0";"0";"2";"2";"0";"2";"0";"430522";"5766"
"LOK1378_1mm";"SILVA (only NR);Eukaryota;SAR;Stramenopiles;Ochrophyta;Diatomea;Coscinodiscophytina;Fragilariales;Licmophora;";"0.0";"0";"29";"29";"0";"29";"0";"430495";"5766"
"LOK1378_1mm";"SILVA (only NR);Eukaryota;SAR;Stramenopiles;Ochrophyta;Diatomea;Coscinodiscophytina;Fragilariales;Licmosphenia;";"0.0";"0";"1";"1";"0";"1";"0";"430523";"5766"
"LOK1378_1mm";"SILVA (only NR);Eukaryota;SAR;Stramenopiles;Ochrophyta;Diatomea;Coscinodiscophytina;Fragilariales;Lucanicum;";"0.0";"0";"1";"1";"0";"1";"0";"430523";"5766"
"LOK1378_1mm";"SILVA (only NR);Eukaryota;SAR;Stramenopiles;Ochrophyta;Diatomea;Coscinodiscophytina;Fragilariales;Mastogloia;";"0.0";"0";"1";"1";"0";"1";"0";"430523";"5766"
"LOK1378_1mm";"SILVA (only NR);Eukaryota;SAR;Stramenopiles;Ochrophyta;Diatomea;Coscinodiscophytina;Fragilariales;Microtabella;";"0.0";"0";"2";"1";"0";"1";"1";"430523";"5766"
"LOK1378_1mm";"SILVA (only NR);Eukaryota;SAR;Stramenopiles;Ochrophyta;Diatomea;Coscinodiscophytina;Fragilariales;Nanofrustulum;";"0.0";"0";"3";"3";"0";"3";"0";"430521";"5766"
"LOK1378_1mm";"SILVA (only NR);Eukaryota;SAR;Stramenopiles;Ochrophyta;Diatomea;Coscinodiscophytina;Fragilariales;Opephora;";"0.0";"0";"1";"1";"0";"1";"0";"430523";"5766"
"LOK1378_1mm";"SILVA (only NR);Eukaryota;SAR;Stramenopiles;Ochrophyta;Diatomea;Coscinodiscophytina;Fragilariales;Plagiostriata;";"0.0";"0";"3";"1";"0";"1";"2";"430523";"5766"
"LOK1378_1mm";"SILVA (only NR);Eukaryota;SAR;Stramenopiles;Ochrophyta;Diatomea;Coscinodiscophytina;Fragilariales;Podocystis;";"0.0";"0";"2";"2";"0";"2";"0";"430522";"5766"
"LOK1378_1mm";"SILVA (only NR);Eukaryota;SAR;Stramenopiles;Ochrophyta;Diatomea;Coscinodiscophytina;Fragilariales;Protoraphis;";"0.0";"0";"2";"2";"0";"2";"0";"430522";"5766"
"LOK1378_1mm";"SILVA (only NR);Eukaryota;SAR;Stramenopiles;Ochrophyta;Diatomea;Coscinodiscophytina;Fragilariales;Pseudohimantidium;";"0.0";"0";"1";"1";"0";"1";"0";"430523";"5766"
"LOK1378_1mm";"SILVA (only NR);Eukaryota;SAR;Stramenopiles;Ochrophyta;Diatomea;Coscinodiscophytina;Fragilariales;Pseudostaurosira;";"0.0";"0";"1";"1";"0";"1";"0";"430523";"5766"
"LOK1378_1mm";"SILVA (only NR);Eukaryota;SAR;Stramenopiles;Ochrophyta;Diatomea;Coscinodiscophytina;Fragilariales;Pseudostriatella;";"0.0";"0";"1";"1";"0";"1";"0";"430523";"5766"
"LOK1378_1mm";"SILVA (only NR);Eukaryota;SAR;Stramenopiles;Ochrophyta;Diatomea;Coscinodiscophytina;Fragilariales;Pteroncola;";"0.0";"0";"1";"1";"0";"1";"0";"430523";"5766"
"LOK1378_1mm";"SILVA (only NR);Eukaryota;SAR;Stramenopiles;Ochrophyta;Diatomea;Coscinodiscophytina;Fragilariales;Rhabdonema;";"0.0";"0";"4";"4";"0";"4";"0";"430520";"5766"
"LOK1378_1mm";"SILVA (only NR);Eukaryota;SAR;Stramenopiles;Ochrophyta;Diatomea;Coscinodiscophytina;Fragilariales;Serratifera;";"0.0";"0";"6";"5";"0";"5";"1";"430519";"5766"
"LOK1378_1mm";"SILVA (only NR);Eukaryota;SAR;Stramenopiles;Ochrophyta;Diatomea;Coscinodiscophytina;Fragilariales;Stauroforma;";"0.0";"0";"1";"1";"0";"1";"0";"430523";"5766"
"LOK1378_1mm";"SILVA (only NR);Eukaryota;SAR;Stramenopiles;Ochrophyta;Diatomea;Coscinodiscophytina;Fragilariales;Staurosira;";"0.0";"0";"14";"14";"0";"14";"0";"430510";"5766"
"LOK1378_1mm";"SILVA (only NR);Eukaryota;SAR;Stramenopiles;Ochrophyta;Diatomea;Coscinodiscophytina;Fragilariales;Striatella;";"0.0";"0";"2";"2";"0";"2";"0";"430522";"5766"
"LOK1378_1mm";"SILVA (only NR);Eukaryota;SAR;Stramenopiles;Ochrophyta;Diatomea;Coscinodiscophytina;Fragilariales;Synedra;";"0.0";"0";"2";"2";"0";"2";"0";"430522";"5766"
"LOK1378_1mm";"SILVA (only NR);Eukaryota;SAR;Stramenopiles;Ochrophyta;Diatomea;Coscinodiscophytina;Fragilariales;Synedropsis;";"0.0";"0";"1";"1";"0";"1";"0";"430523";"5766"
"LOK1378_1mm";"SILVA (only NR);Eukaryota;SAR;Stramenopiles;Ochrophyta;Diatomea;Coscinodiscophytina;Fragilariales;Tabularia;";"0.0";"0";"1";"1";"0";"1";"0";"430523";"5766"
"LOK1378_1mm";"SILVA (only NR);Eukaryota;SAR;Stramenopiles;Ochrophyta;Diatomea;Coscinodiscophytina;Fragilariales;Thalassionema;";"0.0";"0";"7";"7";"0";"7";"0";"430517";"5766"
"LOK1378_1mm";"SILVA (only NR);Eukaryota;SAR;Stramenopiles;Ochrophyta;Diatomea;Coscinodiscophytina;Fragilariales;Ulnaria;";"0.0";"0";"6";"6";"0";"6";"0";"430518";"5766"
"LOK1378_1mm";"SILVA (only NR);Eukaryota;SAR;Stramenopiles;Ochrophyta;Diatomea;Coscinodiscophytina;Melosirids;";"0.0";"0";"27";"27";"0";"27";"0";"430497";"5766"
"LOK1378_1mm";"SILVA (only NR);Eukaryota;SAR;Stramenopiles;Ochrophyta;Diatomea;Coscinodiscophytina;Melosirids;Aulacoseira;";"0.0";"0";"14";"14";"0";"14";"0";"430510";"5766"
"LOK1378_1mm";"SILVA (only NR);Eukaryota;SAR;Stramenopiles;Ochrophyta;Diatomea;Coscinodiscophytina;Melosirids;Endictya;";"0.0";"0";"1";"1";"0";"1";"0";"430523";"5766"
"LOK1378_1mm";"SILVA (only NR);Eukaryota;SAR;Stramenopiles;Ochrophyta;Diatomea;Coscinodiscophytina;Melosirids;Hyalodiscus;";"0.0";"0";"2";"2";"0";"2";"0";"430522";"5766"
"LOK1378_1mm";"SILVA (only NR);Eukaryota;SAR;Stramenopiles;Ochrophyta;Diatomea;Coscinodiscophytina;Melosirids;Melosira;";"0.0";"0";"4";"4";"0";"4";"0";"430520";"5766"
"LOK1378_1mm";"SILVA (only NR);Eukaryota;SAR;Stramenopiles;Ochrophyta;Diatomea;Coscinodiscophytina;Melosirids;Paralia;";"0.0";"0";"3";"3";"0";"3";"0";"430521";"5766"
"LOK1378_1mm";"SILVA (only NR);Eukaryota;SAR;Stramenopiles;Ochrophyta;Diatomea;Coscinodiscophytina;Melosirids;Stephanopyxis;";"0.0";"0";"2";"2";"0";"2";"0";"430522";"5766"
"LOK1378_1mm";"SILVA (only NR);Eukaryota;SAR;Stramenopiles;Ochrophyta;Diatomea;Coscinodiscophytina;Palmerina;";"0.0";"0";"2";"2";"0";"2";"0";"430522";"5766"
"LOK1378_1mm";"SILVA (only NR);Eukaryota;SAR;Stramenopiles;Ochrophyta;Diatomea;Coscinodiscophytina;Rhizosolenids;";"0.0";"0";"28";"28";"0";"28";"0";"430496";"5766"
"LOK1378_1mm";"SILVA (only NR);Eukaryota;SAR;Stramenopiles;Ochrophyta;Diatomea;Coscinodiscophytina;Rhizosolenids;Guinardia;";"0.0";"0";"6";"6";"0";"6";"0";"430518";"5766"
"LOK1378_1mm";"SILVA (only NR);Eukaryota;SAR;Stramenopiles;Ochrophyta;Diatomea;Coscinodiscophytina;Rhizosolenids;Leptocylindrus;";"0.0";"0";"4";"4";"0";"4";"0";"430520";"5766"
"LOK1378_1mm";"SILVA (only NR);Eukaryota;SAR;Stramenopiles;Ochrophyta;Diatomea;Coscinodiscophytina;Rhizosolenids;Proboscia;";"0.0";"0";"5";"5";"0";"5";"0";"430519";"5766"
"LOK1378_1mm";"SILVA (only NR);Eukaryota;SAR;Stramenopiles;Ochrophyta;Diatomea;Coscinodiscophytina;Rhizosolenids;Pseudosolenia;";"0.0";"0";"2";"2";"0";"2";"0";"430522";"5766"
"LOK1378_1mm";"SILVA (only NR);Eukaryota;SAR;Stramenopiles;Ochrophyta;Diatomea;Coscinodiscophytina;Rhizosolenids;Rhizosolenia;";"0.0";"0";"6";"6";"0";"6";"0";"430518";"5766"
"LOK1378_1mm";"SILVA (only NR);Eukaryota;SAR;Stramenopiles;Ochrophyta;Diatomea;Coscinodiscophytina;Rhizosolenids;Tenuicylindrus;";"0.0";"0";"1";"1";"0";"1";"0";"430523";"5766"
"LOK1378_1mm";"SILVA (only NR);Eukaryota;SAR;Stramenopiles;Ochrophyta;Diatomea;Coscinodiscophytina;uncultured;";"0.0";"0";"3";"3";"0";"3";"0";"430521";"5766"
"LOK1378_1mm";"SILVA (only NR);Eukaryota;SAR;Stramenopiles;Ochrophyta;Diatomea;ME-Euk-FW10;";"0.0";"0";"22";"21";"0";"21";"1";"430503";"5766"
"LOK1378_1mm";"SILVA (only NR);Eukaryota;SAR;Stramenopiles;Ochrophyta;Dictyochophyceae;";"0.0";"0";"55";"53";"0";"53";"2";"430471";"5766"
"LOK1378_1mm";"SILVA (only NR);Eukaryota;SAR;Stramenopiles;Ochrophyta;Dictyochophyceae;Dictyochales;";"0.0";"0";"11";"11";"0";"11";"0";"430513";"5766"
"LOK1378_1mm";"SILVA (only NR);Eukaryota;SAR;Stramenopiles;Ochrophyta;Dictyochophyceae;Dictyochales;Dictyocha;";"0.0";"0";"5";"5";"0";"5";"0";"430519";"5766"
"LOK1378_1mm";"SILVA (only NR);Eukaryota;SAR;Stramenopiles;Ochrophyta;Dictyochophyceae;Dictyochales;Florenciella;";"0.0";"0";"6";"6";"0";"6";"0";"430518";"5766"
"LOK1378_1mm";"SILVA (only NR);Eukaryota;SAR;Stramenopiles;Ochrophyta;Dictyochophyceae;Florenciellales;";"0.0";"0";"2";"2";"0";"2";"0";"430522";"5766"
"LOK1378_1mm";"SILVA (only NR);Eukaryota;SAR;Stramenopiles;Ochrophyta;Dictyochophyceae;Florenciellales;Pseudochattonella;";"0.0";"0";"2";"2";"0";"2";"0";"430522";"5766"
"LOK1378_1mm";"SILVA (only NR);Eukaryota;SAR;Stramenopiles;Ochrophyta;Dictyochophyceae;Pedinellales;";"0.0";"0";"31";"30";"0";"30";"1";"430494";"5766"
"LOK1378_1mm";"SILVA (only NR);Eukaryota;SAR;Stramenopiles;Ochrophyta;Dictyochophyceae;Pedinellales;Ciliophrys;";"0.0";"0";"3";"3";"0";"3";"0";"430521";"5766"
"LOK1378_1mm";"SILVA (only NR);Eukaryota;SAR;Stramenopiles;Ochrophyta;Dictyochophyceae;Pedinellales;FV36-2G08;";"0.0";"0";"4";"4";"0";"4";"0";"430520";"5766"
"LOK1378_1mm";"SILVA (only NR);Eukaryota;SAR;Stramenopiles;Ochrophyta;Dictyochophyceae;Pedinellales;Helicopedinella;";"0.0";"0";"1";"0";"0";"0";"1";"430524";"5766"
"LOK1378_1mm";"SILVA (only NR);Eukaryota;SAR;Stramenopiles;Ochrophyta;Dictyochophyceae;Pedinellales;Pedinella;";"0.0";"0";"2";"2";"0";"2";"0";"430522";"5766"
"LOK1378_1mm";"SILVA (only NR);Eukaryota;SAR;Stramenopiles;Ochrophyta;Dictyochophyceae;Pedinellales;Pseudopedinella;";"0.0";"0";"6";"6";"0";"6";"0";"430518";"5766"
"LOK1378_1mm";"SILVA (only NR);Eukaryota;SAR;Stramenopiles;Ochrophyta;Dictyochophyceae;Pedinellales;Pteridomonas;";"0.0";"0";"6";"6";"0";"6";"0";"430518";"5766"
"LOK1378_1mm";"SILVA (only NR);Eukaryota;SAR;Stramenopiles;Ochrophyta;Dictyochophyceae;Rhizochromulinales;";"0.0";"0";"3";"3";"0";"3";"0";"430521";"5766"
"LOK1378_1mm";"SILVA (only NR);Eukaryota;SAR;Stramenopiles;Ochrophyta;Dictyochophyceae;Rhizochromulinales;Rhizochromulina;";"0.0";"0";"3";"3";"0";"3";"0";"430521";"5766"
"LOK1378_1mm";"SILVA (only NR);Eukaryota;SAR;Stramenopiles;Ochrophyta;Eustigmatophyceae;";"0.0";"0";"56";"53";"0";"53";"3";"430471";"5766"
"LOK1378_1mm";"SILVA (only NR);Eukaryota;SAR;Stramenopiles;Ochrophyta;Eustigmatophyceae;Eustigmatales;";"0.0";"0";"56";"53";"0";"53";"3";"430471";"5766"
"LOK1378_1mm";"SILVA (only NR);Eukaryota;SAR;Stramenopiles;Ochrophyta;Eustigmatophyceae;Eustigmatales;Characiopsis;";"0.0";"0";"1";"1";"0";"1";"0";"430523";"5766"
"LOK1378_1mm";"SILVA (only NR);Eukaryota;SAR;Stramenopiles;Ochrophyta;Eustigmatophyceae;Eustigmatales;Chlorobotrys;";"0.0";"0";"1";"1";"0";"1";"0";"430523";"5766"
"LOK1378_1mm";"SILVA (only NR);Eukaryota;SAR;Stramenopiles;Ochrophyta;Eustigmatophyceae;Eustigmatales;Goniochloris;";"0.0";"0";"5";"5";"0";"5";"0";"430519";"5766"
"LOK1378_1mm";"SILVA (only NR);Eukaryota;SAR;Stramenopiles;Ochrophyta;Eustigmatophyceae;Eustigmatales;Monodus;";"0.0";"0";"1";"1";"0";"1";"0";"430523";"5766"
"LOK1378_1mm";"SILVA (only NR);Eukaryota;SAR;Stramenopiles;Ochrophyta;Eustigmatophyceae;Eustigmatales;Nannochloropsis;";"0.0";"0";"15";"14";"0";"14";"1";"430510";"5766"
"LOK1378_1mm";"SILVA (only NR);Eukaryota;SAR;Stramenopiles;Ochrophyta;Eustigmatophyceae;Eustigmatales;Pseudocharaciopsis;";"0.0";"0";"2";"2";"0";"2";"0";"430522";"5766"
"LOK1378_1mm";"SILVA (only NR);Eukaryota;SAR;Stramenopiles;Ochrophyta;Eustigmatophyceae;Eustigmatales;Pseudostaurastrum;";"0.0";"0";"4";"4";"0";"4";"0";"430520";"5766"
"LOK1378_1mm";"SILVA (only NR);Eukaryota;SAR;Stramenopiles;Ochrophyta;Eustigmatophyceae;Eustigmatales;Tetraedriella;";"0.0";"0";"1";"1";"0";"1";"0";"430523";"5766"
"LOK1378_1mm";"SILVA (only NR);Eukaryota;SAR;Stramenopiles;Ochrophyta;Eustigmatophyceae;Eustigmatales;Trachydiscus;";"0.0";"0";"2";"2";"0";"2";"0";"430522";"5766"
"LOK1378_1mm";"SILVA (only NR);Eukaryota;SAR;Stramenopiles;Ochrophyta;Eustigmatophyceae;Eustigmatales;Vacuoliviride;";"0.0";"0";"1";"1";"0";"1";"0";"430523";"5766"
"LOK1378_1mm";"SILVA (only NR);Eukaryota;SAR;Stramenopiles;Ochrophyta;Eustigmatophyceae;Eustigmatales;Vischeria;";"0.0";"0";"1";"1";"0";"1";"0";"430523";"5766"
"LOK1378_1mm";"SILVA (only NR);Eukaryota;SAR;Stramenopiles;Ochrophyta;Eustigmatophyceae;Eustigmatales;phytoplankton;";"0.0";"0";"1";"1";"0";"1";"0";"430523";"5766"
"LOK1378_1mm";"SILVA (only NR);Eukaryota;SAR;Stramenopiles;Ochrophyta;Eustigmatophyceae;Eustigmatales;uncultured;";"0.0";"0";"7";"7";"0";"7";"0";"430517";"5766"
"LOK1378_1mm";"SILVA (only NR);Eukaryota;SAR;Stramenopiles;Ochrophyta;Incertae Sedis;";"0.0";"0";"1";"1";"0";"1";"0";"430523";"5766"
"LOK1378_1mm";"SILVA (only NR);Eukaryota;SAR;Stramenopiles;Ochrophyta;Incertae Sedis;Picophagus;";"0.0";"0";"1";"1";"0";"1";"0";"430523";"5766"
"LOK1378_1mm";"SILVA (only NR);Eukaryota;SAR;Stramenopiles;Ochrophyta;MOCH-2;";"0.0";"0";"4";"4";"0";"4";"0";"430520";"5766"
"LOK1378_1mm";"SILVA (only NR);Eukaryota;SAR;Stramenopiles;Ochrophyta;Pelagophyceae;";"0.0";"0";"38";"38";"0";"38";"0";"430486";"5766"
"LOK1378_1mm";"SILVA (only NR);Eukaryota;SAR;Stramenopiles;Ochrophyta;Pelagophyceae;Pelagomonadales;";"0.0";"0";"9";"9";"0";"9";"0";"430515";"5766"
"LOK1378_1mm";"SILVA (only NR);Eukaryota;SAR;Stramenopiles;Ochrophyta;Pelagophyceae;Pelagomonadales;Aureococcus;";"0.0";"0";"5";"5";"0";"5";"0";"430519";"5766"
"LOK1378_1mm";"SILVA (only NR);Eukaryota;SAR;Stramenopiles;Ochrophyta;Pelagophyceae;Pelagomonadales;Pelagomonas;";"0.0";"0";"1";"1";"0";"1";"0";"430523";"5766"
"LOK1378_1mm";"SILVA (only NR);Eukaryota;SAR;Stramenopiles;Ochrophyta;Pelagophyceae;Sarcinochrysidales;";"0.0";"0";"27";"27";"0";"27";"0";"430497";"5766"
"LOK1378_1mm";"SILVA (only NR);Eukaryota;SAR;Stramenopiles;Ochrophyta;Pelagophyceae;Sarcinochrysidales;Andersenia;";"0.0";"0";"1";"1";"0";"1";"0";"430523";"5766"
"LOK1378_1mm";"SILVA (only NR);Eukaryota;SAR;Stramenopiles;Ochrophyta;Pelagophyceae;Sarcinochrysidales;Ankylochrisis;";"0.0";"0";"6";"6";"0";"6";"0";"430518";"5766"
"LOK1378_1mm";"SILVA (only NR);Eukaryota;SAR;Stramenopiles;Ochrophyta;Pelagophyceae;Sarcinochrysidales;Aureoumbra;";"0.0";"0";"6";"6";"0";"6";"0";"430518";"5766"
"LOK1378_1mm";"SILVA (only NR);Eukaryota;SAR;Stramenopiles;Ochrophyta;Pelagophyceae;Sarcinochrysidales;Chrysophaeum;";"0.0";"0";"1";"1";"0";"1";"0";"430523";"5766"
"LOK1378_1mm";"SILVA (only NR);Eukaryota;SAR;Stramenopiles;Ochrophyta;Pelagophyceae;Sarcinochrysidales;SS1-E01-69;";"0.0";"0";"4";"4";"0";"4";"0";"430520";"5766"
"LOK1378_1mm";"SILVA (only NR);Eukaryota;SAR;Stramenopiles;Ochrophyta;Pelagophyceae;Sarcinochrysidales;Sarcinochrysis;";"0.0";"0";"5";"5";"0";"5";"0";"430519";"5766"
"LOK1378_1mm";"SILVA (only NR);Eukaryota;SAR;Stramenopiles;Ochrophyta;Phaeophyceae;";"0.0";"0";"66";"64";"0";"64";"2";"430460";"5766"
"LOK1378_1mm";"SILVA (only NR);Eukaryota;SAR;Stramenopiles;Ochrophyta;Phaeophyceae;Chorda;";"0.0";"0";"1";"1";"0";"1";"0";"430523";"5766"
"LOK1378_1mm";"SILVA (only NR);Eukaryota;SAR;Stramenopiles;Ochrophyta;Phaeophyceae;Desmarestiales;";"0.0";"0";"1";"1";"0";"1";"0";"430523";"5766"
"LOK1378_1mm";"SILVA (only NR);Eukaryota;SAR;Stramenopiles;Ochrophyta;Phaeophyceae;Desmarestiales;Desmarestia;";"0.0";"0";"1";"1";"0";"1";"0";"430523";"5766"
"LOK1378_1mm";"SILVA (only NR);Eukaryota;SAR;Stramenopiles;Ochrophyta;Phaeophyceae;Dictyotales;";"0.0";"0";"23";"23";"0";"23";"0";"430501";"5766"
"LOK1378_1mm";"SILVA (only NR);Eukaryota;SAR;Stramenopiles;Ochrophyta;Phaeophyceae;Dictyotales;Dictyopteris;";"0.0";"0";"2";"2";"0";"2";"0";"430522";"5766"
"LOK1378_1mm";"SILVA (only NR);Eukaryota;SAR;Stramenopiles;Ochrophyta;Phaeophyceae;Dictyotales;Dictyota;";"0.0";"0";"1";"1";"0";"1";"0";"430523";"5766"
"LOK1378_1mm";"SILVA (only NR);Eukaryota;SAR;Stramenopiles;Ochrophyta;Phaeophyceae;Dictyotales;Distromium;";"0.0";"0";"2";"2";"0";"2";"0";"430522";"5766"
"LOK1378_1mm";"SILVA (only NR);Eukaryota;SAR;Stramenopiles;Ochrophyta;Phaeophyceae;Dictyotales;Exallosorus;";"0.0";"0";"2";"2";"0";"2";"0";"430522";"5766"
"LOK1378_1mm";"SILVA (only NR);Eukaryota;SAR;Stramenopiles;Ochrophyta;Phaeophyceae;Dictyotales;Lobophora;";"0.0";"0";"1";"1";"0";"1";"0";"430523";"5766"
"LOK1378_1mm";"SILVA (only NR);Eukaryota;SAR;Stramenopiles;Ochrophyta;Phaeophyceae;Dictyotales;Lobospira;";"0.0";"0";"1";"1";"0";"1";"0";"430523";"5766"
"LOK1378_1mm";"SILVA (only NR);Eukaryota;SAR;Stramenopiles;Ochrophyta;Phaeophyceae;Dictyotales;Newhousia;";"0.0";"0";"1";"1";"0";"1";"0";"430523";"5766"
"LOK1378_1mm";"SILVA (only NR);Eukaryota;SAR;Stramenopiles;Ochrophyta;Phaeophyceae;Dictyotales;Padina;";"0.0";"0";"7";"7";"0";"7";"0";"430517";"5766"
"LOK1378_1mm";"SILVA (only NR);Eukaryota;SAR;Stramenopiles;Ochrophyta;Phaeophyceae;Dictyotales;Rugulopteryx;";"0.0";"0";"1";"1";"0";"1";"0";"430523";"5766"
"LOK1378_1mm";"SILVA (only NR);Eukaryota;SAR;Stramenopiles;Ochrophyta;Phaeophyceae;Dictyotales;Zonaria;";"0.0";"0";"4";"4";"0";"4";"0";"430520";"5766"
"LOK1378_1mm";"SILVA (only NR);Eukaryota;SAR;Stramenopiles;Ochrophyta;Phaeophyceae;Ectocarpales;";"0.0";"0";"21";"20";"0";"20";"1";"430504";"5766"
"LOK1378_1mm";"SILVA (only NR);Eukaryota;SAR;Stramenopiles;Ochrophyta;Phaeophyceae;Ectocarpales;Asterocladon;";"0.0";"0";"2";"2";"0";"2";"0";"430522";"5766"
"LOK1378_1mm";"SILVA (only NR);Eukaryota;SAR;Stramenopiles;Ochrophyta;Phaeophyceae;Ectocarpales;Ectocarpus;";"0.0";"0";"1";"1";"0";"1";"0";"430523";"5766"
"LOK1378_1mm";"SILVA (only NR);Eukaryota;SAR;Stramenopiles;Ochrophyta;Phaeophyceae;Ectocarpales;Halothrix;";"0.0";"0";"1";"1";"0";"1";"0";"430523";"5766"
"LOK1378_1mm";"SILVA (only NR);Eukaryota;SAR;Stramenopiles;Ochrophyta;Phaeophyceae;Ectocarpales;Heribaudiella;";"0.0";"0";"1";"1";"0";"1";"0";"430523";"5766"
"LOK1378_1mm";"SILVA (only NR);Eukaryota;SAR;Stramenopiles;Ochrophyta;Phaeophyceae;Ectocarpales;Ishige;";"0.0";"0";"2";"2";"0";"2";"0";"430522";"5766"
"LOK1378_1mm";"SILVA (only NR);Eukaryota;SAR;Stramenopiles;Ochrophyta;Phaeophyceae;Ectocarpales;Papenfussiella;";"0.0";"0";"1";"1";"0";"1";"0";"430523";"5766"
"LOK1378_1mm";"SILVA (only NR);Eukaryota;SAR;Stramenopiles;Ochrophyta;Phaeophyceae;Ectocarpales;Petalonia;";"0.0";"0";"1";"0";"0";"0";"1";"430524";"5766"
"LOK1378_1mm";"SILVA (only NR);Eukaryota;SAR;Stramenopiles;Ochrophyta;Phaeophyceae;Ectocarpales;Phaeostrophion;";"0.0";"0";"1";"1";"0";"1";"0";"430523";"5766"
"LOK1378_1mm";"SILVA (only NR);Eukaryota;SAR;Stramenopiles;Ochrophyta;Phaeophyceae;Ectocarpales;Porterinema;";"0.0";"0";"1";"1";"0";"1";"0";"430523";"5766"
"LOK1378_1mm";"SILVA (only NR);Eukaryota;SAR;Stramenopiles;Ochrophyta;Phaeophyceae;Ectocarpales;Pylaiella;";"0.0";"0";"2";"2";"0";"2";"0";"430522";"5766"
"LOK1378_1mm";"SILVA (only NR);Eukaryota;SAR;Stramenopiles;Ochrophyta;Phaeophyceae;Ectocarpales;Scytosiphon;";"0.0";"0";"2";"2";"0";"2";"0";"430522";"5766"
"LOK1378_1mm";"SILVA (only NR);Eukaryota;SAR;Stramenopiles;Ochrophyta;Phaeophyceae;Ectocarpales;Stschapovia;";"0.0";"0";"1";"1";"0";"1";"0";"430523";"5766"
"LOK1378_1mm";"SILVA (only NR);Eukaryota;SAR;Stramenopiles;Ochrophyta;Phaeophyceae;Ectocarpales;Tribonema;";"0.0";"0";"1";"1";"0";"1";"0";"430523";"5766"
"LOK1378_1mm";"SILVA (only NR);Eukaryota;SAR;Stramenopiles;Ochrophyta;Phaeophyceae;Fucales;";"0.0";"0";"9";"9";"0";"9";"0";"430515";"5766"
"LOK1378_1mm";"SILVA (only NR);Eukaryota;SAR;Stramenopiles;Ochrophyta;Phaeophyceae;Fucales;Coccophora;";"0.0";"0";"1";"1";"0";"1";"0";"430523";"5766"
"LOK1378_1mm";"SILVA (only NR);Eukaryota;SAR;Stramenopiles;Ochrophyta;Phaeophyceae;Fucales;Cystoseira;";"0.0";"0";"1";"1";"0";"1";"0";"430523";"5766"
"LOK1378_1mm";"SILVA (only NR);Eukaryota;SAR;Stramenopiles;Ochrophyta;Phaeophyceae;Fucales;Fucus;";"0.0";"0";"1";"1";"0";"1";"0";"430523";"5766"
"LOK1378_1mm";"SILVA (only NR);Eukaryota;SAR;Stramenopiles;Ochrophyta;Phaeophyceae;Fucales;Sargassum;";"0.0";"0";"5";"5";"0";"5";"0";"430519";"5766"
"LOK1378_1mm";"SILVA (only NR);Eukaryota;SAR;Stramenopiles;Ochrophyta;Phaeophyceae;Fucales;Silvetia;";"0.0";"0";"1";"1";"0";"1";"0";"430523";"5766"
"LOK1378_1mm";"SILVA (only NR);Eukaryota;SAR;Stramenopiles;Ochrophyta;Phaeophyceae;Laminariales;";"0.0";"0";"3";"3";"0";"3";"0";"430521";"5766"
"LOK1378_1mm";"SILVA (only NR);Eukaryota;SAR;Stramenopiles;Ochrophyta;Phaeophyceae;Laminariales;Akkesiphycus;";"0.0";"0";"1";"1";"0";"1";"0";"430523";"5766"
"LOK1378_1mm";"SILVA (only NR);Eukaryota;SAR;Stramenopiles;Ochrophyta;Phaeophyceae;Laminariales;Lessonia;";"0.0";"0";"2";"2";"0";"2";"0";"430522";"5766"
"LOK1378_1mm";"SILVA (only NR);Eukaryota;SAR;Stramenopiles;Ochrophyta;Phaeophyceae;Sphacelariales;";"0.0";"0";"2";"2";"0";"2";"0";"430522";"5766"
"LOK1378_1mm";"SILVA (only NR);Eukaryota;SAR;Stramenopiles;Ochrophyta;Phaeophyceae;Sphacelariales;Choristocarpus;";"0.0";"0";"1";"1";"0";"1";"0";"430523";"5766"
"LOK1378_1mm";"SILVA (only NR);Eukaryota;SAR;Stramenopiles;Ochrophyta;Phaeophyceae;Sphacelariales;Discosporangium;";"0.0";"0";"1";"1";"0";"1";"0";"430523";"5766"
"LOK1378_1mm";"SILVA (only NR);Eukaryota;SAR;Stramenopiles;Ochrophyta;Phaeophyceae;Tilopteridales;";"0.0";"0";"3";"3";"0";"3";"0";"430521";"5766"
"LOK1378_1mm";"SILVA (only NR);Eukaryota;SAR;Stramenopiles;Ochrophyta;Phaeophyceae;Tilopteridales;Phaeosiphoniella;";"0.0";"0";"1";"1";"0";"1";"0";"430523";"5766"
"LOK1378_1mm";"SILVA (only NR);Eukaryota;SAR;Stramenopiles;Ochrophyta;Phaeophyceae;Tilopteridales;Saccorhiza;";"0.0";"0";"1";"1";"0";"1";"0";"430523";"5766"
"LOK1378_1mm";"SILVA (only NR);Eukaryota;SAR;Stramenopiles;Ochrophyta;Phaeophyceae;Tilopteridales;Tilopteris;";"0.0";"0";"1";"1";"0";"1";"0";"430523";"5766"
"LOK1378_1mm";"SILVA (only NR);Eukaryota;SAR;Stramenopiles;Ochrophyta;Phaeothamniophyceae;";"0.0";"0";"8";"8";"0";"8";"0";"430516";"5766"
"LOK1378_1mm";"SILVA (only NR);Eukaryota;SAR;Stramenopiles;Ochrophyta;Phaeothamniophyceae;Phaeothamniales;";"0.0";"0";"4";"4";"0";"4";"0";"430520";"5766"
"LOK1378_1mm";"SILVA (only NR);Eukaryota;SAR;Stramenopiles;Ochrophyta;Phaeothamniophyceae;Phaeothamniales;Phaeothamnion;";"0.0";"0";"1";"1";"0";"1";"0";"430523";"5766"
"LOK1378_1mm";"SILVA (only NR);Eukaryota;SAR;Stramenopiles;Ochrophyta;Phaeothamniophyceae;Phaeothamniales;Stichogloea;";"0.0";"0";"1";"1";"0";"1";"0";"430523";"5766"
"LOK1378_1mm";"SILVA (only NR);Eukaryota;SAR;Stramenopiles;Ochrophyta;Phaeothamniophyceae;Pleurochloridales;";"0.0";"0";"4";"4";"0";"4";"0";"430520";"5766"
"LOK1378_1mm";"SILVA (only NR);Eukaryota;SAR;Stramenopiles;Ochrophyta;Phaeothamniophyceae;Pleurochloridales;Phaeobotrys;";"0.0";"0";"1";"1";"0";"1";"0";"430523";"5766"
"LOK1378_1mm";"SILVA (only NR);Eukaryota;SAR;Stramenopiles;Ochrophyta;Phaeothamniophyceae;Pleurochloridales;Pleurochloridella;";"0.0";"0";"2";"2";"0";"2";"0";"430522";"5766"
"LOK1378_1mm";"SILVA (only NR);Eukaryota;SAR;Stramenopiles;Ochrophyta;Phaeothamniophyceae;Pleurochloridales;Tetrasporopsis;";"0.0";"0";"1";"1";"0";"1";"0";"430523";"5766"
"LOK1378_1mm";"SILVA (only NR);Eukaryota;SAR;Stramenopiles;Ochrophyta;Pinguiophyceae;";"0.0";"0";"6";"6";"0";"6";"0";"430518";"5766"
"LOK1378_1mm";"SILVA (only NR);Eukaryota;SAR;Stramenopiles;Ochrophyta;Pinguiophyceae;Pinguiochrysidales;";"0.0";"0";"6";"6";"0";"6";"0";"430518";"5766"
"LOK1378_1mm";"SILVA (only NR);Eukaryota;SAR;Stramenopiles;Ochrophyta;Pinguiophyceae;Pinguiochrysidales;Glossomastix;";"0.0";"0";"1";"1";"0";"1";"0";"430523";"5766"
"LOK1378_1mm";"SILVA (only NR);Eukaryota;SAR;Stramenopiles;Ochrophyta;Pinguiophyceae;Pinguiochrysidales;Phaeomonas;";"0.0";"0";"2";"2";"0";"2";"0";"430522";"5766"
"LOK1378_1mm";"SILVA (only NR);Eukaryota;SAR;Stramenopiles;Ochrophyta;Pinguiophyceae;Pinguiochrysidales;Pinguiochrysis;";"0.0";"0";"1";"1";"0";"1";"0";"430523";"5766"
"LOK1378_1mm";"SILVA (only NR);Eukaryota;SAR;Stramenopiles;Ochrophyta;Pinguiophyceae;Pinguiochrysidales;Pinguiococcus;";"0.0";"0";"1";"1";"0";"1";"0";"430523";"5766"
"LOK1378_1mm";"SILVA (only NR);Eukaryota;SAR;Stramenopiles;Ochrophyta;Pinguiophyceae;Pinguiochrysidales;Polypodochrysis;";"0.0";"0";"1";"1";"0";"1";"0";"430523";"5766"
"LOK1378_1mm";"SILVA (only NR);Eukaryota;SAR;Stramenopiles;Ochrophyta;Raphidophyceae;";"0.0";"0";"23";"23";"0";"23";"0";"430501";"5766"
"LOK1378_1mm";"SILVA (only NR);Eukaryota;SAR;Stramenopiles;Ochrophyta;Raphidophyceae;Chattonellales;";"0.0";"0";"18";"18";"0";"18";"0";"430506";"5766"
"LOK1378_1mm";"SILVA (only NR);Eukaryota;SAR;Stramenopiles;Ochrophyta;Raphidophyceae;Chattonellales;Chattonella;";"0.0";"0";"2";"2";"0";"2";"0";"430522";"5766"
"LOK1378_1mm";"SILVA (only NR);Eukaryota;SAR;Stramenopiles;Ochrophyta;Raphidophyceae;Chattonellales;Chloromorum;";"0.0";"0";"2";"2";"0";"2";"0";"430522";"5766"
"LOK1378_1mm";"SILVA (only NR);Eukaryota;SAR;Stramenopiles;Ochrophyta;Raphidophyceae;Chattonellales;Fibrocapsa;";"0.0";"0";"1";"1";"0";"1";"0";"430523";"5766"
"LOK1378_1mm";"SILVA (only NR);Eukaryota;SAR;Stramenopiles;Ochrophyta;Raphidophyceae;Chattonellales;Gonyostomum;";"0.0";"0";"1";"1";"0";"1";"0";"430523";"5766"
"LOK1378_1mm";"SILVA (only NR);Eukaryota;SAR;Stramenopiles;Ochrophyta;Raphidophyceae;Chattonellales;Haramonas;";"0.0";"0";"3";"3";"0";"3";"0";"430521";"5766"
"LOK1378_1mm";"SILVA (only NR);Eukaryota;SAR;Stramenopiles;Ochrophyta;Raphidophyceae;Chattonellales;Heterosigma;";"0.0";"0";"1";"1";"0";"1";"0";"430523";"5766"
"LOK1378_1mm";"SILVA (only NR);Eukaryota;SAR;Stramenopiles;Ochrophyta;Raphidophyceae;Chattonellales;Isonoura-2009;";"0.0";"0";"2";"2";"0";"2";"0";"430522";"5766"
"LOK1378_1mm";"SILVA (only NR);Eukaryota;SAR;Stramenopiles;Ochrophyta;Raphidophyceae;Chattonellales;Merotricha;";"0.0";"0";"1";"1";"0";"1";"0";"430523";"5766"
"LOK1378_1mm";"SILVA (only NR);Eukaryota;SAR;Stramenopiles;Ochrophyta;Raphidophyceae;Chattonellales;Psammamonas;";"0.0";"0";"1";"1";"0";"1";"0";"430523";"5766"
"LOK1378_1mm";"SILVA (only NR);Eukaryota;SAR;Stramenopiles;Ochrophyta;Raphidophyceae;Chattonellales;Vacuolaria;";"0.0";"0";"1";"1";"0";"1";"0";"430523";"5766"
"LOK1378_1mm";"SILVA (only NR);Eukaryota;SAR;Stramenopiles;Ochrophyta;Raphidophyceae;Chattonellales;Viridilobus;";"0.0";"0";"1";"1";"0";"1";"0";"430523";"5766"
"LOK1378_1mm";"SILVA (only NR);Eukaryota;SAR;Stramenopiles;Ochrophyta;Raphidophyceae;Olisthodiscus;";"0.0";"0";"2";"2";"0";"2";"0";"430522";"5766"
"LOK1378_1mm";"SILVA (only NR);Eukaryota;SAR;Stramenopiles;Ochrophyta;Schizocladiophyceae;";"0.0";"0";"1";"1";"0";"1";"0";"430523";"5766"
"LOK1378_1mm";"SILVA (only NR);Eukaryota;SAR;Stramenopiles;Ochrophyta;Schizocladiophyceae;Schizocladia;";"0.0";"0";"1";"1";"0";"1";"0";"430523";"5766"
"LOK1378_1mm";"SILVA (only NR);Eukaryota;SAR;Stramenopiles;Ochrophyta;Synchromophyceae;";"0.0";"0";"4";"4";"0";"4";"0";"430520";"5766"
"LOK1378_1mm";"SILVA (only NR);Eukaryota;SAR;Stramenopiles;Ochrophyta;Synchromophyceae;Synchroma;";"0.0";"0";"4";"4";"0";"4";"0";"430520";"5766"
"LOK1378_1mm";"SILVA (only NR);Eukaryota;SAR;Stramenopiles;Ochrophyta;Xanthophyceae;";"0.0";"0";"36";"36";"0";"36";"0";"430488";"5766"
"LOK1378_1mm";"SILVA (only NR);Eukaryota;SAR;Stramenopiles;Ochrophyta;Xanthophyceae;Mischococcales;";"0.0";"0";"12";"12";"0";"12";"0";"430512";"5766"
"LOK1378_1mm";"SILVA (only NR);Eukaryota;SAR;Stramenopiles;Ochrophyta;Xanthophyceae;Mischococcales;Botrydiopsis;";"0.0";"0";"3";"3";"0";"3";"0";"430521";"5766"
"LOK1378_1mm";"SILVA (only NR);Eukaryota;SAR;Stramenopiles;Ochrophyta;Xanthophyceae;Mischococcales;Bumilleriopsis;";"0.0";"0";"2";"2";"0";"2";"0";"430522";"5766"
"LOK1378_1mm";"SILVA (only NR);Eukaryota;SAR;Stramenopiles;Ochrophyta;Xanthophyceae;Mischococcales;Chlorellidium;";"0.0";"0";"2";"2";"0";"2";"0";"430522";"5766"
"LOK1378_1mm";"SILVA (only NR);Eukaryota;SAR;Stramenopiles;Ochrophyta;Xanthophyceae;Mischococcales;Mischococcus;";"0.0";"0";"1";"1";"0";"1";"0";"430523";"5766"
"LOK1378_1mm";"SILVA (only NR);Eukaryota;SAR;Stramenopiles;Ochrophyta;Xanthophyceae;Mischococcales;Pleurochloris;";"0.0";"0";"1";"1";"0";"1";"0";"430523";"5766"
"LOK1378_1mm";"SILVA (only NR);Eukaryota;SAR;Stramenopiles;Ochrophyta;Xanthophyceae;Mischococcales;Pseudopleurochloris;";"0.0";"0";"1";"1";"0";"1";"0";"430523";"5766"
"LOK1378_1mm";"SILVA (only NR);Eukaryota;SAR;Stramenopiles;Ochrophyta;Xanthophyceae;Mischococcales;Sphaerosorus;";"0.0";"0";"1";"1";"0";"1";"0";"430523";"5766"
"LOK1378_1mm";"SILVA (only NR);Eukaryota;SAR;Stramenopiles;Ochrophyta;Xanthophyceae;Tribonematales;";"0.0";"0";"11";"11";"0";"11";"0";"430513";"5766"
"LOK1378_1mm";"SILVA (only NR);Eukaryota;SAR;Stramenopiles;Ochrophyta;Xanthophyceae;Tribonematales;Asterosiphon;";"0.0";"0";"1";"1";"0";"1";"0";"430523";"5766"
"LOK1378_1mm";"SILVA (only NR);Eukaryota;SAR;Stramenopiles;Ochrophyta;Xanthophyceae;Tribonematales;Botrydium;";"0.0";"0";"2";"2";"0";"2";"0";"430522";"5766"
"LOK1378_1mm";"SILVA (only NR);Eukaryota;SAR;Stramenopiles;Ochrophyta;Xanthophyceae;Tribonematales;Ophiocytium;";"0.0";"0";"3";"3";"0";"3";"0";"430521";"5766"
"LOK1378_1mm";"SILVA (only NR);Eukaryota;SAR;Stramenopiles;Ochrophyta;Xanthophyceae;Tribonematales;Tribonema;";"0.0";"0";"3";"3";"0";"3";"0";"430521";"5766"
"LOK1378_1mm";"SILVA (only NR);Eukaryota;SAR;Stramenopiles;Ochrophyta;Xanthophyceae;Tribonematales;Xanthonema;";"0.0";"0";"1";"1";"0";"1";"0";"430523";"5766"
"LOK1378_1mm";"SILVA (only NR);Eukaryota;SAR;Stramenopiles;Ochrophyta;Xanthophyceae;Vaucheriales;";"0.0";"0";"2";"2";"0";"2";"0";"430522";"5766"
"LOK1378_1mm";"SILVA (only NR);Eukaryota;SAR;Stramenopiles;Ochrophyta;Xanthophyceae;Vaucheriales;Vaucheria;";"0.0";"0";"2";"2";"0";"2";"0";"430522";"5766"
"LOK1378_1mm";"SILVA (only NR);Eukaryota;SAR;Stramenopiles;Ochrophyta;Xanthophyceae;uncultured;";"0.0";"0";"2";"2";"0";"2";"0";"430522";"5766"
"LOK1378_1mm";"SILVA (only NR);Eukaryota;SAR;Stramenopiles;Opalinata;";"0.0";"0";"5";"5";"0";"5";"0";"430519";"5766"
"LOK1378_1mm";"SILVA (only NR);Eukaryota;SAR;Stramenopiles;Opalinata;Opalinea;";"0.0";"0";"1";"1";"0";"1";"0";"430523";"5766"
"LOK1378_1mm";"SILVA (only NR);Eukaryota;SAR;Stramenopiles;Opalinata;Opalinea;Protoopalina;";"0.0";"0";"1";"1";"0";"1";"0";"430523";"5766"
"LOK1378_1mm";"SILVA (only NR);Eukaryota;SAR;Stramenopiles;Opalinata;Proteromonadea;";"0.0";"0";"1";"1";"0";"1";"0";"430523";"5766"
"LOK1378_1mm";"SILVA (only NR);Eukaryota;SAR;Stramenopiles;Opalinata;Proteromonadea;Proteromonas;";"0.0";"0";"1";"1";"0";"1";"0";"430523";"5766"
"LOK1378_1mm";"SILVA (only NR);Eukaryota;SAR;Stramenopiles;Peronosporomycetes;";"0.0";"0";"177";"164";"0";"164";"13";"430360";"5766"
"LOK1378_1mm";"SILVA (only NR);Eukaryota;SAR;Stramenopiles;Peronosporomycetes;Achlya;";"0.0";"0";"2";"2";"0";"2";"0";"430522";"5766"
"LOK1378_1mm";"SILVA (only NR);Eukaryota;SAR;Stramenopiles;Peronosporomycetes;Aphanomyces;";"0.0";"0";"6";"5";"0";"5";"1";"430519";"5766"
"LOK1378_1mm";"SILVA (only NR);Eukaryota;SAR;Stramenopiles;Peronosporomycetes;Aplanopsis;";"0.0";"0";"1";"1";"0";"1";"0";"430523";"5766"
"LOK1378_1mm";"SILVA (only NR);Eukaryota;SAR;Stramenopiles;Peronosporomycetes;Apodachlya;";"0.0";"0";"1";"1";"0";"1";"0";"430523";"5766"
"LOK1378_1mm";"SILVA (only NR);Eukaryota;SAR;Stramenopiles;Peronosporomycetes;Atkinsiella;";"0.0";"0";"1";"1";"0";"1";"0";"430523";"5766"
"LOK1378_1mm";"SILVA (only NR);Eukaryota;SAR;Stramenopiles;Peronosporomycetes;Eurychasma;";"0.0";"0";"1";"1";"0";"1";"0";"430523";"5766"
"LOK1378_1mm";"SILVA (only NR);Eukaryota;SAR;Stramenopiles;Peronosporomycetes;Haliphthoros;";"0.0";"0";"4";"4";"0";"4";"0";"430520";"5766"
"LOK1378_1mm";"SILVA (only NR);Eukaryota;SAR;Stramenopiles;Peronosporomycetes;Halodaphnea;";"0.0";"0";"2";"2";"0";"2";"0";"430522";"5766"
"LOK1378_1mm";"SILVA (only NR);Eukaryota;SAR;Stramenopiles;Peronosporomycetes;Halophytophthora;";"0.0";"0";"7";"7";"0";"7";"0";"430517";"5766"
"LOK1378_1mm";"SILVA (only NR);Eukaryota;SAR;Stramenopiles;Peronosporomycetes;Haptoglossa;";"0.0";"0";"5";"5";"0";"5";"0";"430519";"5766"
"LOK1378_1mm";"SILVA (only NR);Eukaryota;SAR;Stramenopiles;Peronosporomycetes;Lagenidium;";"0.0";"0";"4";"4";"0";"4";"0";"430520";"5766"
"LOK1378_1mm";"SILVA (only NR);Eukaryota;SAR;Stramenopiles;Peronosporomycetes;Leptolegnia;";"0.0";"0";"2";"1";"0";"1";"1";"430523";"5766"
"LOK1378_1mm";"SILVA (only NR);Eukaryota;SAR;Stramenopiles;Peronosporomycetes;Myzocytiopsis;";"0.0";"0";"3";"3";"0";"3";"0";"430521";"5766"
"LOK1378_1mm";"SILVA (only NR);Eukaryota;SAR;Stramenopiles;Peronosporomycetes;Olpidiopsis;";"0.0";"0";"5";"4";"0";"4";"1";"430520";"5766"
"LOK1378_1mm";"SILVA (only NR);Eukaryota;SAR;Stramenopiles;Peronosporomycetes;Phytophthora;";"0.0";"0";"52";"48";"0";"48";"4";"430476";"5766"
"LOK1378_1mm";"SILVA (only NR);Eukaryota;SAR;Stramenopiles;Peronosporomycetes;Phytopythium;";"0.0";"0";"3";"3";"0";"3";"0";"430521";"5766"
"LOK1378_1mm";"SILVA (only NR);Eukaryota;SAR;Stramenopiles;Peronosporomycetes;Pythium;";"0.0";"0";"23";"22";"0";"22";"1";"430502";"5766"
"LOK1378_1mm";"SILVA (only NR);Eukaryota;SAR;Stramenopiles;Peronosporomycetes;Salispina;";"0.0";"0";"2";"2";"0";"2";"0";"430522";"5766"
"LOK1378_1mm";"SILVA (only NR);Eukaryota;SAR;Stramenopiles;Peronosporomycetes;Saprolegnia;";"0.0";"0";"3";"2";"0";"2";"1";"430522";"5766"
"LOK1378_1mm";"SILVA (only NR);Eukaryota;SAR;Stramenopiles;Peronosporomycetes;Sapromyces;";"0.0";"0";"1";"1";"0";"1";"0";"430523";"5766"
"LOK1378_1mm";"SILVA (only NR);Eukaryota;SAR;Stramenopiles;Peronosporomycetes;uncultured;";"0.0";"0";"25";"22";"0";"22";"3";"430502";"5766"
"LOK1378_1mm";"SILVA (only NR);Eukaryota;SAR;Stramenopiles;Placididea;";"0.0";"0";"9";"9";"0";"9";"0";"430515";"5766"
"LOK1378_1mm";"SILVA (only NR);Eukaryota;SAR;Stramenopiles;Placididea;Placidia;";"0.0";"0";"2";"2";"0";"2";"0";"430522";"5766"
"LOK1378_1mm";"SILVA (only NR);Eukaryota;SAR;Stramenopiles;Placididea;Suigetsumonas;";"0.0";"0";"3";"3";"0";"3";"0";"430521";"5766"
"LOK1378_1mm";"SILVA (only NR);Eukaryota;SAR;Stramenopiles;Placididea;Wobblia;";"0.0";"0";"2";"2";"0";"2";"0";"430522";"5766"
"LOK1378_1mm";"SILVA (only NR);Eukaryota;SAR;Stramenopiles;uncultured;";"0.0";"0";"12";"12";"0";"12";"0";"430512";"5766"
"LOK1378_1mm";"SILVA (only NR);Eukaryota;uncultured;";"0.0";"0";"11";"10";"0";"10";"1";"430514";"5766"
"LOK1378_1mm";"SILVA (only NR);";"1.3";"100";"458561";"430603";"5766";"424837";"27958";"0";"0"
